Month Ending,ME Date,Year,County,State,Vehicle Primary Use,Battery Electric Vehicles (BEVs),Plug-In Hybrid Electric Vehicles (PHEVs),Electric Vehicle (EV) Total,Non-Electric Vehicle Total,Total Vehicles,Percent Electric Vehicles
April,30,2017,Pinal,AZ,Passenger,2,0,2,254,256,0.78
April,30,2017,Island,WA,Passenger,108,128,236,59768,60004,0.39
April,30,2017,Clark,WA,Truck,0,0,0,77561,77561,0
April,30,2017,Allegheny,PA,Passenger,1,0,1,93,94,1.06
April,30,2017,Shelby,TN,Passenger,0,1,1,109,110,0.91
April,30,2017,Dale,AL,Passenger,0,1,1,65,66,1.52
April,30,2017,Jefferson,WA,Passenger,98,56,154,23744,23898,0.64
April,30,2017,,,Passenger,3,1,4,672,676,0.59
April,30,2017,Harnett,NC,Passenger,1,0,1,257,258,0.39
April,30,2017,Salt Lake,UT,Passenger,0,1,1,289,290,0.34
April,30,2017,Yakima,WA,Truck,0,0,0,57219,57219,0
April,30,2017,Montgomery,PA,Passenger,1,0,1,41,42,2.38
April,30,2017,Skamania,WA,Truck,0,0,0,3874,3874,0
April,30,2017,Whitman,WA,Passenger,9,19,28,21964,21992,0.13
April,30,2017,Utah,UT,Passenger,0,1,1,164,165,0.61
April,30,2017,Clark,WA,Passenger,755,471,1226,298474,299700,0.41
April,30,2017,Adams,WA,Passenger,2,3,5,12128,12133,0.04
April,30,2017,Franklin,WA,Passenger,27,47,74,55348,55422,0.13
April,30,2017,Ferry,WA,Truck,0,0,0,3549,3549,0
April,30,2017,San Juan,WA,Truck,0,0,0,5551,5551,0
April,30,2017,Los Angeles,CA,Passenger,3,1,4,1345,1349,0.3
April,30,2017,Lee,AL,Passenger,1,0,1,35,36,2.78
April,30,2017,Klickitat,WA,Passenger,22,23,45,14768,14813,0.3
April,30,2017,Clark,NV,Passenger,1,3,4,857,861,0.46
April,30,2017,Tarrant,TX,Passenger,0,2,2,273,275,0.73
April,30,2017,Skagit,WA,Truck,1,0,1,31395,31396,0
April,30,2017,Monterey,CA,Passenger,0,1,1,210,211,0.47
April,30,2017,San Juan,WA,Passenger,98,35,133,13479,13612,0.98
April,30,2017,Douglas,OR,Passenger,0,1,1,74,75,1.33
April,30,2017,Montgomery,TN,Passenger,1,0,1,293,294,0.34
April,30,2017,Adams,WA,Truck,0,0,0,5072,5072,0
April,30,2017,Lewis,WA,Passenger,46,33,79,55192,55271,0.14
April,30,2017,Lane,OR,Passenger,0,1,1,247,248,0.4
April,30,2017,Whatcom,WA,Truck,2,0,2,41449,41451,0
April,30,2017,Lincoln,WA,Truck,0,0,0,4464,4464,0
April,30,2017,Cobb,GA,Passenger,0,1,1,77,78,1.28
April,30,2017,Juneau,AK,Passenger,0,1,1,53,54,1.85
April,30,2017,Morris,NJ,Passenger,1,0,1,22,23,4.35
April,30,2017,Grays Harbor,WA,Truck,0,0,0,19850,19850,0
April,30,2017,Wayne,MI,Passenger,0,1,1,70,71,1.41
April,30,2017,Okanogan,WA,Passenger,3,16,19,25595,25614,0.07
April,30,2017,Canyon,ID,Passenger,0,1,1,102,103,0.97
April,30,2017,Kitsap,WA,Truck,1,0,1,52312,52313,0
April,30,2017,Fulton,GA,Passenger,1,1,2,119,121,1.65
April,30,2017,Manatee,FL,Passenger,1,0,1,48,49,2.04
April,30,2017,Garfield,WA,Truck,0,0,0,938,938,0
April,30,2017,Nassau,NY,Passenger,0,1,1,40,41,2.44
April,30,2017,Multnomah,OR,Passenger,0,3,3,1068,1071,0.28
April,30,2017,Lewis,WA,Truck,0,0,0,24797,24797,0
April,30,2017,Asotin,WA,Passenger,6,2,8,12343,12351,0.06
April,30,2017,Latah,ID,Passenger,0,1,1,120,121,0.83
April,30,2017,Santa Clara,CA,Passenger,6,2,8,411,419,1.91
April,30,2017,Moore,NC,Passenger,0,1,1,205,206,0.49
April,30,2017,Thurston,WA,Passenger,385,319,704,185729,186433,0.38
April,30,2017,Middlesex,MA,Passenger,1,0,1,148,149,0.67
April,30,2017,Bexar,TX,Passenger,1,0,1,1025,1026,0.1
April,30,2017,Walla Walla,WA,Passenger,22,24,46,34828,34874,0.13
April,30,2017,Stevens,WA,Passenger,8,22,30,31233,31263,0.1
April,30,2017,Okanogan,WA,Truck,0,0,0,16256,16256,0
April,30,2017,Pierce,WA,Truck,0,0,0,137818,137818,0
April,30,2017,Douglas,WA,Passenger,31,21,52,26603,26655,0.2
April,30,2017,Franklin,WA,Truck,0,0,0,17995,17995,0
April,30,2017,Manassas,VA,Passenger,0,1,1,10,11,9.09
April,30,2017,Albemarle,VA,Passenger,0,1,1,31,32,3.12
April,30,2017,Prince George's,MD,Passenger,0,1,1,182,183,0.55
April,30,2017,Hamilton,TN,Passenger,1,0,1,26,27,3.7
April,30,2017,Tulare,CA,Passenger,1,0,1,194,195,0.51
April,30,2017,Franklin,MA,Passenger,0,1,1,4,5,20
April,30,2017,Hardin,KY,Passenger,0,1,1,123,124,0.81
April,30,2017,Fairfax,VA,Passenger,2,2,4,860,864,0.46
April,30,2017,Okaloosa,FL,Passenger,1,0,1,194,195,0.51
April,30,2017,Spokane,WA,Truck,1,0,1,90266,90267,0
April,30,2017,Hamilton,IN,Passenger,1,0,1,61,62,1.61
April,30,2017,Muscogee,GA,Passenger,0,1,1,247,248,0.4
April,30,2017,Nueces,TX,Passenger,0,1,1,98,99,1.01
April,30,2017,King,WA,Truck,8,1,9,188938,188947,0
April,30,2017,Franklin,OH,Passenger,0,1,1,126,127,0.79
April,30,2017,Klickitat,WA,Truck,0,0,0,7954,7954,0
April,30,2017,Virginia Beach,VA,Passenger,2,1,3,645,648,0.46
April,30,2017,Bergen,NJ,Passenger,0,2,2,32,34,5.88
April,30,2017,Orleans,LA,Passenger,0,1,1,49,50,2
April,30,2017,San Diego,CA,Passenger,5,1,6,2768,2774,0.22
April,30,2017,Clallam,WA,Passenger,80,68,148,48127,48275,0.31
April,30,2017,Thurston,WA,Truck,0,0,0,53255,53255,0
April,30,2017,Anne Arundel,MD,Passenger,0,1,1,500,501,0.2
April,30,2017,Saratoga,NY,Passenger,1,1,2,75,77,2.6
April,30,2017,Pacific,WA,Truck,0,0,0,7464,7464,0
April,30,2017,Cumberland,NC,Passenger,1,0,1,612,613,0.16
April,30,2017,Marion,OR,Passenger,1,0,1,181,182,0.55
April,30,2017,Marin,CA,Passenger,1,0,1,60,61,1.64
April,30,2017,Columbia,WA,Truck,0,0,0,1536,1536,0
April,30,2017,El Paso,CO,Passenger,1,1,2,820,822,0.24
April,30,2017,Lincoln,WA,Passenger,2,4,6,7481,7487,0.08
April,30,2017,St. Lucie,FL,Passenger,1,0,1,32,33,3.03
April,30,2017,DeKalb,IN,Passenger,1,0,1,1,2,50
April,30,2017,Richmond,GA,Passenger,0,1,1,93,94,1.06
April,30,2017,Essex,NJ,Passenger,1,0,1,16,17,5.88
April,30,2017,Santa Fe,NM,Passenger,0,1,1,44,45,2.22
April,30,2017,Travis,TX,Passenger,0,1,1,195,196,0.51
April,30,2017,Deschutes,OR,Passenger,1,0,1,198,199,0.5
April,30,2017,Gwinnett,GA,Passenger,0,1,1,87,88,1.14
April,30,2017,Grant,WA,Truck,0,0,0,25091,25091,0
April,30,2017,Norfolk,MA,Passenger,1,0,1,38,39,2.56
April,30,2017,Clackamas,OR,Passenger,1,1,2,325,327,0.61
April,30,2017,Ventura,CA,Passenger,0,1,1,362,363,0.28
April,30,2017,Pacific,WA,Passenger,9,8,17,15082,15099,0.11
April,30,2017,Jefferson,WA,Truck,0,0,0,9442,9442,0
April,30,2017,Missoula,MT,Passenger,1,0,1,77,78,1.28
April,30,2017,Charles,MD,Passenger,0,1,1,90,91,1.1
April,30,2017,Volusia,FL,Passenger,0,1,1,47,48,2.08
April,30,2017,Yakima,WA,Passenger,38,54,92,159283,159375,0.06
April,30,2017,Duval,FL,Passenger,1,1,2,378,380,0.53
April,30,2017,Prince William,VA,Passenger,0,3,3,275,278,1.08
April,30,2017,Orange,CA,Passenger,2,1,3,646,649,0.46
April,30,2017,Walla Walla,WA,Truck,0,0,0,13177,13177,0
April,30,2017,Chelan,WA,Truck,0,0,0,21208,21208,0
April,30,2017,Madison,ID,Passenger,1,0,1,41,42,2.38
April,30,2017,Grant,WA,Passenger,18,21,39,60489,60528,0.06
April,30,2017,Whitman,WA,Truck,0,0,0,8380,8380,0
April,30,2017,Lewis,NY,Passenger,0,1,1,10,11,9.09
April,30,2017,Maui,HI,Passenger,1,0,1,72,73,1.37
April,30,2017,Santa Rosa,FL,Passenger,1,0,1,109,110,0.91
April,30,2017,Spokane,WA,Passenger,236,208,444,295746,296190,0.15
April,30,2017,Grays Harbor,WA,Passenger,29,30,59,44477,44536,0.13
April,30,2017,Maricopa,AZ,Passenger,2,0,2,1800,1802,0.11
April,30,2017,Wahkiakum,WA,Passenger,0,2,2,2848,2850,0.07
April,30,2017,Nantucket,MA,Passenger,1,0,1,3,4,25
April,30,2017,Skamania,WA,Passenger,9,8,17,8521,8538,0.2
April,30,2017,Arlington,VA,Passenger,1,1,2,166,168,1.19
April,30,2017,New London,CT,Passenger,1,1,2,257,259,0.77
April,30,2017,Mason,WA,Truck,0,0,0,19242,19242,0
April,30,2017,Pima,AZ,Passenger,0,2,2,442,444,0.45
April,30,2017,New Haven,CT,Passenger,0,1,1,60,61,1.64
April,30,2017,Norfolk,VA,Passenger,1,1,2,301,303,0.66
April,30,2017,DeKalb,GA,Passenger,1,0,1,84,85,1.18
April,30,2017,Hidalgo,TX,Passenger,0,1,1,98,99,1.01
April,30,2017,King,WA,Passenger,9558,3882,13440,1378548,1391988,0.97
April,30,2017,Orange,FL,Passenger,1,1,2,149,151,1.32
April,30,2017,Clallam,WA,Truck,0,0,0,20962,20962,0
April,30,2017,Sumter,FL,Passenger,0,1,1,10,11,9.09
April,30,2017,Pierce,WA,Passenger,917,807,1724,525754,527478,0.33
April,30,2017,Jefferson,NY,Passenger,1,1,2,255,257,0.78
April,30,2017,Benton,WA,Passenger,143,140,283,128087,128370,0.22
April,30,2017,Island,WA,Truck,0,0,0,20526,20526,0
April,30,2017,Cape May,NJ,Passenger,0,1,1,18,19,5.26
April,30,2017,Guilford,NC,Passenger,1,0,1,31,32,3.12
April,30,2017,Kittitas,WA,Truck,0,0,0,13478,13478,0
April,30,2017,San Mateo,CA,Passenger,0,1,1,158,159,0.63
April,30,2017,District of Columbia,DC,Passenger,0,3,3,225,228,1.32
April,30,2017,Skagit,WA,Passenger,123,97,220,87597,87817,0.25
April,30,2017,Stevens,WA,Truck,0,0,0,18286,18286,0
April,30,2017,Cowlitz,WA,Truck,0,0,0,27856,27856,0
April,30,2017,Snohomish,WA,Passenger,1709,861,2570,512767,515337,0.5
April,30,2017,Riverside,CA,Passenger,1,1,2,829,831,0.24
April,30,2017,Dallas,TX,Passenger,0,1,1,196,197,0.51
April,30,2017,Alameda,CA,Passenger,2,1,3,379,382,0.79
April,30,2017,Portsmouth,VA,Passenger,0,1,1,68,69,1.45
April,30,2017,Jackson,MO,Passenger,1,0,1,68,69,1.45
April,30,2017,Ferry,WA,Passenger,2,1,3,4397,4400,0.07
April,30,2017,Kitsap,WA,Passenger,584,298,882,172672,173554,0.51
April,30,2017,Dakota,MN,Passenger,0,1,1,40,41,2.44
April,30,2017,Douglas,WA,Truck,0,0,0,11451,11451,0
April,30,2017,Wahkiakum,WA,Truck,0,0,0,1631,1631,0
April,30,2017,Honolulu,HI,Passenger,4,2,6,604,610,0.98
April,30,2017,Montgomery,MD,Passenger,1,0,1,308,309,0.32
April,30,2017,Chelan,WA,Passenger,55,31,86,51695,51781,0.17
April,30,2017,Mason,WA,Passenger,49,64,113,43002,43115,0.26
April,30,2017,Polk,FL,Passenger,1,0,1,67,68,1.47
April,30,2017,Kent,MI,Passenger,0,1,1,37,38,2.63
April,30,2017,Hawaii,HI,Passenger,1,0,1,84,85,1.18
April,30,2017,Cascade,MT,Passenger,0,1,1,61,62,1.61
April,30,2017,Northampton,PA,Passenger,2,0,2,192,194,1.03
April,30,2017,Columbia,WA,Passenger,0,1,1,2358,2359,0.04
April,30,2017,Asotin,WA,Truck,0,0,0,6504,6504,0
April,30,2017,Dane,WI,Passenger,1,0,1,138,139,0.72
April,30,2017,Whatcom,WA,Passenger,441,159,600,142459,143059,0.42
April,30,2017,Carroll,NH,Passenger,0,1,1,0,1,100
April,30,2017,Monroe,NY,Passenger,1,0,1,27,28,3.57
April,30,2017,Garfield,WA,Passenger,0,0,0,1283,1283,0
April,30,2017,Palm Beach,FL,Passenger,0,1,1,100,101,0.99
April,30,2017,Pend Oreille,WA,Truck,0,0,0,5586,5586,0
April,30,2017,Benton,WA,Truck,0,0,0,39892,39892,0
April,30,2017,Pend Oreille,WA,Passenger,1,4,5,9320,9325,0.05
April,30,2017,Cowlitz,WA,Passenger,52,48,100,69320,69420,0.14
April,30,2017,Kittitas,WA,Passenger,21,17,38,27202,27240,0.14
April,30,2017,Snohomish,WA,Truck,1,0,1,122009,122010,0
April,30,2017,Howard,MD,Passenger,0,2,2,90,92,2.17
August,31,2017,Tuolumne,CA,Passenger,0,1,1,14,15,6.67
August,31,2017,Lincoln,WA,Passenger,1,5,6,7571,7577,0.08
August,31,2017,Asotin,WA,Passenger,8,5,13,12444,12457,0.1
August,31,2017,Thurston,WA,Truck,0,0,0,53429,53429,0
August,31,2017,Hawaii,HI,Passenger,1,0,1,77,78,1.28
August,31,2017,Essex,NJ,Passenger,1,0,1,13,14,7.14
August,31,2017,Kitsap,WA,Passenger,637,336,973,173831,174804,0.56
August,31,2017,Twin Falls,ID,Passenger,0,1,1,22,23,4.35
August,31,2017,Walla Walla,WA,Truck,0,0,0,13188,13188,0
August,31,2017,Saratoga,NY,Passenger,1,1,2,72,74,2.7
August,31,2017,Manatee,FL,Passenger,1,0,1,42,43,2.33
August,31,2017,Jefferson,NY,Passenger,1,0,1,245,246,0.41
August,31,2017,Lane,OR,Passenger,0,1,1,223,224,0.45
August,31,2017,Sacramento,CA,Passenger,1,0,1,345,346,0.29
August,31,2017,Lewis,WA,Truck,0,0,0,25013,25013,0
August,31,2017,Palm Beach,FL,Passenger,0,1,1,98,99,1.01
August,31,2017,Los Angeles,CA,Passenger,3,2,5,1251,1256,0.4
August,31,2017,Franklin,WA,Truck,0,0,0,18234,18234,0
August,31,2017,Ferry,WA,Truck,0,0,0,3532,3532,0
August,31,2017,Asotin,WA,Truck,0,0,0,6515,6515,0
August,31,2017,Lee,AL,Passenger,1,0,1,36,37,2.7
August,31,2017,Santa Clara,CA,Passenger,5,2,7,393,400,1.75
August,31,2017,Fairfax,VA,Passenger,2,2,4,841,845,0.47
August,31,2017,Grays Harbor,WA,Passenger,37,37,74,44965,45039,0.16
August,31,2017,Snohomish,WA,Passenger,1847,942,2789,513730,516519,0.54
August,31,2017,Wahkiakum,WA,Passenger,0,2,2,2834,2836,0.07
August,31,2017,Missoula,MT,Passenger,1,0,1,70,71,1.41
August,31,2017,Skamania,WA,Passenger,10,7,17,8571,8588,0.2
August,31,2017,Gwinnett,GA,Passenger,0,1,1,84,85,1.18
August,31,2017,Garfield,WA,Truck,0,0,0,932,932,0
August,31,2017,Orange,FL,Passenger,1,1,2,144,146,1.37
August,31,2017,Columbia,WA,Truck,0,0,0,1541,1541,0
August,31,2017,Kittitas,WA,Passenger,27,21,48,27891,27939,0.17
August,31,2017,Pinal,AZ,Passenger,2,0,2,227,229,0.87
August,31,2017,Albemarle,VA,Passenger,0,1,1,32,33,3.03
August,31,2017,Ferry,WA,Passenger,1,1,2,4396,4398,0.05
August,31,2017,Howard,MD,Passenger,0,2,2,89,91,2.2
August,31,2017,Chelan,WA,Passenger,72,36,108,52309,52417,0.21
August,31,2017,Duval,FL,Passenger,1,1,2,377,379,0.53
August,31,2017,Virginia Beach,VA,Passenger,2,1,3,646,649,0.46
August,31,2017,Sedgwick,KS,Passenger,0,1,1,104,105,0.95
August,31,2017,Pierce,WA,Truck,0,0,0,137231,137231,0
August,31,2017,Clark,WA,Passenger,794,528,1322,300774,302096,0.44
August,31,2017,DeKalb,GA,Passenger,1,0,1,86,87,1.15
August,31,2017,Skamania,WA,Truck,0,0,0,3876,3876,0
August,31,2017,Whitman,WA,Truck,0,0,0,8451,8451,0
August,31,2017,Hamilton,TN,Passenger,1,0,1,20,21,4.76
August,31,2017,,,Passenger,5,1,6,689,695,0.86
August,31,2017,Fulton,GA,Passenger,1,0,1,109,110,0.91
August,31,2017,Arlington,VA,Passenger,1,2,3,166,169,1.78
August,31,2017,Jefferson,WA,Passenger,112,64,176,23954,24130,0.73
August,31,2017,Pend Oreille,WA,Passenger,3,4,7,9358,9365,0.07
August,31,2017,Franklin,WA,Passenger,27,48,75,55929,56004,0.13
August,31,2017,Tarrant,TX,Passenger,1,0,1,233,234,0.43
August,31,2017,Montgomery,PA,Passenger,1,0,1,40,41,2.44
August,31,2017,Ramsey,MN,Passenger,1,0,1,39,40,2.5
August,31,2017,Chelan,WA,Truck,0,0,0,21363,21363,0
August,31,2017,Alameda,CA,Passenger,0,1,1,358,359,0.28
August,31,2017,Kitsap,WA,Truck,1,0,1,52562,52563,0
August,31,2017,Travis,TX,Passenger,0,1,1,194,195,0.51
August,31,2017,Riverside,CA,Passenger,1,2,3,769,772,0.39
August,31,2017,Montgomery,TX,Passenger,1,0,1,60,61,1.64
August,31,2017,Utah,UT,Passenger,0,1,1,147,148,0.68
August,31,2017,Grant,WA,Truck,0,0,0,25352,25352,0
August,31,2017,Adams,WA,Passenger,3,3,6,12183,12189,0.05
August,31,2017,Tulare,CA,Passenger,1,0,1,197,198,0.51
August,31,2017,El Paso,CO,Passenger,2,0,2,777,779,0.26
August,31,2017,Stevens,WA,Passenger,8,22,30,31514,31544,0.1
August,31,2017,Cape May,NJ,Passenger,0,1,1,18,19,5.26
August,31,2017,DeKalb,IN,Passenger,1,0,1,1,2,50
August,31,2017,Kent,MI,Passenger,0,1,1,38,39,2.56
August,31,2017,Hardin,KY,Passenger,0,1,1,122,123,0.81
August,31,2017,Shelby,TN,Passenger,0,1,1,103,104,0.96
August,31,2017,Lewis,WA,Passenger,55,38,93,55794,55887,0.17
August,31,2017,Clark,WA,Truck,0,0,0,77898,77898,0
August,31,2017,Pacific,WA,Passenger,10,9,19,15248,15267,0.12
August,31,2017,Klickitat,WA,Truck,0,0,0,7970,7970,0
August,31,2017,St. Clair,IL,Passenger,0,1,1,168,169,0.59
August,31,2017,Montgomery,TN,Passenger,1,0,1,281,282,0.35
August,31,2017,Morris,NJ,Passenger,1,0,1,23,24,4.17
August,31,2017,Dakota,MN,Passenger,0,2,2,36,38,5.26
August,31,2017,Cowlitz,WA,Truck,0,0,0,27992,27992,0
August,31,2017,Pacific,WA,Truck,0,0,0,7515,7515,0
August,31,2017,Madison,ID,Passenger,1,0,1,37,38,2.63
August,31,2017,Benton,WA,Truck,0,0,0,40164,40164,0
August,31,2017,Whatcom,WA,Passenger,481,182,663,143561,144224,0.46
August,31,2017,Wayne,MI,Passenger,0,1,1,67,68,1.47
August,31,2017,Prince William,VA,Passenger,0,3,3,267,270,1.11
August,31,2017,Moore,NC,Passenger,0,1,1,200,201,0.5
August,31,2017,Yakima,WA,Passenger,54,67,121,160149,160270,0.08
August,31,2017,Frederick,MD,Passenger,0,1,1,83,84,1.19
August,31,2017,San Juan,WA,Passenger,113,39,152,13645,13797,1.1
August,31,2017,Snohomish,WA,Truck,1,0,1,121668,121669,0
August,31,2017,Northampton,PA,Passenger,0,1,1,97,98,1.02
August,31,2017,Nueces,TX,Passenger,0,1,1,94,95,1.05
August,31,2017,Santa Fe,NM,Passenger,0,1,1,43,44,2.27
August,31,2017,Juneau,AK,Passenger,0,1,1,43,44,2.27
August,31,2017,Wahkiakum,WA,Truck,0,0,0,1655,1655,0
August,31,2017,Garfield,WA,Passenger,1,0,1,1302,1303,0.08
August,31,2017,Montgomery,MD,Passenger,1,0,1,307,308,0.32
August,31,2017,Monterey,CA,Passenger,0,2,2,195,197,1.02
August,31,2017,Canyon,ID,Passenger,0,1,1,97,98,1.02
August,31,2017,Polk,FL,Passenger,1,0,1,64,65,1.54
August,31,2017,Thurston,WA,Passenger,421,359,780,187775,188555,0.41
August,31,2017,Flathead,MT,Passenger,1,0,1,59,60,1.67
August,31,2017,Portsmouth,VA,Passenger,0,1,1,65,66,1.52
August,31,2017,Stevens,WA,Truck,0,0,0,18218,18218,0
August,31,2017,Charles,MD,Passenger,0,1,1,85,86,1.16
August,31,2017,Dale,AL,Passenger,0,1,1,63,64,1.56
August,31,2017,New Haven,CT,Passenger,0,1,1,57,58,1.72
August,31,2017,Walla Walla,WA,Passenger,27,27,54,34981,35035,0.15
August,31,2017,Jefferson,WA,Truck,0,0,0,9427,9427,0
August,31,2017,Kittitas,WA,Truck,0,0,0,13610,13610,0
August,31,2017,Pierce,WA,Passenger,999,866,1865,524926,526791,0.35
August,31,2017,Spokane,WA,Passenger,268,220,488,297411,297899,0.16
August,31,2017,Skagit,WA,Passenger,140,112,252,88466,88718,0.28
August,31,2017,Carroll,NH,Passenger,0,1,1,1,2,50
August,31,2017,Norfolk,VA,Passenger,1,1,2,313,315,0.63
August,31,2017,Maui,HI,Passenger,1,0,1,69,70,1.43
August,31,2017,Benton,WA,Passenger,161,147,308,129043,129351,0.24
August,31,2017,Adams,WA,Truck,0,0,0,5097,5097,0
August,31,2017,Orange,CA,Passenger,3,1,4,611,615,0.65
August,31,2017,Okaloosa,FL,Passenger,1,0,1,184,185,0.54
August,31,2017,Clark,NV,Passenger,1,2,3,795,798,0.38
August,31,2017,King,WA,Truck,7,1,8,186770,186778,0
August,31,2017,District of Columbia,DC,Passenger,0,2,2,206,208,0.96
August,31,2017,Pend Oreille,WA,Truck,0,0,0,5552,5552,0
August,31,2017,Pima,AZ,Passenger,1,2,3,418,421,0.71
August,31,2017,Douglas,WA,Truck,0,0,0,11570,11570,0
August,31,2017,Clallam,WA,Passenger,96,79,175,48546,48721,0.36
August,31,2017,Sangamon,IL,Passenger,1,0,1,11,12,8.33
August,31,2017,Nantucket,MA,Passenger,1,0,1,3,4,25
August,31,2017,Latah,ID,Passenger,0,1,1,92,93,1.08
August,31,2017,Whatcom,WA,Truck,2,0,2,41764,41766,0
August,31,2017,Spokane,WA,Truck,1,0,1,90996,90997,0
August,31,2017,Okanogan,WA,Passenger,4,18,22,25673,25695,0.09
August,31,2017,Lincoln,WA,Truck,0,0,0,4457,4457,0
August,31,2017,New London,CT,Passenger,1,1,2,255,257,0.78
August,31,2017,Okanogan,WA,Truck,0,0,0,16242,16242,0
August,31,2017,Santa Rosa,FL,Passenger,1,0,1,110,111,0.9
August,31,2017,Grant,WA,Passenger,19,32,51,61193,61244,0.08
August,31,2017,Multnomah,OR,Passenger,1,3,4,937,941,0.43
August,31,2017,Allegheny,PA,Passenger,1,0,1,89,90,1.11
August,31,2017,Douglas,WA,Passenger,35,27,62,26835,26897,0.23
August,31,2017,Cowlitz,WA,Passenger,50,62,112,70013,70125,0.16
August,31,2017,San Mateo,CA,Passenger,0,1,1,150,151,0.66
August,31,2017,Anne Arundel,MD,Passenger,0,1,1,496,497,0.2
August,31,2017,Jackson,MO,Passenger,1,0,1,57,58,1.72
August,31,2017,Grays Harbor,WA,Truck,0,0,0,19935,19935,0
August,31,2017,San Juan,WA,Truck,0,0,0,5549,5549,0
August,31,2017,King,WA,Passenger,10441,4267,14708,1372396,1387104,1.06
August,31,2017,Manassas,VA,Passenger,0,1,1,9,10,10
August,31,2017,Maricopa,AZ,Passenger,2,0,2,1690,1692,0.12
August,31,2017,Deschutes,OR,Passenger,1,0,1,194,195,0.51
August,31,2017,Norfolk,MA,Passenger,1,0,1,38,39,2.56
August,31,2017,Marin,CA,Passenger,1,0,1,58,59,1.69
August,31,2017,Franklin,MA,Passenger,0,1,1,4,5,20
August,31,2017,Island,WA,Passenger,124,149,273,60582,60855,0.45
August,31,2017,Richmond,GA,Passenger,0,1,1,88,89,1.12
August,31,2017,Mason,WA,Truck,0,0,0,19333,19333,0
August,31,2017,Mason,WA,Passenger,59,73,132,43923,44055,0.3
August,31,2017,Dallas,TX,Passenger,0,1,1,181,182,0.55
August,31,2017,Prince George's,MD,Passenger,0,1,1,187,188,0.53
August,31,2017,Columbia,WA,Passenger,1,1,2,2352,2354,0.08
August,31,2017,Nassau,NY,Passenger,1,1,2,39,41,4.88
August,31,2017,St. Lucie,FL,Passenger,1,0,1,28,29,3.45
August,31,2017,Orleans,LA,Passenger,0,1,1,44,45,2.22
August,31,2017,Richland,SC,Passenger,0,1,1,188,189,0.53
August,31,2017,Bexar,TX,Passenger,1,1,2,852,854,0.23
August,31,2017,Cobb,GA,Passenger,0,1,1,73,74,1.35
August,31,2017,Volusia,FL,Passenger,0,1,1,46,47,2.13
August,31,2017,Franklin,OH,Passenger,0,1,1,115,116,0.86
August,31,2017,Island,WA,Truck,0,0,0,20519,20519,0
August,31,2017,Clallam,WA,Truck,0,0,0,21059,21059,0
August,31,2017,Yakima,WA,Truck,0,0,0,57643,57643,0
August,31,2017,Sumter,FL,Passenger,0,1,1,10,11,9.09
August,31,2017,Skagit,WA,Truck,1,0,1,31515,31516,0
August,31,2017,Hamilton,IN,Passenger,1,0,1,58,59,1.69
August,31,2017,Klickitat,WA,Passenger,21,24,45,14782,14827,0.3
August,31,2017,San Diego,CA,Passenger,6,1,7,2660,2667,0.26
August,31,2017,Lumpkin,GA,Passenger,1,0,1,9,10,10
August,31,2017,Whitman,WA,Passenger,11,22,33,22128,22161,0.15
August,31,2017,Bergen,NJ,Passenger,0,2,2,30,32,6.25
August,31,2017,Honolulu,HI,Passenger,3,2,5,561,566,0.88
December,31,2017,Wahkiakum,WA,Passenger,0,2,2,2860,2862,0.07
December,31,2017,Sangamon,IL,Passenger,1,0,1,10,11,9.09
December,31,2017,Franklin,WA,Truck,0,0,0,18492,18492,0
December,31,2017,San Juan,WA,Passenger,132,43,175,13853,14028,1.25
December,31,2017,Jefferson,WA,Truck,0,0,0,9475,9475,0
December,31,2017,DuPage,IL,Passenger,1,0,1,61,62,1.61
December,31,2017,Lincoln,WA,Passenger,2,5,7,7569,7576,0.09
December,31,2017,Montgomery,TN,Passenger,1,0,1,269,270,0.37
December,31,2017,Okanogan,WA,Passenger,7,18,25,25740,25765,0.1
December,31,2017,Marin,CA,Passenger,1,0,1,58,59,1.69
December,31,2017,Tarrant,TX,Passenger,1,0,1,228,229,0.44
December,31,2017,Orange,CA,Passenger,3,1,4,576,580,0.69
December,31,2017,Richmond,GA,Passenger,0,1,1,93,94,1.06
December,31,2017,Whitman,WA,Passenger,17,20,37,22426,22463,0.16
December,31,2017,Kittitas,WA,Passenger,35,26,61,28449,28510,0.21
December,31,2017,Duval,FL,Passenger,1,2,3,370,373,0.8
December,31,2017,Alameda,CA,Passenger,0,1,1,352,353,0.28
December,31,2017,Stevens,WA,Truck,0,0,0,18379,18379,0
December,31,2017,Santa Rosa,FL,Passenger,1,0,1,103,104,0.96
December,31,2017,Palm Beach,FL,Passenger,0,1,1,90,91,1.1
December,31,2017,Multnomah,OR,Passenger,3,3,6,879,885,0.68
December,31,2017,Hamilton,IN,Passenger,1,0,1,54,55,1.82
December,31,2017,Lewis,WA,Passenger,54,40,94,56571,56665,0.17
December,31,2017,Yakima,WA,Passenger,59,75,134,162075,162209,0.08
December,31,2017,Stevens,WA,Passenger,10,21,31,31533,31564,0.1
December,31,2017,Deschutes,OR,Passenger,1,0,1,178,179,0.56
December,31,2017,Columbia,WA,Truck,0,0,0,1540,1540,0
December,31,2017,King,WA,Truck,8,1,9,185056,185065,0
December,31,2017,Polk,FL,Passenger,1,0,1,61,62,1.61
December,31,2017,Pend Oreille,WA,Truck,0,0,0,5618,5618,0
December,31,2017,Twin Falls,ID,Passenger,0,1,1,24,25,4
December,31,2017,Canyon,ID,Passenger,0,1,1,92,93,1.08
December,31,2017,Asotin,WA,Truck,0,0,0,6543,6543,0
December,31,2017,Fulton,GA,Passenger,1,0,1,106,107,0.93
December,31,2017,Moore,NC,Passenger,0,1,1,199,200,0.5
December,31,2017,Manatee,FL,Passenger,1,0,1,39,40,2.5
December,31,2017,Clallam,WA,Passenger,99,91,190,49056,49246,0.39
December,31,2017,Columbia,WA,Passenger,2,1,3,2403,2406,0.12
December,31,2017,Garfield,WA,Truck,0,0,0,943,943,0
December,31,2017,Kitsap,WA,Truck,1,0,1,52687,52688,0
December,31,2017,Klickitat,WA,Truck,0,0,0,8003,8003,0
December,31,2017,Hardin,KY,Passenger,0,1,1,119,120,0.83
December,31,2017,Snohomish,WA,Passenger,2016,1051,3067,516915,519982,0.59
December,31,2017,Sacramento,CA,Passenger,1,0,1,311,312,0.32
December,31,2017,Pacific,WA,Truck,0,0,0,7545,7545,0
December,31,2017,Whatcom,WA,Passenger,532,227,759,145194,145953,0.52
December,31,2017,Clark,WA,Truck,0,0,0,78388,78388,0
December,31,2017,Gwinnett,GA,Passenger,0,1,1,83,84,1.19
December,31,2017,Prince William,VA,Passenger,0,3,3,271,274,1.09
December,31,2017,Howard,MD,Passenger,0,2,2,87,89,2.25
December,31,2017,Okaloosa,FL,Passenger,1,0,1,184,185,0.54
December,31,2017,Norfolk,MA,Passenger,1,0,1,38,39,2.56
December,31,2017,Grays Harbor,WA,Truck,0,0,0,20064,20064,0
December,31,2017,Lee,AL,Passenger,1,0,1,37,38,2.63
December,31,2017,Contra Costa,CA,Passenger,0,1,1,467,468,0.21
December,31,2017,Monterey,CA,Passenger,0,2,2,191,193,1.04
December,31,2017,Albemarle,VA,Passenger,0,1,1,32,33,3.03
December,31,2017,Santa Clara,CA,Passenger,7,1,8,383,391,2.05
December,31,2017,Ramsey,MN,Passenger,1,0,1,38,39,2.56
December,31,2017,Benton,WA,Passenger,172,168,340,130229,130569,0.26
December,31,2017,Travis,TX,Passenger,0,1,1,188,189,0.53
December,31,2017,Douglas,WA,Truck,0,0,0,11757,11757,0
December,31,2017,Douglas,WA,Passenger,38,33,71,27171,27242,0.26
December,31,2017,Maui,HI,Passenger,1,0,1,67,68,1.47
December,31,2017,DeKalb,IN,Passenger,1,0,1,1,2,50
December,31,2017,Jefferson,WA,Passenger,121,74,195,24283,24478,0.8
December,31,2017,Spokane,WA,Truck,1,0,1,91580,91581,0
December,31,2017,Grant,WA,Passenger,26,35,61,62097,62158,0.1
December,31,2017,Madison,ID,Passenger,1,0,1,39,40,2.5
December,31,2017,Pima,AZ,Passenger,1,1,2,409,411,0.49
December,31,2017,,,Passenger,5,1,6,711,717,0.84
December,31,2017,Pierce,WA,Truck,0,0,0,137028,137028,0
December,31,2017,Ada,ID,Passenger,0,1,1,349,350,0.29
December,31,2017,Whatcom,WA,Truck,1,0,1,42016,42017,0
December,31,2017,DeKalb,GA,Passenger,1,0,1,87,88,1.14
December,31,2017,Nassau,NY,Passenger,1,1,2,38,40,5
December,31,2017,Prince George's,MD,Passenger,0,1,1,177,178,0.56
December,31,2017,Thurston,WA,Passenger,470,391,861,190046,190907,0.45
December,31,2017,Cowlitz,WA,Truck,0,0,0,28150,28150,0
December,31,2017,Bexar,TX,Passenger,1,2,3,822,825,0.36
December,31,2017,Skagit,WA,Passenger,167,138,305,89553,89858,0.34
December,31,2017,Pierce,WA,Passenger,1071,963,2034,526446,528480,0.38
December,31,2017,Mason,WA,Truck,0,0,0,19593,19593,0
December,31,2017,Portsmouth,VA,Passenger,0,1,1,67,68,1.47
December,31,2017,Dakota,MN,Passenger,0,2,2,38,40,5
December,31,2017,Norfolk,VA,Passenger,1,1,2,308,310,0.65
December,31,2017,Island,WA,Truck,0,0,0,20753,20753,0
December,31,2017,Okanogan,WA,Truck,0,0,0,16269,16269,0
December,31,2017,Shelby,TN,Passenger,0,1,1,104,105,0.95
December,31,2017,Skamania,WA,Passenger,10,7,17,8589,8606,0.2
December,31,2017,Orange,FL,Passenger,1,1,2,139,141,1.42
December,31,2017,Kittitas,WA,Truck,0,0,0,13805,13805,0
December,31,2017,Montgomery,PA,Passenger,1,0,1,39,40,2.5
December,31,2017,El Paso,TX,Passenger,1,0,1,522,523,0.19
December,31,2017,Walla Walla,WA,Truck,0,0,0,13292,13292,0
December,31,2017,Yakima,WA,Truck,0,0,0,58011,58011,0
December,31,2017,Virginia Beach,VA,Passenger,2,1,3,669,672,0.45
December,31,2017,Garfield,WA,Passenger,1,0,1,1321,1322,0.08
December,31,2017,Clark,NV,Passenger,1,2,3,752,755,0.4
December,31,2017,Dale,AL,Passenger,0,1,1,64,65,1.54
December,31,2017,Los Angeles,CA,Passenger,5,2,7,1209,1216,0.58
December,31,2017,Sumter,FL,Passenger,0,1,1,10,11,9.09
December,31,2017,Manassas,VA,Passenger,0,1,1,9,10,10
December,31,2017,Northampton,PA,Passenger,0,1,1,67,68,1.47
December,31,2017,Wahkiakum,WA,Truck,0,0,0,1670,1670,0
December,31,2017,Spokane,WA,Passenger,297,240,537,300106,300643,0.18
December,31,2017,Richland,SC,Passenger,0,1,1,171,172,0.58
December,31,2017,Island,WA,Passenger,155,165,320,61576,61896,0.52
December,31,2017,Fairfax,VA,Passenger,2,2,4,828,832,0.48
December,31,2017,Snohomish,WA,Truck,1,0,1,121405,121406,0
December,31,2017,Cowlitz,WA,Passenger,54,67,121,70747,70868,0.17
December,31,2017,Kitsap,WA,Passenger,693,377,1070,175868,176938,0.6
December,31,2017,Lane,OR,Passenger,0,1,1,208,209,0.48
December,31,2017,Clay,FL,Passenger,0,1,1,106,107,0.93
December,31,2017,Utah,UT,Passenger,0,1,1,134,135,0.74
December,31,2017,Hamilton,TN,Passenger,1,0,1,21,22,4.55
December,31,2017,Asotin,WA,Passenger,8,5,13,12519,12532,0.1
December,31,2017,Queens,NY,Passenger,1,0,1,61,62,1.61
December,31,2017,Dallas,TX,Passenger,0,1,1,182,183,0.55
December,31,2017,Adams,WA,Passenger,4,5,9,12408,12417,0.07
December,31,2017,Benton,WA,Truck,0,0,0,40573,40573,0
December,31,2017,Nantucket,MA,Passenger,1,0,1,3,4,25
December,31,2017,Flathead,MT,Passenger,1,0,1,55,56,1.79
December,31,2017,Montgomery,TX,Passenger,1,0,1,62,63,1.59
December,31,2017,Clark,WA,Passenger,851,573,1424,304270,305694,0.47
December,31,2017,Honolulu,HI,Passenger,2,2,4,556,560,0.71
December,31,2017,Adams,WA,Truck,0,0,0,5128,5128,0
December,31,2017,Nueces,TX,Passenger,1,1,2,92,94,2.13
December,31,2017,Arlington,VA,Passenger,1,2,3,172,175,1.71
December,31,2017,Latah,ID,Passenger,0,1,1,77,78,1.28
December,31,2017,New Haven,CT,Passenger,0,1,1,54,55,1.82
December,31,2017,Ferry,WA,Truck,0,0,0,3523,3523,0
December,31,2017,San Juan,WA,Truck,0,0,0,5604,5604,0
December,31,2017,Thurston,WA,Truck,0,0,0,53761,53761,0
December,31,2017,Allegheny,PA,Passenger,1,0,1,84,85,1.18
December,31,2017,Morris,NJ,Passenger,1,0,1,21,22,4.55
December,31,2017,Tuolumne,CA,Passenger,0,1,1,14,15,6.67
December,31,2017,Carroll,NH,Passenger,0,1,1,1,2,50
December,31,2017,King,WA,Passenger,11277,4684,15961,1370800,1386761,1.15
December,31,2017,District of Columbia,DC,Passenger,0,3,3,201,204,1.47
December,31,2017,Prince George,VA,Passenger,0,1,1,74,75,1.33
December,31,2017,Franklin,OH,Passenger,0,1,1,108,109,0.92
December,31,2017,Missoula,MT,Passenger,1,0,1,69,70,1.43
December,31,2017,San Mateo,CA,Passenger,0,1,1,147,148,0.68
December,31,2017,New London,CT,Passenger,1,1,2,249,251,0.8
December,31,2017,Pend Oreille,WA,Passenger,3,4,7,9440,9447,0.07
December,31,2017,Juneau,AK,Passenger,0,1,1,46,47,2.13
December,31,2017,Ferry,WA,Passenger,1,3,4,4402,4406,0.09
December,31,2017,Ventura,CA,Passenger,0,1,1,328,329,0.3
December,31,2017,Grant,WA,Truck,0,0,0,25587,25587,0
December,31,2017,Chelan,WA,Truck,0,0,0,21619,21619,0
December,31,2017,Anne Arundel,MD,Passenger,0,1,1,474,475,0.21
December,31,2017,St. Clair,IL,Passenger,0,1,1,159,160,0.62
December,31,2017,Pacific,WA,Passenger,15,13,28,15404,15432,0.18
December,31,2017,Santa Fe,NM,Passenger,0,1,1,43,44,2.27
December,31,2017,Skamania,WA,Truck,0,0,0,3896,3896,0
December,31,2017,Lewis,WA,Truck,0,0,0,25311,25311,0
December,31,2017,Kent,MI,Passenger,0,1,1,34,35,2.86
December,31,2017,St. Lucie,FL,Passenger,1,0,1,26,27,3.7
December,31,2017,Riverside,CA,Passenger,1,2,3,739,742,0.4
December,31,2017,Whitman,WA,Truck,0,0,0,8450,8450,0
December,31,2017,Lumpkin,GA,Passenger,1,0,1,9,10,10
December,31,2017,Klickitat,WA,Passenger,23,26,49,14902,14951,0.33
December,31,2017,Franklin,MA,Passenger,0,1,1,4,5,20
December,31,2017,San Diego,CA,Passenger,6,1,7,2563,2570,0.27
December,31,2017,Walla Walla,WA,Passenger,29,32,61,35287,35348,0.17
December,31,2017,Mason,WA,Passenger,66,75,141,44844,44985,0.31
December,31,2017,Maricopa,AZ,Passenger,2,0,2,1621,1623,0.12
December,31,2017,Hawaii,HI,Passenger,1,0,1,78,79,1.27
December,31,2017,Grays Harbor,WA,Passenger,42,41,83,45821,45904,0.18
December,31,2017,Brevard,FL,Passenger,0,1,1,101,102,0.98
December,31,2017,Lincoln,WA,Truck,0,0,0,4493,4493,0
December,31,2017,Chelan,WA,Passenger,86,38,124,53028,53152,0.23
December,31,2017,Clallam,WA,Truck,0,0,0,21218,21218,0
December,31,2017,Jefferson,NY,Passenger,1,0,1,232,233,0.43
December,31,2017,Charles,MD,Passenger,0,1,1,85,86,1.16
December,31,2017,Sedgwick,KS,Passenger,0,1,1,106,107,0.93
December,31,2017,Saratoga,NY,Passenger,1,1,2,69,71,2.82
December,31,2017,Montgomery,MD,Passenger,1,0,1,300,301,0.33
December,31,2017,Essex,NJ,Passenger,1,0,1,10,11,9.09
December,31,2017,El Paso,CO,Passenger,2,0,2,764,766,0.26
December,31,2017,Franklin,WA,Passenger,30,50,80,56860,56940,0.14
December,31,2017,Orleans,LA,Passenger,0,1,1,47,48,2.08
December,31,2017,Frederick,MD,Passenger,0,1,1,88,89,1.12
December,31,2017,Volusia,FL,Passenger,0,1,1,37,38,2.63
December,31,2017,Pinal,AZ,Passenger,2,0,2,213,215,0.93
December,31,2017,Skagit,WA,Truck,1,0,1,31731,31732,0
December,31,2017,Cape May,NJ,Passenger,0,1,1,22,23,4.35
February,28,2017,Columbia,WA,Passenger,0,1,1,2337,2338,0.04
February,28,2017,New London,CT,Passenger,2,1,3,265,268,1.12
February,28,2017,Pacific,WA,Passenger,5,6,11,14997,15008,0.07
February,28,2017,Island,WA,Passenger,100,122,222,59448,59670,0.37
February,28,2017,Harnett,NC,Passenger,1,0,1,263,264,0.38
February,28,2017,Allegheny,PA,Passenger,1,0,1,92,93,1.08
February,28,2017,Prince William,VA,Passenger,0,3,3,277,280,1.07
February,28,2017,Clark,WA,Truck,0,0,0,77521,77521,0
February,28,2017,Durham,NC,Passenger,0,1,1,37,38,2.63
February,28,2017,Cowlitz,WA,Passenger,50,46,96,69052,69148,0.14
February,28,2017,DeKalb,IN,Passenger,1,0,1,1,2,50
February,28,2017,San Mateo,CA,Passenger,0,1,1,165,166,0.6
February,28,2017,Santa Clara,CA,Passenger,5,3,8,424,432,1.85
February,28,2017,Salt Lake,UT,Passenger,0,1,1,332,333,0.3
February,28,2017,Lane,OR,Passenger,0,1,1,258,259,0.39
February,28,2017,Jefferson,NY,Passenger,1,1,2,255,257,0.78
February,28,2017,Virginia Beach,VA,Passenger,2,1,3,651,654,0.46
February,28,2017,Skagit,WA,Truck,1,0,1,31404,31405,0
February,28,2017,Clark,WA,Passenger,695,434,1129,297935,299064,0.38
February,28,2017,Utah,UT,Passenger,0,1,1,169,170,0.59
February,28,2017,Dane,WI,Passenger,1,0,1,168,169,0.59
February,28,2017,Manassas,VA,Passenger,0,1,1,8,9,11.11
February,28,2017,Essex,NJ,Passenger,1,0,1,16,17,5.88
February,28,2017,Adams,WA,Truck,0,0,0,5071,5071,0
February,28,2017,Benton,WA,Passenger,134,133,267,127653,127920,0.21
February,28,2017,Mason,WA,Truck,0,0,0,19196,19196,0
February,28,2017,Wayne,MI,Passenger,0,2,2,69,71,2.82
February,28,2017,Lee,AL,Passenger,1,0,1,36,37,2.7
February,28,2017,Douglas,WA,Passenger,30,19,49,26547,26596,0.18
February,28,2017,Morris,NJ,Passenger,1,0,1,22,23,4.35
February,28,2017,Franklin,WA,Truck,0,0,0,17907,17907,0
February,28,2017,Richmond,GA,Passenger,0,1,1,99,100,1
February,28,2017,Dakota,MN,Passenger,0,1,1,41,42,2.38
February,28,2017,Ferry,WA,Truck,0,0,0,3562,3562,0
February,28,2017,Guilford,NC,Passenger,1,0,1,32,33,3.03
February,28,2017,Kittitas,WA,Truck,0,0,0,13383,13383,0
February,28,2017,Prince George's,MD,Passenger,0,1,1,186,187,0.53
February,28,2017,Franklin,WA,Passenger,26,42,68,55221,55289,0.12
February,28,2017,Orange,FL,Passenger,1,1,2,153,155,1.29
February,28,2017,Jackson,MO,Passenger,1,0,1,71,72,1.39
February,28,2017,Latah,ID,Passenger,0,1,1,131,132,0.76
February,28,2017,Hidalgo,TX,Passenger,0,1,1,95,96,1.04
February,28,2017,Middlesex,MA,Passenger,1,0,1,158,159,0.63
February,28,2017,Dallas,TX,Passenger,1,0,1,210,211,0.47
February,28,2017,Lincoln,WA,Passenger,2,4,6,7509,7515,0.08
February,28,2017,Island,WA,Truck,0,0,0,20499,20499,0
February,28,2017,Montgomery,TN,Passenger,1,0,1,294,295,0.34
February,28,2017,Cowlitz,WA,Truck,0,0,0,27871,27871,0
February,28,2017,Spokane,WA,Passenger,226,196,422,295023,295445,0.14
February,28,2017,Maui,HI,Passenger,1,0,1,71,72,1.39
February,28,2017,Fairfax,VA,Passenger,2,2,4,877,881,0.45
February,28,2017,Jefferson,WA,Passenger,89,55,144,23601,23745,0.61
February,28,2017,Manatee,FL,Passenger,1,0,1,55,56,1.79
February,28,2017,Clallam,WA,Passenger,75,64,139,47981,48120,0.29
February,28,2017,Okanogan,WA,Truck,0,0,0,16300,16300,0
February,28,2017,Wahkiakum,WA,Passenger,0,1,1,2843,2844,0.04
February,28,2017,Monterey,CA,Passenger,0,1,1,224,225,0.44
February,28,2017,Honolulu,HI,Passenger,4,2,6,628,634,0.95
February,28,2017,Grant,WA,Truck,0,0,0,24996,24996,0
February,28,2017,Charles,MD,Passenger,0,1,1,91,92,1.09
February,28,2017,Benton,WA,Truck,0,0,0,39743,39743,0
February,28,2017,Franklin,MA,Passenger,0,1,1,4,5,20
February,28,2017,Lewis,WA,Passenger,45,31,76,54970,55046,0.14
February,28,2017,Grant,WA,Passenger,16,21,37,60193,60230,0.06
February,28,2017,Cascade,MT,Passenger,0,1,1,59,60,1.67
February,28,2017,King,WA,Passenger,9098,3713,12811,1385263,1398074,0.92
February,28,2017,Whatcom,WA,Passenger,401,146,547,141888,142435,0.38
February,28,2017,Stevens,WA,Truck,0,0,0,18333,18333,0
February,28,2017,Whitman,WA,Passenger,8,18,26,21938,21964,0.12
February,28,2017,San Juan,WA,Passenger,88,31,119,13403,13522,0.88
February,28,2017,Oklahoma,OK,Passenger,0,1,1,187,188,0.53
February,28,2017,Nassau,NY,Passenger,0,1,1,39,40,2.5
February,28,2017,Walla Walla,WA,Passenger,17,21,38,34781,34819,0.11
February,28,2017,Pinal,AZ,Passenger,2,0,2,263,265,0.75
February,28,2017,Hardin,KY,Passenger,0,1,1,128,129,0.78
February,28,2017,Dale,AL,Passenger,0,1,1,65,66,1.52
February,28,2017,Bergen,NJ,Passenger,0,2,2,32,34,5.88
February,28,2017,Grays Harbor,WA,Passenger,27,24,51,44252,44303,0.12
February,28,2017,Klickitat,WA,Truck,0,0,0,7937,7937,0
February,28,2017,San Diego,CA,Passenger,4,1,5,2821,2826,0.18
February,28,2017,Madison,ID,Passenger,1,0,1,44,45,2.22
February,28,2017,Klickitat,WA,Passenger,20,22,42,14768,14810,0.28
February,28,2017,Asotin,WA,Truck,0,0,0,6475,6475,0
February,28,2017,King,WA,Truck,8,1,9,190501,190510,0
February,28,2017,New Haven,CT,Passenger,0,1,1,62,63,1.59
February,28,2017,Ferry,WA,Passenger,2,1,3,4391,4394,0.07
February,28,2017,Clackamas,OR,Passenger,1,2,3,361,364,0.82
February,28,2017,Pend Oreille,WA,Truck,0,0,0,5573,5573,0
February,28,2017,Cape May,NJ,Passenger,0,1,1,19,20,5
February,28,2017,Norfolk,MA,Passenger,1,0,1,37,38,2.63
February,28,2017,Whatcom,WA,Truck,2,0,2,41327,41329,0
February,28,2017,Missoula,MT,Passenger,1,0,1,81,82,1.22
February,28,2017,Orange,CA,Passenger,2,1,3,676,679,0.44
February,28,2017,Polk,FL,Passenger,1,0,1,65,66,1.52
February,28,2017,Walla Walla,WA,Truck,0,0,0,13161,13161,0
February,28,2017,Los Angeles,CA,Passenger,3,1,4,1376,1380,0.29
February,28,2017,Clark,NV,Passenger,1,3,4,877,881,0.45
February,28,2017,Pend Oreille,WA,Passenger,1,4,5,9300,9305,0.05
February,28,2017,Douglas,WA,Truck,0,0,0,11387,11387,0
February,28,2017,Moore,NC,Passenger,0,1,1,210,211,0.47
February,28,2017,Okanogan,WA,Passenger,3,15,18,25674,25692,0.07
February,28,2017,Nantucket,MA,Passenger,1,0,1,3,4,25
February,28,2017,Juneau,AK,Passenger,0,1,1,55,56,1.79
February,28,2017,Monroe,NY,Passenger,1,0,1,28,29,3.45
February,28,2017,Saratoga,NY,Passenger,1,1,2,78,80,2.5
February,28,2017,Snohomish,WA,Passenger,1604,824,2428,514072,516500,0.47
February,28,2017,Chelan,WA,Passenger,55,29,84,51755,51839,0.16
February,28,2017,Lewis,WA,Truck,0,0,0,24783,24783,0
February,28,2017,Bexar,TX,Passenger,1,2,3,1157,1160,0.26
February,28,2017,Marin,CA,Passenger,1,0,1,59,60,1.67
February,28,2017,Hamilton,TN,Passenger,1,0,1,26,27,3.7
February,28,2017,Montgomery,MD,Passenger,1,0,1,305,306,0.33
February,28,2017,Garfield,WA,Truck,0,0,0,934,934,0
February,28,2017,Columbia,WA,Truck,0,0,0,1528,1528,0
February,28,2017,Volusia,FL,Passenger,0,1,1,47,48,2.08
February,28,2017,Carroll,NH,Passenger,0,1,1,0,1,100
February,28,2017,Pierce,WA,Truck,0,0,0,138554,138554,0
February,28,2017,Norfolk,VA,Passenger,1,1,2,303,305,0.66
February,28,2017,Snohomish,WA,Truck,1,0,1,122505,122506,0
February,28,2017,Travis,TX,Passenger,0,1,1,198,199,0.5
February,28,2017,Santa Fe,NM,Passenger,0,1,1,44,45,2.22
February,28,2017,DeKalb,GA,Passenger,1,0,1,84,85,1.18
February,28,2017,Lincoln,WA,Truck,0,0,0,4463,4463,0
February,28,2017,Thurston,WA,Truck,0,0,0,53345,53345,0
February,28,2017,Shoshone,ID,Passenger,0,1,1,82,83,1.2
February,28,2017,Thurston,WA,Passenger,351,309,660,184902,185562,0.36
February,28,2017,Howard,MD,Passenger,0,2,2,88,90,2.22
February,28,2017,Hawaii,HI,Passenger,1,0,1,86,87,1.15
February,28,2017,Tulare,CA,Passenger,1,0,1,200,201,0.5
February,28,2017,Whitman,WA,Truck,0,0,0,8399,8399,0
February,28,2017,Clallam,WA,Truck,0,0,0,21029,21029,0
February,28,2017,Cobb,GA,Passenger,0,1,1,80,81,1.23
February,28,2017,Northampton,PA,Passenger,2,0,2,231,233,0.86
February,28,2017,Alameda,CA,Passenger,3,1,4,389,393,1.02
February,28,2017,Maricopa,AZ,Passenger,3,0,3,1858,1861,0.16
February,28,2017,Skamania,WA,Truck,0,0,0,3889,3889,0
February,28,2017,Yakima,WA,Passenger,36,50,86,159126,159212,0.05
February,28,2017,Cumberland,NC,Passenger,1,0,1,624,625,0.16
February,28,2017,Douglas,OR,Passenger,0,1,1,79,80,1.25
February,28,2017,Deschutes,OR,Passenger,1,0,1,203,204,0.49
February,28,2017,Anne Arundel,MD,Passenger,0,1,1,511,512,0.2
February,28,2017,Stevens,WA,Passenger,6,21,27,31317,31344,0.09
February,28,2017,Lewis,NY,Passenger,0,1,1,10,11,9.09
February,28,2017,Fulton,GA,Passenger,1,1,2,128,130,1.54
February,28,2017,Okaloosa,FL,Passenger,1,0,1,190,191,0.52
February,28,2017,District of Columbia,DC,Passenger,0,3,3,231,234,1.28
February,28,2017,Pacific,WA,Truck,0,0,0,7486,7486,0
February,28,2017,Skamania,WA,Passenger,7,7,14,8543,8557,0.16
February,28,2017,Arlington,VA,Passenger,1,1,2,170,172,1.16
February,28,2017,Shelby,TN,Passenger,0,1,1,108,109,0.92
February,28,2017,Yakima,WA,Truck,0,0,0,57223,57223,0
February,28,2017,Sumter,FL,Passenger,0,1,1,10,11,9.09
February,28,2017,Orleans,LA,Passenger,0,1,1,51,52,1.92
February,28,2017,Contra Costa,CA,Passenger,1,0,1,653,654,0.15
February,28,2017,Spokane,WA,Truck,1,0,1,90241,90242,0
February,28,2017,Duval,FL,Passenger,1,1,2,371,373,0.54
February,28,2017,Marion,OR,Passenger,1,0,1,202,203,0.49
February,28,2017,El Paso,CO,Passenger,1,1,2,844,846,0.24
February,28,2017,Canyon,ID,Passenger,0,1,1,108,109,0.92
February,28,2017,Gwinnett,GA,Passenger,0,1,1,87,88,1.14
February,28,2017,Riverside,CA,Passenger,1,1,2,842,844,0.24
February,28,2017,Garfield,WA,Passenger,0,0,0,1290,1290,0
February,28,2017,Kittitas,WA,Passenger,15,15,30,27062,27092,0.11
February,28,2017,,,Passenger,3,1,4,666,670,0.6
February,28,2017,Pima,AZ,Passenger,0,2,2,441,443,0.45
February,28,2017,Nueces,TX,Passenger,0,1,1,98,99,1.01
February,28,2017,Skagit,WA,Passenger,113,86,199,87262,87461,0.23
February,28,2017,Hamilton,IN,Passenger,1,0,1,67,68,1.47
February,28,2017,Jefferson,WA,Truck,0,0,0,9472,9472,0
February,28,2017,Pierce,WA,Passenger,862,778,1640,526771,528411,0.31
February,28,2017,Portsmouth,VA,Passenger,0,1,1,66,67,1.49
February,28,2017,Ventura,CA,Passenger,0,2,2,376,378,0.53
February,28,2017,Grays Harbor,WA,Truck,0,0,0,19819,19819,0
February,28,2017,Adams,WA,Passenger,2,2,4,12126,12130,0.03
February,28,2017,Kitsap,WA,Truck,1,0,1,52347,52348,0
February,28,2017,Asotin,WA,Passenger,4,3,7,12324,12331,0.06
February,28,2017,Multnomah,OR,Passenger,0,3,3,1150,1153,0.26
February,28,2017,Muscogee,GA,Passenger,0,1,1,256,257,0.39
February,28,2017,San Juan,WA,Truck,0,0,0,5573,5573,0
February,28,2017,Tarrant,TX,Passenger,0,2,2,304,306,0.65
February,28,2017,St. Lucie,FL,Passenger,1,0,1,31,32,3.12
February,28,2017,Franklin,OH,Passenger,0,1,1,116,117,0.85
February,28,2017,Mason,WA,Passenger,47,63,110,42778,42888,0.26
February,28,2017,Kitsap,WA,Passenger,561,280,841,172111,172952,0.49
February,28,2017,Chelan,WA,Truck,0,0,0,21250,21250,0
February,28,2017,Wahkiakum,WA,Truck,0,0,0,1625,1625,0
January,31,2017,Collier,FL,Passenger,0,1,1,22,23,4.35
January,31,2017,Portsmouth,VA,Passenger,0,1,1,65,66,1.52
January,31,2017,Monroe,NY,Passenger,1,0,1,30,31,3.23
January,31,2017,Garfield,WA,Truck,0,0,0,941,941,0
January,31,2017,Lane,OR,Passenger,0,1,1,291,292,0.34
January,31,2017,Sumter,FL,Passenger,0,1,1,10,11,9.09
January,31,2017,Skagit,WA,Truck,1,0,1,31404,31405,0
January,31,2017,Anne Arundel,MD,Passenger,0,1,1,515,516,0.19
January,31,2017,Dane,WI,Passenger,1,0,1,192,193,0.52
January,31,2017,Saratoga,NY,Passenger,1,1,2,79,81,2.47
January,31,2017,Adams,WA,Passenger,1,1,2,12175,12177,0.02
January,31,2017,Skamania,WA,Truck,0,0,0,3908,3908,0
January,31,2017,Kitsap,WA,Passenger,556,262,818,172401,173219,0.47
January,31,2017,Los Angeles,CA,Passenger,3,1,4,1470,1474,0.27
January,31,2017,Guilford,NC,Passenger,1,0,1,34,35,2.86
January,31,2017,Cape May,NJ,Passenger,0,1,1,19,20,5
January,31,2017,Thurston,WA,Truck,0,0,0,53340,53340,0
January,31,2017,Yakima,WA,Passenger,36,49,85,159930,160015,0.05
January,31,2017,Pend Oreille,WA,Truck,0,0,0,5595,5595,0
January,31,2017,Brown,WI,Passenger,1,0,1,46,47,2.13
January,31,2017,Kitsap,WA,Truck,1,0,1,52380,52381,0
January,31,2017,Cowlitz,WA,Passenger,51,44,95,69109,69204,0.14
January,31,2017,Grant,WA,Truck,0,0,0,25039,25039,0
January,31,2017,Utah,UT,Passenger,0,1,1,195,196,0.51
January,31,2017,Whitman,WA,Passenger,8,19,27,21936,21963,0.12
January,31,2017,Santa Clara,CA,Passenger,5,3,8,460,468,1.71
January,31,2017,Douglas,WA,Truck,0,0,0,11426,11426,0
January,31,2017,Monterey,CA,Passenger,0,1,1,232,233,0.43
January,31,2017,Durham,NC,Passenger,0,1,1,38,39,2.56
January,31,2017,Columbia,WA,Passenger,0,1,1,2331,2332,0.04
January,31,2017,DeKalb,GA,Passenger,1,0,1,91,92,1.09
January,31,2017,Carroll,NH,Passenger,0,1,1,0,1,100
January,31,2017,Yakima,WA,Truck,0,0,0,57337,57337,0
January,31,2017,Stevens,WA,Truck,0,0,0,18341,18341,0
January,31,2017,Clark,WA,Truck,0,0,0,77522,77522,0
January,31,2017,El Paso,CO,Passenger,1,1,2,884,886,0.23
January,31,2017,Clark,WA,Passenger,673,426,1099,297819,298918,0.37
January,31,2017,Wayne,MI,Passenger,0,2,2,77,79,2.53
January,31,2017,Maricopa,AZ,Passenger,3,0,3,1977,1980,0.15
January,31,2017,Chelan,WA,Passenger,54,28,82,51898,51980,0.16
January,31,2017,Pend Oreille,WA,Passenger,1,4,5,9345,9350,0.05
January,31,2017,Hardin,KY,Passenger,0,1,1,127,128,0.78
January,31,2017,Loudoun,VA,Passenger,0,1,1,86,87,1.15
January,31,2017,Lincoln,WA,Truck,0,0,0,4462,4462,0
January,31,2017,Skamania,WA,Passenger,7,7,14,8549,8563,0.16
January,31,2017,Mason,WA,Passenger,48,60,108,42807,42915,0.25
January,31,2017,Lincoln,WA,Passenger,2,4,6,7543,7549,0.08
January,31,2017,Clallam,WA,Truck,0,0,0,21044,21044,0
January,31,2017,Bexar,TX,Passenger,3,3,6,1255,1261,0.48
January,31,2017,Ferry,WA,Passenger,2,1,3,4386,4389,0.07
January,31,2017,Clackamas,OR,Passenger,1,2,3,426,429,0.7
January,31,2017,Alameda,CA,Passenger,6,1,7,399,406,1.72
January,31,2017,Cowlitz,WA,Truck,0,0,0,27949,27949,0
January,31,2017,Deschutes,OR,Passenger,1,1,2,238,240,0.83
January,31,2017,Hamilton,IN,Passenger,1,0,1,73,74,1.35
January,31,2017,Franklin,MA,Passenger,0,1,1,5,6,16.67
January,31,2017,Walla Walla,WA,Passenger,16,21,37,34864,34901,0.11
January,31,2017,Benton,WA,Passenger,129,129,258,127860,128118,0.2
January,31,2017,Lewis,NY,Passenger,0,1,1,10,11,9.09
January,31,2017,Lewis,WA,Truck,0,0,0,24791,24791,0
January,31,2017,Klickitat,WA,Truck,0,0,0,7945,7945,0
January,31,2017,Fairfax,VA,Passenger,2,2,4,885,889,0.45
January,31,2017,Clark,NV,Passenger,1,4,5,930,935,0.53
January,31,2017,Cascade,MT,Passenger,0,1,1,62,63,1.59
January,31,2017,Asotin,WA,Passenger,4,3,7,12319,12326,0.06
January,31,2017,Gwinnett,GA,Passenger,0,1,1,94,95,1.05
January,31,2017,New London,CT,Passenger,2,1,3,271,274,1.09
January,31,2017,Douglas,WA,Passenger,29,19,48,26580,26628,0.18
January,31,2017,Orleans,LA,Passenger,0,1,1,52,53,1.89
January,31,2017,Middlesex,MA,Passenger,1,0,1,161,162,0.62
January,31,2017,Shoshone,ID,Passenger,0,1,1,99,100,1
January,31,2017,Polk,FL,Passenger,1,0,1,64,65,1.54
January,31,2017,Morris,NJ,Passenger,1,0,1,23,24,4.17
January,31,2017,Santa Fe,NM,Passenger,0,1,1,44,45,2.22
January,31,2017,DeKalb,IN,Passenger,1,0,1,1,2,50
January,31,2017,Juneau,AK,Passenger,0,1,1,58,59,1.69
January,31,2017,Pierce,WA,Passenger,822,751,1573,528314,529887,0.3
January,31,2017,Okanogan,WA,Passenger,3,15,18,25814,25832,0.07
January,31,2017,Arlington,VA,Passenger,1,1,2,176,178,1.12
January,31,2017,Thurston,WA,Passenger,336,299,635,184964,185599,0.34
January,31,2017,Montgomery,MD,Passenger,1,0,1,312,313,0.32
January,31,2017,Hamilton,TN,Passenger,1,0,1,28,29,3.45
January,31,2017,Manassas,VA,Passenger,0,1,1,8,9,11.11
January,31,2017,King,WA,Truck,8,1,9,191085,191094,0
January,31,2017,Spokane,WA,Truck,1,0,1,90429,90430,0
January,31,2017,Douglas,OR,Passenger,0,1,1,90,91,1.1
January,31,2017,Walla Walla,WA,Truck,0,0,0,13168,13168,0
January,31,2017,Lee,AL,Passenger,1,0,1,36,37,2.7
January,31,2017,Jefferson,WA,Truck,0,0,0,9469,9469,0
January,31,2017,Pacific,WA,Passenger,5,6,11,15034,15045,0.07
January,31,2017,New Haven,CT,Passenger,0,1,1,66,67,1.49
January,31,2017,Jackson,MO,Passenger,1,0,1,75,76,1.32
January,31,2017,Cobb,GA,Passenger,0,1,1,82,83,1.2
January,31,2017,Allegheny,PA,Passenger,1,0,1,94,95,1.05
January,31,2017,Jefferson,NY,Passenger,1,1,2,250,252,0.79
January,31,2017,San Mateo,CA,Passenger,0,1,1,177,178,0.56
January,31,2017,Franklin,WA,Passenger,27,42,69,55402,55471,0.12
January,31,2017,Adams,WA,Truck,0,0,0,5077,5077,0
January,31,2017,Spokane,WA,Passenger,221,196,417,296020,296437,0.14
January,31,2017,Grant,WA,Passenger,16,21,37,60386,60423,0.06
January,31,2017,Marion,FL,Passenger,1,0,1,26,27,3.7
January,31,2017,Okaloosa,FL,Passenger,1,0,1,189,190,0.53
January,31,2017,Snohomish,WA,Truck,1,0,1,122825,122826,0
January,31,2017,Stevens,WA,Passenger,6,21,27,31528,31555,0.09
January,31,2017,Multnomah,OR,Passenger,0,3,3,1282,1285,0.23
January,31,2017,Skagit,WA,Passenger,106,81,187,87447,87634,0.21
January,31,2017,Ferry,WA,Truck,0,0,0,3581,3581,0
January,31,2017,Orange,CA,Passenger,2,1,3,704,707,0.42
January,31,2017,Salt Lake,UT,Passenger,0,1,1,358,359,0.28
January,31,2017,San Juan,WA,Truck,0,0,0,5594,5594,0
January,31,2017,Shelby,TN,Passenger,0,1,1,113,114,0.88
January,31,2017,Travis,TX,Passenger,0,1,1,213,214,0.47
January,31,2017,Norfolk,MA,Passenger,1,0,1,39,40,2.5
January,31,2017,Kittitas,WA,Passenger,15,16,31,27158,27189,0.11
January,31,2017,Orange,FL,Passenger,0,1,1,159,160,0.62
January,31,2017,Pinal,AZ,Passenger,2,0,2,281,283,0.71
January,31,2017,Asotin,WA,Truck,0,0,0,6487,6487,0
January,31,2017,Northampton,PA,Passenger,2,0,2,259,261,0.77
January,31,2017,Essex,NJ,Passenger,1,0,1,16,17,5.88
January,31,2017,Pacific,WA,Truck,0,0,0,7509,7509,0
January,31,2017,Honolulu,HI,Passenger,4,2,6,663,669,0.9
January,31,2017,Hidalgo,TX,Passenger,0,1,1,98,99,1.01
January,31,2017,St. Lucie,FL,Passenger,1,0,1,32,33,3.03
January,31,2017,Prince George's,MD,Passenger,0,1,1,189,190,0.53
January,31,2017,Richmond,GA,Passenger,0,1,1,103,104,0.96
January,31,2017,Prince William,VA,Passenger,0,3,3,281,284,1.06
January,31,2017,San Diego,CA,Passenger,4,2,6,2895,2901,0.21
January,31,2017,Santa Barbara,CA,Passenger,0,1,1,133,134,0.75
January,31,2017,Norfolk,VA,Passenger,1,1,2,305,307,0.65
January,31,2017,Latah,ID,Passenger,0,1,1,142,143,0.7
January,31,2017,Pierce,WA,Truck,0,0,0,138768,138768,0
January,31,2017,Oklahoma,OK,Passenger,0,1,1,211,212,0.47
January,31,2017,Muscogee,GA,Passenger,0,1,1,265,266,0.38
January,31,2017,Klickitat,WA,Passenger,20,22,42,14793,14835,0.28
January,31,2017,Hood River,OR,Passenger,1,0,1,43,44,2.27
January,31,2017,King,WA,Passenger,8804,3621,12425,1387384,1399809,0.89
January,31,2017,Clallam,WA,Passenger,73,64,137,48005,48142,0.28
January,31,2017,Grays Harbor,WA,Passenger,27,24,51,44315,44366,0.11
January,31,2017,Harnett,NC,Passenger,1,0,1,269,270,0.37
January,31,2017,Columbia,WA,Truck,0,0,0,1543,1543,0
January,31,2017,Dale,AL,Passenger,0,1,1,67,68,1.47
January,31,2017,El Paso,TX,Passenger,0,1,1,593,594,0.17
January,31,2017,Cumberland,NC,Passenger,1,0,1,636,637,0.16
January,31,2017,Yavapai,AZ,Passenger,1,0,1,85,86,1.16
January,31,2017,Whitman,WA,Truck,0,0,0,8403,8403,0
January,31,2017,Manatee,FL,Passenger,1,0,1,59,60,1.67
January,31,2017,Island,WA,Truck,1,0,1,20520,20521,0
January,31,2017,Lake,IL,Passenger,1,0,1,187,188,0.53
January,31,2017,Whatcom,WA,Passenger,383,141,524,141886,142410,0.37
January,31,2017,Hawaii,HI,Passenger,1,0,1,90,91,1.1
January,31,2017,Whatcom,WA,Truck,2,0,2,41337,41339,0
January,31,2017,Island,WA,Passenger,103,119,222,59416,59638,0.37
January,31,2017,Maui,HI,Passenger,1,0,1,82,83,1.2
January,31,2017,Mason,WA,Truck,0,0,0,19187,19187,0
January,31,2017,Charles,MD,Passenger,0,1,1,89,90,1.11
January,31,2017,Kittitas,WA,Truck,0,0,0,13412,13412,0
January,31,2017,Madison,ID,Passenger,1,0,1,48,49,2.04
January,31,2017,Dallas,TX,Passenger,1,0,1,230,231,0.43
January,31,2017,Garfield,WA,Passenger,0,0,0,1285,1285,0
January,31,2017,Chelan,WA,Truck,0,0,0,21262,21262,0
January,31,2017,District of Columbia,DC,Passenger,0,3,3,238,241,1.24
January,31,2017,Benton,WA,Truck,0,0,0,39813,39813,0
January,31,2017,Bergen,NJ,Passenger,0,2,2,33,35,5.71
January,31,2017,Marion,OR,Passenger,1,0,1,238,239,0.42
January,31,2017,,,Passenger,3,1,4,682,686,0.58
January,31,2017,Duval,FL,Passenger,1,1,2,379,381,0.52
January,31,2017,Lewis,WA,Passenger,43,30,73,54960,55033,0.13
January,31,2017,Nantucket,MA,Passenger,1,0,1,3,4,25
January,31,2017,Union,OH,Passenger,1,0,1,4,5,20
January,31,2017,Okanogan,WA,Truck,0,0,0,16374,16374,0
January,31,2017,Riverside,CA,Passenger,1,1,2,888,890,0.22
January,31,2017,Tulare,CA,Passenger,1,0,1,203,204,0.49
January,31,2017,Moore,NC,Passenger,0,1,1,210,211,0.47
January,31,2017,Pima,AZ,Passenger,0,2,2,468,470,0.43
January,31,2017,Montgomery,TN,Passenger,1,0,1,307,308,0.32
January,31,2017,Contra Costa,CA,Passenger,1,0,1,683,684,0.15
January,31,2017,Canyon,ID,Passenger,0,1,1,118,119,0.84
January,31,2017,Jefferson,WA,Passenger,87,53,140,23606,23746,0.59
January,31,2017,Howard,MD,Passenger,0,2,2,90,92,2.17
January,31,2017,Grays Harbor,WA,Truck,0,0,0,19862,19862,0
January,31,2017,Virginia Beach,VA,Passenger,2,1,3,658,661,0.45
January,31,2017,Ventura,CA,Passenger,0,2,2,392,394,0.51
January,31,2017,St. Mary's,MD,Passenger,0,1,1,205,206,0.49
January,31,2017,Fulton,GA,Passenger,1,2,3,136,139,2.16
January,31,2017,San Juan,WA,Passenger,84,31,115,13348,13463,0.85
January,31,2017,Franklin,WA,Truck,0,0,0,17912,17912,0
January,31,2017,Marin,CA,Passenger,1,0,1,57,58,1.72
January,31,2017,Wahkiakum,WA,Passenger,0,1,1,2861,2862,0.03
January,31,2017,Snohomish,WA,Passenger,1549,803,2352,514965,517317,0.45
January,31,2017,Wahkiakum,WA,Truck,0,0,0,1624,1624,0
January,31,2017,Volusia,FL,Passenger,0,1,1,49,50,2
January,31,2017,Tarrant,TX,Passenger,0,2,2,333,335,0.6
January,31,2017,Dakota,MN,Passenger,0,1,1,46,47,2.13
July,31,2017,Pierce,WA,Passenger,986,856,1842,524592,526434,0.35
July,31,2017,Jefferson,NY,Passenger,1,1,2,249,251,0.8
July,31,2017,Allegheny,PA,Passenger,1,0,1,90,91,1.1
July,31,2017,Clark,NV,Passenger,1,2,3,813,816,0.37
July,31,2017,Volusia,FL,Passenger,0,1,1,45,46,2.17
July,31,2017,Franklin,MA,Passenger,0,1,1,4,5,20
July,31,2017,New Haven,CT,Passenger,0,1,1,57,58,1.72
July,31,2017,Gwinnett,GA,Passenger,0,1,1,82,83,1.2
July,31,2017,Walla Walla,WA,Truck,0,0,0,13177,13177,0
July,31,2017,Sedgwick,KS,Passenger,0,1,1,109,110,0.91
July,31,2017,Dane,WI,Passenger,1,0,1,86,87,1.15
July,31,2017,Franklin,WA,Passenger,26,47,73,55735,55808,0.13
July,31,2017,Clark,WA,Truck,0,0,0,77737,77737,0
July,31,2017,Latah,ID,Passenger,0,1,1,97,98,1.02
July,31,2017,Ferry,WA,Truck,0,0,0,3526,3526,0
July,31,2017,Hardin,KY,Passenger,0,1,1,121,122,0.82
July,31,2017,Clallam,WA,Truck,0,0,0,21043,21043,0
July,31,2017,Pinal,AZ,Passenger,2,0,2,235,237,0.84
July,31,2017,Nassau,NY,Passenger,1,1,2,39,41,4.88
July,31,2017,Garfield,WA,Passenger,0,0,0,1296,1296,0
July,31,2017,Yakima,WA,Truck,0,0,0,57469,57469,0
July,31,2017,Island,WA,Truck,0,0,0,20500,20500,0
July,31,2017,Anne Arundel,MD,Passenger,0,1,1,501,502,0.2
July,31,2017,Kittitas,WA,Truck,0,0,0,13581,13581,0
July,31,2017,Canyon,ID,Passenger,0,1,1,97,98,1.02
July,31,2017,King,WA,Passenger,10255,4174,14429,1373311,1387740,1.04
July,31,2017,Nueces,TX,Passenger,0,1,1,96,97,1.03
July,31,2017,Kitsap,WA,Passenger,622,324,946,173384,174330,0.54
July,31,2017,Morris,NJ,Passenger,1,0,1,25,26,3.85
July,31,2017,Whitman,WA,Passenger,12,19,31,22108,22139,0.14
July,31,2017,Flathead,MT,Passenger,1,0,1,60,61,1.64
July,31,2017,Fairfax,VA,Passenger,2,2,4,848,852,0.47
July,31,2017,Alameda,CA,Passenger,1,1,2,358,360,0.56
July,31,2017,Mason,WA,Truck,0,0,0,19261,19261,0
July,31,2017,Juneau,AK,Passenger,0,1,1,45,46,2.17
July,31,2017,Wayne,MI,Passenger,0,1,1,69,70,1.43
July,31,2017,Pend Oreille,WA,Truck,0,0,0,5582,5582,0
July,31,2017,Tulare,CA,Passenger,1,0,1,195,196,0.51
July,31,2017,Grant,WA,Passenger,19,30,49,61004,61053,0.08
July,31,2017,Marion,OR,Passenger,1,0,1,162,163,0.61
July,31,2017,St. Lucie,FL,Passenger,1,0,1,32,33,3.03
July,31,2017,Jefferson,WA,Truck,0,0,0,9414,9414,0
July,31,2017,Douglas,WA,Passenger,35,26,61,26756,26817,0.23
July,31,2017,Orleans,LA,Passenger,0,1,1,47,48,2.08
July,31,2017,Albemarle,VA,Passenger,0,1,1,32,33,3.03
July,31,2017,Dallas,TX,Passenger,0,1,1,180,181,0.55
July,31,2017,Grays Harbor,WA,Truck,0,0,0,19894,19894,0
July,31,2017,Asotin,WA,Passenger,8,4,12,12439,12451,0.1
July,31,2017,Shelby,TN,Passenger,0,1,1,109,110,0.91
July,31,2017,Garfield,WA,Truck,0,0,0,926,926,0
July,31,2017,San Diego,CA,Passenger,6,1,7,2699,2706,0.26
July,31,2017,Lincoln,WA,Truck,0,0,0,4445,4445,0
July,31,2017,Clark,WA,Passenger,795,517,1312,299957,301269,0.44
July,31,2017,Montgomery,MD,Passenger,1,0,1,306,307,0.33
July,31,2017,Multnomah,OR,Passenger,1,3,4,953,957,0.42
July,31,2017,San Juan,WA,Truck,0,0,0,5547,5547,0
July,31,2017,Lewis,WA,Truck,0,0,0,24914,24914,0
July,31,2017,Hamilton,TN,Passenger,1,0,1,18,19,5.26
July,31,2017,Skagit,WA,Passenger,141,104,245,88182,88427,0.28
July,31,2017,Palm Beach,FL,Passenger,0,1,1,96,97,1.03
July,31,2017,Hawaii,HI,Passenger,1,0,1,80,81,1.23
July,31,2017,Skamania,WA,Passenger,9,7,16,8552,8568,0.19
July,31,2017,Tuolumne,CA,Passenger,0,1,1,14,15,6.67
July,31,2017,Essex,NJ,Passenger,1,0,1,14,15,6.67
July,31,2017,Bergen,NJ,Passenger,0,2,2,30,32,6.25
July,31,2017,Richmond,GA,Passenger,0,1,1,88,89,1.12
July,31,2017,Deschutes,OR,Passenger,1,0,1,195,196,0.51
July,31,2017,Thurston,WA,Passenger,418,350,768,187062,187830,0.41
July,31,2017,Kittitas,WA,Passenger,24,19,43,27678,27721,0.16
July,31,2017,Snohomish,WA,Passenger,1818,920,2738,513286,516024,0.53
July,31,2017,Lincoln,WA,Passenger,2,5,7,7519,7526,0.09
July,31,2017,Prince George's,MD,Passenger,0,1,1,187,188,0.53
July,31,2017,Pierce,WA,Truck,0,0,0,137369,137369,0
July,31,2017,Clallam,WA,Passenger,93,77,170,48417,48587,0.35
July,31,2017,Jackson,MO,Passenger,1,0,1,57,58,1.72
July,31,2017,Kent,MI,Passenger,0,1,1,37,38,2.63
July,31,2017,San Mateo,CA,Passenger,0,1,1,151,152,0.66
July,31,2017,Madison,ID,Passenger,1,0,1,39,40,2.5
July,31,2017,Manassas,VA,Passenger,0,1,1,9,10,10
July,31,2017,DeKalb,IN,Passenger,1,0,1,1,2,50
July,31,2017,Okaloosa,FL,Passenger,1,0,1,183,184,0.54
July,31,2017,Chelan,WA,Passenger,68,35,103,52135,52238,0.2
July,31,2017,District of Columbia,DC,Passenger,0,3,3,211,214,1.4
July,31,2017,Virginia Beach,VA,Passenger,2,1,3,653,656,0.46
July,31,2017,Franklin,WA,Truck,0,0,0,18175,18175,0
July,31,2017,Cowlitz,WA,Truck,0,0,0,27954,27954,0
July,31,2017,Missoula,MT,Passenger,1,0,1,72,73,1.37
July,31,2017,Santa Clara,CA,Passenger,5,2,7,399,406,1.72
July,31,2017,Hamilton,IN,Passenger,1,0,1,58,59,1.69
July,31,2017,Stevens,WA,Truck,0,0,0,18211,18211,0
July,31,2017,Polk,FL,Passenger,1,0,1,63,64,1.56
July,31,2017,Chelan,WA,Truck,0,0,0,21329,21329,0
July,31,2017,Dale,AL,Passenger,0,1,1,64,65,1.54
July,31,2017,Pacific,WA,Passenger,10,9,19,15197,15216,0.12
July,31,2017,Montgomery,PA,Passenger,1,0,1,39,40,2.5
July,31,2017,Carroll,NH,Passenger,0,1,1,1,2,50
July,31,2017,,,Passenger,5,1,6,679,685,0.88
July,31,2017,Fulton,GA,Passenger,1,0,1,113,114,0.88
July,31,2017,Monterey,CA,Passenger,0,2,2,199,201,1
July,31,2017,Grant,WA,Truck,0,0,0,25271,25271,0
July,31,2017,Honolulu,HI,Passenger,3,2,5,570,575,0.87
July,31,2017,Charles,MD,Passenger,0,1,1,86,87,1.15
July,31,2017,Skagit,WA,Truck,1,0,1,31485,31486,0
July,31,2017,Okanogan,WA,Passenger,4,18,22,25634,25656,0.09
July,31,2017,Cobb,GA,Passenger,0,1,1,77,78,1.28
July,31,2017,Jefferson,WA,Passenger,107,61,168,23895,24063,0.7
July,31,2017,Franklin,OH,Passenger,0,1,1,119,120,0.83
July,31,2017,Columbia,WA,Truck,0,0,0,1533,1533,0
July,31,2017,Utah,UT,Passenger,0,1,1,153,154,0.65
July,31,2017,Wahkiakum,WA,Passenger,0,2,2,2836,2838,0.07
July,31,2017,Benton,WA,Passenger,155,148,303,128671,128974,0.23
July,31,2017,Orange,FL,Passenger,1,1,2,131,133,1.5
July,31,2017,Spokane,WA,Truck,1,0,1,90744,90745,0
July,31,2017,El Paso,CO,Passenger,2,0,2,789,791,0.25
July,31,2017,Prince William,VA,Passenger,0,3,3,271,274,1.09
July,31,2017,Frederick,MD,Passenger,0,1,1,82,83,1.2
July,31,2017,Moore,NC,Passenger,0,1,1,199,200,0.5
July,31,2017,Dakota,MN,Passenger,0,1,1,36,37,2.7
July,31,2017,Pima,AZ,Passenger,1,2,3,425,428,0.7
July,31,2017,Wahkiakum,WA,Truck,0,0,0,1659,1659,0
July,31,2017,Santa Fe,NM,Passenger,0,1,1,43,44,2.27
July,31,2017,Duval,FL,Passenger,1,1,2,378,380,0.53
July,31,2017,New London,CT,Passenger,1,1,2,253,255,0.78
July,31,2017,Okanogan,WA,Truck,0,0,0,16226,16226,0
July,31,2017,Island,WA,Passenger,121,141,262,60273,60535,0.43
July,31,2017,Yakima,WA,Passenger,49,62,111,159655,159766,0.07
July,31,2017,Sangamon,IL,Passenger,1,0,1,11,12,8.33
July,31,2017,Grays Harbor,WA,Passenger,36,35,71,44850,44921,0.16
July,31,2017,Kitsap,WA,Truck,1,0,1,52511,52512,0
July,31,2017,Columbia,WA,Passenger,1,1,2,2350,2352,0.09
July,31,2017,Stevens,WA,Passenger,8,23,31,31395,31426,0.1
July,31,2017,Klickitat,WA,Truck,0,0,0,7953,7953,0
July,31,2017,Asotin,WA,Truck,0,0,0,6532,6532,0
July,31,2017,DeKalb,GA,Passenger,1,0,1,84,85,1.18
July,31,2017,Sumter,FL,Passenger,0,1,1,10,11,9.09
July,31,2017,Walla Walla,WA,Passenger,27,26,53,34886,34939,0.15
July,31,2017,Adams,WA,Truck,0,0,0,5123,5123,0
July,31,2017,Pacific,WA,Truck,0,0,0,7495,7495,0
July,31,2017,Pend Oreille,WA,Passenger,3,4,7,9321,9328,0.08
July,31,2017,Spokane,WA,Passenger,262,213,475,296652,297127,0.16
July,31,2017,Whatcom,WA,Truck,2,0,2,41660,41662,0
July,31,2017,Travis,TX,Passenger,0,1,1,190,191,0.52
July,31,2017,Maui,HI,Passenger,1,0,1,68,69,1.45
July,31,2017,Benton,WA,Truck,0,0,0,40129,40129,0
July,31,2017,Los Angeles,CA,Passenger,3,1,4,1271,1275,0.31
July,31,2017,Norfolk,MA,Passenger,1,0,1,37,38,2.63
July,31,2017,Cape May,NJ,Passenger,0,1,1,19,20,5
July,31,2017,Arlington,VA,Passenger,1,1,2,167,169,1.18
July,31,2017,Lumpkin,GA,Passenger,1,0,1,9,10,10
July,31,2017,Portsmouth,VA,Passenger,0,1,1,66,67,1.49
July,31,2017,San Juan,WA,Passenger,112,39,151,13563,13714,1.1
July,31,2017,Ferry,WA,Passenger,1,1,2,4400,4402,0.05
July,31,2017,Lee,AL,Passenger,1,0,1,36,37,2.7
July,31,2017,Ramsey,MN,Passenger,1,0,1,40,41,2.44
July,31,2017,Manatee,FL,Passenger,1,0,1,42,43,2.33
July,31,2017,Snohomish,WA,Truck,1,0,1,121771,121772,0
July,31,2017,Klickitat,WA,Passenger,22,24,46,14803,14849,0.31
July,31,2017,Adams,WA,Passenger,3,3,6,12184,12190,0.05
July,31,2017,Thurston,WA,Truck,0,0,0,53297,53297,0
July,31,2017,Lane,OR,Passenger,0,1,1,228,229,0.44
July,31,2017,Douglas,WA,Truck,0,0,0,11515,11515,0
July,31,2017,Howard,MD,Passenger,0,2,2,92,94,2.13
July,31,2017,Montgomery,TN,Passenger,1,0,1,280,281,0.36
July,31,2017,Riverside,CA,Passenger,1,1,2,787,789,0.25
July,31,2017,Skamania,WA,Truck,0,0,0,3873,3873,0
July,31,2017,Mason,WA,Passenger,57,71,128,43631,43759,0.29
July,31,2017,Maricopa,AZ,Passenger,2,0,2,1705,1707,0.12
July,31,2017,Whitman,WA,Truck,0,0,0,8425,8425,0
July,31,2017,Lewis,WA,Passenger,52,36,88,55557,55645,0.16
July,31,2017,Bexar,TX,Passenger,1,1,2,888,890,0.22
July,31,2017,Whatcom,WA,Passenger,474,179,653,143186,143839,0.45
July,31,2017,Orange,CA,Passenger,3,1,4,627,631,0.63
July,31,2017,King,WA,Truck,8,1,9,187250,187259,0
July,31,2017,Norfolk,VA,Passenger,1,1,2,312,314,0.64
July,31,2017,Saratoga,NY,Passenger,1,1,2,74,76,2.63
July,31,2017,Tarrant,TX,Passenger,1,0,1,242,243,0.41
July,31,2017,Nantucket,MA,Passenger,1,0,1,3,4,25
July,31,2017,Santa Rosa,FL,Passenger,1,0,1,112,113,0.88
July,31,2017,Cowlitz,WA,Passenger,52,61,113,69775,69888,0.16
July,31,2017,Marin,CA,Passenger,1,0,1,58,59,1.69
July,31,2017,Twin Falls,ID,Passenger,0,1,1,23,24,4.17
June,30,2017,Franklin,MA,Passenger,0,1,1,4,5,20
June,30,2017,Prince George's,MD,Passenger,0,1,1,183,184,0.54
June,30,2017,Honolulu,HI,Passenger,3,2,5,591,596,0.84
June,30,2017,Ferry,WA,Truck,0,0,0,3537,3537,0
June,30,2017,Saratoga,NY,Passenger,1,1,2,75,77,2.6
June,30,2017,Travis,TX,Passenger,0,1,1,191,192,0.52
June,30,2017,Bergen,NJ,Passenger,0,2,2,31,33,6.06
June,30,2017,Hamilton,IN,Passenger,1,0,1,58,59,1.69
June,30,2017,Grays Harbor,WA,Passenger,35,31,66,44778,44844,0.15
June,30,2017,Canyon,ID,Passenger,0,1,1,100,101,0.99
June,30,2017,Howard,MD,Passenger,0,2,2,93,95,2.11
June,30,2017,Morris,NJ,Passenger,1,0,1,24,25,4
June,30,2017,Kitsap,WA,Truck,1,0,1,52519,52520,0
June,30,2017,Garfield,WA,Truck,0,0,0,940,940,0
June,30,2017,Palm Beach,FL,Passenger,0,1,1,98,99,1.01
June,30,2017,Douglas,WA,Truck,0,0,0,11527,11527,0
June,30,2017,Snohomish,WA,Passenger,1793,903,2696,513181,515877,0.52
June,30,2017,Douglas,WA,Passenger,34,26,60,26716,26776,0.22
June,30,2017,Chelan,WA,Passenger,67,37,104,52044,52148,0.2
June,30,2017,Moore,NC,Passenger,0,1,1,199,200,0.5
June,30,2017,Maui,HI,Passenger,1,0,1,69,70,1.43
June,30,2017,Missoula,MT,Passenger,1,0,1,72,73,1.37
June,30,2017,Bexar,TX,Passenger,1,1,2,938,940,0.21
June,30,2017,Whitman,WA,Truck,0,0,0,8429,8429,0
June,30,2017,Clallam,WA,Truck,0,0,0,21016,21016,0
June,30,2017,Franklin,WA,Truck,0,0,0,18122,18122,0
June,30,2017,Prince William,VA,Passenger,0,3,3,270,273,1.1
June,30,2017,Santa Clara,CA,Passenger,5,2,7,400,407,1.72
June,30,2017,Snohomish,WA,Truck,1,0,1,121886,121887,0
June,30,2017,Twin Falls,ID,Passenger,0,1,1,23,24,4.17
June,30,2017,Pinal,AZ,Passenger,2,0,2,243,245,0.82
June,30,2017,Walla Walla,WA,Truck,0,0,0,13205,13205,0
June,30,2017,Ramsey,MN,Passenger,1,0,1,41,42,2.38
June,30,2017,Alameda,CA,Passenger,1,1,2,365,367,0.54
June,30,2017,San Juan,WA,Passenger,107,40,147,13551,13698,1.07
June,30,2017,Kitsap,WA,Passenger,605,319,924,173378,174302,0.53
June,30,2017,Cape May,NJ,Passenger,0,1,1,19,20,5
June,30,2017,Orange,CA,Passenger,3,1,4,627,631,0.63
June,30,2017,Volusia,FL,Passenger,0,1,1,47,48,2.08
June,30,2017,New Haven,CT,Passenger,0,1,1,57,58,1.72
June,30,2017,DeKalb,GA,Passenger,1,0,1,85,86,1.16
June,30,2017,Hawaii,HI,Passenger,1,0,1,81,82,1.22
June,30,2017,Pacific,WA,Truck,0,0,0,7471,7471,0
June,30,2017,Wahkiakum,WA,Passenger,0,2,2,2832,2834,0.07
June,30,2017,Norfolk,VA,Passenger,1,1,2,316,318,0.63
June,30,2017,Kittitas,WA,Truck,0,0,0,13560,13560,0
June,30,2017,Cumberland,NC,Passenger,1,0,1,584,585,0.17
June,30,2017,Stevens,WA,Passenger,8,23,31,31384,31415,0.1
June,30,2017,Skamania,WA,Truck,0,0,0,3892,3892,0
June,30,2017,Arlington,VA,Passenger,1,1,2,167,169,1.18
June,30,2017,Anne Arundel,MD,Passenger,0,1,1,499,500,0.2
June,30,2017,Albemarle,VA,Passenger,0,1,1,32,33,3.03
June,30,2017,Pima,AZ,Passenger,1,2,3,430,433,0.69
June,30,2017,Norfolk,MA,Passenger,1,0,1,39,40,2.5
June,30,2017,Grays Harbor,WA,Truck,0,0,0,19888,19888,0
June,30,2017,Manassas,VA,Passenger,0,1,1,9,10,10
June,30,2017,Okanogan,WA,Truck,0,0,0,16204,16204,0
June,30,2017,Kent,MI,Passenger,0,1,1,37,38,2.63
June,30,2017,Salt Lake,UT,Passenger,0,1,1,266,267,0.37
June,30,2017,Lewis,WA,Truck,0,0,0,24838,24838,0
June,30,2017,Klickitat,WA,Truck,0,0,0,7971,7971,0
June,30,2017,Polk,FL,Passenger,1,0,1,64,65,1.54
June,30,2017,Tarrant,TX,Passenger,1,0,1,252,253,0.4
June,30,2017,Asotin,WA,Truck,0,0,0,6502,6502,0
June,30,2017,Juneau,AK,Passenger,0,1,1,45,46,2.17
June,30,2017,,,Passenger,5,1,6,672,678,0.88
June,30,2017,Skagit,WA,Passenger,140,103,243,88070,88313,0.28
June,30,2017,Manatee,FL,Passenger,1,0,1,46,47,2.13
June,30,2017,Spokane,WA,Passenger,253,208,461,296812,297273,0.16
June,30,2017,Cowlitz,WA,Truck,0,0,0,27913,27913,0
June,30,2017,Whatcom,WA,Passenger,462,175,637,143061,143698,0.44
June,30,2017,Monterey,CA,Passenger,0,1,1,206,207,0.48
June,30,2017,Whatcom,WA,Truck,2,0,2,41620,41622,0
June,30,2017,Dallas,TX,Passenger,0,1,1,186,187,0.53
June,30,2017,St. Lucie,FL,Passenger,1,0,1,33,34,2.94
June,30,2017,Franklin,WA,Passenger,26,45,71,55615,55686,0.13
June,30,2017,Jefferson,NY,Passenger,1,1,2,252,254,0.79
June,30,2017,Nassau,NY,Passenger,0,1,1,39,40,2.5
June,30,2017,Walla Walla,WA,Passenger,25,26,51,34843,34894,0.15
June,30,2017,Essex,NJ,Passenger,1,0,1,14,15,6.67
June,30,2017,Hardin,KY,Passenger,0,1,1,121,122,0.82
June,30,2017,Shelby,TN,Passenger,0,1,1,110,111,0.9
June,30,2017,Ferry,WA,Passenger,1,1,2,4394,4396,0.05
June,30,2017,Jefferson,WA,Passenger,104,61,165,23850,24015,0.69
June,30,2017,Marin,CA,Passenger,1,0,1,59,60,1.67
June,30,2017,Mason,WA,Truck,0,0,0,19273,19273,0
June,30,2017,Madison,ID,Passenger,1,0,1,39,40,2.5
June,30,2017,Pierce,WA,Truck,0,0,0,137535,137535,0
June,30,2017,Mason,WA,Passenger,56,68,124,43451,43575,0.28
June,30,2017,Cowlitz,WA,Passenger,50,60,110,69653,69763,0.16
June,30,2017,King,WA,Passenger,10028,4104,14132,1375372,1389504,1.02
June,30,2017,Nueces,TX,Passenger,0,1,1,96,97,1.03
June,30,2017,Clark,WA,Truck,0,0,0,77648,77648,0
June,30,2017,Whitman,WA,Passenger,10,20,30,22038,22068,0.14
June,30,2017,Charles,MD,Passenger,0,1,1,88,89,1.12
June,30,2017,El Paso,CO,Passenger,2,1,3,805,808,0.37
June,30,2017,Pend Oreille,WA,Passenger,3,4,7,9316,9323,0.08
June,30,2017,Orange,FL,Passenger,1,1,2,134,136,1.47
June,30,2017,Sangamon,IL,Passenger,1,0,1,11,12,8.33
June,30,2017,Garfield,WA,Passenger,0,0,0,1295,1295,0
June,30,2017,Flathead,MT,Passenger,1,0,1,61,62,1.61
June,30,2017,Portsmouth,VA,Passenger,0,1,1,68,69,1.45
June,30,2017,Okaloosa,FL,Passenger,1,0,1,183,184,0.54
June,30,2017,Montgomery,MD,Passenger,1,0,1,306,307,0.33
June,30,2017,Cascade,MT,Passenger,0,1,1,59,60,1.67
June,30,2017,Riverside,CA,Passenger,1,1,2,808,810,0.25
June,30,2017,Asotin,WA,Passenger,6,3,9,12427,12436,0.07
June,30,2017,Nantucket,MA,Passenger,1,0,1,3,4,25
June,30,2017,Jackson,MO,Passenger,1,0,1,60,61,1.64
June,30,2017,Orleans,LA,Passenger,0,1,1,46,47,2.13
June,30,2017,Marion,OR,Passenger,1,0,1,165,166,0.6
June,30,2017,Carroll,NH,Passenger,0,1,1,1,2,50
June,30,2017,Skamania,WA,Passenger,9,7,16,8566,8582,0.19
June,30,2017,Montgomery,TN,Passenger,1,0,1,283,284,0.35
June,30,2017,Wahkiakum,WA,Truck,0,0,0,1644,1644,0
June,30,2017,Tuolumne,CA,Passenger,0,1,1,14,15,6.67
June,30,2017,Cobb,GA,Passenger,0,1,1,76,77,1.3
June,30,2017,Deschutes,OR,Passenger,1,0,1,196,197,0.51
June,30,2017,Franklin,OH,Passenger,0,1,1,122,123,0.81
June,30,2017,Los Angeles,CA,Passenger,3,1,4,1294,1298,0.31
June,30,2017,Grant,WA,Truck,0,0,0,25220,25220,0
June,30,2017,Dale,AL,Passenger,0,1,1,64,65,1.54
June,30,2017,DeKalb,IN,Passenger,1,0,1,1,2,50
June,30,2017,Allegheny,PA,Passenger,1,0,1,93,94,1.06
June,30,2017,Utah,UT,Passenger,0,1,1,156,157,0.64
June,30,2017,Latah,ID,Passenger,0,1,1,103,104,0.96
June,30,2017,Lincoln,WA,Truck,0,0,0,4429,4429,0
June,30,2017,Lumpkin,GA,Passenger,1,0,1,9,10,10
June,30,2017,Ventura,CA,Passenger,0,1,1,356,357,0.28
June,30,2017,Lee,AL,Passenger,1,0,1,36,37,2.7
June,30,2017,Lane,OR,Passenger,0,1,1,237,238,0.42
June,30,2017,Santa Rosa,FL,Passenger,1,0,1,113,114,0.88
June,30,2017,San Juan,WA,Truck,0,0,0,5535,5535,0
June,30,2017,Dakota,MN,Passenger,0,1,1,37,38,2.63
June,30,2017,San Diego,CA,Passenger,5,1,6,2725,2731,0.22
June,30,2017,Santa Fe,NM,Passenger,0,1,1,46,47,2.13
June,30,2017,Clark,NV,Passenger,1,2,3,829,832,0.36
June,30,2017,Multnomah,OR,Passenger,1,3,4,998,1002,0.4
June,30,2017,Okanogan,WA,Passenger,4,17,21,25707,25728,0.08
June,30,2017,Grant,WA,Passenger,20,27,47,60844,60891,0.08
June,30,2017,Klickitat,WA,Passenger,22,24,46,14799,14845,0.31
June,30,2017,Skagit,WA,Truck,1,0,1,31458,31459,0
June,30,2017,Yakima,WA,Truck,0,0,0,57351,57351,0
June,30,2017,Benton,WA,Truck,0,0,0,40055,40055,0
June,30,2017,Benton,WA,Passenger,148,143,291,128515,128806,0.23
June,30,2017,Adams,WA,Passenger,2,3,5,12204,12209,0.04
June,30,2017,Virginia Beach,VA,Passenger,2,1,3,652,655,0.46
June,30,2017,Tulare,CA,Passenger,1,0,1,198,199,0.5
June,30,2017,Harnett,NC,Passenger,1,0,1,258,259,0.39
June,30,2017,Island,WA,Truck,0,0,0,20501,20501,0
June,30,2017,Maricopa,AZ,Passenger,2,0,2,1748,1750,0.11
June,30,2017,Adams,WA,Truck,0,0,0,5106,5106,0
June,30,2017,Yakima,WA,Passenger,45,57,102,159401,159503,0.06
June,30,2017,Wayne,MI,Passenger,0,1,1,69,70,1.43
June,30,2017,Sedgwick,KS,Passenger,0,1,1,110,111,0.9
June,30,2017,Clackamas,OR,Passenger,0,1,1,292,293,0.34
June,30,2017,District of Columbia,DC,Passenger,0,3,3,218,221,1.36
June,30,2017,Kittitas,WA,Passenger,21,17,38,27579,27617,0.14
June,30,2017,Dane,WI,Passenger,1,0,1,103,104,0.96
June,30,2017,Columbia,WA,Passenger,1,1,2,2353,2355,0.08
June,30,2017,Lewis,WA,Passenger,51,34,85,55546,55631,0.15
June,30,2017,Stevens,WA,Truck,0,0,0,18273,18273,0
June,30,2017,Hamilton,TN,Passenger,1,0,1,19,20,5
June,30,2017,Columbia,WA,Truck,0,0,0,1531,1531,0
June,30,2017,King,WA,Truck,8,1,9,187744,187753,0
June,30,2017,Fairfax,VA,Passenger,2,2,4,858,862,0.46
June,30,2017,Pierce,WA,Passenger,956,842,1798,524957,526755,0.34
June,30,2017,Gwinnett,GA,Passenger,0,1,1,84,85,1.18
June,30,2017,Pacific,WA,Passenger,10,7,17,15145,15162,0.11
June,30,2017,Montgomery,PA,Passenger,1,0,1,40,41,2.44
June,30,2017,Chelan,WA,Truck,0,0,0,21303,21303,0
June,30,2017,New London,CT,Passenger,1,1,2,253,255,0.78
June,30,2017,Jefferson,WA,Truck,0,0,0,9424,9424,0
June,30,2017,Northampton,PA,Passenger,1,0,1,147,148,0.68
June,30,2017,Richmond,GA,Passenger,0,1,1,89,90,1.11
June,30,2017,Pend Oreille,WA,Truck,0,0,0,5574,5574,0
June,30,2017,Island,WA,Passenger,117,136,253,60111,60364,0.42
June,30,2017,Duval,FL,Passenger,1,1,2,383,385,0.52
June,30,2017,Thurston,WA,Truck,0,0,0,53295,53295,0
June,30,2017,Fulton,GA,Passenger,1,0,1,115,116,0.86
June,30,2017,Spokane,WA,Truck,1,0,1,90624,90625,0
June,30,2017,Sumter,FL,Passenger,0,1,1,10,11,9.09
June,30,2017,Thurston,WA,Passenger,398,336,734,186654,187388,0.39
June,30,2017,Lincoln,WA,Passenger,2,5,7,7527,7534,0.09
June,30,2017,Clark,WA,Passenger,787,504,1291,299553,300844,0.43
June,30,2017,San Mateo,CA,Passenger,0,1,1,151,152,0.66
June,30,2017,Clallam,WA,Passenger,90,76,166,48373,48539,0.34
March,31,2017,Cape May,NJ,Passenger,0,1,1,18,19,5.26
March,31,2017,Pacific,WA,Passenger,6,8,14,15078,15092,0.09
March,31,2017,Kittitas,WA,Passenger,17,16,33,27117,27150,0.12
March,31,2017,Pima,AZ,Passenger,0,2,2,445,447,0.45
March,31,2017,Lincoln,WA,Truck,0,0,0,4469,4469,0
March,31,2017,Portsmouth,VA,Passenger,0,1,1,67,68,1.47
March,31,2017,Skagit,WA,Truck,1,0,1,31426,31427,0
March,31,2017,Virginia Beach,VA,Passenger,2,1,3,652,655,0.46
March,31,2017,Manatee,FL,Passenger,1,0,1,52,53,1.89
March,31,2017,Prince George's,MD,Passenger,0,1,1,183,184,0.54
March,31,2017,Clark,NV,Passenger,1,3,4,865,869,0.46
March,31,2017,Manassas,VA,Passenger,0,1,1,9,10,10
March,31,2017,Harnett,NC,Passenger,1,0,1,258,259,0.39
March,31,2017,El Paso,CO,Passenger,1,1,2,825,827,0.24
March,31,2017,Charles,MD,Passenger,0,1,1,91,92,1.09
March,31,2017,Yakima,WA,Passenger,36,50,86,159228,159314,0.05
March,31,2017,Cascade,MT,Passenger,0,1,1,60,61,1.64
March,31,2017,Wahkiakum,WA,Passenger,0,2,2,2849,2851,0.07
March,31,2017,Pierce,WA,Passenger,876,784,1660,526368,528028,0.31
March,31,2017,Howard,MD,Passenger,0,2,2,89,91,2.2
March,31,2017,Pacific,WA,Truck,0,0,0,7480,7480,0
March,31,2017,Jackson,MO,Passenger,1,0,1,68,69,1.45
March,31,2017,Saratoga,NY,Passenger,1,1,2,77,79,2.53
March,31,2017,Yakima,WA,Truck,0,0,0,57266,57266,0
March,31,2017,Cobb,GA,Passenger,0,1,1,79,80,1.25
March,31,2017,Franklin,MA,Passenger,0,1,1,4,5,20
March,31,2017,Dane,WI,Passenger,1,0,1,153,154,0.65
March,31,2017,Nueces,TX,Passenger,0,1,1,100,101,0.99
March,31,2017,Fulton,GA,Passenger,1,1,2,123,125,1.6
March,31,2017,Albemarle,VA,Passenger,0,1,1,30,31,3.23
March,31,2017,Montgomery,MD,Passenger,1,0,1,306,307,0.33
March,31,2017,Canyon,ID,Passenger,0,1,1,104,105,0.95
March,31,2017,Lane,OR,Passenger,0,1,1,257,258,0.39
March,31,2017,Monroe,NY,Passenger,1,0,1,29,30,3.33
March,31,2017,Grant,WA,Truck,0,0,0,25045,25045,0
March,31,2017,Santa Fe,NM,Passenger,0,1,1,45,46,2.17
March,31,2017,Clallam,WA,Truck,0,0,0,21041,21041,0
March,31,2017,Anne Arundel,MD,Passenger,0,1,1,503,504,0.2
March,31,2017,San Mateo,CA,Passenger,0,1,1,157,158,0.63
March,31,2017,Cowlitz,WA,Truck,0,0,0,27906,27906,0
March,31,2017,Los Angeles,CA,Passenger,3,1,4,1365,1369,0.29
March,31,2017,Ferry,WA,Passenger,2,1,3,4386,4389,0.07
March,31,2017,Orange,CA,Passenger,2,1,3,659,662,0.45
March,31,2017,Sumter,FL,Passenger,0,1,1,10,11,9.09
March,31,2017,Kitsap,WA,Passenger,572,289,861,172480,173341,0.5
March,31,2017,Douglas,OR,Passenger,0,1,1,75,76,1.32
March,31,2017,Spokane,WA,Passenger,232,202,434,295454,295888,0.15
March,31,2017,Fairfax,VA,Passenger,2,2,4,867,871,0.46
March,31,2017,Klickitat,WA,Passenger,21,23,44,14774,14818,0.3
March,31,2017,Lewis,WA,Passenger,45,34,79,55095,55174,0.14
March,31,2017,Douglas,WA,Passenger,29,19,48,26592,26640,0.18
March,31,2017,Utah,UT,Passenger,0,1,1,168,169,0.59
March,31,2017,Grant,WA,Passenger,17,21,38,60332,60370,0.06
March,31,2017,Hawaii,HI,Passenger,1,0,1,87,88,1.14
March,31,2017,Adams,WA,Truck,0,0,0,5070,5070,0
March,31,2017,Mason,WA,Truck,0,0,0,19230,19230,0
March,31,2017,Grays Harbor,WA,Truck,0,0,0,19865,19865,0
March,31,2017,Orleans,LA,Passenger,0,1,1,50,51,1.96
March,31,2017,DeKalb,IN,Passenger,1,0,1,1,2,50
March,31,2017,Asotin,WA,Truck,0,0,0,6511,6511,0
March,31,2017,King,WA,Passenger,9317,3787,13104,1382738,1395842,0.94
March,31,2017,Dallas,TX,Passenger,1,1,2,206,208,0.96
March,31,2017,Ferry,WA,Truck,0,0,0,3554,3554,0
March,31,2017,San Juan,WA,Passenger,88,34,122,13420,13542,0.9
March,31,2017,Columbia,WA,Truck,0,0,0,1529,1529,0
March,31,2017,New London,CT,Passenger,1,1,2,263,265,0.75
March,31,2017,Clackamas,OR,Passenger,1,2,3,339,342,0.88
March,31,2017,Hamilton,IN,Passenger,1,0,1,64,65,1.54
March,31,2017,Pend Oreille,WA,Truck,0,0,0,5583,5583,0
March,31,2017,Travis,TX,Passenger,0,1,1,192,193,0.52
March,31,2017,Guilford,NC,Passenger,1,0,1,31,32,3.12
March,31,2017,Deschutes,OR,Passenger,1,0,1,202,203,0.49
March,31,2017,Lewis,NY,Passenger,0,1,1,10,11,9.09
March,31,2017,Dakota,MN,Passenger,0,1,1,41,42,2.38
March,31,2017,Wahkiakum,WA,Truck,0,0,0,1635,1635,0
March,31,2017,Clark,WA,Truck,0,0,0,77572,77572,0
March,31,2017,Hardin,KY,Passenger,0,1,1,126,127,0.79
March,31,2017,Douglas,WA,Truck,0,0,0,11441,11441,0
March,31,2017,Ventura,CA,Passenger,0,2,2,375,377,0.53
March,31,2017,Richmond,GA,Passenger,0,1,1,95,96,1.04
March,31,2017,Chelan,WA,Passenger,55,30,85,51678,51763,0.16
March,31,2017,Tarrant,TX,Passenger,0,2,2,289,291,0.69
March,31,2017,Muscogee,GA,Passenger,0,1,1,253,254,0.39
March,31,2017,Benton,WA,Passenger,140,139,279,127941,128220,0.22
March,31,2017,Jefferson,NY,Passenger,1,1,2,260,262,0.76
March,31,2017,Nantucket,MA,Passenger,1,0,1,3,4,25
March,31,2017,Jefferson,WA,Truck,0,0,0,9447,9447,0
March,31,2017,Marin,CA,Passenger,1,0,1,59,60,1.67
March,31,2017,Okanogan,WA,Truck,0,0,0,16304,16304,0
March,31,2017,Stevens,WA,Passenger,6,20,26,31284,31310,0.08
March,31,2017,Clallam,WA,Passenger,77,65,142,48078,48220,0.29
March,31,2017,Duval,FL,Passenger,1,1,2,373,375,0.53
March,31,2017,San Juan,WA,Truck,0,0,0,5583,5583,0
March,31,2017,Whatcom,WA,Passenger,416,156,572,142234,142806,0.4
March,31,2017,Pinal,AZ,Passenger,2,0,2,263,265,0.75
March,31,2017,Montgomery,TN,Passenger,1,0,1,287,288,0.35
March,31,2017,Moore,NC,Passenger,0,1,1,208,209,0.48
March,31,2017,Missoula,MT,Passenger,1,0,1,80,81,1.23
March,31,2017,Island,WA,Truck,0,0,0,20500,20500,0
March,31,2017,Okanogan,WA,Passenger,3,16,19,25642,25661,0.07
March,31,2017,Nassau,NY,Passenger,0,1,1,40,41,2.44
March,31,2017,Essex,NJ,Passenger,1,0,1,16,17,5.88
March,31,2017,Chelan,WA,Truck,0,0,0,21220,21220,0
March,31,2017,Grays Harbor,WA,Passenger,27,26,53,44419,44472,0.12
March,31,2017,Franklin,WA,Truck,0,0,0,17960,17960,0
March,31,2017,Norfolk,VA,Passenger,1,1,2,304,306,0.65
March,31,2017,Whatcom,WA,Truck,2,0,2,41393,41395,0
March,31,2017,Gwinnett,GA,Passenger,0,1,1,84,85,1.18
March,31,2017,Northampton,PA,Passenger,2,0,2,209,211,0.95
March,31,2017,Lee,AL,Passenger,1,0,1,35,36,2.78
March,31,2017,Asotin,WA,Passenger,5,2,7,12335,12342,0.06
March,31,2017,Benton,WA,Truck,0,0,0,39849,39849,0
March,31,2017,Garfield,WA,Truck,0,0,0,940,940,0
March,31,2017,Thurston,WA,Passenger,365,313,678,185430,186108,0.36
March,31,2017,Shelby,TN,Passenger,0,1,1,110,111,0.9
March,31,2017,Wayne,MI,Passenger,0,1,1,71,72,1.39
March,31,2017,Clark,WA,Passenger,718,454,1172,298270,299442,0.39
March,31,2017,Latah,ID,Passenger,0,1,1,121,122,0.82
March,31,2017,Hidalgo,TX,Passenger,0,1,1,97,98,1.02
March,31,2017,Madison,ID,Passenger,1,0,1,44,45,2.22
March,31,2017,Dale,AL,Passenger,0,1,1,64,65,1.54
March,31,2017,Monterey,CA,Passenger,0,1,1,218,219,0.46
March,31,2017,Kittitas,WA,Truck,0,0,0,13423,13423,0
March,31,2017,Thurston,WA,Truck,0,0,0,53299,53299,0
March,31,2017,Pierce,WA,Truck,0,0,0,138175,138175,0
March,31,2017,Whitman,WA,Passenger,9,18,27,21937,21964,0.12
March,31,2017,Prince William,VA,Passenger,0,3,3,275,278,1.08
March,31,2017,DeKalb,GA,Passenger,1,0,1,84,85,1.18
March,31,2017,Cumberland,NC,Passenger,1,0,1,622,623,0.16
March,31,2017,Adams,WA,Passenger,2,4,6,12107,12113,0.05
March,31,2017,Honolulu,HI,Passenger,4,2,6,616,622,0.96
March,31,2017,Skagit,WA,Passenger,118,91,209,87516,87725,0.24
March,31,2017,Volusia,FL,Passenger,0,1,1,46,47,2.13
March,31,2017,Snohomish,WA,Truck,1,0,1,122199,122200,0
March,31,2017,Bexar,TX,Passenger,1,2,3,1088,1091,0.27
March,31,2017,Allegheny,PA,Passenger,1,0,1,91,92,1.09
March,31,2017,Middlesex,MA,Passenger,1,0,1,152,153,0.65
March,31,2017,Norfolk,MA,Passenger,1,0,1,37,38,2.63
March,31,2017,Walla Walla,WA,Truck,0,0,0,13186,13186,0
March,31,2017,Klickitat,WA,Truck,0,0,0,7941,7941,0
March,31,2017,Multnomah,OR,Passenger,0,3,3,1110,1113,0.27
March,31,2017,Snohomish,WA,Passenger,1656,849,2505,513393,515898,0.49
March,31,2017,Stevens,WA,Truck,0,0,0,18309,18309,0
March,31,2017,Salt Lake,UT,Passenger,0,1,1,309,310,0.32
March,31,2017,Marion,OR,Passenger,1,0,1,195,196,0.51
March,31,2017,Maricopa,AZ,Passenger,2,0,2,1827,1829,0.11
March,31,2017,King,WA,Truck,8,1,9,189758,189767,0
March,31,2017,Walla Walla,WA,Passenger,20,22,42,34821,34863,0.12
March,31,2017,Arlington,VA,Passenger,1,1,2,168,170,1.18
March,31,2017,New Haven,CT,Passenger,0,1,1,61,62,1.61
March,31,2017,Morris,NJ,Passenger,1,0,1,22,23,4.35
March,31,2017,Orange,FL,Passenger,1,1,2,152,154,1.3
March,31,2017,Franklin,WA,Passenger,26,47,73,55311,55384,0.13
March,31,2017,Skamania,WA,Passenger,8,8,16,8529,8545,0.19
March,31,2017,Garfield,WA,Passenger,0,0,0,1283,1283,0
March,31,2017,San Diego,CA,Passenger,5,1,6,2806,2812,0.21
March,31,2017,Pend Oreille,WA,Passenger,1,4,5,9307,9312,0.05
March,31,2017,Tulare,CA,Passenger,1,0,1,194,195,0.51
March,31,2017,Whitman,WA,Truck,0,0,0,8389,8389,0
March,31,2017,Polk,FL,Passenger,1,0,1,66,67,1.49
March,31,2017,Franklin,OH,Passenger,0,1,1,115,116,0.86
March,31,2017,Alameda,CA,Passenger,3,1,4,383,387,1.03
March,31,2017,Hamilton,TN,Passenger,1,0,1,26,27,3.7
March,31,2017,Okaloosa,FL,Passenger,1,0,1,193,194,0.52
March,31,2017,St. Lucie,FL,Passenger,1,0,1,31,32,3.12
March,31,2017,Maui,HI,Passenger,1,0,1,71,72,1.39
March,31,2017,Columbia,WA,Passenger,0,1,1,2355,2356,0.04
March,31,2017,Island,WA,Passenger,105,129,234,59602,59836,0.39
March,31,2017,Riverside,CA,Passenger,1,1,2,828,830,0.24
March,31,2017,Lincoln,WA,Passenger,2,4,6,7506,7512,0.08
March,31,2017,Santa Clara,CA,Passenger,6,2,8,415,423,1.89
March,31,2017,Cowlitz,WA,Passenger,51,48,99,69297,69396,0.14
March,31,2017,Montgomery,PA,Passenger,1,0,1,42,43,2.33
March,31,2017,Juneau,AK,Passenger,0,1,1,53,54,1.85
March,31,2017,Bergen,NJ,Passenger,0,2,2,32,34,5.88
March,31,2017,Jefferson,WA,Passenger,94,57,151,23648,23799,0.63
March,31,2017,Carroll,NH,Passenger,0,1,1,0,1,100
March,31,2017,Mason,WA,Passenger,50,65,115,42929,43044,0.27
March,31,2017,Kitsap,WA,Truck,1,0,1,52317,52318,0
March,31,2017,District of Columbia,DC,Passenger,0,3,3,224,227,1.32
March,31,2017,Lewis,WA,Truck,0,0,0,24813,24813,0
March,31,2017,Spokane,WA,Truck,1,0,1,90256,90257,0
March,31,2017,Skamania,WA,Truck,0,0,0,3882,3882,0
March,31,2017,Oklahoma,OK,Passenger,0,1,1,168,169,0.59
March,31,2017,,,Passenger,3,1,4,663,667,0.6
May,31,2017,Thurston,WA,Passenger,390,334,724,186064,186788,0.39
May,31,2017,Klickitat,WA,Passenger,22,24,46,14787,14833,0.31
May,31,2017,Dallas,TX,Passenger,0,1,1,187,188,0.53
May,31,2017,Skamania,WA,Truck,0,0,0,3863,3863,0
May,31,2017,King,WA,Passenger,9796,3990,13786,1377129,1390915,0.99
May,31,2017,Lane,OR,Passenger,0,1,1,244,245,0.41
May,31,2017,Alameda,CA,Passenger,1,1,2,372,374,0.53
May,31,2017,Walla Walla,WA,Truck,0,0,0,13189,13189,0
May,31,2017,Franklin,MA,Passenger,0,1,1,4,5,20
May,31,2017,Chelan,WA,Truck,0,0,0,21248,21248,0
May,31,2017,Sumter,FL,Passenger,0,1,1,10,11,9.09
May,31,2017,Garfield,WA,Passenger,0,0,0,1287,1287,0
May,31,2017,Pacific,WA,Passenger,9,7,16,15138,15154,0.11
May,31,2017,Pend Oreille,WA,Truck,0,0,0,5564,5564,0
May,31,2017,Latah,ID,Passenger,0,1,1,110,111,0.9
May,31,2017,Grays Harbor,WA,Truck,0,0,0,19898,19898,0
May,31,2017,Grays Harbor,WA,Passenger,31,30,61,44516,44577,0.14
May,31,2017,Montgomery,TN,Passenger,1,0,1,283,284,0.35
May,31,2017,Northampton,PA,Passenger,1,0,1,168,169,0.59
May,31,2017,Polk,FL,Passenger,1,0,1,66,67,1.49
May,31,2017,Adams,WA,Truck,0,0,0,5079,5079,0
May,31,2017,Snohomish,WA,Passenger,1739,867,2606,512625,515231,0.51
May,31,2017,Bergen,NJ,Passenger,0,2,2,31,33,6.06
May,31,2017,Kitsap,WA,Passenger,595,302,897,172845,173742,0.52
May,31,2017,Pacific,WA,Truck,0,0,0,7463,7463,0
May,31,2017,Dakota,MN,Passenger,0,1,1,40,41,2.44
May,31,2017,Maricopa,AZ,Passenger,2,0,2,1783,1785,0.11
May,31,2017,Wahkiakum,WA,Passenger,0,2,2,2837,2839,0.07
May,31,2017,Canyon,ID,Passenger,0,1,1,102,103,0.97
May,31,2017,Virginia Beach,VA,Passenger,2,1,3,655,658,0.46
May,31,2017,Hardin,KY,Passenger,0,1,1,122,123,0.81
May,31,2017,Essex,NJ,Passenger,1,0,1,15,16,6.25
May,31,2017,Twin Falls,ID,Passenger,0,1,1,22,23,4.35
May,31,2017,Montgomery,MD,Passenger,1,0,1,304,305,0.33
May,31,2017,Wahkiakum,WA,Truck,0,0,0,1643,1643,0
May,31,2017,Shelby,TN,Passenger,0,1,1,109,110,0.91
May,31,2017,San Juan,WA,Truck,0,0,0,5541,5541,0
May,31,2017,Lewis,WA,Passenger,49,33,82,55363,55445,0.15
May,31,2017,Ramsey,MN,Passenger,1,0,1,42,43,2.33
May,31,2017,Anne Arundel,MD,Passenger,0,1,1,503,504,0.2
May,31,2017,Missoula,MT,Passenger,1,0,1,74,75,1.33
May,31,2017,Prince George's,MD,Passenger,0,1,1,185,186,0.54
May,31,2017,Thurston,WA,Truck,0,0,0,53243,53243,0
May,31,2017,Franklin,WA,Passenger,28,44,72,55459,55531,0.13
May,31,2017,Carroll,NH,Passenger,0,1,1,0,1,100
May,31,2017,Albemarle,VA,Passenger,0,1,1,31,32,3.12
May,31,2017,Clark,WA,Truck,0,0,0,77598,77598,0
May,31,2017,Benton,WA,Passenger,146,142,288,128293,128581,0.22
May,31,2017,DeKalb,IN,Passenger,1,0,1,1,2,50
May,31,2017,Salt Lake,UT,Passenger,0,1,1,275,276,0.36
May,31,2017,Juneau,AK,Passenger,0,1,1,49,50,2
May,31,2017,Asotin,WA,Passenger,6,3,9,12376,12385,0.07
May,31,2017,Cobb,GA,Passenger,0,1,1,77,78,1.28
May,31,2017,Stevens,WA,Truck,0,0,0,18254,18254,0
May,31,2017,Harnett,NC,Passenger,1,0,1,263,264,0.38
May,31,2017,Ferry,WA,Truck,0,0,0,3544,3544,0
May,31,2017,Charles,MD,Passenger,0,1,1,89,90,1.11
May,31,2017,Skagit,WA,Passenger,134,102,236,87854,88090,0.27
May,31,2017,Cascade,MT,Passenger,0,1,1,61,62,1.61
May,31,2017,Stevens,WA,Passenger,8,23,31,31329,31360,0.1
May,31,2017,Columbia,WA,Passenger,0,1,1,2359,2360,0.04
May,31,2017,Norfolk,VA,Passenger,1,1,2,308,310,0.65
May,31,2017,Gwinnett,GA,Passenger,0,1,1,86,87,1.15
May,31,2017,Dane,WI,Passenger,1,0,1,121,122,0.82
May,31,2017,Prince William,VA,Passenger,0,3,3,275,278,1.08
May,31,2017,Yakima,WA,Passenger,42,55,97,159375,159472,0.06
May,31,2017,Morris,NJ,Passenger,1,0,1,24,25,4
May,31,2017,Lincoln,WA,Truck,0,0,0,4459,4459,0
May,31,2017,New Haven,CT,Passenger,0,1,1,60,61,1.64
May,31,2017,Okanogan,WA,Truck,0,0,0,16215,16215,0
May,31,2017,Lee,AL,Passenger,1,0,1,36,37,2.7
May,31,2017,Madison,ID,Passenger,1,0,1,41,42,2.38
May,31,2017,Arlington,VA,Passenger,1,1,2,167,169,1.18
May,31,2017,Pierce,WA,Truck,0,0,0,137682,137682,0
May,31,2017,Benton,WA,Truck,0,0,0,39974,39974,0
May,31,2017,Allegheny,PA,Passenger,1,0,1,93,94,1.06
May,31,2017,San Diego,CA,Passenger,5,1,6,2743,2749,0.22
May,31,2017,Santa Rosa,FL,Passenger,1,0,1,110,111,0.9
May,31,2017,Multnomah,OR,Passenger,1,3,4,1032,1036,0.39
May,31,2017,Yakima,WA,Truck,0,0,0,57281,57281,0
May,31,2017,Douglas,WA,Truck,0,0,0,11484,11484,0
May,31,2017,Richmond,GA,Passenger,0,1,1,93,94,1.06
May,31,2017,Los Angeles,CA,Passenger,3,1,4,1325,1329,0.3
May,31,2017,Nassau,NY,Passenger,0,1,1,39,40,2.5
May,31,2017,Pend Oreille,WA,Passenger,2,4,6,9313,9319,0.06
May,31,2017,Pierce,WA,Passenger,933,823,1756,525215,526971,0.33
May,31,2017,Orange,FL,Passenger,1,1,2,144,146,1.37
May,31,2017,Pinal,AZ,Passenger,2,0,2,253,255,0.78
May,31,2017,,,Passenger,4,1,5,667,672,0.74
May,31,2017,Columbia,WA,Truck,0,0,0,1537,1537,0
May,31,2017,Hamilton,TN,Passenger,1,0,1,22,23,4.35
May,31,2017,Skamania,WA,Passenger,9,7,16,8532,8548,0.19
May,31,2017,Mason,WA,Passenger,51,66,117,43298,43415,0.27
May,31,2017,Franklin,OH,Passenger,0,1,1,123,124,0.81
May,31,2017,Portsmouth,VA,Passenger,0,1,1,68,69,1.45
May,31,2017,Kitsap,WA,Truck,1,0,1,52377,52378,0
May,31,2017,Grant,WA,Truck,0,0,0,25222,25222,0
May,31,2017,Klickitat,WA,Truck,0,0,0,7967,7967,0
May,31,2017,Norfolk,MA,Passenger,1,0,1,39,40,2.5
May,31,2017,Adams,WA,Passenger,2,3,5,12197,12202,0.04
May,31,2017,Santa Clara,CA,Passenger,5,2,7,402,409,1.71
May,31,2017,Chelan,WA,Passenger,60,36,96,51875,51971,0.18
May,31,2017,Duval,FL,Passenger,1,1,2,379,381,0.52
May,31,2017,New London,CT,Passenger,1,1,2,252,254,0.79
May,31,2017,Utah,UT,Passenger,0,1,1,162,163,0.61
May,31,2017,San Juan,WA,Passenger,104,38,142,13498,13640,1.04
May,31,2017,Montgomery,PA,Passenger,1,0,1,39,40,2.5
May,31,2017,Spokane,WA,Truck,1,0,1,90329,90330,0
May,31,2017,Walla Walla,WA,Passenger,23,24,47,34853,34900,0.13
May,31,2017,Cowlitz,WA,Truck,0,0,0,27873,27873,0
May,31,2017,Whitman,WA,Passenger,10,20,30,21988,22018,0.14
May,31,2017,San Mateo,CA,Passenger,0,1,1,157,158,0.63
May,31,2017,Riverside,CA,Passenger,1,1,2,821,823,0.24
May,31,2017,Cape May,NJ,Passenger,0,1,1,19,20,5
May,31,2017,Manassas,VA,Passenger,0,1,1,9,10,10
May,31,2017,Fairfax,VA,Passenger,2,2,4,861,865,0.46
May,31,2017,Hamilton,IN,Passenger,1,0,1,62,63,1.59
May,31,2017,Jackson,MO,Passenger,1,0,1,63,64,1.56
May,31,2017,Moore,NC,Passenger,0,1,1,201,202,0.5
May,31,2017,Monroe,NY,Passenger,1,0,1,26,27,3.7
May,31,2017,Franklin,WA,Truck,0,0,0,18090,18090,0
May,31,2017,Clark,WA,Passenger,770,489,1259,298797,300056,0.42
May,31,2017,Orleans,LA,Passenger,0,1,1,49,50,2
May,31,2017,Kittitas,WA,Truck,0,0,0,13532,13532,0
May,31,2017,Dale,AL,Passenger,0,1,1,64,65,1.54
May,31,2017,Grant,WA,Passenger,20,25,45,60675,60720,0.07
May,31,2017,Muscogee,GA,Passenger,0,1,1,244,245,0.41
May,31,2017,Lewis,WA,Truck,0,0,0,24822,24822,0
May,31,2017,Snohomish,WA,Truck,1,0,1,121865,121866,0
May,31,2017,Jefferson,WA,Passenger,103,59,162,23819,23981,0.68
May,31,2017,Monterey,CA,Passenger,0,1,1,209,210,0.48
May,31,2017,Volusia,FL,Passenger,0,1,1,45,46,2.17
May,31,2017,Okaloosa,FL,Passenger,1,0,1,185,186,0.54
May,31,2017,DeKalb,GA,Passenger,1,0,1,83,84,1.19
May,31,2017,Skagit,WA,Truck,1,0,1,31389,31390,0
May,31,2017,Island,WA,Passenger,113,129,242,59919,60161,0.4
May,31,2017,Okanogan,WA,Passenger,3,16,19,25686,25705,0.07
May,31,2017,Flathead,MT,Passenger,1,0,1,63,64,1.56
May,31,2017,Whatcom,WA,Truck,2,0,2,41518,41520,0
May,31,2017,Middlesex,MA,Passenger,1,0,1,146,147,0.68
May,31,2017,Saratoga,NY,Passenger,1,1,2,73,75,2.67
May,31,2017,Hawaii,HI,Passenger,1,0,1,86,87,1.15
May,31,2017,Whitman,WA,Truck,0,0,0,8394,8394,0
May,31,2017,Cumberland,NC,Passenger,1,0,1,591,592,0.17
May,31,2017,Kent,MI,Passenger,0,1,1,35,36,2.78
May,31,2017,Nantucket,MA,Passenger,1,0,1,3,4,25
May,31,2017,Kittitas,WA,Passenger,22,17,39,27357,27396,0.14
May,31,2017,Marin,CA,Passenger,1,0,1,58,59,1.69
May,31,2017,Tulare,CA,Passenger,1,0,1,193,194,0.52
May,31,2017,Lincoln,WA,Passenger,2,5,7,7507,7514,0.09
May,31,2017,Honolulu,HI,Passenger,3,2,5,600,605,0.83
May,31,2017,Douglas,WA,Passenger,32,23,55,26684,26739,0.21
May,31,2017,Clackamas,OR,Passenger,1,1,2,306,308,0.65
May,31,2017,St. Lucie,FL,Passenger,1,0,1,32,33,3.03
May,31,2017,Marion,OR,Passenger,1,0,1,173,174,0.57
May,31,2017,Mason,WA,Truck,0,0,0,19265,19265,0
May,31,2017,Sedgwick,KS,Passenger,0,1,1,108,109,0.92
May,31,2017,Palm Beach,FL,Passenger,0,1,1,98,99,1.01
May,31,2017,Cowlitz,WA,Passenger,52,50,102,69536,69638,0.15
May,31,2017,Manatee,FL,Passenger,1,0,1,47,48,2.08
May,31,2017,Nueces,TX,Passenger,0,1,1,98,99,1.01
May,31,2017,Pima,AZ,Passenger,0,2,2,444,446,0.45
May,31,2017,Travis,TX,Passenger,0,1,1,192,193,0.52
May,31,2017,King,WA,Truck,8,1,9,188266,188275,0
May,31,2017,Asotin,WA,Truck,0,0,0,6491,6491,0
May,31,2017,Jefferson,WA,Truck,0,0,0,9440,9440,0
May,31,2017,Jefferson,NY,Passenger,1,1,2,254,256,0.78
May,31,2017,District of Columbia,DC,Passenger,0,3,3,222,225,1.33
May,31,2017,Maui,HI,Passenger,1,0,1,73,74,1.35
May,31,2017,Whatcom,WA,Passenger,455,167,622,142686,143308,0.43
May,31,2017,Ferry,WA,Passenger,1,1,2,4409,4411,0.05
May,31,2017,Ventura,CA,Passenger,0,1,1,360,361,0.28
May,31,2017,Santa Fe,NM,Passenger,0,1,1,46,47,2.13
May,31,2017,Fulton,GA,Passenger,1,0,1,117,118,0.85
May,31,2017,Spokane,WA,Passenger,245,211,456,296382,296838,0.15
May,31,2017,Clallam,WA,Passenger,84,74,158,48203,48361,0.33
May,31,2017,Wayne,MI,Passenger,0,1,1,68,69,1.45
May,31,2017,Island,WA,Truck,0,0,0,20531,20531,0
May,31,2017,Clallam,WA,Truck,0,0,0,20959,20959,0
May,31,2017,El Paso,CO,Passenger,2,1,3,808,811,0.37
May,31,2017,Clark,NV,Passenger,1,2,3,848,851,0.35
May,31,2017,Deschutes,OR,Passenger,1,0,1,194,195,0.51
May,31,2017,Howard,MD,Passenger,0,2,2,90,92,2.17
May,31,2017,Hidalgo,TX,Passenger,0,1,1,99,100,1
May,31,2017,Bexar,TX,Passenger,1,0,1,973,974,0.1
May,31,2017,Garfield,WA,Truck,0,0,0,932,932,0
May,31,2017,Orange,CA,Passenger,3,1,4,644,648,0.62
November,30,2017,New Haven,CT,Passenger,0,1,1,53,54,1.85
November,30,2017,District of Columbia,DC,Passenger,0,3,3,206,209,1.44
November,30,2017,Franklin,OH,Passenger,0,1,1,109,110,0.91
November,30,2017,Pinal,AZ,Passenger,2,0,2,221,223,0.9
November,30,2017,Ferry,WA,Passenger,1,3,4,4408,4412,0.09
November,30,2017,Okanogan,WA,Passenger,5,17,22,25731,25753,0.09
November,30,2017,Clark,NV,Passenger,1,2,3,760,763,0.39
November,30,2017,Pacific,WA,Truck,0,0,0,7535,7535,0
November,30,2017,Clallam,WA,Truck,0,0,0,21181,21181,0
November,30,2017,Skagit,WA,Truck,1,0,1,31687,31688,0
November,30,2017,Monterey,CA,Passenger,0,2,2,196,198,1.01
November,30,2017,Brevard,FL,Passenger,0,1,1,104,105,0.95
November,30,2017,Lumpkin,GA,Passenger,1,0,1,9,10,10
November,30,2017,Klickitat,WA,Truck,0,0,0,8002,8002,0
November,30,2017,Jefferson,WA,Truck,0,0,0,9461,9461,0
November,30,2017,Franklin,WA,Passenger,31,48,79,56681,56760,0.14
November,30,2017,Prince William,VA,Passenger,0,3,3,271,274,1.09
November,30,2017,Sumter,FL,Passenger,0,1,1,10,11,9.09
November,30,2017,Nantucket,MA,Passenger,1,0,1,3,4,25
November,30,2017,San Juan,WA,Passenger,126,41,167,13785,13952,1.2
November,30,2017,Spokane,WA,Truck,1,0,1,91421,91422,0
November,30,2017,Clark,WA,Passenger,840,558,1398,303188,304586,0.46
November,30,2017,Pacific,WA,Passenger,15,11,26,15334,15360,0.17
November,30,2017,Prince George,VA,Passenger,0,1,1,71,72,1.39
November,30,2017,Clay,FL,Passenger,0,1,1,108,109,0.92
November,30,2017,Ramsey,MN,Passenger,1,0,1,39,40,2.5
November,30,2017,Missoula,MT,Passenger,1,0,1,69,70,1.43
November,30,2017,Adams,WA,Passenger,3,5,8,12358,12366,0.06
November,30,2017,Skamania,WA,Passenger,10,7,17,8576,8593,0.2
November,30,2017,Whitman,WA,Truck,0,0,0,8437,8437,0
November,30,2017,Maricopa,AZ,Passenger,2,0,2,1629,1631,0.12
November,30,2017,Pend Oreille,WA,Passenger,3,4,7,9428,9435,0.07
November,30,2017,Essex,NJ,Passenger,1,0,1,10,11,9.09
November,30,2017,El Paso,TX,Passenger,1,0,1,524,525,0.19
November,30,2017,Columbia,WA,Truck,0,0,0,1537,1537,0
November,30,2017,Northampton,PA,Passenger,0,1,1,66,67,1.49
November,30,2017,Thurston,WA,Passenger,457,380,837,189509,190346,0.44
November,30,2017,Palm Beach,FL,Passenger,0,1,1,92,93,1.08
November,30,2017,King,WA,Passenger,11131,4614,15745,1371535,1387280,1.13
November,30,2017,Carroll,NH,Passenger,0,1,1,1,2,50
November,30,2017,Douglas,WA,Passenger,37,33,70,27072,27142,0.26
November,30,2017,Island,WA,Truck,0,0,0,20694,20694,0
November,30,2017,Wahkiakum,WA,Truck,0,0,0,1661,1661,0
November,30,2017,Maui,HI,Passenger,1,0,1,68,69,1.45
November,30,2017,Fairfax,VA,Passenger,2,2,4,833,837,0.48
November,30,2017,Multnomah,OR,Passenger,3,3,6,901,907,0.66
November,30,2017,Queens,NY,Passenger,1,0,1,61,62,1.61
November,30,2017,Benton,WA,Truck,0,0,0,40497,40497,0
November,30,2017,Lewis,WA,Truck,0,0,0,25234,25234,0
November,30,2017,Riverside,CA,Passenger,1,2,3,748,751,0.4
November,30,2017,Thurston,WA,Truck,0,0,0,53689,53689,0
November,30,2017,Norfolk,MA,Passenger,1,0,1,38,39,2.56
November,30,2017,Klickitat,WA,Passenger,23,26,49,14871,14920,0.33
November,30,2017,Gwinnett,GA,Passenger,0,1,1,83,84,1.19
November,30,2017,Whatcom,WA,Truck,1,0,1,41929,41930,0
November,30,2017,Fulton,GA,Passenger,1,0,1,109,110,0.91
November,30,2017,Yakima,WA,Truck,0,0,0,57917,57917,0
November,30,2017,Kitsap,WA,Passenger,676,367,1043,175388,176431,0.59
November,30,2017,Anne Arundel,MD,Passenger,0,1,1,488,489,0.2
November,30,2017,Pima,AZ,Passenger,1,1,2,412,414,0.48
November,30,2017,Clallam,WA,Passenger,98,86,184,48866,49050,0.38
November,30,2017,San Diego,CA,Passenger,5,1,6,2584,2590,0.23
November,30,2017,Mason,WA,Passenger,63,72,135,44603,44738,0.3
November,30,2017,Walla Walla,WA,Passenger,29,31,60,35239,35299,0.17
November,30,2017,Frederick,MD,Passenger,0,1,1,87,88,1.14
November,30,2017,Wahkiakum,WA,Passenger,0,2,2,2868,2870,0.07
November,30,2017,Columbia,WA,Passenger,2,1,3,2391,2394,0.13
November,30,2017,Ferry,WA,Truck,0,0,0,3544,3544,0
November,30,2017,Polk,FL,Passenger,1,0,1,62,63,1.59
November,30,2017,San Mateo,CA,Passenger,0,1,1,147,148,0.68
November,30,2017,Albemarle,VA,Passenger,0,1,1,32,33,3.03
November,30,2017,Orleans,LA,Passenger,0,1,1,46,47,2.13
November,30,2017,Los Angeles,CA,Passenger,5,2,7,1212,1219,0.57
November,30,2017,Cowlitz,WA,Truck,0,0,0,28144,28144,0
November,30,2017,Virginia Beach,VA,Passenger,2,1,3,661,664,0.45
November,30,2017,Cowlitz,WA,Passenger,54,65,119,70592,70711,0.17
November,30,2017,Skagit,WA,Passenger,159,131,290,89317,89607,0.32
November,30,2017,Dakota,MN,Passenger,0,2,2,37,39,5.13
November,30,2017,Ventura,CA,Passenger,0,1,1,327,328,0.3
November,30,2017,Dale,AL,Passenger,0,1,1,63,64,1.56
November,30,2017,Snohomish,WA,Passenger,1987,1019,3006,516018,519024,0.58
November,30,2017,Pierce,WA,Passenger,1050,942,1992,526013,528005,0.38
November,30,2017,Utah,UT,Passenger,0,1,1,136,137,0.73
November,30,2017,Lane,OR,Passenger,0,1,1,207,208,0.48
November,30,2017,Morris,NJ,Passenger,1,0,1,22,23,4.35
November,30,2017,Sedgwick,KS,Passenger,0,1,1,105,106,0.94
November,30,2017,Chelan,WA,Truck,0,0,0,21519,21519,0
November,30,2017,Dallas,TX,Passenger,0,1,1,181,182,0.55
November,30,2017,Stevens,WA,Passenger,10,21,31,31554,31585,0.1
November,30,2017,King,WA,Truck,7,1,8,185511,185519,0
November,30,2017,Nassau,NY,Passenger,1,1,2,38,40,5
November,30,2017,Grays Harbor,WA,Passenger,42,41,83,45582,45665,0.18
November,30,2017,San Juan,WA,Truck,0,0,0,5574,5574,0
November,30,2017,Juneau,AK,Passenger,0,1,1,45,46,2.17
November,30,2017,Latah,ID,Passenger,0,1,1,77,78,1.28
November,30,2017,Island,WA,Passenger,147,156,303,61346,61649,0.49
November,30,2017,Manassas,VA,Passenger,0,1,1,9,10,10
November,30,2017,Marin,CA,Passenger,1,0,1,57,58,1.72
November,30,2017,Contra Costa,CA,Passenger,0,1,1,470,471,0.21
November,30,2017,Montgomery,MD,Passenger,1,0,1,300,301,0.33
November,30,2017,Duval,FL,Passenger,1,1,2,365,367,0.54
November,30,2017,Garfield,WA,Passenger,1,0,1,1313,1314,0.08
November,30,2017,,,Passenger,5,1,6,713,719,0.83
November,30,2017,Travis,TX,Passenger,0,1,1,186,187,0.53
November,30,2017,Benton,WA,Passenger,165,160,325,129883,130208,0.25
November,30,2017,Lincoln,WA,Passenger,2,5,7,7552,7559,0.09
November,30,2017,Allegheny,PA,Passenger,1,0,1,91,92,1.09
November,30,2017,Canyon,ID,Passenger,0,1,1,91,92,1.09
November,30,2017,Tarrant,TX,Passenger,1,0,1,230,231,0.43
November,30,2017,Whitman,WA,Passenger,16,19,35,22387,22422,0.16
November,30,2017,Bexar,TX,Passenger,1,1,2,825,827,0.24
November,30,2017,Lewis,WA,Passenger,53,39,92,56418,56510,0.16
November,30,2017,Nueces,TX,Passenger,1,1,2,92,94,2.13
November,30,2017,Charles,MD,Passenger,0,1,1,84,85,1.18
November,30,2017,Manatee,FL,Passenger,1,0,1,40,41,2.44
November,30,2017,Madison,ID,Passenger,1,0,1,39,40,2.5
November,30,2017,Lincoln,WA,Truck,0,0,0,4484,4484,0
November,30,2017,Lee,AL,Passenger,1,0,1,35,36,2.78
November,30,2017,Okanogan,WA,Truck,0,0,0,16273,16273,0
November,30,2017,Tulare,CA,Passenger,1,0,1,189,190,0.53
November,30,2017,St. Clair,IL,Passenger,0,1,1,162,163,0.61
November,30,2017,Sangamon,IL,Passenger,1,0,1,11,12,8.33
November,30,2017,Montgomery,TX,Passenger,1,0,1,62,63,1.59
November,30,2017,Prince George's,MD,Passenger,0,1,1,180,181,0.55
November,30,2017,Kittitas,WA,Passenger,34,24,58,28271,28329,0.2
November,30,2017,Twin Falls,ID,Passenger,0,1,1,24,25,4
November,30,2017,Pierce,WA,Truck,0,0,0,137030,137030,0
November,30,2017,Orange,CA,Passenger,3,1,4,584,588,0.68
November,30,2017,Deschutes,OR,Passenger,1,0,1,180,181,0.55
November,30,2017,Howard,MD,Passenger,0,2,2,91,93,2.15
November,30,2017,Grays Harbor,WA,Truck,0,0,0,20019,20019,0
November,30,2017,Flathead,MT,Passenger,1,0,1,55,56,1.79
November,30,2017,Asotin,WA,Passenger,7,5,12,12514,12526,0.1
November,30,2017,Cape May,NJ,Passenger,0,1,1,21,22,4.55
November,30,2017,Chelan,WA,Passenger,83,36,119,52832,52951,0.22
November,30,2017,Volusia,FL,Passenger,0,1,1,38,39,2.56
November,30,2017,Hawaii,HI,Passenger,1,0,1,77,78,1.28
November,30,2017,New London,CT,Passenger,1,1,2,251,253,0.79
November,30,2017,Hardin,KY,Passenger,0,1,1,119,120,0.83
November,30,2017,Adams,WA,Truck,0,0,0,5141,5141,0
November,30,2017,Kittitas,WA,Truck,0,0,0,13759,13759,0
November,30,2017,Jefferson,WA,Passenger,116,71,187,24182,24369,0.77
November,30,2017,Snohomish,WA,Truck,1,0,1,121380,121381,0
November,30,2017,Whatcom,WA,Passenger,524,214,738,144659,145397,0.51
November,30,2017,Yakima,WA,Passenger,57,73,130,161627,161757,0.08
November,30,2017,Kent,MI,Passenger,0,1,1,34,35,2.86
November,30,2017,St. Lucie,FL,Passenger,1,0,1,26,27,3.7
November,30,2017,Norfolk,VA,Passenger,1,1,2,305,307,0.65
November,30,2017,Pend Oreille,WA,Truck,0,0,0,5595,5595,0
November,30,2017,Jefferson,NY,Passenger,1,0,1,235,236,0.42
November,30,2017,Spokane,WA,Passenger,291,239,530,299642,300172,0.18
November,30,2017,Grant,WA,Passenger,24,33,57,61891,61948,0.09
November,30,2017,Alameda,CA,Passenger,0,1,1,353,354,0.28
November,30,2017,Shelby,TN,Passenger,0,1,1,104,105,0.95
November,30,2017,Richland,SC,Passenger,0,1,1,178,179,0.56
November,30,2017,Sacramento,CA,Passenger,1,0,1,317,318,0.31
November,30,2017,Hamilton,TN,Passenger,1,0,1,21,22,4.55
November,30,2017,Montgomery,PA,Passenger,1,0,1,39,40,2.5
November,30,2017,Asotin,WA,Truck,0,0,0,6552,6552,0
November,30,2017,Montgomery,TN,Passenger,1,0,1,271,272,0.37
November,30,2017,Orange,FL,Passenger,1,1,2,144,146,1.37
November,30,2017,Walla Walla,WA,Truck,0,0,0,13312,13312,0
November,30,2017,Hamilton,IN,Passenger,1,0,1,54,55,1.82
November,30,2017,Garfield,WA,Truck,0,0,0,937,937,0
November,30,2017,Santa Fe,NM,Passenger,0,1,1,42,43,2.33
November,30,2017,Franklin,MA,Passenger,0,1,1,4,5,20
November,30,2017,El Paso,CO,Passenger,2,0,2,764,766,0.26
November,30,2017,Mason,WA,Truck,0,0,0,19540,19540,0
November,30,2017,Douglas,WA,Truck,0,0,0,11702,11702,0
November,30,2017,Moore,NC,Passenger,0,1,1,202,203,0.49
November,30,2017,Okaloosa,FL,Passenger,1,0,1,186,187,0.53
November,30,2017,Arlington,VA,Passenger,1,2,3,170,173,1.73
November,30,2017,DeKalb,GA,Passenger,1,0,1,85,86,1.16
November,30,2017,Richmond,GA,Passenger,0,1,1,91,92,1.09
November,30,2017,Saratoga,NY,Passenger,1,1,2,71,73,2.74
November,30,2017,Clark,WA,Truck,0,0,0,78247,78247,0
November,30,2017,Santa Clara,CA,Passenger,7,1,8,385,393,2.04
November,30,2017,DeKalb,IN,Passenger,1,0,1,1,2,50
November,30,2017,Tuolumne,CA,Passenger,0,1,1,16,17,5.88
November,30,2017,Santa Rosa,FL,Passenger,1,0,1,105,106,0.94
November,30,2017,Stevens,WA,Truck,0,0,0,18334,18334,0
November,30,2017,Kitsap,WA,Truck,1,0,1,52629,52630,0
November,30,2017,Portsmouth,VA,Passenger,0,1,1,67,68,1.47
November,30,2017,Honolulu,HI,Passenger,2,2,4,557,561,0.71
November,30,2017,Franklin,WA,Truck,0,0,0,18414,18414,0
November,30,2017,Skamania,WA,Truck,0,0,0,3893,3893,0
November,30,2017,Grant,WA,Truck,0,0,0,25520,25520,0
October,31,2017,Adams,WA,Passenger,3,3,6,12283,12289,0.05
October,31,2017,Mason,WA,Truck,0,0,0,19470,19470,0
October,31,2017,Pend Oreille,WA,Passenger,3,4,7,9370,9377,0.07
October,31,2017,Albemarle,VA,Passenger,0,1,1,32,33,3.03
October,31,2017,Twin Falls,ID,Passenger,0,1,1,24,25,4
October,31,2017,DeKalb,GA,Passenger,1,0,1,85,86,1.16
October,31,2017,Monterey,CA,Passenger,0,2,2,193,195,1.03
October,31,2017,Grant,WA,Passenger,20,33,53,61666,61719,0.09
October,31,2017,Garfield,WA,Truck,0,0,0,943,943,0
October,31,2017,Thurston,WA,Truck,0,0,0,53577,53577,0
October,31,2017,Pima,AZ,Passenger,1,1,2,414,416,0.48
October,31,2017,Franklin,OH,Passenger,0,1,1,112,113,0.88
October,31,2017,Richmond,GA,Passenger,0,1,1,90,91,1.1
October,31,2017,Contra Costa,CA,Passenger,0,1,1,489,490,0.2
October,31,2017,Kent,MI,Passenger,0,1,1,34,35,2.86
October,31,2017,Wahkiakum,WA,Truck,0,0,0,1672,1672,0
October,31,2017,Hamilton,TN,Passenger,1,0,1,21,22,4.55
October,31,2017,Bexar,TX,Passenger,1,1,2,822,824,0.24
October,31,2017,Franklin,WA,Passenger,31,49,80,56508,56588,0.14
October,31,2017,Honolulu,HI,Passenger,2,2,4,557,561,0.71
October,31,2017,Adams,WA,Truck,0,0,0,5135,5135,0
October,31,2017,Lane,OR,Passenger,0,1,1,214,215,0.47
October,31,2017,Whatcom,WA,Truck,2,0,2,41876,41878,0
October,31,2017,Lewis,WA,Truck,0,0,0,25209,25209,0
October,31,2017,Orange,FL,Passenger,1,1,2,145,147,1.36
October,31,2017,Skamania,WA,Passenger,10,7,17,8571,8588,0.2
October,31,2017,Morris,NJ,Passenger,1,0,1,22,23,4.35
October,31,2017,Grays Harbor,WA,Passenger,38,41,79,45374,45453,0.17
October,31,2017,Maricopa,AZ,Passenger,2,0,2,1627,1629,0.12
October,31,2017,Ferry,WA,Truck,0,0,0,3549,3549,0
October,31,2017,San Juan,WA,Truck,0,0,0,5569,5569,0
October,31,2017,Douglas,WA,Truck,0,0,0,11656,11656,0
October,31,2017,Yakima,WA,Truck,0,0,0,57813,57813,0
October,31,2017,Santa Rosa,FL,Passenger,1,0,1,108,109,0.92
October,31,2017,Grays Harbor,WA,Truck,0,0,0,20007,20007,0
October,31,2017,Cowlitz,WA,Passenger,54,65,119,70430,70549,0.17
October,31,2017,Fairfax,VA,Passenger,2,2,4,839,843,0.47
October,31,2017,Manatee,FL,Passenger,1,0,1,42,43,2.33
October,31,2017,Whitman,WA,Passenger,12,20,32,22299,22331,0.14
October,31,2017,El Paso,TX,Passenger,1,0,1,527,528,0.19
October,31,2017,Shelby,TN,Passenger,0,1,1,104,105,0.95
October,31,2017,New London,CT,Passenger,1,1,2,249,251,0.8
October,31,2017,Nueces,TX,Passenger,0,1,1,93,94,1.06
October,31,2017,Riverside,CA,Passenger,1,2,3,744,747,0.4
October,31,2017,Pierce,WA,Passenger,1040,916,1956,525482,527438,0.37
October,31,2017,Deschutes,OR,Passenger,1,0,1,185,186,0.54
October,31,2017,Volusia,FL,Passenger,0,1,1,40,41,2.44
October,31,2017,Clallam,WA,Truck,0,0,0,21147,21147,0
October,31,2017,Clark,WA,Passenger,829,559,1388,302262,303650,0.46
October,31,2017,Los Angeles,CA,Passenger,5,2,7,1219,1226,0.57
October,31,2017,Missoula,MT,Passenger,1,0,1,70,71,1.41
October,31,2017,Virginia Beach,VA,Passenger,2,1,3,654,657,0.46
October,31,2017,Asotin,WA,Passenger,7,5,12,12479,12491,0.1
October,31,2017,Prince William,VA,Passenger,0,3,3,268,271,1.11
October,31,2017,Sacramento,CA,Passenger,1,0,1,323,324,0.31
October,31,2017,Benton,WA,Truck,0,0,0,40386,40386,0
October,31,2017,Flathead,MT,Passenger,1,0,1,54,55,1.82
October,31,2017,Mason,WA,Passenger,61,74,135,44453,44588,0.3
October,31,2017,Santa Fe,NM,Passenger,0,1,1,41,42,2.38
October,31,2017,Okaloosa,FL,Passenger,1,0,1,186,187,0.53
October,31,2017,Benton,WA,Passenger,164,155,319,129410,129729,0.25
October,31,2017,Kitsap,WA,Truck,1,0,1,52588,52589,0
October,31,2017,Snohomish,WA,Passenger,1947,999,2946,515244,518190,0.57
October,31,2017,Klickitat,WA,Truck,0,0,0,8005,8005,0
October,31,2017,Anne Arundel,MD,Passenger,0,1,1,486,487,0.21
October,31,2017,Moore,NC,Passenger,0,1,1,202,203,0.49
October,31,2017,Palm Beach,FL,Passenger,0,1,1,95,96,1.04
October,31,2017,Nantucket,MA,Passenger,1,0,1,3,4,25
October,31,2017,Saratoga,NY,Passenger,1,1,2,73,75,2.67
October,31,2017,Skagit,WA,Truck,1,0,1,31629,31630,0
October,31,2017,Santa Clara,CA,Passenger,6,1,7,386,393,1.78
October,31,2017,Thurston,WA,Passenger,442,371,813,188869,189682,0.43
October,31,2017,Clark,WA,Truck,0,0,0,78122,78122,0
October,31,2017,Pacific,WA,Passenger,14,10,24,15322,15346,0.16
October,31,2017,Ventura,CA,Passenger,0,1,1,335,336,0.3
October,31,2017,Lee,AL,Passenger,1,0,1,35,36,2.78
October,31,2017,Chelan,WA,Passenger,77,36,113,52717,52830,0.21
October,31,2017,Tuolumne,CA,Passenger,0,1,1,15,16,6.25
October,31,2017,Okanogan,WA,Passenger,5,17,22,25713,25735,0.09
October,31,2017,Franklin,WA,Truck,0,0,0,18324,18324,0
October,31,2017,Snohomish,WA,Truck,1,0,1,121462,121463,0
October,31,2017,Sedgwick,KS,Passenger,0,1,1,103,104,0.96
October,31,2017,Queens,NY,Passenger,1,0,1,62,63,1.59
October,31,2017,Carroll,NH,Passenger,0,1,1,1,2,50
October,31,2017,Dakota,MN,Passenger,0,2,2,38,40,5
October,31,2017,Alameda,CA,Passenger,0,1,1,352,353,0.28
October,31,2017,Jefferson,WA,Passenger,116,68,184,24072,24256,0.76
October,31,2017,Columbia,WA,Truck,0,0,0,1542,1542,0
October,31,2017,Lincoln,WA,Truck,0,0,0,4491,4491,0
October,31,2017,Stevens,WA,Truck,0,0,0,18305,18305,0
October,31,2017,Wayne,MI,Passenger,0,1,1,68,69,1.45
October,31,2017,Travis,TX,Passenger,0,1,1,193,194,0.52
October,31,2017,Sangamon,IL,Passenger,1,0,1,11,12,8.33
October,31,2017,Latah,ID,Passenger,0,1,1,84,85,1.18
October,31,2017,Utah,UT,Passenger,0,1,1,142,143,0.7
October,31,2017,Clay,FL,Passenger,0,1,1,112,113,0.88
October,31,2017,Tarrant,TX,Passenger,1,0,1,228,229,0.44
October,31,2017,Jefferson,NY,Passenger,1,0,1,241,242,0.41
October,31,2017,Garfield,WA,Passenger,1,0,1,1315,1316,0.08
October,31,2017,Ramsey,MN,Passenger,1,0,1,40,41,2.44
October,31,2017,Lumpkin,GA,Passenger,1,0,1,9,10,10
October,31,2017,Essex,NJ,Passenger,1,0,1,13,14,7.14
October,31,2017,Chelan,WA,Truck,0,0,0,21490,21490,0
October,31,2017,,,Passenger,5,1,6,709,715,0.84
October,31,2017,Kittitas,WA,Passenger,33,23,56,28118,28174,0.2
October,31,2017,King,WA,Passenger,10942,4483,15425,1372199,1387624,1.11
October,31,2017,Franklin,MA,Passenger,0,1,1,4,5,20
October,31,2017,Tulare,CA,Passenger,1,0,1,193,194,0.52
October,31,2017,San Diego,CA,Passenger,5,1,6,2612,2618,0.23
October,31,2017,King,WA,Truck,7,1,8,185856,185864,0
October,31,2017,Pend Oreille,WA,Truck,0,0,0,5562,5562,0
October,31,2017,Prince George's,MD,Passenger,0,1,1,180,181,0.55
October,31,2017,San Juan,WA,Passenger,127,40,167,13759,13926,1.2
October,31,2017,Fulton,GA,Passenger,1,0,1,109,110,0.91
October,31,2017,Skamania,WA,Truck,0,0,0,3892,3892,0
October,31,2017,Whitman,WA,Truck,0,0,0,8440,8440,0
October,31,2017,Kittitas,WA,Truck,0,0,0,13695,13695,0
October,31,2017,Orleans,LA,Passenger,0,1,1,46,47,2.13
October,31,2017,Walla Walla,WA,Truck,0,0,0,13256,13256,0
October,31,2017,Orange,CA,Passenger,3,1,4,600,604,0.66
October,31,2017,Montgomery,TN,Passenger,1,0,1,272,273,0.37
October,31,2017,Madison,ID,Passenger,1,0,1,37,38,2.63
October,31,2017,Frederick,MD,Passenger,0,1,1,84,85,1.18
October,31,2017,Multnomah,OR,Passenger,1,3,4,911,915,0.44
October,31,2017,Hamilton,IN,Passenger,1,0,1,58,59,1.69
October,31,2017,Yakima,WA,Passenger,57,72,129,161008,161137,0.08
October,31,2017,Nassau,NY,Passenger,1,1,2,38,40,5
October,31,2017,Dale,AL,Passenger,0,1,1,61,62,1.61
October,31,2017,Cape May,NJ,Passenger,0,1,1,19,20,5
October,31,2017,Spokane,WA,Truck,1,0,1,91331,91332,0
October,31,2017,District of Columbia,DC,Passenger,0,3,3,204,207,1.45
October,31,2017,Stevens,WA,Passenger,9,22,31,31532,31563,0.1
October,31,2017,Island,WA,Passenger,138,153,291,61081,61372,0.47
October,31,2017,Hardin,KY,Passenger,0,1,1,117,118,0.85
October,31,2017,Spokane,WA,Passenger,286,238,524,298905,299429,0.17
October,31,2017,Okanogan,WA,Truck,0,0,0,16246,16246,0
October,31,2017,Manassas,VA,Passenger,0,1,1,9,10,10
October,31,2017,DeKalb,IN,Passenger,1,0,1,1,2,50
October,31,2017,Howard,MD,Passenger,0,2,2,88,90,2.22
October,31,2017,Maui,HI,Passenger,1,0,1,69,70,1.43
October,31,2017,Lincoln,WA,Passenger,2,5,7,7575,7582,0.09
October,31,2017,Montgomery,MD,Passenger,1,0,1,302,303,0.33
October,31,2017,St. Clair,IL,Passenger,0,1,1,160,161,0.62
October,31,2017,Columbia,WA,Passenger,1,1,2,2393,2395,0.08
October,31,2017,Lewis,WA,Passenger,53,39,92,56275,56367,0.16
October,31,2017,Dallas,TX,Passenger,0,1,1,180,181,0.55
October,31,2017,San Mateo,CA,Passenger,0,1,1,149,150,0.67
October,31,2017,Jefferson,WA,Truck,0,0,0,9438,9438,0
October,31,2017,Walla Walla,WA,Passenger,28,28,56,35147,35203,0.16
October,31,2017,New Haven,CT,Passenger,0,1,1,52,53,1.89
October,31,2017,Arlington,VA,Passenger,1,2,3,168,171,1.75
October,31,2017,Ferry,WA,Passenger,1,1,2,4396,4398,0.05
October,31,2017,Charles,MD,Passenger,0,1,1,83,84,1.19
October,31,2017,Canyon,ID,Passenger,0,1,1,92,93,1.08
October,31,2017,Sumter,FL,Passenger,0,1,1,10,11,9.09
October,31,2017,Pacific,WA,Truck,0,0,0,7521,7521,0
October,31,2017,Norfolk,MA,Passenger,1,0,1,37,38,2.63
October,31,2017,Hawaii,HI,Passenger,1,0,1,74,75,1.33
October,31,2017,Whatcom,WA,Passenger,510,202,712,144316,145028,0.49
October,31,2017,St. Lucie,FL,Passenger,1,0,1,27,28,3.57
October,31,2017,Douglas,WA,Passenger,36,32,68,26967,27035,0.25
October,31,2017,Clallam,WA,Passenger,96,85,181,48722,48903,0.37
October,31,2017,Montgomery,PA,Passenger,1,0,1,38,39,2.56
October,31,2017,Juneau,AK,Passenger,0,1,1,45,46,2.17
October,31,2017,Norfolk,VA,Passenger,1,1,2,307,309,0.65
October,31,2017,Kitsap,WA,Passenger,661,355,1016,174891,175907,0.58
October,31,2017,Skagit,WA,Passenger,151,126,277,88959,89236,0.31
October,31,2017,Montgomery,TX,Passenger,1,0,1,61,62,1.61
October,31,2017,El Paso,CO,Passenger,2,0,2,769,771,0.26
October,31,2017,Northampton,PA,Passenger,0,1,1,69,70,1.43
October,31,2017,Pierce,WA,Truck,0,0,0,137020,137020,0
October,31,2017,Clark,NV,Passenger,1,2,3,767,770,0.39
October,31,2017,Asotin,WA,Truck,0,0,0,6524,6524,0
October,31,2017,Allegheny,PA,Passenger,1,0,1,91,92,1.09
October,31,2017,Wahkiakum,WA,Passenger,0,2,2,2849,2851,0.07
October,31,2017,Gwinnett,GA,Passenger,0,1,1,85,86,1.16
October,31,2017,Portsmouth,VA,Passenger,0,1,1,65,66,1.52
October,31,2017,Richland,SC,Passenger,0,1,1,183,184,0.54
October,31,2017,Marin,CA,Passenger,1,0,1,58,59,1.69
October,31,2017,Pinal,AZ,Passenger,2,0,2,222,224,0.89
October,31,2017,Island,WA,Truck,0,0,0,20596,20596,0
October,31,2017,Klickitat,WA,Passenger,22,27,49,14805,14854,0.33
October,31,2017,Grant,WA,Truck,0,0,0,25459,25459,0
October,31,2017,Duval,FL,Passenger,1,1,2,368,370,0.54
October,31,2017,Polk,FL,Passenger,1,0,1,63,64,1.56
October,31,2017,Cowlitz,WA,Truck,0,0,0,28114,28114,0
September,30,2017,Santa Fe,NM,Passenger,0,1,1,42,43,2.33
September,30,2017,Kittitas,WA,Passenger,33,21,54,27988,28042,0.19
September,30,2017,Ferry,WA,Truck,0,0,0,3538,3538,0
September,30,2017,Pierce,WA,Passenger,1012,898,1910,525165,527075,0.36
September,30,2017,Prince William,VA,Passenger,0,3,3,268,271,1.11
September,30,2017,Norfolk,MA,Passenger,1,0,1,38,39,2.56
September,30,2017,Madison,ID,Passenger,1,0,1,37,38,2.63
September,30,2017,Arlington,VA,Passenger,1,2,3,163,166,1.81
September,30,2017,Virginia Beach,VA,Passenger,2,1,3,656,659,0.46
September,30,2017,Grant,WA,Passenger,20,33,53,61457,61510,0.09
September,30,2017,Adams,WA,Passenger,3,3,6,12263,12269,0.05
September,30,2017,Sangamon,IL,Passenger,1,0,1,11,12,8.33
September,30,2017,King,WA,Truck,7,1,8,186365,186373,0
September,30,2017,Travis,TX,Passenger,0,1,1,190,191,0.52
September,30,2017,Pend Oreille,WA,Passenger,3,4,7,9371,9378,0.07
September,30,2017,Lane,OR,Passenger,0,1,1,218,219,0.46
September,30,2017,Wahkiakum,WA,Truck,0,0,0,1667,1667,0
September,30,2017,El Paso,CO,Passenger,2,0,2,774,776,0.26
September,30,2017,Whitman,WA,Passenger,12,22,34,22193,22227,0.15
September,30,2017,Frederick,MD,Passenger,0,1,1,83,84,1.19
September,30,2017,Riverside,CA,Passenger,1,2,3,751,754,0.4
September,30,2017,Okanogan,WA,Passenger,5,18,23,25690,25713,0.09
September,30,2017,Sedgwick,KS,Passenger,0,1,1,102,103,0.97
September,30,2017,Los Angeles,CA,Passenger,5,2,7,1234,1241,0.56
September,30,2017,Lincoln,WA,Truck,0,0,0,4472,4472,0
September,30,2017,Spokane,WA,Truck,1,0,1,91172,91173,0
September,30,2017,Kent,MI,Passenger,0,1,1,36,37,2.7
September,30,2017,Lewis,WA,Passenger,53,38,91,56022,56113,0.16
September,30,2017,Portsmouth,VA,Passenger,0,1,1,66,67,1.49
September,30,2017,Whitman,WA,Truck,0,0,0,8428,8428,0
September,30,2017,Wayne,MI,Passenger,0,1,1,67,68,1.47
September,30,2017,Wahkiakum,WA,Passenger,0,2,2,2836,2838,0.07
September,30,2017,Montgomery,TX,Passenger,1,0,1,61,62,1.61
September,30,2017,Stevens,WA,Passenger,8,22,30,31547,31577,0.1
September,30,2017,Canyon,ID,Passenger,0,1,1,92,93,1.08
September,30,2017,Duval,FL,Passenger,1,1,2,367,369,0.54
September,30,2017,Walla Walla,WA,Passenger,27,28,55,35036,35091,0.16
September,30,2017,Benton,WA,Passenger,163,150,313,129262,129575,0.24
September,30,2017,Anne Arundel,MD,Passenger,0,1,1,494,495,0.2
September,30,2017,Manatee,FL,Passenger,1,0,1,42,43,2.33
September,30,2017,Howard,MD,Passenger,0,2,2,88,90,2.22
September,30,2017,Pacific,WA,Passenger,12,9,21,15262,15283,0.14
September,30,2017,Nassau,NY,Passenger,1,1,2,39,41,4.88
September,30,2017,Skagit,WA,Passenger,148,120,268,88642,88910,0.3
September,30,2017,Lee,AL,Passenger,1,0,1,34,35,2.86
September,30,2017,Kitsap,WA,Truck,1,0,1,52599,52600,0
September,30,2017,Cowlitz,WA,Passenger,52,64,116,70272,70388,0.16
September,30,2017,Okaloosa,FL,Passenger,1,0,1,186,187,0.53
September,30,2017,Sacramento,CA,Passenger,1,0,1,334,335,0.3
September,30,2017,DeKalb,GA,Passenger,1,0,1,84,85,1.18
September,30,2017,Columbia,WA,Passenger,1,1,2,2378,2380,0.08
September,30,2017,Okanogan,WA,Truck,0,0,0,16235,16235,0
September,30,2017,Norfolk,VA,Passenger,1,1,2,312,314,0.64
September,30,2017,Klickitat,WA,Passenger,22,26,48,14774,14822,0.32
September,30,2017,Garfield,WA,Passenger,1,0,1,1295,1296,0.08
September,30,2017,Gwinnett,GA,Passenger,0,1,1,84,85,1.18
September,30,2017,Hamilton,IN,Passenger,1,0,1,58,59,1.69
September,30,2017,Grays Harbor,WA,Truck,0,0,0,19976,19976,0
September,30,2017,Juneau,AK,Passenger,0,1,1,45,46,2.17
September,30,2017,Polk,FL,Passenger,1,0,1,62,63,1.59
September,30,2017,Prince George's,MD,Passenger,0,1,1,182,183,0.55
September,30,2017,San Mateo,CA,Passenger,0,1,1,147,148,0.68
September,30,2017,Pacific,WA,Truck,0,0,0,7514,7514,0
September,30,2017,Charles,MD,Passenger,0,1,1,84,85,1.18
September,30,2017,Maricopa,AZ,Passenger,2,0,2,1647,1649,0.12
September,30,2017,Skamania,WA,Passenger,10,7,17,8572,8589,0.2
September,30,2017,Morris,NJ,Passenger,1,0,1,22,23,4.35
September,30,2017,Clay,FL,Passenger,0,1,1,113,114,0.88
September,30,2017,Cobb,GA,Passenger,0,1,1,68,69,1.45
September,30,2017,Multnomah,OR,Passenger,1,3,4,924,928,0.43
September,30,2017,Flathead,MT,Passenger,1,0,1,56,57,1.75
September,30,2017,Kitsap,WA,Passenger,653,346,999,174309,175308,0.57
September,30,2017,Clark,WA,Passenger,810,542,1352,301404,302756,0.45
September,30,2017,Lincoln,WA,Passenger,2,6,8,7563,7571,0.11
September,30,2017,Island,WA,Passenger,129,149,278,60853,61131,0.45
September,30,2017,Honolulu,HI,Passenger,2,2,4,561,565,0.71
September,30,2017,Nueces,TX,Passenger,0,1,1,93,94,1.06
September,30,2017,Tuolumne,CA,Passenger,0,1,1,15,16,6.25
September,30,2017,Deschutes,OR,Passenger,1,0,1,193,194,0.52
September,30,2017,District of Columbia,DC,Passenger,0,2,2,204,206,0.97
September,30,2017,Contra Costa,CA,Passenger,0,1,1,506,507,0.2
September,30,2017,Clallam,WA,Passenger,95,83,178,48609,48787,0.36
September,30,2017,Richland,SC,Passenger,0,1,1,185,186,0.54
September,30,2017,Jefferson,WA,Passenger,114,65,179,24008,24187,0.74
September,30,2017,Chelan,WA,Truck,0,0,0,21414,21414,0
September,30,2017,Moore,NC,Passenger,0,1,1,202,203,0.49
September,30,2017,Snohomish,WA,Passenger,1911,975,2886,514376,517262,0.56
September,30,2017,Walla Walla,WA,Truck,0,0,0,13243,13243,0
September,30,2017,Pend Oreille,WA,Truck,0,0,0,5552,5552,0
September,30,2017,Orleans,LA,Passenger,0,1,1,45,46,2.17
September,30,2017,Franklin,MA,Passenger,0,1,1,4,5,20
September,30,2017,Hawaii,HI,Passenger,1,0,1,77,78,1.28
September,30,2017,Bexar,TX,Passenger,1,1,2,837,839,0.24
September,30,2017,Cape May,NJ,Passenger,0,1,1,19,20,5
September,30,2017,Albemarle,VA,Passenger,0,1,1,32,33,3.03
September,30,2017,San Juan,WA,Passenger,117,42,159,13676,13835,1.15
September,30,2017,Yakima,WA,Passenger,57,69,126,160618,160744,0.08
September,30,2017,New London,CT,Passenger,1,1,2,250,252,0.79
September,30,2017,Columbia,WA,Truck,0,0,0,1557,1557,0
September,30,2017,Mason,WA,Truck,0,0,0,19379,19379,0
September,30,2017,Hamilton,TN,Passenger,1,0,1,21,22,4.55
September,30,2017,Jefferson,WA,Truck,0,0,0,9419,9419,0
September,30,2017,Richmond,GA,Passenger,0,1,1,90,91,1.1
September,30,2017,Clark,WA,Truck,0,0,0,77868,77868,0
September,30,2017,Asotin,WA,Passenger,7,5,12,12463,12475,0.1
September,30,2017,Maui,HI,Passenger,1,0,1,70,71,1.41
September,30,2017,San Diego,CA,Passenger,6,1,7,2641,2648,0.26
September,30,2017,Whatcom,WA,Passenger,496,190,686,143859,144545,0.47
September,30,2017,Fulton,GA,Passenger,1,0,1,110,111,0.9
September,30,2017,St. Lucie,FL,Passenger,1,0,1,27,28,3.57
September,30,2017,Thurston,WA,Passenger,435,363,798,188247,189045,0.42
September,30,2017,Yakima,WA,Truck,0,0,0,57707,57707,0
September,30,2017,Island,WA,Truck,0,0,0,20564,20564,0
September,30,2017,Benton,WA,Truck,0,0,0,40273,40273,0
September,30,2017,Santa Clara,CA,Passenger,5,2,7,388,395,1.77
September,30,2017,Snohomish,WA,Truck,1,0,1,121526,121527,0
September,30,2017,Chelan,WA,Passenger,75,37,112,52503,52615,0.21
September,30,2017,St. Clair,IL,Passenger,0,1,1,165,166,0.6
September,30,2017,Manassas,VA,Passenger,0,1,1,9,10,10
September,30,2017,Sumter,FL,Passenger,0,1,1,10,11,9.09
September,30,2017,Shelby,TN,Passenger,0,1,1,106,107,0.93
September,30,2017,Dale,AL,Passenger,0,1,1,63,64,1.56
September,30,2017,Missoula,MT,Passenger,1,0,1,70,71,1.41
September,30,2017,Saratoga,NY,Passenger,1,1,2,72,74,2.7
September,30,2017,Franklin,OH,Passenger,0,1,1,112,113,0.88
September,30,2017,Mason,WA,Passenger,61,73,134,44172,44306,0.3
September,30,2017,Lewis,WA,Truck,0,0,0,25113,25113,0
September,30,2017,Douglas,WA,Truck,0,0,0,11592,11592,0
September,30,2017,Douglas,WA,Passenger,35,29,64,26927,26991,0.24
September,30,2017,King,WA,Passenger,10654,4350,15004,1372562,1387566,1.08
September,30,2017,Monterey,CA,Passenger,0,2,2,195,197,1.02
September,30,2017,Volusia,FL,Passenger,0,1,1,43,44,2.27
September,30,2017,Grant,WA,Truck,0,0,0,25425,25425,0
September,30,2017,Allegheny,PA,Passenger,1,0,1,87,88,1.14
September,30,2017,Fairfax,VA,Passenger,2,2,4,845,849,0.47
September,30,2017,Clallam,WA,Truck,0,0,0,21085,21085,0
September,30,2017,Franklin,WA,Passenger,29,48,77,56181,56258,0.14
September,30,2017,Skagit,WA,Truck,1,0,1,31550,31551,0
September,30,2017,San Juan,WA,Truck,0,0,0,5559,5559,0
September,30,2017,Palm Beach,FL,Passenger,0,1,1,96,97,1.03
September,30,2017,Skamania,WA,Truck,0,0,0,3878,3878,0
September,30,2017,Twin Falls,ID,Passenger,0,1,1,22,23,4.35
September,30,2017,Marin,CA,Passenger,1,0,1,59,60,1.67
September,30,2017,Santa Rosa,FL,Passenger,1,0,1,109,110,0.91
September,30,2017,Franklin,WA,Truck,0,0,0,18248,18248,0
September,30,2017,Whatcom,WA,Truck,2,0,2,41837,41839,0
September,30,2017,Northampton,PA,Passenger,0,1,1,83,84,1.19
September,30,2017,Klickitat,WA,Truck,0,0,0,7988,7988,0
September,30,2017,Grays Harbor,WA,Passenger,38,38,76,45132,45208,0.17
September,30,2017,Montgomery,PA,Passenger,1,0,1,37,38,2.63
September,30,2017,Latah,ID,Passenger,0,1,1,91,92,1.09
September,30,2017,Carroll,NH,Passenger,0,1,1,1,2,50
September,30,2017,Ferry,WA,Passenger,1,1,2,4380,4382,0.05
September,30,2017,Kittitas,WA,Truck,0,0,0,13657,13657,0
September,30,2017,New Haven,CT,Passenger,0,1,1,54,55,1.82
September,30,2017,DeKalb,IN,Passenger,1,0,1,1,2,50
September,30,2017,Alameda,CA,Passenger,0,1,1,351,352,0.28
September,30,2017,Tulare,CA,Passenger,1,0,1,197,198,0.51
September,30,2017,Tarrant,TX,Passenger,1,0,1,235,236,0.42
September,30,2017,El Paso,TX,Passenger,1,0,1,545,546,0.18
September,30,2017,Ramsey,MN,Passenger,1,0,1,40,41,2.44
September,30,2017,Orange,FL,Passenger,1,1,2,144,146,1.37
September,30,2017,Adams,WA,Truck,0,0,0,5123,5123,0
September,30,2017,Pinal,AZ,Passenger,2,0,2,226,228,0.88
September,30,2017,Dallas,TX,Passenger,0,1,1,179,180,0.56
September,30,2017,Utah,UT,Passenger,0,1,1,145,146,0.68
September,30,2017,Essex,NJ,Passenger,1,0,1,13,14,7.14
September,30,2017,Thurston,WA,Truck,0,0,0,53500,53500,0
September,30,2017,Garfield,WA,Truck,0,0,0,940,940,0
September,30,2017,Montgomery,TN,Passenger,1,0,1,276,277,0.36
September,30,2017,Hardin,KY,Passenger,0,1,1,116,117,0.85
September,30,2017,Jefferson,NY,Passenger,1,0,1,242,243,0.41
September,30,2017,Pierce,WA,Truck,0,0,0,137078,137078,0
September,30,2017,,,Passenger,5,1,6,701,707,0.85
September,30,2017,Nantucket,MA,Passenger,1,0,1,3,4,25
September,30,2017,Pima,AZ,Passenger,1,1,2,418,420,0.48
September,30,2017,Spokane,WA,Passenger,276,229,505,298150,298655,0.17
September,30,2017,Clark,NV,Passenger,1,2,3,774,777,0.39
September,30,2017,Lumpkin,GA,Passenger,1,0,1,9,10,10
September,30,2017,Cowlitz,WA,Truck,0,0,0,28041,28041,0
September,30,2017,Asotin,WA,Truck,0,0,0,6507,6507,0
September,30,2017,Montgomery,MD,Passenger,1,0,1,305,306,0.33
September,30,2017,Orange,CA,Passenger,3,1,4,607,611,0.65
September,30,2017,Stevens,WA,Truck,0,0,0,18251,18251,0
September,30,2017,Dakota,MN,Passenger,0,2,2,36,38,5.26
April,30,2018,Howard,MD,Passenger,0,1,1,85,86,1.16
April,30,2018,Lincoln,WA,Truck,0,0,0,4532,4532,0
April,30,2018,Norfolk,VA,Passenger,1,2,3,326,329,0.91
April,30,2018,Santa Clara,CA,Passenger,6,1,7,380,387,1.81
April,30,2018,Franklin,WA,Truck,0,0,0,18597,18597,0
April,30,2018,Los Angeles,CA,Passenger,6,4,10,1172,1182,0.85
April,30,2018,Charles,MD,Passenger,0,1,1,82,83,1.2
April,30,2018,Grays Harbor,WA,Passenger,47,52,99,46287,46386,0.21
April,30,2018,Ferry,WA,Truck,0,0,0,3499,3499,0
April,30,2018,Riverside,CA,Passenger,2,2,4,706,710,0.56
April,30,2018,Spokane,WA,Truck,1,0,1,92061,92062,0
April,30,2018,Gwinnett,GA,Passenger,0,1,1,80,81,1.23
April,30,2018,Latah,ID,Passenger,0,1,1,78,79,1.27
April,30,2018,Montgomery,TX,Passenger,1,0,1,63,64,1.56
April,30,2018,Lee,FL,Passenger,1,0,1,58,59,1.69
April,30,2018,Yakima,WA,Truck,0,0,0,58216,58216,0
April,30,2018,Flathead,MT,Passenger,1,0,1,51,52,1.92
April,30,2018,Monterey,CA,Passenger,0,1,1,188,189,0.53
April,30,2018,Benton,WA,Passenger,178,188,366,130946,131312,0.28
April,30,2018,Skamania,WA,Truck,0,0,0,3922,3922,0
April,30,2018,Thurston,WA,Truck,0,0,0,54065,54065,0
April,30,2018,Tulsa,OK,Passenger,0,1,1,47,48,2.08
April,30,2018,Whatcom,WA,Truck,2,0,2,42122,42124,0
April,30,2018,Columbia,WA,Passenger,2,1,3,2414,2417,0.12
April,30,2018,Montgomery,TN,Passenger,1,0,1,270,271,0.37
April,30,2018,Douglas,WA,Passenger,41,32,73,27438,27511,0.27
April,30,2018,Franklin,MA,Passenger,0,1,1,2,3,33.33
April,30,2018,Thurston,WA,Passenger,523,444,967,191803,192770,0.5
April,30,2018,Essex,NJ,Passenger,1,0,1,11,12,8.33
April,30,2018,Fairfax,VA,Passenger,2,2,4,832,836,0.48
April,30,2018,Kent,MI,Passenger,0,1,1,33,34,2.94
April,30,2018,Volusia,FL,Passenger,0,1,1,33,34,2.94
April,30,2018,Cowlitz,WA,Passenger,55,73,128,71356,71484,0.18
April,30,2018,San Juan,WA,Passenger,141,53,194,13961,14155,1.37
April,30,2018,Richland,SC,Passenger,0,1,1,173,174,0.57
April,30,2018,Garfield,WA,Passenger,1,0,1,1330,1331,0.08
April,30,2018,Walla Walla,WA,Truck,0,0,0,13332,13332,0
April,30,2018,Beaufort,SC,Passenger,1,0,1,38,39,2.56
April,30,2018,Cowlitz,WA,Truck,0,0,0,28292,28292,0
April,30,2018,Mason,WA,Passenger,71,87,158,45392,45550,0.35
April,30,2018,Pacific,WA,Passenger,14,19,33,15488,15521,0.21
April,30,2018,Santa Rosa,FL,Passenger,1,0,1,100,101,0.99
April,30,2018,Nantucket,MA,Passenger,1,0,1,4,5,20
April,30,2018,Prince George,VA,Passenger,0,1,1,73,74,1.35
April,30,2018,Northampton,PA,Passenger,0,1,1,64,65,1.54
April,30,2018,Maricopa,AZ,Passenger,2,1,3,1572,1575,0.19
April,30,2018,Okaloosa,FL,Passenger,1,0,1,172,173,0.58
April,30,2018,Pinal,AZ,Passenger,2,0,2,207,209,0.96
April,30,2018,Ventura,CA,Passenger,0,1,1,319,320,0.31
April,30,2018,Snohomish,WA,Truck,1,0,1,121256,121257,0
April,30,2018,Lane,OR,Passenger,0,1,1,190,191,0.52
April,30,2018,Yakima,WA,Passenger,62,84,146,163240,163386,0.09
April,30,2018,Twin Falls,ID,Passenger,0,1,1,23,24,4.17
April,30,2018,Prince William,VA,Passenger,0,4,4,265,269,1.49
April,30,2018,New Haven,CT,Passenger,0,1,1,50,51,1.96
April,30,2018,Anne Arundel,MD,Passenger,0,2,2,448,450,0.44
April,30,2018,Skamania,WA,Passenger,12,8,20,8705,8725,0.23
April,30,2018,Chelan,WA,Passenger,98,45,143,53398,53541,0.27
April,30,2018,Skagit,WA,Passenger,182,155,337,90035,90372,0.37
April,30,2018,Wahkiakum,WA,Passenger,1,3,4,2887,2891,0.14
April,30,2018,Cape May,NJ,Passenger,0,1,1,21,22,4.55
April,30,2018,Santa Fe,NM,Passenger,0,1,1,41,42,2.38
April,30,2018,Allegheny,PA,Passenger,1,0,1,76,77,1.3
April,30,2018,Montgomery,MD,Passenger,1,0,1,293,294,0.34
April,30,2018,Asotin,WA,Truck,0,0,0,6594,6594,0
April,30,2018,Grays Harbor,WA,Truck,0,0,0,20130,20130,0
April,30,2018,Stevens,WA,Truck,0,0,0,18512,18512,0
April,30,2018,Lewis,WA,Truck,0,0,0,25310,25310,0
April,30,2018,Snohomish,WA,Passenger,2189,1194,3383,518822,522205,0.65
April,30,2018,Kootenai,ID,Passenger,0,1,1,224,225,0.44
April,30,2018,Columbia,WA,Truck,0,0,0,1523,1523,0
April,30,2018,Dallas,TX,Passenger,0,1,1,188,189,0.53
April,30,2018,Clark,WA,Passenger,943,657,1600,306447,308047,0.52
April,30,2018,Lee,AL,Passenger,1,0,1,32,33,3.03
April,30,2018,Utah,UT,Passenger,0,1,1,136,137,0.73
April,30,2018,Washtenaw,MI,Passenger,1,0,1,39,40,2.5
April,30,2018,Marion,IN,Passenger,1,0,1,116,117,0.85
April,30,2018,Adams,WA,Passenger,5,4,9,12523,12532,0.07
April,30,2018,Lewis,WA,Passenger,78,51,129,57351,57480,0.22
April,30,2018,Moore,NC,Passenger,0,1,1,195,196,0.51
April,30,2018,Canyon,ID,Passenger,0,1,1,87,88,1.14
April,30,2018,Sacramento,CA,Passenger,1,0,1,298,299,0.33
April,30,2018,Pend Oreille,WA,Passenger,4,5,9,9474,9483,0.09
April,30,2018,Jefferson,NY,Passenger,1,0,1,220,221,0.45
April,30,2018,Pierce,WA,Passenger,1154,1091,2245,529160,531405,0.42
April,30,2018,Shelby,TN,Passenger,0,1,1,101,102,0.98
April,30,2018,Monroe,IL,Passenger,1,0,1,5,6,16.67
April,30,2018,Travis,TX,Passenger,0,1,1,189,190,0.53
April,30,2018,Jefferson,CO,Passenger,0,1,1,72,73,1.37
April,30,2018,El Paso,TX,Passenger,1,0,1,518,519,0.19
April,30,2018,Clallam,WA,Passenger,117,105,222,49605,49827,0.45
April,30,2018,San Mateo,CA,Passenger,1,1,2,133,135,1.48
April,30,2018,Douglas,WA,Truck,0,0,0,11882,11882,0
April,30,2018,Williamson,TX,Passenger,0,1,1,157,158,0.63
April,30,2018,Richmond,GA,Passenger,0,1,1,91,92,1.09
April,30,2018,Morris,NJ,Passenger,1,0,1,18,19,5.26
April,30,2018,Benton,WA,Truck,0,0,0,40852,40852,0
April,30,2018,Fulton,GA,Passenger,1,1,2,100,102,1.96
April,30,2018,Klickitat,WA,Truck,0,0,0,8070,8070,0
April,30,2018,Duval,FL,Passenger,1,2,3,377,380,0.79
April,30,2018,Whatcom,WA,Passenger,593,269,862,146611,147473,0.58
April,30,2018,Hawaii,HI,Passenger,1,0,1,75,76,1.32
April,30,2018,Dakota,MN,Passenger,0,2,2,37,39,5.13
April,30,2018,Walla Walla,WA,Passenger,34,40,74,35454,35528,0.21
April,30,2018,Spokane,WA,Passenger,318,288,606,301923,302529,0.2
April,30,2018,Adams,WA,Truck,0,0,0,5150,5150,0
April,30,2018,Hardin,KY,Passenger,0,1,1,118,119,0.84
April,30,2018,Pacific,WA,Truck,0,0,0,7596,7596,0
April,30,2018,St. Clair,IL,Passenger,0,1,1,150,151,0.66
April,30,2018,Kitsap,WA,Passenger,742,441,1183,177372,178555,0.66
April,30,2018,Stevens,WA,Passenger,10,24,34,31585,31619,0.11
April,30,2018,Prince George's,MD,Passenger,1,1,2,185,187,1.07
April,30,2018,San Juan,WA,Truck,0,0,0,5698,5698,0
April,30,2018,Manassas,VA,Passenger,0,1,1,9,10,10
April,30,2018,Nueces,TX,Passenger,1,1,2,96,98,2.04
April,30,2018,Kittitas,WA,Passenger,40,32,72,28774,28846,0.25
April,30,2018,Clark,NV,Passenger,1,2,3,746,749,0.4
April,30,2018,Polk,FL,Passenger,1,0,1,63,64,1.56
April,30,2018,Broward,FL,Passenger,0,1,1,130,131,0.76
April,30,2018,Grant,WA,Passenger,31,42,73,62794,62867,0.12
April,30,2018,Kitsap,WA,Truck,1,0,1,52991,52992,0
April,30,2018,Clallam,WA,Truck,0,0,0,21359,21359,0
April,30,2018,Sedgwick,KS,Passenger,0,1,1,99,100,1
April,30,2018,Whitman,WA,Passenger,20,24,44,22555,22599,0.19
April,30,2018,Whitman,WA,Truck,0,0,0,8463,8463,0
April,30,2018,Island,WA,Truck,0,0,0,20845,20845,0
April,30,2018,Carroll,NH,Passenger,0,1,1,1,2,50
April,30,2018,Asotin,WA,Passenger,8,6,14,12640,12654,0.11
April,30,2018,San Francisco,CA,Passenger,0,1,1,133,134,0.75
April,30,2018,Marin,CA,Passenger,1,0,1,56,57,1.75
April,30,2018,Hamilton,TN,Passenger,1,0,1,23,24,4.17
April,30,2018,Sumter,FL,Passenger,0,1,1,10,11,9.09
April,30,2018,Klamath,OR,Passenger,1,0,1,34,35,2.86
April,30,2018,Orleans,LA,Passenger,0,1,1,47,48,2.08
April,30,2018,Tuolumne,CA,Passenger,0,1,1,13,14,7.14
April,30,2018,Queens,NY,Passenger,1,0,1,62,63,1.59
April,30,2018,Clackamas,OR,Passenger,0,1,1,227,228,0.44
April,30,2018,Deschutes,OR,Passenger,1,0,1,172,173,0.58
April,30,2018,Ferry,WA,Passenger,2,3,5,4414,4419,0.11
April,30,2018,Garfield,WA,Truck,0,0,0,950,950,0
April,30,2018,Honolulu,HI,Passenger,2,2,4,532,536,0.75
April,30,2018,Lumpkin,GA,Passenger,1,0,1,7,8,12.5
April,30,2018,Wahkiakum,WA,Truck,0,0,0,1668,1668,0
April,30,2018,Pend Oreille,WA,Truck,0,0,0,5654,5654,0
April,30,2018,Pima,AZ,Passenger,1,1,2,415,417,0.48
April,30,2018,New London,CT,Passenger,0,1,1,250,251,0.4
April,30,2018,Norfolk,MA,Passenger,1,0,1,36,37,2.7
April,30,2018,Virginia Beach,VA,Passenger,2,1,3,683,686,0.44
April,30,2018,Arlington,VA,Passenger,1,2,3,172,175,1.71
April,30,2018,Franklin,WA,Passenger,37,59,96,57403,57499,0.17
April,30,2018,Garfield,OK,Passenger,1,0,1,19,20,5
April,30,2018,Bexar,TX,Passenger,2,2,4,777,781,0.51
April,30,2018,Multnomah,OR,Passenger,4,4,8,816,824,0.97
April,30,2018,Manatee,FL,Passenger,1,0,1,38,39,2.56
April,30,2018,Mason,WA,Truck,0,0,0,19808,19808,0
April,30,2018,St. Lucie,FL,Passenger,1,0,1,26,27,3.7
April,30,2018,Ada,ID,Passenger,0,2,2,331,333,0.6
April,30,2018,El Paso,CO,Passenger,2,0,2,751,753,0.27
April,30,2018,Sangamon,IL,Passenger,1,0,1,11,12,8.33
April,30,2018,Brevard,FL,Passenger,0,1,1,102,103,0.97
April,30,2018,San Diego,CA,Passenger,7,1,8,2553,2561,0.31
April,30,2018,Tarrant,TX,Passenger,1,0,1,216,217,0.46
April,30,2018,Klickitat,WA,Passenger,24,29,53,15050,15103,0.35
April,30,2018,Palm Beach,FL,Passenger,0,1,1,87,88,1.14
April,30,2018,Madison,ID,Passenger,1,0,1,37,38,2.63
April,30,2018,DeKalb,GA,Passenger,1,0,1,83,84,1.19
April,30,2018,Caddo,LA,Passenger,0,1,1,22,23,4.35
April,30,2018,Frederick,MD,Passenger,0,1,1,86,87,1.15
April,30,2018,King,WA,Truck,7,1,8,183356,183364,0
April,30,2018,Orange,CA,Passenger,3,1,4,568,572,0.7
April,30,2018,King,WA,Passenger,12284,5290,17574,1368427,1386001,1.27
April,30,2018,District of Columbia,DC,Passenger,0,3,3,192,195,1.54
April,30,2018,Island,WA,Passenger,184,177,361,62281,62642,0.58
April,30,2018,Pierce,WA,Truck,0,0,0,137364,137364,0
April,30,2018,Jefferson,WA,Truck,0,0,0,9525,9525,0
April,30,2018,Ramsey,MN,Passenger,1,0,1,39,40,2.5
April,30,2018,Kittitas,WA,Truck,0,0,0,13993,13993,0
April,30,2018,Nassau,NY,Passenger,1,0,1,37,38,2.63
April,30,2018,,,Passenger,6,2,8,712,720,1.11
April,30,2018,Skagit,WA,Truck,1,0,1,31980,31981,0
April,30,2018,Okanogan,WA,Passenger,8,19,27,25823,25850,0.1
April,30,2018,Clay,FL,Passenger,0,1,1,100,101,0.99
April,30,2018,Lincoln,WA,Passenger,2,6,8,7613,7621,0.1
April,30,2018,DuPage,IL,Passenger,1,0,1,63,64,1.56
April,30,2018,Okanogan,WA,Truck,0,0,0,16350,16350,0
April,30,2018,Alameda,CA,Passenger,0,1,1,352,353,0.28
April,30,2018,Saratoga,NY,Passenger,1,1,2,66,68,2.94
April,30,2018,Orange,FL,Passenger,2,1,3,169,172,1.74
April,30,2018,Hamilton,IN,Passenger,1,0,1,47,48,2.08
April,30,2018,Portsmouth,VA,Passenger,0,1,1,73,74,1.35
April,30,2018,Juneau,AK,Passenger,0,1,1,46,47,2.13
April,30,2018,Maui,HI,Passenger,1,0,1,58,59,1.69
April,30,2018,Cook,IL,Passenger,1,0,1,271,272,0.37
April,30,2018,Grant,WA,Truck,0,0,0,25855,25855,0
April,30,2018,Chelan,WA,Truck,0,0,0,21764,21764,0
April,30,2018,Montgomery,PA,Passenger,1,0,1,35,36,2.78
April,30,2018,Dale,AL,Passenger,0,1,1,63,64,1.56
April,30,2018,Contra Costa,CA,Passenger,0,1,1,461,462,0.22
April,30,2018,Clark,WA,Truck,0,0,0,78735,78735,0
April,30,2018,DeKalb,IN,Passenger,1,0,1,1,2,50
April,30,2018,Jefferson,WA,Passenger,134,88,222,24353,24575,0.9
August,31,2018,Garfield,WA,Passenger,1,1,2,1318,1320,0.15
August,31,2018,Whatcom,WA,Passenger,653,321,974,148265,149239,0.65
August,31,2018,Marion,OR,Passenger,1,0,1,122,123,0.81
August,31,2018,Bexar,TX,Passenger,3,4,7,737,744,0.94
August,31,2018,Douglas,NE,Passenger,0,1,1,70,71,1.41
August,31,2018,Maui,HI,Passenger,1,0,1,55,56,1.79
August,31,2018,Snohomish,WA,Passenger,2471,1311,3782,523635,527417,0.72
August,31,2018,Jefferson,WA,Truck,0,0,0,9623,9623,0
August,31,2018,El Paso,TX,Passenger,1,0,1,507,508,0.2
August,31,2018,Los Angeles,CA,Passenger,7,4,11,1136,1147,0.96
August,31,2018,Douglas,WA,Passenger,45,31,76,27791,27867,0.27
August,31,2018,Prince George's,MD,Passenger,1,1,2,181,183,1.09
August,31,2018,DeKalb,GA,Passenger,1,0,1,79,80,1.25
August,31,2018,Virginia Beach,VA,Passenger,2,1,3,697,700,0.43
August,31,2018,St. Lucie,FL,Passenger,1,0,1,30,31,3.23
August,31,2018,Fulton,GA,Passenger,1,2,3,106,109,2.75
August,31,2018,Carson City,NV,Passenger,1,0,1,14,15,6.67
August,31,2018,Travis,TX,Passenger,0,1,1,195,196,0.51
August,31,2018,Whitman,WA,Passenger,20,30,50,22680,22730,0.22
August,31,2018,Moore,NC,Passenger,0,1,1,198,199,0.5
August,31,2018,DuPage,IL,Passenger,1,0,1,56,57,1.75
August,31,2018,,,Passenger,6,2,8,768,776,1.03
August,31,2018,Benton,WA,Truck,0,0,0,41231,41231,0
August,31,2018,Madison,ID,Passenger,1,0,1,36,37,2.7
August,31,2018,Whitman,WA,Truck,0,0,0,8505,8505,0
August,31,2018,Stevens,WA,Truck,0,0,0,18676,18676,0
August,31,2018,Ferry,WA,Passenger,2,2,4,4420,4424,0.09
August,31,2018,Essex,NJ,Passenger,1,0,1,11,12,8.33
August,31,2018,Columbia,WA,Truck,0,0,0,1535,1535,0
August,31,2018,Wahkiakum,WA,Passenger,1,1,2,2961,2963,0.07
August,31,2018,Garfield,WA,Truck,0,0,0,956,956,0
August,31,2018,Cape May,NJ,Passenger,0,1,1,22,23,4.35
August,31,2018,Okanogan,WA,Passenger,10,20,30,26065,26095,0.11
August,31,2018,Clallam,WA,Passenger,128,115,243,50115,50358,0.48
August,31,2018,Monroe,IL,Passenger,1,0,1,5,6,16.67
August,31,2018,Allegheny,PA,Passenger,1,0,1,78,79,1.27
August,31,2018,Pacific,WA,Passenger,19,22,41,15677,15718,0.26
August,31,2018,Carroll,NH,Passenger,0,1,1,1,2,50
August,31,2018,Hawaii,HI,Passenger,1,0,1,71,72,1.39
August,31,2018,Lewis,WA,Truck,0,0,0,25605,25605,0
August,31,2018,Franklin,WA,Truck,0,0,0,18794,18794,0
August,31,2018,Cumberland,NC,Passenger,0,1,1,534,535,0.19
August,31,2018,Clay,FL,Passenger,0,1,1,93,94,1.06
August,31,2018,Juneau,AK,Passenger,0,1,1,44,45,2.22
August,31,2018,Yakima,WA,Truck,0,0,0,58619,58619,0
August,31,2018,Washington,OR,Passenger,0,1,1,472,473,0.21
August,31,2018,Kent,MI,Passenger,0,1,1,27,28,3.57
August,31,2018,Norfolk,VA,Passenger,2,2,4,334,338,1.18
August,31,2018,San Juan,PR,Passenger,0,1,1,4,5,20
August,31,2018,Williamson,TX,Passenger,0,1,1,162,163,0.61
August,31,2018,Ramsey,MN,Passenger,1,0,1,40,41,2.44
August,31,2018,Kitsap,WA,Truck,1,0,1,53439,53440,0
August,31,2018,Kittitas,WA,Truck,0,0,0,14113,14113,0
August,31,2018,Dallas,TX,Passenger,0,1,1,196,197,0.51
August,31,2018,Lee,FL,Passenger,1,0,1,58,59,1.69
August,31,2018,Cowlitz,WA,Passenger,62,81,143,71989,72132,0.2
August,31,2018,Clackamas,OR,Passenger,0,1,1,219,220,0.45
August,31,2018,Clark,WA,Truck,0,0,0,79303,79303,0
August,31,2018,Cochise,AZ,Passenger,0,1,1,117,118,0.85
August,31,2018,Manassas,VA,Passenger,0,1,1,9,10,10
August,31,2018,Skagit,WA,Truck,1,0,1,32229,32230,0
August,31,2018,Suffolk,MA,Passenger,0,1,1,42,43,2.33
August,31,2018,Sangamon,IL,Passenger,1,0,1,11,12,8.33
August,31,2018,Collin,TX,Passenger,1,0,1,149,150,0.67
August,31,2018,Orange,CA,Passenger,4,1,5,553,558,0.9
August,31,2018,Spokane,WA,Passenger,360,336,696,304743,305439,0.23
August,31,2018,Duval,FL,Passenger,1,2,3,380,383,0.78
August,31,2018,Walla Walla,WA,Truck,0,0,0,13497,13497,0
August,31,2018,Tarrant,TX,Passenger,1,0,1,213,214,0.47
August,31,2018,Lane,OR,Passenger,0,1,1,181,182,0.55
August,31,2018,San Mateo,CA,Passenger,1,1,2,133,135,1.48
August,31,2018,Portsmouth,VA,Passenger,0,1,1,75,76,1.32
August,31,2018,Riverside,CA,Passenger,2,2,4,692,696,0.57
August,31,2018,Larimer,CO,Passenger,1,0,1,63,64,1.56
August,31,2018,Pierce,WA,Truck,0,0,0,138304,138304,0
August,31,2018,Jefferson,NY,Passenger,0,1,1,225,226,0.44
August,31,2018,Prince George,VA,Passenger,0,1,1,78,79,1.27
August,31,2018,King,WA,Passenger,13801,5938,19739,1373749,1393488,1.42
August,31,2018,Richmond,GA,Passenger,0,1,1,92,93,1.08
August,31,2018,Wahkiakum,WA,Truck,0,0,0,1691,1691,0
August,31,2018,Kitsap,WA,Passenger,828,488,1316,179328,180644,0.73
August,31,2018,Cowlitz,WA,Truck,0,0,0,28606,28606,0
August,31,2018,Jefferson,WA,Passenger,152,101,253,24679,24932,1.01
August,31,2018,Arlington,VA,Passenger,1,1,2,173,175,1.14
August,31,2018,New Haven,CT,Passenger,0,1,1,48,49,2.04
August,31,2018,Klamath,OR,Passenger,1,0,1,35,36,2.78
August,31,2018,Manatee,FL,Passenger,1,0,1,37,38,2.63
August,31,2018,Santa Rosa,FL,Passenger,1,0,1,92,93,1.08
August,31,2018,Clark,NV,Passenger,1,2,3,734,737,0.41
August,31,2018,San Juan,WA,Truck,0,0,0,5755,5755,0
August,31,2018,Palm Beach,FL,Passenger,0,1,1,86,87,1.15
August,31,2018,Clark,WA,Passenger,1069,765,1834,309220,311054,0.59
August,31,2018,Pacific,WA,Truck,0,0,0,7624,7624,0
August,31,2018,Washoe,NV,Passenger,1,0,1,113,114,0.88
August,31,2018,Whatcom,WA,Truck,2,0,2,42393,42395,0
August,31,2018,Ventura,CA,Passenger,0,2,2,315,317,0.63
August,31,2018,Prince William,VA,Passenger,0,4,4,260,264,1.52
August,31,2018,St. Mary's,MD,Passenger,1,0,1,218,219,0.46
August,31,2018,DeKalb,IN,Passenger,1,0,1,1,2,50
August,31,2018,Pierce,WA,Passenger,1303,1224,2527,534848,537375,0.47
August,31,2018,Hennepin,MN,Passenger,1,0,1,110,111,0.9
August,31,2018,Twin Falls,ID,Passenger,0,1,1,23,24,4.17
August,31,2018,Richland,SC,Passenger,0,1,1,171,172,0.58
August,31,2018,Thurston,WA,Passenger,603,517,1120,194254,195374,0.57
August,31,2018,Thurston,WA,Truck,0,0,0,54562,54562,0
August,31,2018,Orange,FL,Passenger,2,1,3,167,170,1.76
August,31,2018,Gwinnett,GA,Passenger,0,1,1,82,83,1.2
August,31,2018,Caddo,LA,Passenger,0,1,1,23,24,4.17
August,31,2018,Columbia,WA,Passenger,2,2,4,2415,2419,0.17
August,31,2018,Maricopa,AZ,Passenger,2,1,3,1562,1565,0.19
August,31,2018,Honolulu,HI,Passenger,1,2,3,526,529,0.57
August,31,2018,Mason,WA,Truck,0,0,0,20084,20084,0
August,31,2018,New London,CT,Passenger,0,1,1,254,255,0.39
August,31,2018,Middlesex,MA,Passenger,0,1,1,139,140,0.71
August,31,2018,Grant,WA,Truck,0,0,0,26008,26008,0
August,31,2018,Lincoln,WA,Passenger,3,6,9,7748,7757,0.12
August,31,2018,Chelan,WA,Passenger,114,55,169,53723,53892,0.31
August,31,2018,Pend Oreille,WA,Truck,0,0,0,5718,5718,0
August,31,2018,District of Columbia,DC,Passenger,0,3,3,192,195,1.54
August,31,2018,Benton,WA,Passenger,189,198,387,132209,132596,0.29
August,31,2018,Washtenaw,MI,Passenger,1,0,1,38,39,2.56
August,31,2018,Island,WA,Passenger,216,204,420,62724,63144,0.67
August,31,2018,Latah,ID,Passenger,0,1,1,75,76,1.32
August,31,2018,Asotin,WA,Truck,0,0,0,6649,6649,0
August,31,2018,Tulsa,OK,Passenger,1,1,2,47,49,4.08
August,31,2018,Howard,MD,Passenger,0,1,1,86,87,1.15
August,31,2018,Adams,WA,Passenger,5,5,10,12682,12692,0.08
August,31,2018,Marion,IN,Passenger,1,0,1,119,120,0.83
August,31,2018,Dakota,MN,Passenger,0,2,2,35,37,5.41
August,31,2018,Camden,NJ,Passenger,0,1,1,32,33,3.03
August,31,2018,Ada,ID,Passenger,0,2,2,314,316,0.63
August,31,2018,Asotin,WA,Passenger,11,8,19,12663,12682,0.15
August,31,2018,Klickitat,WA,Passenger,24,32,56,15283,15339,0.37
August,31,2018,Skagit,WA,Passenger,220,169,389,90837,91226,0.43
August,31,2018,Fairfax,VA,Passenger,2,2,4,814,818,0.49
August,31,2018,Houston,GA,Passenger,1,0,1,54,55,1.82
August,31,2018,Lee,AL,Passenger,1,0,1,37,38,2.63
August,31,2018,Skamania,WA,Truck,0,0,0,3948,3948,0
August,31,2018,Sumter,FL,Passenger,0,1,1,10,11,9.09
August,31,2018,Skamania,WA,Passenger,14,10,24,8670,8694,0.28
August,31,2018,Grays Harbor,WA,Passenger,54,65,119,46989,47108,0.25
August,31,2018,St. Clair,IL,Passenger,0,1,1,156,157,0.64
August,31,2018,Snohomish,WA,Truck,1,0,1,121713,121714,0
August,31,2018,Fresno,CA,Passenger,1,0,1,195,196,0.51
August,31,2018,Douglas,WA,Truck,0,0,0,12028,12028,0
August,31,2018,Polk,FL,Passenger,1,0,1,64,65,1.54
August,31,2018,Volusia,FL,Passenger,0,1,1,34,35,2.86
August,31,2018,Yakima,WA,Passenger,67,92,159,164210,164369,0.1
August,31,2018,Chelan,WA,Truck,0,0,0,21983,21983,0
August,31,2018,Hamilton,IN,Passenger,1,0,1,46,47,2.13
August,31,2018,Cook,IL,Passenger,1,0,1,252,253,0.4
August,31,2018,Grant,WA,Passenger,34,49,83,63544,63627,0.13
August,31,2018,Pend Oreille,WA,Passenger,5,5,10,9583,9593,0.1
August,31,2018,Charles,MD,Passenger,0,1,1,82,83,1.2
August,31,2018,San Diego,CA,Passenger,7,2,9,2568,2577,0.35
August,31,2018,Tuolumne,CA,Passenger,0,1,1,12,13,7.69
August,31,2018,Utah,UT,Passenger,0,1,1,137,138,0.72
August,31,2018,Franklin,MA,Passenger,0,1,1,1,2,50
August,31,2018,Nueces,TX,Passenger,1,1,2,88,90,2.22
August,31,2018,Sedgwick,KS,Passenger,0,1,1,100,101,0.99
August,31,2018,Adams,WA,Truck,0,0,0,5174,5174,0
August,31,2018,Dale,AL,Passenger,0,1,1,57,58,1.72
August,31,2018,Mason,WA,Passenger,92,97,189,46050,46239,0.41
August,31,2018,Lumpkin,GA,Passenger,1,0,1,7,8,12.5
August,31,2018,Multnomah,OR,Passenger,3,5,8,777,785,1.02
August,31,2018,Klickitat,WA,Truck,0,0,0,8158,8158,0
August,31,2018,Okanogan,WA,Truck,0,0,0,16469,16469,0
August,31,2018,Frederick,MD,Passenger,0,1,1,85,86,1.16
August,31,2018,Pinal,AZ,Passenger,2,0,2,203,205,0.98
August,31,2018,Franklin,WA,Passenger,36,65,101,58372,58473,0.17
August,31,2018,Charleston,SC,Passenger,1,0,1,128,129,0.78
August,31,2018,Queens,NY,Passenger,1,0,1,61,62,1.61
August,31,2018,Norfolk,MA,Passenger,1,0,1,36,37,2.7
August,31,2018,Kittitas,WA,Passenger,51,34,85,29121,29206,0.29
August,31,2018,Santa Fe,NM,Passenger,0,1,1,45,46,2.17
August,31,2018,Lincoln,WA,Truck,0,0,0,4572,4572,0
August,31,2018,Alameda,CA,Passenger,0,1,1,340,341,0.29
August,31,2018,Ferry,WA,Truck,0,0,0,3550,3550,0
August,31,2018,Nantucket,MA,Passenger,1,0,1,4,5,20
August,31,2018,El Paso,CO,Passenger,3,1,4,756,760,0.53
August,31,2018,Anne Arundel,MD,Passenger,0,1,1,452,453,0.22
August,31,2018,Hardin,KY,Passenger,0,1,1,120,121,0.83
August,31,2018,Lewis,WA,Passenger,83,62,145,57867,58012,0.25
August,31,2018,Montgomery,PA,Passenger,2,0,2,36,38,5.26
August,31,2018,Deschutes,OR,Passenger,2,0,2,163,165,1.21
August,31,2018,Brevard,FL,Passenger,0,1,1,92,93,1.08
August,31,2018,Monterey,CA,Passenger,0,1,1,186,187,0.53
August,31,2018,Clallam,WA,Truck,0,0,0,21476,21476,0
August,31,2018,Garfield,OK,Passenger,1,0,1,16,17,5.88
August,31,2018,Montgomery,TX,Passenger,2,0,2,61,63,3.17
August,31,2018,Pima,AZ,Passenger,1,1,2,413,415,0.48
August,31,2018,Broward,FL,Passenger,1,1,2,134,136,1.47
August,31,2018,Contra Costa,CA,Passenger,0,1,1,440,441,0.23
August,31,2018,Island,WA,Truck,0,0,0,21052,21052,0
August,31,2018,Jefferson,CO,Passenger,0,1,1,65,66,1.52
August,31,2018,Morris,NJ,Passenger,1,0,1,16,17,5.88
August,31,2018,Flathead,MT,Passenger,1,0,1,53,54,1.85
August,31,2018,Stevens,WA,Passenger,12,26,38,31687,31725,0.12
August,31,2018,San Juan,WA,Passenger,152,66,218,14152,14370,1.52
August,31,2018,Nassau,NY,Passenger,2,0,2,36,38,5.26
August,31,2018,Shelby,TN,Passenger,0,1,1,101,102,0.98
August,31,2018,King,WA,Truck,7,1,8,182994,183002,0
August,31,2018,San Francisco,CA,Passenger,1,1,2,121,123,1.63
August,31,2018,Montgomery,MD,Passenger,1,0,1,283,284,0.35
August,31,2018,Kootenai,ID,Passenger,0,1,1,220,221,0.45
August,31,2018,Saratoga,NY,Passenger,1,0,1,63,64,1.56
August,31,2018,Grays Harbor,WA,Truck,0,0,0,20309,20309,0
August,31,2018,Santa Clara,CA,Passenger,8,0,8,376,384,2.08
August,31,2018,Spokane,WA,Truck,1,0,1,93029,93030,0
August,31,2018,Beaufort,SC,Passenger,1,0,1,38,39,2.56
August,31,2018,Walla Walla,WA,Passenger,34,48,82,35872,35954,0.23
December,31,2018,Franklin,WA,Truck,0,0,0,19057,19057,0
December,31,2018,Arlington,VA,Passenger,1,1,2,165,167,1.2
December,31,2018,Franklin,MA,Passenger,0,1,1,1,2,50
December,31,2018,Carroll,NH,Passenger,0,1,1,1,2,50
December,31,2018,Snohomish,WA,Truck,1,0,1,121967,121968,0
December,31,2018,Skamania,WA,Passenger,16,13,29,8731,8760,0.33
December,31,2018,Wahkiakum,WA,Passenger,1,1,2,2979,2981,0.07
December,31,2018,Kitsap,WA,Passenger,946,544,1490,179830,181320,0.82
December,31,2018,Pacific,WA,Passenger,21,25,46,15834,15880,0.29
December,31,2018,Grays Harbor,WA,Passenger,62,72,134,47465,47599,0.28
December,31,2018,Tuolumne,CA,Passenger,0,1,1,13,14,7.14
December,31,2018,Asotin,WA,Passenger,12,9,21,12724,12745,0.16
December,31,2018,Caddo,LA,Passenger,0,1,1,21,22,4.55
December,31,2018,Chelan,WA,Passenger,140,61,201,54138,54339,0.37
December,31,2018,Fulton,GA,Passenger,1,2,3,108,111,2.7
December,31,2018,Cowlitz,WA,Passenger,72,94,166,72436,72602,0.23
December,31,2018,Walla Walla,WA,Passenger,41,52,93,36097,36190,0.26
December,31,2018,Pacific,WA,Truck,0,0,0,7614,7614,0
December,31,2018,Twin Falls,ID,Passenger,0,1,1,23,24,4.17
December,31,2018,Monroe,IL,Passenger,1,0,1,4,5,20
December,31,2018,Lane,OR,Passenger,0,1,1,169,170,0.59
December,31,2018,District of Columbia,DC,Passenger,1,3,4,197,201,1.99
December,31,2018,New London,CT,Passenger,0,2,2,252,254,0.79
December,31,2018,Cumberland,NC,Passenger,0,1,1,522,523,0.19
December,31,2018,,,Passenger,7,2,9,780,789,1.14
December,31,2018,El Paso,CO,Passenger,3,1,4,763,767,0.52
December,31,2018,Nantucket,MA,Passenger,1,0,1,4,5,20
December,31,2018,Jefferson,WA,Passenger,168,106,274,24838,25112,1.09
December,31,2018,Fairfax,VA,Passenger,3,2,5,808,813,0.62
December,31,2018,DeKalb,GA,Passenger,1,0,1,77,78,1.28
December,31,2018,Pend Oreille,WA,Truck,0,0,0,5738,5738,0
December,31,2018,Jefferson,WA,Truck,0,0,0,9606,9606,0
December,31,2018,Bexar,TX,Passenger,3,4,7,711,718,0.97
December,31,2018,Prince William,VA,Passenger,0,4,4,254,258,1.55
December,31,2018,Snohomish,WA,Passenger,2915,1437,4352,527237,531589,0.82
December,31,2018,Chelan,WA,Truck,0,0,0,22052,22052,0
December,31,2018,Richland,SC,Passenger,0,1,1,162,163,0.61
December,31,2018,Tarrant,TX,Passenger,1,0,1,204,205,0.49
December,31,2018,Harnett,NC,Passenger,1,0,1,228,229,0.44
December,31,2018,El Paso,TX,Passenger,1,0,1,495,496,0.2
December,31,2018,Jefferson,NY,Passenger,0,1,1,228,229,0.44
December,31,2018,Fresno,CA,Passenger,1,0,1,190,191,0.52
December,31,2018,Clay,FL,Passenger,0,1,1,87,88,1.14
December,31,2018,Grant,WA,Passenger,32,52,84,64196,64280,0.13
December,31,2018,Nueces,TX,Passenger,1,1,2,93,95,2.11
December,31,2018,Multnomah,OR,Passenger,3,5,8,764,772,1.04
December,31,2018,Marion,IN,Passenger,1,0,1,119,120,0.83
December,31,2018,Cowlitz,WA,Truck,0,0,0,28739,28739,0
December,31,2018,Cochise,AZ,Passenger,0,1,1,119,120,0.83
December,31,2018,Richmond,GA,Passenger,0,1,1,90,91,1.1
December,31,2018,Klickitat,WA,Passenger,28,32,60,15431,15491,0.39
December,31,2018,Franklin,WA,Passenger,45,66,111,59124,59235,0.19
December,31,2018,Grays Harbor,WA,Truck,0,0,0,20356,20356,0
December,31,2018,Kittitas,WA,Passenger,66,37,103,29339,29442,0.35
December,31,2018,Skagit,WA,Truck,1,0,1,32318,32319,0
December,31,2018,Middlesex,MA,Passenger,1,1,2,128,130,1.54
December,31,2018,Maui,HI,Passenger,1,0,1,51,52,1.92
December,31,2018,Beaufort,SC,Passenger,1,0,1,34,35,2.86
December,31,2018,Lincoln,WA,Truck,0,0,0,4639,4639,0
December,31,2018,Sedgwick,KS,Passenger,0,1,1,98,99,1.01
December,31,2018,Santa Rosa,FL,Passenger,1,0,1,88,89,1.12
December,31,2018,Ferry,WA,Truck,0,0,0,3585,3585,0
December,31,2018,Skamania,WA,Truck,0,0,0,4008,4008,0
December,31,2018,Garfield,WA,Passenger,1,1,2,1329,1331,0.15
December,31,2018,Manassas,VA,Passenger,0,1,1,9,10,10
December,31,2018,Kent,MI,Passenger,0,1,1,23,24,4.17
December,31,2018,St. Lucie,FL,Passenger,1,0,1,30,31,3.23
December,31,2018,Clallam,WA,Passenger,150,124,274,50353,50627,0.54
December,31,2018,Flathead,MT,Passenger,1,0,1,56,57,1.75
December,31,2018,Yakima,WA,Truck,0,0,0,58848,58848,0
December,31,2018,Clallam,WA,Truck,0,0,0,21642,21642,0
December,31,2018,Douglas,WA,Truck,0,0,0,12160,12160,0
December,31,2018,Sumter,FL,Passenger,0,1,1,10,11,9.09
December,31,2018,St. Clair,IL,Passenger,0,1,1,165,166,0.6
December,31,2018,Nassau,NY,Passenger,3,0,3,35,38,7.89
December,31,2018,Columbia,WA,Truck,0,0,0,1517,1517,0
December,31,2018,Howard,MD,Passenger,0,1,1,84,85,1.18
December,31,2018,Montgomery,TX,Passenger,2,0,2,61,63,3.17
December,31,2018,Benton,WA,Passenger,227,235,462,132930,133392,0.35
December,31,2018,Washtenaw,MI,Passenger,1,0,1,40,41,2.44
December,31,2018,San Juan,WA,Truck,0,0,0,5818,5818,0
December,31,2018,Thurston,WA,Passenger,739,572,1311,195602,196913,0.67
December,31,2018,Maricopa,AZ,Passenger,3,2,5,1544,1549,0.32
December,31,2018,Los Angeles,CA,Passenger,7,5,12,1105,1117,1.07
December,31,2018,Duval,FL,Passenger,1,2,3,381,384,0.78
December,31,2018,Bucks,PA,Passenger,1,0,1,16,17,5.88
December,31,2018,Hawaii,HI,Passenger,1,0,1,62,63,1.59
December,31,2018,Santa Cruz,CA,Passenger,1,0,1,41,42,2.38
December,31,2018,Cape May,NJ,Passenger,0,1,1,21,22,4.55
December,31,2018,Guadalupe,TX,Passenger,1,0,1,79,80,1.25
December,31,2018,Kittitas,WA,Truck,0,0,0,14196,14196,0
December,31,2018,Riverside,CA,Passenger,2,2,4,677,681,0.59
December,31,2018,Houston,GA,Passenger,1,0,1,51,52,1.92
December,31,2018,Dakota,MN,Passenger,0,2,2,34,36,5.56
December,31,2018,San Juan,WA,Passenger,183,69,252,14224,14476,1.74
December,31,2018,Tulsa,OK,Passenger,1,1,2,47,49,4.08
December,31,2018,Albemarle,VA,Passenger,1,0,1,25,26,3.85
December,31,2018,Adams,WA,Truck,0,0,0,5149,5149,0
December,31,2018,Charles,MD,Passenger,0,1,1,76,77,1.3
December,31,2018,Suffolk,MA,Passenger,0,1,1,42,43,2.33
December,31,2018,Orange,FL,Passenger,2,0,2,166,168,1.19
December,31,2018,Whatcom,WA,Truck,2,0,2,42664,42666,0
December,31,2018,Polk,FL,Passenger,1,0,1,64,65,1.54
December,31,2018,Pima,AZ,Passenger,1,1,2,399,401,0.5
December,31,2018,Douglas,NE,Passenger,0,1,1,67,68,1.47
December,31,2018,Deschutes,OR,Passenger,2,0,2,165,167,1.2
December,31,2018,Lewis,WA,Passenger,93,77,170,58326,58496,0.29
December,31,2018,Clackamas,OR,Passenger,1,1,2,214,216,0.93
December,31,2018,Whatcom,WA,Passenger,757,371,1128,149448,150576,0.75
December,31,2018,Washoe,NV,Passenger,2,0,2,110,112,1.79
December,31,2018,Bergen,NJ,Passenger,1,0,1,27,28,3.57
December,31,2018,Mason,WA,Passenger,107,110,217,46462,46679,0.46
December,31,2018,Mason,WA,Truck,0,0,0,20192,20192,0
December,31,2018,San Francisco,CA,Passenger,2,1,3,115,118,2.54
December,31,2018,Cook,IL,Passenger,1,0,1,247,248,0.4
December,31,2018,Larimer,CO,Passenger,1,0,1,60,61,1.64
December,31,2018,Virginia Beach,VA,Passenger,2,1,3,695,698,0.43
December,31,2018,Goochland,VA,Passenger,0,1,1,243,244,0.41
December,31,2018,Thurston,WA,Truck,0,0,0,54873,54873,0
December,31,2018,Jefferson,CO,Passenger,0,2,2,61,63,3.17
December,31,2018,Island,WA,Truck,0,0,0,21185,21185,0
December,31,2018,Garfield,WA,Truck,0,0,0,965,965,0
December,31,2018,Rogers,OK,Passenger,1,0,1,5,6,16.67
December,31,2018,Lewis,WA,Truck,0,0,0,25634,25634,0
December,31,2018,Yakima,WA,Passenger,82,99,181,164762,164943,0.11
December,31,2018,Sangamon,IL,Passenger,1,0,1,9,10,10
December,31,2018,Frederick,MD,Passenger,0,1,1,79,80,1.25
December,31,2018,Benton,WA,Truck,0,0,0,41561,41561,0
December,31,2018,Manatee,FL,Passenger,1,0,1,37,38,2.63
December,31,2018,Marion,OR,Passenger,1,0,1,117,118,0.85
December,31,2018,St. Mary's,MD,Passenger,1,0,1,214,215,0.47
December,31,2018,Ventura,CA,Passenger,0,2,2,319,321,0.62
December,31,2018,Pierce,WA,Truck,0,0,0,139122,139122,0
December,31,2018,Pinal,AZ,Passenger,2,0,2,200,202,0.99
December,31,2018,Clark,NV,Passenger,2,2,4,719,723,0.55
December,31,2018,Kootenai,ID,Passenger,1,1,2,218,220,0.91
December,31,2018,Dale,AL,Passenger,0,1,1,56,57,1.75
December,31,2018,Travis,TX,Passenger,1,1,2,197,199,1.01
December,31,2018,Hennepin,MN,Passenger,2,0,2,105,107,1.87
December,31,2018,Grant,WA,Truck,0,0,0,26258,26258,0
December,31,2018,Honolulu,HI,Passenger,1,3,4,516,520,0.77
December,31,2018,Denver,CO,Passenger,1,0,1,128,129,0.78
December,31,2018,Ferry,WA,Passenger,3,2,5,4383,4388,0.11
December,31,2018,Norfolk,VA,Passenger,2,2,4,341,345,1.16
December,31,2018,Garfield,OK,Passenger,1,0,1,13,14,7.14
December,31,2018,Norfolk,MA,Passenger,1,0,1,36,37,2.7
December,31,2018,Camden,NJ,Passenger,0,1,1,28,29,3.45
December,31,2018,Ada,ID,Passenger,0,2,2,312,314,0.64
December,31,2018,Spokane,WA,Truck,1,0,1,93762,93763,0
December,31,2018,Hardin,KY,Passenger,0,1,1,107,108,0.93
December,31,2018,Asotin,WA,Truck,0,0,0,6635,6635,0
December,31,2018,Madison,ID,Passenger,1,0,1,35,36,2.78
December,31,2018,Valencia,NM,Passenger,1,0,1,10,11,9.09
December,31,2018,Carson City,NV,Passenger,1,0,1,15,16,6.25
December,31,2018,Montgomery,PA,Passenger,2,0,2,35,37,5.41
December,31,2018,Adams,WA,Passenger,5,6,11,12744,12755,0.09
December,31,2018,San Juan,PR,Passenger,0,1,1,5,6,16.67
December,31,2018,DuPage,IL,Passenger,1,0,1,59,60,1.67
December,31,2018,King,WA,Truck,6,1,7,182653,182660,0
December,31,2018,Santa Fe,NM,Passenger,0,1,1,41,42,2.38
December,31,2018,New Haven,CT,Passenger,0,1,1,49,50,2
December,31,2018,DeKalb,IN,Passenger,1,0,1,1,2,50
December,31,2018,Clark,WA,Passenger,1246,841,2087,311394,313481,0.67
December,31,2018,Washington,OR,Passenger,0,1,1,471,472,0.21
December,31,2018,Kitsap,WA,Truck,1,0,1,53636,53637,0
December,31,2018,Douglas,WA,Passenger,50,34,84,28009,28093,0.3
December,31,2018,San Mateo,CA,Passenger,2,1,3,128,131,2.29
December,31,2018,Collin,TX,Passenger,1,1,2,145,147,1.36
December,31,2018,Shasta,CA,Passenger,1,0,1,42,43,2.33
December,31,2018,Island,WA,Passenger,276,225,501,63178,63679,0.79
December,31,2018,Saratoga,NY,Passenger,1,0,1,62,63,1.59
December,31,2018,Lee,AL,Passenger,1,0,1,36,37,2.7
December,31,2018,Williamson,TX,Passenger,0,1,1,147,148,0.68
December,31,2018,Ramsey,MN,Passenger,1,0,1,39,40,2.5
December,31,2018,Brevard,FL,Passenger,0,1,1,94,95,1.05
December,31,2018,Skagit,WA,Passenger,259,187,446,91196,91642,0.49
December,31,2018,Portsmouth,VA,Passenger,0,1,1,81,82,1.22
December,31,2018,Lumpkin,GA,Passenger,1,0,1,7,8,12.5
December,31,2018,Charleston,SC,Passenger,1,0,1,123,124,0.81
December,31,2018,Gwinnett,GA,Passenger,0,1,1,78,79,1.27
December,31,2018,Randolph,NC,Passenger,1,0,1,6,7,14.29
December,31,2018,Santa Clara,CA,Passenger,8,1,9,372,381,2.36
December,31,2018,Klickitat,WA,Truck,0,0,0,8209,8209,0
December,31,2018,Lincoln,WA,Passenger,2,5,7,7780,7787,0.09
December,31,2018,Volusia,FL,Passenger,0,1,1,37,38,2.63
December,31,2018,Pierce,WA,Passenger,1509,1373,2882,538890,541772,0.53
December,31,2018,Walla Walla,WA,Truck,0,0,0,13523,13523,0
December,31,2018,Juneau,AK,Passenger,0,1,1,43,44,2.27
December,31,2018,Prince George's,MD,Passenger,1,1,2,183,185,1.08
December,31,2018,Oldham,KY,Passenger,0,1,1,5,6,16.67
December,31,2018,Spokane,WA,Passenger,439,373,812,307178,307990,0.26
December,31,2018,Allegheny,PA,Passenger,1,0,1,81,82,1.22
December,31,2018,Stevens,WA,Truck,0,0,0,18764,18764,0
December,31,2018,Moore,NC,Passenger,0,1,1,191,192,0.52
December,31,2018,Montgomery,AL,Passenger,0,1,1,46,47,2.13
December,31,2018,Palm Beach,FL,Passenger,0,1,1,94,95,1.05
December,31,2018,Clark,WA,Truck,0,0,0,79840,79840,0
December,31,2018,Orange,CA,Passenger,6,2,8,539,547,1.46
December,31,2018,Montgomery,MD,Passenger,1,0,1,275,276,0.36
December,31,2018,Okanogan,WA,Truck,0,0,0,16487,16487,0
December,31,2018,King,WA,Passenger,16280,6530,22810,1378186,1400996,1.63
December,31,2018,Mecklenburg,NC,Passenger,1,0,1,79,80,1.25
December,31,2018,Okanogan,WA,Passenger,16,22,38,26070,26108,0.15
December,31,2018,Contra Costa,CA,Passenger,0,2,2,408,410,0.49
December,31,2018,Pend Oreille,WA,Passenger,5,5,10,9533,9543,0.1
December,31,2018,Columbia,WA,Passenger,2,2,4,2421,2425,0.16
December,31,2018,Alameda,CA,Passenger,0,2,2,323,325,0.62
December,31,2018,San Diego,CA,Passenger,8,2,10,2569,2579,0.39
December,31,2018,Shelby,TN,Passenger,0,1,1,98,99,1.01
December,31,2018,Broward,FL,Passenger,2,1,3,128,131,2.29
December,31,2018,Klamath,OR,Passenger,1,0,1,37,38,2.63
December,31,2018,Whitman,WA,Passenger,24,38,62,22811,22873,0.27
December,31,2018,Lee,FL,Passenger,1,0,1,52,53,1.89
December,31,2018,Stevens,WA,Passenger,16,27,43,31786,31829,0.14
December,31,2018,Wahkiakum,WA,Truck,0,0,0,1722,1722,0
December,31,2018,Anne Arundel,MD,Passenger,0,2,2,452,454,0.44
December,31,2018,Whitman,WA,Truck,0,0,0,8542,8542,0
December,31,2018,Dallas,TX,Passenger,0,1,1,203,204,0.49
February,28,2018,Cape May,NJ,Passenger,0,1,1,22,23,4.35
February,28,2018,Mason,WA,Truck,0,0,0,19725,19725,0
February,28,2018,Grant,WA,Passenger,31,38,69,62313,62382,0.11
February,28,2018,Pacific,WA,Passenger,15,17,32,15463,15495,0.21
February,28,2018,Wahkiakum,WA,Truck,0,0,0,1673,1673,0
February,28,2018,Island,WA,Truck,0,0,0,20828,20828,0
February,28,2018,San Mateo,CA,Passenger,0,1,1,138,139,0.72
February,28,2018,Skagit,WA,Truck,1,0,1,31814,31815,0
February,28,2018,Asotin,WA,Passenger,8,5,13,12588,12601,0.1
February,28,2018,Franklin,MA,Passenger,0,1,1,3,4,25
February,28,2018,Garfield,WA,Truck,0,0,0,942,942,0
February,28,2018,Walla Walla,WA,Passenger,31,35,66,35386,35452,0.19
February,28,2018,Queens,NY,Passenger,1,0,1,61,62,1.61
February,28,2018,Gwinnett,GA,Passenger,0,1,1,78,79,1.27
February,28,2018,Duval,FL,Passenger,1,2,3,368,371,0.81
February,28,2018,Manatee,FL,Passenger,1,0,1,38,39,2.56
February,28,2018,Whitman,WA,Passenger,18,21,39,22530,22569,0.17
February,28,2018,Yakima,WA,Truck,0,0,0,58125,58125,0
February,28,2018,Los Angeles,CA,Passenger,5,3,8,1192,1200,0.67
February,28,2018,Grays Harbor,WA,Truck,0,0,0,20115,20115,0
February,28,2018,Jefferson,WA,Truck,0,0,0,9511,9511,0
February,28,2018,Garfield,WA,Passenger,1,0,1,1323,1324,0.08
February,28,2018,Adams,WA,Truck,0,0,0,5139,5139,0
February,28,2018,Fairfax,VA,Passenger,2,2,4,825,829,0.48
February,28,2018,Contra Costa,CA,Passenger,0,1,1,469,470,0.21
February,28,2018,Adams,WA,Passenger,5,4,9,12458,12467,0.07
February,28,2018,Maricopa,AZ,Passenger,2,0,2,1598,1600,0.12
February,28,2018,Frederick,MD,Passenger,0,1,1,90,91,1.1
February,28,2018,Portsmouth,VA,Passenger,0,1,1,72,73,1.37
February,28,2018,Multnomah,OR,Passenger,3,4,7,835,842,0.83
February,28,2018,Dallas,TX,Passenger,0,1,1,185,186,0.54
February,28,2018,Clallam,WA,Passenger,109,101,210,49356,49566,0.42
February,28,2018,Sumter,FL,Passenger,0,1,1,10,11,9.09
February,28,2018,Norfolk,MA,Passenger,1,0,1,39,40,2.5
February,28,2018,Columbia,WA,Truck,0,0,0,1535,1535,0
February,28,2018,Latah,ID,Passenger,0,1,1,76,77,1.3
February,28,2018,Garfield,OK,Passenger,1,0,1,21,22,4.55
February,28,2018,Cowlitz,WA,Truck,0,0,0,28183,28183,0
February,28,2018,Northampton,PA,Passenger,0,1,1,61,62,1.61
February,28,2018,Yakima,WA,Passenger,61,79,140,162333,162473,0.09
February,28,2018,Fulton,GA,Passenger,1,0,1,106,107,0.93
February,28,2018,Deschutes,OR,Passenger,1,0,1,177,178,0.56
February,28,2018,Ferry,WA,Truck,0,0,0,3527,3527,0
February,28,2018,Whatcom,WA,Truck,1,0,1,42039,42040,0
February,28,2018,Missoula,MT,Passenger,1,0,1,67,68,1.47
February,28,2018,Franklin,WA,Passenger,32,51,83,57008,57091,0.15
February,28,2018,District of Columbia,DC,Passenger,0,3,3,194,197,1.52
February,28,2018,Pend Oreille,WA,Truck,0,0,0,5631,5631,0
February,28,2018,Cook,IL,Passenger,1,0,1,286,287,0.35
February,28,2018,Hardin,KY,Passenger,0,1,1,116,117,0.85
February,28,2018,Montgomery,TN,Passenger,1,0,1,264,265,0.38
February,28,2018,Polk,FL,Passenger,1,0,1,63,64,1.56
February,28,2018,Lincoln,WA,Passenger,2,5,7,7594,7601,0.09
February,28,2018,Sacramento,CA,Passenger,1,0,1,297,298,0.34
February,28,2018,Santa Clara,CA,Passenger,7,1,8,380,388,2.06
February,28,2018,Marin,CA,Passenger,1,0,1,56,57,1.75
February,28,2018,Bexar,TX,Passenger,2,2,4,798,802,0.5
February,28,2018,Lane,OR,Passenger,0,1,1,199,200,0.5
February,28,2018,Arlington,VA,Passenger,1,2,3,171,174,1.72
February,28,2018,Caddo,LA,Passenger,0,1,1,22,23,4.35
February,28,2018,Skagit,WA,Passenger,172,145,317,89751,90068,0.35
February,28,2018,Thurston,WA,Passenger,492,414,906,190758,191664,0.47
February,28,2018,Benton,WA,Passenger,175,179,354,130454,130808,0.27
February,28,2018,Broward,FL,Passenger,0,1,1,139,140,0.71
February,28,2018,Santa Rosa,FL,Passenger,1,0,1,99,100,1
February,28,2018,Orange,FL,Passenger,2,1,3,169,172,1.74
February,28,2018,Nantucket,MA,Passenger,1,0,1,4,5,20
February,28,2018,Kitsap,WA,Passenger,716,418,1134,176380,177514,0.64
February,28,2018,Utah,UT,Passenger,0,1,1,133,134,0.75
February,28,2018,Clark,WA,Passenger,888,616,1504,305306,306810,0.49
February,28,2018,Travis,TX,Passenger,0,1,1,186,187,0.53
February,28,2018,Flathead,MT,Passenger,1,0,1,53,54,1.85
February,28,2018,Kent,MI,Passenger,0,1,1,35,36,2.78
February,28,2018,Madison,ID,Passenger,1,0,1,39,40,2.5
February,28,2018,Jefferson,WA,Passenger,127,80,207,24312,24519,0.84
February,28,2018,Chelan,WA,Passenger,94,39,133,53238,53371,0.25
February,28,2018,Palm Beach,FL,Passenger,0,1,1,86,87,1.15
February,28,2018,DuPage,IL,Passenger,1,0,1,65,66,1.52
February,28,2018,Dale,AL,Passenger,0,1,1,64,65,1.54
February,28,2018,Okaloosa,FL,Passenger,1,0,1,178,179,0.56
February,28,2018,Franklin,WA,Truck,0,0,0,18577,18577,0
February,28,2018,Clay,FL,Passenger,0,1,1,103,104,0.96
February,28,2018,Pierce,WA,Truck,0,0,0,137016,137016,0
February,28,2018,Alameda,CA,Passenger,0,1,1,357,358,0.28
February,28,2018,Richmond,GA,Passenger,0,1,1,92,93,1.08
February,28,2018,Nueces,TX,Passenger,1,1,2,96,98,2.04
February,28,2018,St. Lucie,FL,Passenger,1,0,1,26,27,3.7
February,28,2018,Spokane,WA,Passenger,306,263,569,300527,301096,0.19
February,28,2018,Columbia,WA,Passenger,2,1,3,2407,2410,0.12
February,28,2018,Prince George's,MD,Passenger,0,1,1,180,181,0.55
February,28,2018,Howard,MD,Passenger,0,1,1,87,88,1.14
February,28,2018,Riverside,CA,Passenger,2,2,4,723,727,0.55
February,28,2018,Clark,NV,Passenger,1,2,3,739,742,0.4
February,28,2018,Lewis,WA,Truck,0,0,0,25269,25269,0
February,28,2018,Snohomish,WA,Passenger,2088,1119,3207,517277,520484,0.62
February,28,2018,Anne Arundel,MD,Passenger,0,1,1,473,474,0.21
February,28,2018,Allegheny,PA,Passenger,1,0,1,81,82,1.22
February,28,2018,Spokane,WA,Truck,1,0,1,91721,91722,0
February,28,2018,Whitman,WA,Truck,0,0,0,8453,8453,0
February,28,2018,Tuolumne,CA,Passenger,0,1,1,14,15,6.67
February,28,2018,Montgomery,MD,Passenger,1,0,1,298,299,0.33
February,28,2018,Manassas,VA,Passenger,0,1,1,9,10,10
February,28,2018,Hamilton,TN,Passenger,1,0,1,22,23,4.35
February,28,2018,New Haven,CT,Passenger,0,1,1,52,53,1.89
February,28,2018,Dakota,MN,Passenger,0,2,2,36,38,5.26
February,28,2018,Chelan,WA,Truck,0,0,0,21668,21668,0
February,28,2018,Sangamon,IL,Passenger,1,0,1,11,12,8.33
February,28,2018,Moore,NC,Passenger,0,1,1,199,200,0.5
February,28,2018,Maui,HI,Passenger,1,0,1,65,66,1.52
February,28,2018,Orange,CA,Passenger,3,1,4,572,576,0.69
February,28,2018,Santa Fe,NM,Passenger,0,1,1,43,44,2.27
February,28,2018,Grant,WA,Truck,0,0,0,25680,25680,0
February,28,2018,Pacific,WA,Truck,0,0,0,7561,7561,0
February,28,2018,Jefferson,NY,Passenger,1,0,1,227,228,0.44
February,28,2018,Cowlitz,WA,Passenger,54,70,124,70938,71062,0.17
February,28,2018,,,Passenger,5,2,7,709,716,0.98
February,28,2018,Juneau,AK,Passenger,0,1,1,43,44,2.27
February,28,2018,Clark,WA,Truck,0,0,0,78570,78570,0
February,28,2018,Klickitat,WA,Passenger,24,27,51,14944,14995,0.34
February,28,2018,Douglas,WA,Passenger,43,33,76,27316,27392,0.28
February,28,2018,Mason,WA,Passenger,64,80,144,45049,45193,0.32
February,28,2018,Canyon,ID,Passenger,0,1,1,95,96,1.04
February,28,2018,Hawaii,HI,Passenger,1,0,1,81,82,1.22
February,28,2018,DeKalb,IN,Passenger,1,0,1,1,2,50
February,28,2018,Benton,WA,Truck,0,0,0,40752,40752,0
February,28,2018,DeKalb,GA,Passenger,1,0,1,84,85,1.18
February,28,2018,Ramsey,MN,Passenger,1,0,1,37,38,2.63
February,28,2018,Orleans,LA,Passenger,0,1,1,47,48,2.08
February,28,2018,Prince William,VA,Passenger,0,4,4,268,272,1.47
February,28,2018,Okanogan,WA,Truck,0,0,0,16305,16305,0
February,28,2018,Monterey,CA,Passenger,0,2,2,194,196,1.02
February,28,2018,Thurston,WA,Truck,0,0,0,53921,53921,0
February,28,2018,Honolulu,HI,Passenger,2,2,4,555,559,0.72
February,28,2018,Whatcom,WA,Passenger,556,249,805,145579,146384,0.55
February,28,2018,Pend Oreille,WA,Passenger,4,3,7,9418,9425,0.07
February,28,2018,Prince George,VA,Passenger,0,1,1,74,75,1.33
February,28,2018,Wahkiakum,WA,Passenger,0,2,2,2860,2862,0.07
February,28,2018,Ferry,WA,Passenger,1,3,4,4396,4400,0.09
February,28,2018,Brevard,FL,Passenger,0,1,1,102,103,0.97
February,28,2018,Carroll,NH,Passenger,0,1,1,1,2,50
February,28,2018,Montgomery,PA,Passenger,1,0,1,35,36,2.78
February,28,2018,Lincoln,WA,Truck,0,0,0,4511,4511,0
February,28,2018,Douglas,WA,Truck,0,0,0,11812,11812,0
February,28,2018,Twin Falls,ID,Passenger,0,1,1,23,24,4.17
February,28,2018,Island,WA,Passenger,165,171,336,61877,62213,0.54
February,28,2018,Stevens,WA,Truck,0,0,0,18404,18404,0
February,28,2018,Shelby,TN,Passenger,0,1,1,105,106,0.94
February,28,2018,Jefferson,CO,Passenger,0,1,1,75,76,1.32
February,28,2018,Essex,NJ,Passenger,1,0,1,10,11,9.09
February,28,2018,El Paso,CO,Passenger,2,0,2,763,765,0.26
February,28,2018,Montgomery,TX,Passenger,1,0,1,62,63,1.59
February,28,2018,Pierce,WA,Passenger,1116,1028,2144,526413,528557,0.41
February,28,2018,Okanogan,WA,Passenger,7,19,26,25665,25691,0.1
February,28,2018,Virginia Beach,VA,Passenger,2,1,3,680,683,0.44
February,28,2018,San Juan,WA,Truck,0,0,0,5641,5641,0
February,28,2018,Ventura,CA,Passenger,0,1,1,333,334,0.3
February,28,2018,Kitsap,WA,Truck,1,0,1,52833,52834,0
February,28,2018,St. Clair,IL,Passenger,0,1,1,157,158,0.63
February,28,2018,Richland,SC,Passenger,0,1,1,172,173,0.58
February,28,2018,Lewis,WA,Passenger,52,45,97,56859,56956,0.17
February,28,2018,Ada,ID,Passenger,0,2,2,344,346,0.58
February,28,2018,Lee,AL,Passenger,1,0,1,34,35,2.86
February,28,2018,Sedgwick,KS,Passenger,0,1,1,103,104,0.96
February,28,2018,Morris,NJ,Passenger,1,0,1,19,20,5
February,28,2018,Snohomish,WA,Truck,1,0,1,121335,121336,0
February,28,2018,King,WA,Truck,8,1,9,184086,184095,0
February,28,2018,Walla Walla,WA,Truck,0,0,0,13323,13323,0
February,28,2018,San Juan,WA,Passenger,140,48,188,13922,14110,1.33
February,28,2018,Saratoga,NY,Passenger,1,1,2,67,69,2.9
February,28,2018,Pinal,AZ,Passenger,2,0,2,210,212,0.94
February,28,2018,Stevens,WA,Passenger,10,21,31,31515,31546,0.1
February,28,2018,Tarrant,TX,Passenger,1,0,1,224,225,0.44
February,28,2018,Volusia,FL,Passenger,0,1,1,34,35,2.86
February,28,2018,Pima,AZ,Passenger,1,1,2,412,414,0.48
February,28,2018,Charles,MD,Passenger,0,1,1,81,82,1.22
February,28,2018,King,WA,Passenger,11758,5019,16777,1368249,1385026,1.21
February,28,2018,Skamania,WA,Truck,0,0,0,3920,3920,0
February,28,2018,Asotin,WA,Truck,0,0,0,6580,6580,0
February,28,2018,Skamania,WA,Passenger,11,8,19,8624,8643,0.22
February,28,2018,Kittitas,WA,Truck,0,0,0,13948,13948,0
February,28,2018,Grays Harbor,WA,Passenger,42,44,86,45889,45975,0.19
February,28,2018,El Paso,TX,Passenger,1,0,1,522,523,0.19
February,28,2018,Norfolk,VA,Passenger,1,1,2,319,321,0.62
February,28,2018,Clallam,WA,Truck,0,0,0,21289,21289,0
February,28,2018,New London,CT,Passenger,1,1,2,252,254,0.79
February,28,2018,Lumpkin,GA,Passenger,1,0,1,7,8,12.5
February,28,2018,Hamilton,IN,Passenger,1,0,1,51,52,1.92
February,28,2018,Nassau,NY,Passenger,1,0,1,37,38,2.63
February,28,2018,San Diego,CA,Passenger,6,1,7,2566,2573,0.27
February,28,2018,Klickitat,WA,Truck,0,0,0,8038,8038,0
February,28,2018,Kittitas,WA,Passenger,36,27,63,28690,28753,0.22
January,31,2018,Polk,FL,Passenger,1,0,1,62,63,1.59
January,31,2018,Garfield,WA,Truck,0,0,0,945,945,0
January,31,2018,Walla Walla,WA,Truck,0,0,0,13323,13323,0
January,31,2018,Klickitat,WA,Truck,0,0,0,8000,8000,0
January,31,2018,Palm Beach,FL,Passenger,0,1,1,87,88,1.14
January,31,2018,Canyon,ID,Passenger,0,1,1,95,96,1.04
January,31,2018,Fairfax,VA,Passenger,2,2,4,821,825,0.48
January,31,2018,Hardin,KY,Passenger,0,1,1,118,119,0.84
January,31,2018,Multnomah,OR,Passenger,3,4,7,845,852,0.82
January,31,2018,Spokane,WA,Passenger,300,255,555,300795,301350,0.18
January,31,2018,Clark,WA,Truck,0,0,0,78578,78578,0
January,31,2018,Cowlitz,WA,Passenger,54,69,123,70972,71095,0.17
January,31,2018,Franklin,WA,Passenger,31,51,82,57013,57095,0.14
January,31,2018,Benton,WA,Passenger,175,179,354,130623,130977,0.27
January,31,2018,Pinal,AZ,Passenger,2,0,2,210,212,0.94
January,31,2018,Jefferson,NY,Passenger,1,0,1,228,229,0.44
January,31,2018,Skamania,WA,Passenger,11,8,19,8608,8627,0.22
January,31,2018,Okaloosa,FL,Passenger,1,0,1,179,180,0.56
January,31,2018,Franklin,MA,Passenger,0,1,1,3,4,25
January,31,2018,District of Columbia,DC,Passenger,0,3,3,198,201,1.49
January,31,2018,King,WA,Passenger,11619,4878,16497,1370831,1387328,1.19
January,31,2018,El Paso,CO,Passenger,2,0,2,762,764,0.26
January,31,2018,Grant,WA,Truck,0,0,0,25641,25641,0
January,31,2018,Pend Oreille,WA,Passenger,4,4,8,9441,9449,0.08
January,31,2018,Mason,WA,Truck,0,0,0,19646,19646,0
January,31,2018,Tuolumne,CA,Passenger,0,1,1,14,15,6.67
January,31,2018,Shelby,TN,Passenger,0,1,1,104,105,0.95
January,31,2018,Garfield,WA,Passenger,1,0,1,1329,1330,0.08
January,31,2018,Snohomish,WA,Passenger,2073,1094,3167,518066,521233,0.61
January,31,2018,Kittitas,WA,Passenger,36,27,63,28637,28700,0.22
January,31,2018,Clark,NV,Passenger,1,2,3,746,749,0.4
January,31,2018,Carroll,NH,Passenger,0,1,1,1,2,50
January,31,2018,Pierce,WA,Passenger,1095,996,2091,527421,529512,0.39
January,31,2018,Lewis,WA,Passenger,52,43,95,56805,56900,0.17
January,31,2018,Volusia,FL,Passenger,0,1,1,34,35,2.86
January,31,2018,Santa Rosa,FL,Passenger,1,0,1,102,103,0.97
January,31,2018,Essex,NJ,Passenger,1,0,1,10,11,9.09
January,31,2018,Richmond,GA,Passenger,0,1,1,93,94,1.06
January,31,2018,Sumter,FL,Passenger,0,1,1,10,11,9.09
January,31,2018,Santa Fe,NM,Passenger,0,1,1,44,45,2.22
January,31,2018,Manassas,VA,Passenger,0,1,1,9,10,10
January,31,2018,Orleans,LA,Passenger,0,1,1,46,47,2.13
January,31,2018,Travis,TX,Passenger,0,1,1,185,186,0.54
January,31,2018,Cook,IL,Passenger,1,0,1,284,285,0.35
January,31,2018,Kitsap,WA,Truck,1,0,1,52751,52752,0
January,31,2018,Morris,NJ,Passenger,1,0,1,20,21,4.76
January,31,2018,,,Passenger,5,2,7,710,717,0.98
January,31,2018,Spokane,WA,Truck,1,0,1,91739,91740,0
January,31,2018,Pacific,WA,Passenger,15,13,28,15453,15481,0.18
January,31,2018,Twin Falls,ID,Passenger,0,1,1,23,24,4.17
January,31,2018,Norfolk,VA,Passenger,1,1,2,316,318,0.63
January,31,2018,Whatcom,WA,Truck,1,0,1,42070,42071,0
January,31,2018,Bexar,TX,Passenger,1,2,3,813,816,0.37
January,31,2018,Lumpkin,GA,Passenger,1,0,1,7,8,12.5
January,31,2018,Wahkiakum,WA,Passenger,0,2,2,2844,2846,0.07
January,31,2018,Dale,AL,Passenger,0,1,1,66,67,1.49
January,31,2018,Chelan,WA,Truck,0,0,0,21676,21676,0
January,31,2018,Prince George's,MD,Passenger,0,1,1,179,180,0.56
January,31,2018,Jefferson,WA,Passenger,124,80,204,24352,24556,0.83
January,31,2018,Monterey,CA,Passenger,0,2,2,195,197,1.02
January,31,2018,Anne Arundel,MD,Passenger,0,1,1,471,472,0.21
January,31,2018,Honolulu,HI,Passenger,2,2,4,555,559,0.72
January,31,2018,Benton,WA,Truck,0,0,0,40708,40708,0
January,31,2018,St. Clair,IL,Passenger,0,1,1,159,160,0.62
January,31,2018,Skamania,WA,Truck,0,0,0,3900,3900,0
January,31,2018,Queens,NY,Passenger,1,0,1,62,63,1.59
January,31,2018,Portsmouth,VA,Passenger,0,1,1,71,72,1.39
January,31,2018,Pima,AZ,Passenger,1,1,2,412,414,0.48
January,31,2018,Klickitat,WA,Passenger,23,26,49,14933,14982,0.33
January,31,2018,Norfolk,MA,Passenger,1,0,1,36,37,2.7
January,31,2018,Asotin,WA,Passenger,8,5,13,12548,12561,0.1
January,31,2018,Lane,OR,Passenger,0,1,1,201,202,0.5
January,31,2018,Nantucket,MA,Passenger,1,0,1,3,4,25
January,31,2018,Jefferson,WA,Truck,0,0,0,9485,9485,0
January,31,2018,Missoula,MT,Passenger,1,0,1,68,69,1.45
January,31,2018,Allegheny,PA,Passenger,1,0,1,83,84,1.19
January,31,2018,Lincoln,WA,Truck,0,0,0,4504,4504,0
January,31,2018,Stevens,WA,Truck,0,0,0,18391,18391,0
January,31,2018,Stevens,WA,Passenger,10,22,32,31598,31630,0.1
January,31,2018,Northampton,PA,Passenger,0,1,1,65,66,1.52
January,31,2018,Frederick,MD,Passenger,0,1,1,90,91,1.1
January,31,2018,Gwinnett,GA,Passenger,0,1,1,81,82,1.22
January,31,2018,Arlington,VA,Passenger,1,2,3,172,175,1.71
January,31,2018,Okanogan,WA,Passenger,7,19,26,25706,25732,0.1
January,31,2018,Marin,CA,Passenger,1,0,1,56,57,1.75
January,31,2018,Asotin,WA,Truck,0,0,0,6559,6559,0
January,31,2018,Maricopa,AZ,Passenger,2,0,2,1621,1623,0.12
January,31,2018,Franklin,OH,Passenger,0,1,1,110,111,0.9
January,31,2018,Sangamon,IL,Passenger,1,0,1,11,12,8.33
January,31,2018,Santa Clara,CA,Passenger,7,1,8,389,397,2.02
January,31,2018,Thurston,WA,Passenger,487,407,894,190668,191562,0.47
January,31,2018,Albemarle,VA,Passenger,0,1,1,30,31,3.23
January,31,2018,Sedgwick,KS,Passenger,0,1,1,106,107,0.93
January,31,2018,Adams,WA,Truck,0,0,0,5148,5148,0
January,31,2018,Montgomery,TX,Passenger,1,0,1,61,62,1.61
January,31,2018,Manatee,FL,Passenger,1,0,1,39,40,2.5
January,31,2018,Riverside,CA,Passenger,1,2,3,731,734,0.41
January,31,2018,Okanogan,WA,Truck,0,0,0,16333,16333,0
January,31,2018,Wahkiakum,WA,Truck,0,0,0,1681,1681,0
January,31,2018,Ferry,WA,Truck,0,0,0,3544,3544,0
January,31,2018,Skagit,WA,Truck,1,0,1,31840,31841,0
January,31,2018,Thurston,WA,Truck,0,0,0,53893,53893,0
January,31,2018,Grays Harbor,WA,Truck,0,0,0,20089,20089,0
January,31,2018,Richland,SC,Passenger,0,1,1,173,174,0.57
January,31,2018,Alameda,CA,Passenger,0,1,1,358,359,0.28
January,31,2018,New London,CT,Passenger,1,1,2,251,253,0.79
January,31,2018,Kittitas,WA,Truck,0,0,0,13876,13876,0
January,31,2018,Lewis,WA,Truck,0,0,0,25325,25325,0
January,31,2018,Ferry,WA,Passenger,1,3,4,4408,4412,0.09
January,31,2018,Howard,MD,Passenger,0,2,2,87,89,2.25
January,31,2018,Duval,FL,Passenger,1,2,3,367,370,0.81
January,31,2018,Hamilton,IN,Passenger,1,0,1,53,54,1.85
January,31,2018,Moore,NC,Passenger,0,1,1,199,200,0.5
January,31,2018,Sacramento,CA,Passenger,1,0,1,303,304,0.33
January,31,2018,King,WA,Truck,8,1,9,184806,184815,0
January,31,2018,San Diego,CA,Passenger,6,1,7,2567,2574,0.27
January,31,2018,Brevard,FL,Passenger,0,1,1,102,103,0.97
January,31,2018,Clark,WA,Passenger,873,599,1472,305301,306773,0.48
January,31,2018,Contra Costa,CA,Passenger,0,1,1,469,470,0.21
January,31,2018,Hawaii,HI,Passenger,1,0,1,79,80,1.25
January,31,2018,Adams,WA,Passenger,4,4,8,12443,12451,0.06
January,31,2018,New Haven,CT,Passenger,0,1,1,53,54,1.85
January,31,2018,Pend Oreille,WA,Truck,0,0,0,5618,5618,0
January,31,2018,DeKalb,GA,Passenger,1,0,1,84,85,1.18
January,31,2018,Dakota,MN,Passenger,0,2,2,38,40,5
January,31,2018,Grant,WA,Passenger,29,37,66,62283,62349,0.11
January,31,2018,Fulton,GA,Passenger,1,0,1,106,107,0.93
January,31,2018,Skagit,WA,Passenger,170,140,310,89781,90091,0.34
January,31,2018,Cowlitz,WA,Truck,0,0,0,28201,28201,0
January,31,2018,Whitman,WA,Passenger,18,20,38,22475,22513,0.17
January,31,2018,Walla Walla,WA,Passenger,30,33,63,35373,35436,0.18
January,31,2018,Dallas,TX,Passenger,0,1,1,186,187,0.53
January,31,2018,Latah,ID,Passenger,0,1,1,76,77,1.3
January,31,2018,Utah,UT,Passenger,0,1,1,135,136,0.74
January,31,2018,El Paso,TX,Passenger,1,0,1,520,521,0.19
January,31,2018,Flathead,MT,Passenger,1,0,1,52,53,1.89
January,31,2018,Island,WA,Truck,0,0,0,20786,20786,0
January,31,2018,San Mateo,CA,Passenger,0,1,1,142,143,0.7
January,31,2018,Yakima,WA,Passenger,60,76,136,162512,162648,0.08
January,31,2018,Cape May,NJ,Passenger,0,1,1,22,23,4.35
January,31,2018,Mason,WA,Passenger,65,77,142,44977,45119,0.31
January,31,2018,Hamilton,TN,Passenger,1,0,1,21,22,4.55
January,31,2018,Douglas,WA,Truck,0,0,0,11790,11790,0
January,31,2018,Charles,MD,Passenger,0,1,1,82,83,1.2
January,31,2018,Nueces,TX,Passenger,1,1,2,95,97,2.06
January,31,2018,Los Angeles,CA,Passenger,5,3,8,1195,1203,0.67
January,31,2018,Yakima,WA,Truck,0,0,0,58106,58106,0
January,31,2018,Ventura,CA,Passenger,0,1,1,327,328,0.3
January,31,2018,Montgomery,TN,Passenger,1,0,1,270,271,0.37
January,31,2018,Saratoga,NY,Passenger,1,1,2,68,70,2.86
January,31,2018,Pierce,WA,Truck,0,0,0,137147,137147,0
January,31,2018,Lincoln,WA,Passenger,2,5,7,7587,7594,0.09
January,31,2018,Kitsap,WA,Passenger,706,402,1108,176404,177512,0.62
January,31,2018,Snohomish,WA,Truck,1,0,1,121550,121551,0
January,31,2018,Columbia,WA,Truck,0,0,0,1545,1545,0
January,31,2018,Grays Harbor,WA,Passenger,42,42,84,45972,46056,0.18
January,31,2018,San Juan,WA,Passenger,137,46,183,13927,14110,1.3
January,31,2018,DuPage,IL,Passenger,1,0,1,64,65,1.54
January,31,2018,Maui,HI,Passenger,1,0,1,66,67,1.49
January,31,2018,Clay,FL,Passenger,0,1,1,106,107,0.93
January,31,2018,Kent,MI,Passenger,0,1,1,35,36,2.78
January,31,2018,Tarrant,TX,Passenger,1,0,1,224,225,0.44
January,31,2018,Ada,ID,Passenger,0,1,1,348,349,0.29
January,31,2018,Whitman,WA,Truck,0,0,0,8472,8472,0
January,31,2018,Clallam,WA,Passenger,106,95,201,49281,49482,0.41
January,31,2018,Lee,AL,Passenger,1,0,1,35,36,2.78
January,31,2018,Whatcom,WA,Passenger,548,238,786,145510,146296,0.54
January,31,2018,Virginia Beach,VA,Passenger,2,1,3,673,676,0.44
January,31,2018,Chelan,WA,Passenger,94,38,132,53236,53368,0.25
January,31,2018,Douglas,WA,Passenger,43,33,76,27223,27299,0.28
January,31,2018,Orange,CA,Passenger,3,1,4,565,569,0.7
January,31,2018,St. Lucie,FL,Passenger,1,0,1,27,28,3.57
January,31,2018,Prince William,VA,Passenger,0,4,4,268,272,1.47
January,31,2018,Ramsey,MN,Passenger,1,0,1,39,40,2.5
January,31,2018,Clallam,WA,Truck,0,0,0,21280,21280,0
January,31,2018,Juneau,AK,Passenger,0,1,1,44,45,2.22
January,31,2018,Orange,FL,Passenger,2,1,3,166,169,1.78
January,31,2018,Pacific,WA,Truck,0,0,0,7534,7534,0
January,31,2018,Nassau,NY,Passenger,1,0,1,37,38,2.63
January,31,2018,Montgomery,MD,Passenger,1,0,1,298,299,0.33
January,31,2018,Island,WA,Passenger,159,167,326,61838,62164,0.52
January,31,2018,Prince George,VA,Passenger,0,1,1,74,75,1.33
January,31,2018,Columbia,WA,Passenger,2,1,3,2401,2404,0.12
January,31,2018,San Juan,WA,Truck,0,0,0,5644,5644,0
January,31,2018,Deschutes,OR,Passenger,1,0,1,178,179,0.56
January,31,2018,Montgomery,PA,Passenger,1,0,1,34,35,2.86
January,31,2018,Madison,ID,Passenger,1,0,1,39,40,2.5
January,31,2018,Franklin,WA,Truck,0,0,0,18563,18563,0
January,31,2018,DeKalb,IN,Passenger,1,0,1,1,2,50
July,31,2018,Whatcom,WA,Truck,2,0,2,42313,42315,0
July,31,2018,Nantucket,MA,Passenger,1,0,1,4,5,20
July,31,2018,Whatcom,WA,Passenger,637,318,955,147985,148940,0.64
July,31,2018,Skagit,WA,Truck,1,0,1,32118,32119,0
July,31,2018,Grays Harbor,WA,Truck,0,0,0,20227,20227,0
July,31,2018,Washington,OR,Passenger,0,1,1,479,480,0.21
July,31,2018,Pacific,WA,Truck,0,0,0,7611,7611,0
July,31,2018,Charles,MD,Passenger,0,1,1,82,83,1.2
July,31,2018,Okanogan,WA,Truck,0,0,0,16423,16423,0
July,31,2018,Stevens,WA,Passenger,11,25,36,31650,31686,0.11
July,31,2018,Jefferson,CO,Passenger,0,1,1,65,66,1.52
July,31,2018,Lane,OR,Passenger,0,1,1,184,185,0.54
July,31,2018,Hawaii,HI,Passenger,1,0,1,73,74,1.35
July,31,2018,Clay,FL,Passenger,0,1,1,92,93,1.08
July,31,2018,Lewis,WA,Truck,0,0,0,25583,25583,0
July,31,2018,Franklin,MA,Passenger,0,1,1,1,2,50
July,31,2018,Multnomah,OR,Passenger,3,4,7,791,798,0.88
July,31,2018,DeKalb,GA,Passenger,1,0,1,79,80,1.25
July,31,2018,Carson City,NV,Passenger,1,0,1,14,15,6.67
July,31,2018,Clackamas,OR,Passenger,0,1,1,216,217,0.46
July,31,2018,Island,WA,Truck,0,0,0,20994,20994,0
July,31,2018,Cowlitz,WA,Truck,0,0,0,28560,28560,0
July,31,2018,Los Angeles,CA,Passenger,7,4,11,1140,1151,0.96
July,31,2018,Benton,WA,Passenger,193,197,390,131733,132123,0.3
July,31,2018,Anne Arundel,MD,Passenger,0,1,1,450,451,0.22
July,31,2018,Spokane,WA,Truck,1,0,1,92869,92870,0
July,31,2018,Pima,AZ,Passenger,1,1,2,410,412,0.49
July,31,2018,Garfield,WA,Passenger,1,1,2,1320,1322,0.15
July,31,2018,Manassas,VA,Passenger,0,1,1,9,10,10
July,31,2018,Richland,SC,Passenger,0,1,1,169,170,0.59
July,31,2018,Lewis,WA,Passenger,83,59,142,57814,57956,0.25
July,31,2018,Manatee,FL,Passenger,1,0,1,37,38,2.63
July,31,2018,Morris,NJ,Passenger,1,0,1,16,17,5.88
July,31,2018,Grant,WA,Truck,0,0,0,25943,25943,0
July,31,2018,Virginia Beach,VA,Passenger,2,1,3,692,695,0.43
July,31,2018,Cowlitz,WA,Passenger,57,77,134,71871,72005,0.19
July,31,2018,Grant,WA,Passenger,33,47,80,63265,63345,0.13
July,31,2018,Columbia,WA,Truck,0,0,0,1530,1530,0
July,31,2018,Tarrant,TX,Passenger,1,0,1,218,219,0.46
July,31,2018,Allegheny,PA,Passenger,1,0,1,77,78,1.28
July,31,2018,San Mateo,CA,Passenger,1,1,2,130,132,1.52
July,31,2018,Ada,ID,Passenger,0,2,2,319,321,0.62
July,31,2018,Pierce,WA,Truck,0,0,0,138077,138077,0
July,31,2018,Queens,NY,Passenger,1,0,1,61,62,1.61
July,31,2018,Wahkiakum,WA,Truck,0,0,0,1681,1681,0
July,31,2018,Richmond,GA,Passenger,0,1,1,92,93,1.08
July,31,2018,Cochise,AZ,Passenger,0,1,1,119,120,0.83
July,31,2018,Klickitat,WA,Truck,0,0,0,8126,8126,0
July,31,2018,Jefferson,WA,Passenger,147,99,246,24581,24827,0.99
July,31,2018,Grays Harbor,WA,Passenger,54,62,116,46760,46876,0.25
July,31,2018,Yakima,WA,Passenger,65,93,158,163968,164126,0.1
July,31,2018,Skamania,WA,Truck,0,0,0,3960,3960,0
July,31,2018,Arlington,VA,Passenger,1,2,3,175,178,1.69
July,31,2018,Clark,WA,Passenger,1042,744,1786,308652,310438,0.58
July,31,2018,Shelby,TN,Passenger,0,1,1,102,103,0.97
July,31,2018,Ramsey,MN,Passenger,1,0,1,40,41,2.44
July,31,2018,Lincoln,WA,Passenger,3,6,9,7748,7757,0.12
July,31,2018,Hennepin,MN,Passenger,1,0,1,108,109,0.92
July,31,2018,Brevard,FL,Passenger,0,1,1,91,92,1.09
July,31,2018,Sangamon,IL,Passenger,1,0,1,11,12,8.33
July,31,2018,Washtenaw,MI,Passenger,1,0,1,38,39,2.56
July,31,2018,Jefferson,NY,Passenger,0,1,1,226,227,0.44
July,31,2018,San Juan,PR,Passenger,0,1,1,4,5,20
July,31,2018,Frederick,MD,Passenger,0,1,1,86,87,1.15
July,31,2018,Nueces,TX,Passenger,1,1,2,89,91,2.2
July,31,2018,Carroll,NH,Passenger,0,1,1,1,2,50
July,31,2018,Tuolumne,CA,Passenger,0,1,1,11,12,8.33
July,31,2018,King,WA,Passenger,13479,5802,19281,1372470,1391751,1.39
July,31,2018,Montgomery,PA,Passenger,2,0,2,34,36,5.56
July,31,2018,Adams,WA,Passenger,5,5,10,12641,12651,0.08
July,31,2018,Honolulu,HI,Passenger,1,2,3,525,528,0.57
July,31,2018,Pinal,AZ,Passenger,2,0,2,204,206,0.97
July,31,2018,Thurston,WA,Truck,0,0,0,54414,54414,0
July,31,2018,Jefferson,WA,Truck,0,0,0,9588,9588,0
July,31,2018,Moore,NC,Passenger,0,1,1,197,198,0.51
July,31,2018,Lee,AL,Passenger,1,0,1,37,38,2.63
July,31,2018,Franklin,WA,Passenger,38,66,104,58177,58281,0.18
July,31,2018,Beaufort,SC,Passenger,1,0,1,37,38,2.63
July,31,2018,Whitman,WA,Truck,0,0,0,8496,8496,0
July,31,2018,Montgomery,TX,Passenger,1,0,1,62,63,1.59
July,31,2018,Twin Falls,ID,Passenger,0,1,1,23,24,4.17
July,31,2018,Island,WA,Passenger,206,194,400,62580,62980,0.64
July,31,2018,Ferry,WA,Truck,0,0,0,3535,3535,0
July,31,2018,New London,CT,Passenger,0,1,1,250,251,0.4
July,31,2018,Kootenai,ID,Passenger,0,1,1,220,221,0.45
July,31,2018,Orleans,LA,Passenger,0,1,1,47,48,2.08
July,31,2018,Charleston,SC,Passenger,1,0,1,128,129,0.78
July,31,2018,Gwinnett,GA,Passenger,0,1,1,82,83,1.2
July,31,2018,Volusia,FL,Passenger,0,1,1,32,33,3.03
July,31,2018,Monroe,IL,Passenger,1,0,1,5,6,16.67
July,31,2018,District of Columbia,DC,Passenger,0,3,3,192,195,1.54
July,31,2018,Madison,ID,Passenger,1,0,1,40,41,2.44
July,31,2018,Collin,TX,Passenger,1,0,1,155,156,0.64
July,31,2018,Franklin,WA,Truck,0,0,0,18741,18741,0
July,31,2018,Lumpkin,GA,Passenger,1,0,1,7,8,12.5
July,31,2018,Fulton,GA,Passenger,1,2,3,106,109,2.75
July,31,2018,Chelan,WA,Truck,0,0,0,21950,21950,0
July,31,2018,Skagit,WA,Passenger,215,171,386,90712,91098,0.42
July,31,2018,Riverside,CA,Passenger,2,2,4,693,697,0.57
July,31,2018,Thurston,WA,Passenger,577,497,1074,193753,194827,0.55
July,31,2018,San Juan,WA,Passenger,149,62,211,14115,14326,1.47
July,31,2018,Sedgwick,KS,Passenger,0,1,1,99,100,1
July,31,2018,Douglas,WA,Passenger,43,32,75,27719,27794,0.27
July,31,2018,San Diego,CA,Passenger,7,1,8,2569,2577,0.31
July,31,2018,Montgomery,MD,Passenger,1,0,1,285,286,0.35
July,31,2018,Alameda,CA,Passenger,0,1,1,343,344,0.29
July,31,2018,Caddo,LA,Passenger,0,1,1,22,23,4.35
July,31,2018,Skamania,WA,Passenger,13,9,22,8635,8657,0.25
July,31,2018,Palm Beach,FL,Passenger,0,1,1,85,86,1.16
July,31,2018,Pend Oreille,WA,Passenger,5,5,10,9578,9588,0.1
July,31,2018,Santa Clara,CA,Passenger,7,0,7,372,379,1.85
July,31,2018,Washoe,NV,Passenger,1,0,1,119,120,0.83
July,31,2018,Mason,WA,Truck,0,0,0,20051,20051,0
July,31,2018,DuPage,IL,Passenger,1,0,1,61,62,1.61
July,31,2018,Mason,WA,Passenger,87,93,180,45864,46044,0.39
July,31,2018,Essex,NJ,Passenger,1,0,1,11,12,8.33
July,31,2018,Cook,IL,Passenger,1,0,1,257,258,0.39
July,31,2018,Santa Fe,NM,Passenger,0,1,1,44,45,2.22
July,31,2018,St. Lucie,FL,Passenger,1,0,1,29,30,3.33
July,31,2018,Ventura,CA,Passenger,0,2,2,312,314,0.64
July,31,2018,,,Passenger,5,2,7,740,747,0.94
July,31,2018,Stevens,WA,Truck,0,0,0,18650,18650,0
July,31,2018,Hamilton,IN,Passenger,1,0,1,46,47,2.13
July,31,2018,Klickitat,WA,Passenger,24,31,55,15220,15275,0.36
July,31,2018,Howard,MD,Passenger,0,1,1,87,88,1.14
July,31,2018,San Juan,WA,Truck,0,0,0,5730,5730,0
July,31,2018,Kitsap,WA,Truck,1,0,1,53372,53373,0
July,31,2018,Marion,IN,Passenger,1,0,1,118,119,0.84
July,31,2018,Pierce,WA,Passenger,1262,1194,2456,533502,535958,0.46
July,31,2018,Lincoln,WA,Truck,0,0,0,4557,4557,0
July,31,2018,Snohomish,WA,Passenger,2404,1295,3699,522666,526365,0.7
July,31,2018,Saratoga,NY,Passenger,1,1,2,63,65,3.08
July,31,2018,Asotin,WA,Passenger,11,8,19,12637,12656,0.15
July,31,2018,Deschutes,OR,Passenger,1,0,1,165,166,0.6
July,31,2018,Kitsap,WA,Passenger,809,473,1282,178849,180131,0.71
July,31,2018,King,WA,Truck,7,1,8,182983,182991,0
July,31,2018,Bexar,TX,Passenger,2,4,6,741,747,0.8
July,31,2018,Asotin,WA,Truck,0,0,0,6628,6628,0
July,31,2018,San Francisco,CA,Passenger,1,1,2,124,126,1.59
July,31,2018,Pend Oreille,WA,Truck,0,0,0,5699,5699,0
July,31,2018,Pacific,WA,Passenger,19,21,40,15621,15661,0.26
July,31,2018,Polk,FL,Passenger,1,0,1,65,66,1.52
July,31,2018,Walla Walla,WA,Passenger,34,44,78,35739,35817,0.22
July,31,2018,Benton,WA,Truck,0,0,0,41093,41093,0
July,31,2018,Santa Rosa,FL,Passenger,1,0,1,94,95,1.05
July,31,2018,Monterey,CA,Passenger,0,1,1,184,185,0.54
July,31,2018,Contra Costa,CA,Passenger,0,1,1,449,450,0.22
July,31,2018,Garfield,OK,Passenger,1,0,1,16,17,5.88
July,31,2018,Nassau,NY,Passenger,2,0,2,37,39,5.13
July,31,2018,DeKalb,IN,Passenger,1,0,1,1,2,50
July,31,2018,Snohomish,WA,Truck,1,0,1,121679,121680,0
July,31,2018,Hardin,KY,Passenger,0,1,1,120,121,0.83
July,31,2018,Walla Walla,WA,Truck,0,0,0,13467,13467,0
July,31,2018,Cape May,NJ,Passenger,0,1,1,21,22,4.55
July,31,2018,Marin,CA,Passenger,1,0,1,55,56,1.79
July,31,2018,Orange,CA,Passenger,4,1,5,553,558,0.9
July,31,2018,Prince William,VA,Passenger,0,4,4,264,268,1.49
July,31,2018,Wahkiakum,WA,Passenger,1,1,2,2938,2940,0.07
July,31,2018,Norfolk,MA,Passenger,1,0,1,38,39,2.56
July,31,2018,Clallam,WA,Truck,0,0,0,21477,21477,0
July,31,2018,El Paso,CO,Passenger,2,1,3,755,758,0.4
July,31,2018,Broward,FL,Passenger,1,1,2,131,133,1.5
July,31,2018,Chelan,WA,Passenger,112,52,164,53574,53738,0.31
July,31,2018,Maui,HI,Passenger,1,0,1,55,56,1.79
July,31,2018,Lee,FL,Passenger,1,0,1,57,58,1.72
July,31,2018,Juneau,AK,Passenger,0,1,1,48,49,2.04
July,31,2018,St. Clair,IL,Passenger,0,1,1,152,153,0.65
July,31,2018,Sumter,FL,Passenger,0,1,1,10,11,9.09
July,31,2018,Spokane,WA,Passenger,347,320,667,304017,304684,0.22
July,31,2018,Columbia,WA,Passenger,2,2,4,2419,2423,0.17
July,31,2018,Clark,WA,Truck,0,0,0,79240,79240,0
July,31,2018,Portsmouth,VA,Passenger,0,1,1,72,73,1.37
July,31,2018,Maricopa,AZ,Passenger,2,1,3,1570,1573,0.19
July,31,2018,New Haven,CT,Passenger,0,1,1,48,49,2.04
July,31,2018,Prince George,VA,Passenger,0,1,1,76,77,1.3
July,31,2018,Douglas,NE,Passenger,0,1,1,71,72,1.39
July,31,2018,Orange,FL,Passenger,2,1,3,172,175,1.71
July,31,2018,Prince George's,MD,Passenger,1,1,2,185,187,1.07
July,31,2018,Flathead,MT,Passenger,1,0,1,49,50,2
July,31,2018,Williamson,TX,Passenger,0,1,1,161,162,0.62
July,31,2018,Duval,FL,Passenger,1,2,3,383,386,0.78
July,31,2018,Norfolk,VA,Passenger,2,2,4,328,332,1.2
July,31,2018,Kent,MI,Passenger,0,1,1,28,29,3.45
July,31,2018,Camden,NJ,Passenger,0,1,1,32,33,3.03
July,31,2018,Fairfax,VA,Passenger,2,2,4,832,836,0.48
July,31,2018,St. Mary's,MD,Passenger,1,0,1,217,218,0.46
July,31,2018,El Paso,TX,Passenger,1,0,1,509,510,0.2
July,31,2018,Garfield,WA,Truck,0,0,0,956,956,0
July,31,2018,Tulsa,OK,Passenger,1,1,2,47,49,4.08
July,31,2018,Travis,TX,Passenger,0,1,1,191,192,0.52
July,31,2018,Yakima,WA,Truck,0,0,0,58542,58542,0
July,31,2018,Utah,UT,Passenger,0,1,1,133,134,0.75
July,31,2018,Ferry,WA,Passenger,3,3,6,4424,4430,0.14
July,31,2018,Clallam,WA,Passenger,127,111,238,49977,50215,0.47
July,31,2018,Kittitas,WA,Truck,0,0,0,14053,14053,0
July,31,2018,Dale,AL,Passenger,0,1,1,59,60,1.67
July,31,2018,Adams,WA,Truck,0,0,0,5161,5161,0
July,31,2018,Kittitas,WA,Passenger,48,32,80,28990,29070,0.28
July,31,2018,Dakota,MN,Passenger,0,2,2,35,37,5.41
July,31,2018,Douglas,WA,Truck,0,0,0,11970,11970,0
July,31,2018,Clark,NV,Passenger,1,2,3,739,742,0.4
July,31,2018,Latah,ID,Passenger,0,1,1,72,73,1.37
July,31,2018,Okanogan,WA,Passenger,9,20,29,26029,26058,0.11
July,31,2018,Whitman,WA,Passenger,19,28,47,22658,22705,0.21
July,31,2018,Klamath,OR,Passenger,1,0,1,35,36,2.78
July,31,2018,Dallas,TX,Passenger,0,1,1,193,194,0.52
June,30,2018,Spokane,WA,Passenger,340,316,656,303132,303788,0.22
June,30,2018,Norfolk,MA,Passenger,1,0,1,38,39,2.56
June,30,2018,Garfield,WA,Truck,0,0,0,950,950,0
June,30,2018,Lewis,WA,Truck,0,0,0,25481,25481,0
June,30,2018,DeKalb,GA,Passenger,1,0,1,80,81,1.23
June,30,2018,Dale,AL,Passenger,0,1,1,58,59,1.69
June,30,2018,Clark,NV,Passenger,1,2,3,742,745,0.4
June,30,2018,Volusia,FL,Passenger,0,1,1,33,34,2.94
June,30,2018,Lumpkin,GA,Passenger,1,0,1,7,8,12.5
June,30,2018,Pierce,WA,Passenger,1228,1173,2401,532275,534676,0.45
June,30,2018,District of Columbia,DC,Passenger,0,3,3,188,191,1.57
June,30,2018,Clallam,WA,Truck,0,0,0,21442,21442,0
June,30,2018,Hardin,KY,Passenger,0,1,1,120,121,0.83
June,30,2018,Bexar,TX,Passenger,2,4,6,750,756,0.79
June,30,2018,Nantucket,MA,Passenger,1,0,1,4,5,20
June,30,2018,Jefferson,WA,Truck,0,0,0,9548,9548,0
June,30,2018,Moore,NC,Passenger,0,1,1,194,195,0.51
June,30,2018,King,WA,Passenger,13167,5678,18845,1371166,1390011,1.36
June,30,2018,Richland,SC,Passenger,0,1,1,169,170,0.59
June,30,2018,Multnomah,OR,Passenger,3,4,7,801,808,0.87
June,30,2018,Tuolumne,CA,Passenger,0,1,1,11,12,8.33
June,30,2018,Skagit,WA,Truck,1,0,1,32042,32043,0
June,30,2018,Lincoln,WA,Truck,0,0,0,4559,4559,0
June,30,2018,Camden,NJ,Passenger,0,1,1,33,34,2.94
June,30,2018,Clark,WA,Passenger,1009,719,1728,307969,309697,0.56
June,30,2018,Contra Costa,CA,Passenger,0,1,1,452,453,0.22
June,30,2018,Santa Clara,CA,Passenger,7,0,7,375,382,1.83
June,30,2018,Lee,AL,Passenger,1,0,1,35,36,2.78
June,30,2018,Los Angeles,CA,Passenger,7,4,11,1150,1161,0.95
June,30,2018,Maricopa,AZ,Passenger,2,1,3,1583,1586,0.19
June,30,2018,Santa Rosa,FL,Passenger,1,0,1,96,97,1.03
June,30,2018,Pierce,WA,Truck,0,0,0,137831,137831,0
June,30,2018,Manatee,FL,Passenger,1,0,1,37,38,2.63
June,30,2018,Flathead,MT,Passenger,1,0,1,50,51,1.96
June,30,2018,Broward,FL,Passenger,1,1,2,131,133,1.5
June,30,2018,Wahkiakum,WA,Passenger,1,2,3,2915,2918,0.1
June,30,2018,Island,WA,Passenger,197,188,385,62531,62916,0.61
June,30,2018,Tarrant,TX,Passenger,1,0,1,219,220,0.45
June,30,2018,Alameda,CA,Passenger,0,1,1,347,348,0.29
June,30,2018,Orange,FL,Passenger,2,1,3,174,177,1.69
June,30,2018,Pima,AZ,Passenger,1,1,2,411,413,0.48
June,30,2018,Adams,WA,Passenger,5,5,10,12616,12626,0.08
June,30,2018,Dakota,MN,Passenger,0,2,2,38,40,5
June,30,2018,Beaufort,SC,Passenger,1,0,1,38,39,2.56
June,30,2018,Allegheny,PA,Passenger,1,0,1,77,78,1.28
June,30,2018,Garfield,WA,Passenger,1,1,2,1316,1318,0.15
June,30,2018,Saratoga,NY,Passenger,1,1,2,64,66,3.03
June,30,2018,Sacramento,CA,Passenger,1,0,1,299,300,0.33
June,30,2018,Lewis,WA,Passenger,80,59,139,57688,57827,0.24
June,30,2018,Snohomish,WA,Truck,1,0,1,121653,121654,0
June,30,2018,Franklin,WA,Truck,0,0,0,18663,18663,0
June,30,2018,Ferry,WA,Passenger,3,3,6,4425,4431,0.14
June,30,2018,Hennepin,MN,Passenger,1,0,1,108,109,0.92
June,30,2018,DeKalb,IN,Passenger,1,0,1,1,2,50
June,30,2018,Stevens,WA,Passenger,11,25,36,31637,31673,0.11
June,30,2018,Pacific,WA,Passenger,17,20,37,15572,15609,0.24
June,30,2018,Cook,IL,Passenger,1,0,1,265,266,0.38
June,30,2018,Columbia,WA,Passenger,2,2,4,2424,2428,0.16
June,30,2018,New Haven,CT,Passenger,0,1,1,49,50,2
June,30,2018,Anne Arundel,MD,Passenger,0,1,1,449,450,0.22
June,30,2018,Dallas,TX,Passenger,0,1,1,191,192,0.52
June,30,2018,Fulton,GA,Passenger,1,1,2,101,103,1.94
June,30,2018,Fairfax,VA,Passenger,2,2,4,831,835,0.48
June,30,2018,Douglas,WA,Truck,0,0,0,11947,11947,0
June,30,2018,Franklin,MA,Passenger,0,1,1,1,2,50
June,30,2018,Manassas,VA,Passenger,0,1,1,9,10,10
June,30,2018,Orange,CA,Passenger,4,1,5,556,561,0.89
June,30,2018,Kitsap,WA,Truck,1,0,1,53204,53205,0
June,30,2018,Canyon,ID,Passenger,0,1,1,91,92,1.09
June,30,2018,Monroe,IL,Passenger,1,0,1,5,6,16.67
June,30,2018,Queens,NY,Passenger,1,0,1,61,62,1.61
June,30,2018,Kootenai,ID,Passenger,0,1,1,219,220,0.45
June,30,2018,Thurston,WA,Truck,0,0,0,54326,54326,0
June,30,2018,Richmond,GA,Passenger,0,1,1,90,91,1.1
June,30,2018,San Francisco,CA,Passenger,1,1,2,129,131,1.53
June,30,2018,Klamath,OR,Passenger,1,0,1,35,36,2.78
June,30,2018,Washtenaw,MI,Passenger,1,0,1,38,39,2.56
June,30,2018,Caddo,LA,Passenger,0,1,1,23,24,4.17
June,30,2018,Stevens,WA,Truck,0,0,0,18609,18609,0
June,30,2018,Okanogan,WA,Passenger,9,19,28,25958,25986,0.11
June,30,2018,Gwinnett,GA,Passenger,0,1,1,81,82,1.22
June,30,2018,Carroll,NH,Passenger,0,1,1,1,2,50
June,30,2018,Mason,WA,Truck,0,0,0,19955,19955,0
June,30,2018,Tulsa,OK,Passenger,0,1,1,48,49,2.04
June,30,2018,Ramsey,MN,Passenger,1,0,1,39,40,2.5
June,30,2018,Kittitas,WA,Truck,0,0,0,14056,14056,0
June,30,2018,Norfolk,VA,Passenger,2,2,4,329,333,1.2
June,30,2018,Garfield,OK,Passenger,1,0,1,17,18,5.56
June,30,2018,Lane,OR,Passenger,0,1,1,184,185,0.54
June,30,2018,Prince William,VA,Passenger,0,4,4,263,267,1.5
June,30,2018,St. Mary's,MD,Passenger,1,0,1,216,217,0.46
June,30,2018,Skagit,WA,Passenger,206,166,372,90487,90859,0.41
June,30,2018,San Diego,CA,Passenger,7,1,8,2582,2590,0.31
June,30,2018,El Paso,TX,Passenger,1,0,1,518,519,0.19
June,30,2018,Madison,ID,Passenger,1,0,1,39,40,2.5
June,30,2018,Ferry,WA,Truck,0,0,0,3512,3512,0
June,30,2018,Chelan,WA,Passenger,110,53,163,53555,53718,0.3
June,30,2018,Mason,WA,Passenger,82,92,174,45712,45886,0.38
June,30,2018,Okanogan,WA,Truck,0,0,0,16431,16431,0
June,30,2018,Clay,FL,Passenger,0,1,1,94,95,1.05
June,30,2018,Grays Harbor,WA,Truck,0,0,0,20226,20226,0
June,30,2018,Kittitas,WA,Passenger,47,32,79,28926,29005,0.27
June,30,2018,Hamilton,IN,Passenger,1,0,1,46,47,2.13
June,30,2018,Yakima,WA,Truck,0,0,0,58487,58487,0
June,30,2018,Ada,ID,Passenger,0,2,2,322,324,0.62
June,30,2018,Duval,FL,Passenger,1,2,3,382,385,0.78
June,30,2018,Maui,HI,Passenger,1,0,1,55,56,1.79
June,30,2018,Hawaii,HI,Passenger,1,0,1,71,72,1.39
June,30,2018,Charleston,SC,Passenger,1,0,1,125,126,0.79
June,30,2018,Yakima,WA,Passenger,60,88,148,163780,163928,0.09
June,30,2018,Asotin,WA,Passenger,9,6,15,12602,12617,0.12
June,30,2018,Nassau,NY,Passenger,2,0,2,37,39,5.13
June,30,2018,Grant,WA,Passenger,31,45,76,63139,63215,0.12
June,30,2018,Whatcom,WA,Passenger,631,301,932,147658,148590,0.63
June,30,2018,Sedgwick,KS,Passenger,0,1,1,99,100,1
June,30,2018,New London,CT,Passenger,0,1,1,252,253,0.4
June,30,2018,Pend Oreille,WA,Truck,0,0,0,5682,5682,0
June,30,2018,Montgomery,PA,Passenger,2,0,2,34,36,5.56
June,30,2018,Kitsap,WA,Passenger,796,460,1256,178527,179783,0.7
June,30,2018,Charles,MD,Passenger,0,1,1,82,83,1.2
June,30,2018,Whitman,WA,Passenger,19,28,47,22602,22649,0.21
June,30,2018,St. Lucie,FL,Passenger,1,0,1,28,29,3.45
June,30,2018,Pend Oreille,WA,Passenger,5,5,10,9547,9557,0.1
June,30,2018,Arlington,VA,Passenger,1,2,3,172,175,1.71
June,30,2018,Northampton,PA,Passenger,0,1,1,66,67,1.49
June,30,2018,Riverside,CA,Passenger,2,2,4,699,703,0.57
June,30,2018,Frederick,MD,Passenger,0,1,1,85,86,1.16
June,30,2018,Shelby,TN,Passenger,0,1,1,102,103,0.97
June,30,2018,San Mateo,CA,Passenger,1,1,2,131,133,1.5
June,30,2018,Juneau,AK,Passenger,0,1,1,47,48,2.08
June,30,2018,Morris,NJ,Passenger,1,0,1,18,19,5.26
June,30,2018,Columbia,WA,Truck,0,0,0,1527,1527,0
June,30,2018,Marin,CA,Passenger,1,0,1,55,56,1.79
June,30,2018,San Juan,WA,Passenger,145,61,206,14069,14275,1.44
June,30,2018,Nueces,TX,Passenger,1,1,2,89,91,2.2
June,30,2018,Collin,TX,Passenger,1,0,1,153,154,0.65
June,30,2018,Lincoln,WA,Passenger,2,6,8,7685,7693,0.1
June,30,2018,,,Passenger,5,2,7,720,727,0.96
June,30,2018,Deschutes,OR,Passenger,1,0,1,168,169,0.59
June,30,2018,Monterey,CA,Passenger,0,1,1,185,186,0.54
June,30,2018,Benton,WA,Truck,0,0,0,41024,41024,0
June,30,2018,Marion,IN,Passenger,1,0,1,117,118,0.85
June,30,2018,Klickitat,WA,Passenger,25,30,55,15166,15221,0.36
June,30,2018,Prince George,VA,Passenger,0,1,1,74,75,1.33
June,30,2018,Chelan,WA,Truck,0,0,0,21872,21872,0
June,30,2018,Virginia Beach,VA,Passenger,2,1,3,689,692,0.43
June,30,2018,Okaloosa,FL,Passenger,1,0,1,171,172,0.58
June,30,2018,Essex,NJ,Passenger,1,0,1,11,12,8.33
June,30,2018,Pinal,AZ,Passenger,2,0,2,204,206,0.97
June,30,2018,Cowlitz,WA,Passenger,55,74,129,71731,71860,0.18
June,30,2018,Adams,WA,Truck,0,0,0,5165,5165,0
June,30,2018,Portsmouth,VA,Passenger,0,1,1,73,74,1.35
June,30,2018,Kent,MI,Passenger,0,1,1,27,28,3.57
June,30,2018,Orleans,LA,Passenger,0,1,1,47,48,2.08
June,30,2018,Howard,MD,Passenger,0,1,1,88,89,1.12
June,30,2018,Santa Fe,NM,Passenger,0,1,1,43,44,2.27
June,30,2018,Benton,WA,Passenger,192,199,391,131476,131867,0.3
June,30,2018,Skamania,WA,Truck,0,0,0,3946,3946,0
June,30,2018,Montgomery,MD,Passenger,1,0,1,284,285,0.35
June,30,2018,Montgomery,TX,Passenger,1,0,1,63,64,1.56
June,30,2018,Brevard,FL,Passenger,0,1,1,94,95,1.05
June,30,2018,St. Clair,IL,Passenger,0,1,1,153,154,0.65
June,30,2018,King,WA,Truck,7,1,8,183054,183062,0
June,30,2018,Klickitat,WA,Truck,0,0,0,8117,8117,0
June,30,2018,Grays Harbor,WA,Passenger,52,58,110,46575,46685,0.24
June,30,2018,Walla Walla,WA,Truck,0,0,0,13416,13416,0
June,30,2018,Pacific,WA,Truck,0,0,0,7600,7600,0
June,30,2018,Polk,FL,Passenger,1,0,1,66,67,1.49
June,30,2018,Wahkiakum,WA,Truck,0,0,0,1675,1675,0
June,30,2018,Clackamas,OR,Passenger,0,1,1,226,227,0.44
June,30,2018,Jefferson,CO,Passenger,0,1,1,65,66,1.52
June,30,2018,Sumter,FL,Passenger,0,1,1,9,10,10
June,30,2018,Travis,TX,Passenger,0,1,1,187,188,0.53
June,30,2018,San Juan,WA,Truck,0,0,0,5713,5713,0
June,30,2018,Franklin,WA,Passenger,39,66,105,57858,57963,0.18
June,30,2018,Clark,WA,Truck,0,0,0,79122,79122,0
June,30,2018,Whitman,WA,Truck,0,0,0,8493,8493,0
June,30,2018,El Paso,CO,Passenger,2,1,3,752,755,0.4
June,30,2018,Cowlitz,WA,Truck,0,0,0,28460,28460,0
June,30,2018,Asotin,WA,Truck,0,0,0,6616,6616,0
June,30,2018,Cochise,AZ,Passenger,0,1,1,122,123,0.81
June,30,2018,Walla Walla,WA,Passenger,34,43,77,35660,35737,0.22
June,30,2018,Douglas,WA,Passenger,43,31,74,27649,27723,0.27
June,30,2018,Cape May,NJ,Passenger,0,1,1,21,22,4.55
June,30,2018,Washoe,NV,Passenger,1,0,1,118,119,0.84
June,30,2018,Island,WA,Truck,0,0,0,20955,20955,0
June,30,2018,Skamania,WA,Passenger,11,9,20,8660,8680,0.23
June,30,2018,Latah,ID,Passenger,0,1,1,74,75,1.33
June,30,2018,Jefferson,WA,Passenger,144,97,241,24453,24694,0.98
June,30,2018,Grant,WA,Truck,0,0,0,25921,25921,0
June,30,2018,DuPage,IL,Passenger,1,0,1,62,63,1.59
June,30,2018,Lee,FL,Passenger,1,0,1,56,57,1.75
June,30,2018,Utah,UT,Passenger,0,1,1,132,133,0.75
June,30,2018,Spokane,WA,Truck,1,0,1,92636,92637,0
June,30,2018,Clallam,WA,Passenger,124,112,236,49911,50147,0.47
June,30,2018,Sangamon,IL,Passenger,1,0,1,11,12,8.33
June,30,2018,Snohomish,WA,Passenger,2349,1262,3611,521519,525130,0.69
June,30,2018,Washington,OR,Passenger,0,1,1,480,481,0.21
June,30,2018,Honolulu,HI,Passenger,1,2,3,523,526,0.57
June,30,2018,Palm Beach,FL,Passenger,0,1,1,83,84,1.19
June,30,2018,Prince George's,MD,Passenger,1,1,2,184,186,1.08
June,30,2018,Ventura,CA,Passenger,0,2,2,321,323,0.62
June,30,2018,Twin Falls,ID,Passenger,0,1,1,22,23,4.35
June,30,2018,Thurston,WA,Passenger,572,481,1053,193030,194083,0.54
June,30,2018,Williamson,TX,Passenger,0,1,1,161,162,0.62
June,30,2018,Jefferson,NY,Passenger,0,1,1,223,224,0.45
June,30,2018,Whatcom,WA,Truck,2,0,2,42285,42287,0
March,31,2018,Kittitas,WA,Truck,0,0,0,13984,13984,0
March,31,2018,Thurston,WA,Passenger,518,432,950,191158,192108,0.49
March,31,2018,Hardin,KY,Passenger,0,1,1,118,119,0.84
March,31,2018,Los Angeles,CA,Passenger,5,4,9,1180,1189,0.76
March,31,2018,Pend Oreille,WA,Passenger,4,3,7,9455,9462,0.07
March,31,2018,El Paso,CO,Passenger,2,0,2,753,755,0.26
March,31,2018,DuPage,IL,Passenger,1,0,1,65,66,1.52
March,31,2018,Okanogan,WA,Truck,0,0,0,16333,16333,0
March,31,2018,Chelan,WA,Truck,0,0,0,21720,21720,0
March,31,2018,,,Passenger,4,2,6,711,717,0.84
March,31,2018,Anne Arundel,MD,Passenger,0,2,2,466,468,0.43
March,31,2018,Cowlitz,WA,Truck,0,0,0,28271,28271,0
March,31,2018,Saratoga,NY,Passenger,1,1,2,66,68,2.94
March,31,2018,Pinal,AZ,Passenger,2,0,2,209,211,0.95
March,31,2018,Cowlitz,WA,Passenger,55,70,125,71222,71347,0.18
March,31,2018,Stevens,WA,Truck,0,0,0,18427,18427,0
March,31,2018,Whatcom,WA,Truck,2,0,2,42069,42071,0
March,31,2018,Orleans,LA,Passenger,0,1,1,46,47,2.13
March,31,2018,Pierce,WA,Passenger,1126,1053,2179,527857,530036,0.41
March,31,2018,Flathead,MT,Passenger,1,0,1,51,52,1.92
March,31,2018,Montgomery,MD,Passenger,1,0,1,296,297,0.34
March,31,2018,Ferry,WA,Passenger,1,3,4,4404,4408,0.09
March,31,2018,Walla Walla,WA,Truck,0,0,0,13311,13311,0
March,31,2018,Pierce,WA,Truck,0,0,0,137102,137102,0
March,31,2018,Lewis,WA,Truck,0,0,0,25255,25255,0
March,31,2018,Lumpkin,GA,Passenger,1,0,1,7,8,12.5
March,31,2018,Santa Clara,CA,Passenger,6,1,7,377,384,1.82
March,31,2018,Riverside,CA,Passenger,2,2,4,706,710,0.56
March,31,2018,Ferry,WA,Truck,0,0,0,3504,3504,0
March,31,2018,San Mateo,CA,Passenger,1,1,2,135,137,1.46
March,31,2018,DeKalb,GA,Passenger,1,0,1,81,82,1.22
March,31,2018,Canyon,ID,Passenger,0,1,1,94,95,1.05
March,31,2018,Douglas,WA,Passenger,42,33,75,27415,27490,0.27
March,31,2018,Dale,AL,Passenger,0,1,1,62,63,1.59
March,31,2018,Monterey,CA,Passenger,0,2,2,190,192,1.04
March,31,2018,Jefferson,WA,Passenger,132,88,220,24289,24509,0.9
March,31,2018,Montgomery,TX,Passenger,1,0,1,63,64,1.56
March,31,2018,Nueces,TX,Passenger,1,1,2,94,96,2.08
March,31,2018,Twin Falls,ID,Passenger,0,1,1,24,25,4
March,31,2018,Charles,MD,Passenger,0,1,1,81,82,1.22
March,31,2018,Columbia,WA,Truck,0,0,0,1532,1532,0
March,31,2018,Montgomery,PA,Passenger,1,0,1,35,36,2.78
March,31,2018,Kittitas,WA,Passenger,40,30,70,28748,28818,0.24
March,31,2018,Clark,WA,Truck,0,0,0,78628,78628,0
March,31,2018,Travis,TX,Passenger,0,1,1,188,189,0.53
March,31,2018,Jefferson,NY,Passenger,1,0,1,224,225,0.44
March,31,2018,Garfield,WA,Truck,0,0,0,952,952,0
March,31,2018,Hamilton,IN,Passenger,1,0,1,49,50,2
March,31,2018,Asotin,WA,Passenger,8,5,13,12627,12640,0.1
March,31,2018,Norfolk,MA,Passenger,1,0,1,37,38,2.63
March,31,2018,Prince George,VA,Passenger,0,1,1,74,75,1.33
March,31,2018,Cook,IL,Passenger,1,0,1,279,280,0.36
March,31,2018,Clallam,WA,Truck,0,0,0,21314,21314,0
March,31,2018,Santa Fe,NM,Passenger,0,1,1,41,42,2.38
March,31,2018,New Haven,CT,Passenger,0,1,1,51,52,1.92
March,31,2018,Columbia,WA,Passenger,2,1,3,2409,2412,0.12
March,31,2018,Sumter,FL,Passenger,0,1,1,10,11,9.09
March,31,2018,Whatcom,WA,Passenger,574,260,834,146117,146951,0.57
March,31,2018,Alameda,CA,Passenger,0,1,1,353,354,0.28
March,31,2018,Whitman,WA,Passenger,18,23,41,22489,22530,0.18
March,31,2018,Pend Oreille,WA,Truck,0,0,0,5658,5658,0
March,31,2018,Tarrant,TX,Passenger,1,0,1,218,219,0.46
March,31,2018,Klickitat,WA,Passenger,25,27,52,14973,15025,0.35
March,31,2018,Skamania,WA,Passenger,12,8,20,8667,8687,0.23
March,31,2018,Walla Walla,WA,Passenger,32,36,68,35462,35530,0.19
March,31,2018,Douglas,WA,Truck,0,0,0,11857,11857,0
March,31,2018,St. Clair,IL,Passenger,0,1,1,154,155,0.65
March,31,2018,Yakima,WA,Truck,0,0,0,58175,58175,0
March,31,2018,Utah,UT,Passenger,0,1,1,136,137,0.73
March,31,2018,Arlington,VA,Passenger,1,2,3,173,176,1.7
March,31,2018,Pacific,WA,Truck,0,0,0,7577,7577,0
March,31,2018,Sangamon,IL,Passenger,1,0,1,11,12,8.33
March,31,2018,Orange,CA,Passenger,3,1,4,570,574,0.7
March,31,2018,Cape May,NJ,Passenger,0,1,1,21,22,4.55
March,31,2018,San Diego,CA,Passenger,6,1,7,2555,2562,0.27
March,31,2018,Manassas,VA,Passenger,0,1,1,8,9,11.11
March,31,2018,Queens,NY,Passenger,1,0,1,63,64,1.56
March,31,2018,Yakima,WA,Passenger,63,81,144,162826,162970,0.09
March,31,2018,Howard,MD,Passenger,0,1,1,87,88,1.14
March,31,2018,King,WA,Truck,7,1,8,183718,183726,0
March,31,2018,Richmond,GA,Passenger,0,1,1,89,90,1.11
March,31,2018,Honolulu,HI,Passenger,2,2,4,546,550,0.73
March,31,2018,Island,WA,Truck,0,0,0,20857,20857,0
March,31,2018,Maui,HI,Passenger,1,0,1,63,64,1.56
March,31,2018,Lane,OR,Passenger,0,1,1,188,189,0.53
March,31,2018,Hamilton,TN,Passenger,1,0,1,23,24,4.17
March,31,2018,Duval,FL,Passenger,1,2,3,374,377,0.8
March,31,2018,Morris,NJ,Passenger,1,0,1,19,20,5
March,31,2018,Pima,AZ,Passenger,1,1,2,414,416,0.48
March,31,2018,Mason,WA,Passenger,68,83,151,45217,45368,0.33
March,31,2018,Skamania,WA,Truck,0,0,0,3925,3925,0
March,31,2018,Adams,WA,Truck,0,0,0,5152,5152,0
March,31,2018,Polk,FL,Passenger,1,0,1,62,63,1.59
March,31,2018,Juneau,AK,Passenger,0,1,1,44,45,2.22
March,31,2018,Broward,FL,Passenger,0,1,1,132,133,0.75
March,31,2018,Chelan,WA,Passenger,96,41,137,53348,53485,0.26
March,31,2018,Sacramento,CA,Passenger,1,0,1,294,295,0.34
March,31,2018,Williamson,TX,Passenger,0,1,1,160,161,0.62
March,31,2018,Lincoln,WA,Truck,0,0,0,4515,4515,0
March,31,2018,Frederick,MD,Passenger,0,1,1,87,88,1.14
March,31,2018,Franklin,WA,Passenger,34,55,89,57213,57302,0.16
March,31,2018,King,WA,Passenger,11972,5152,17124,1367947,1385071,1.24
March,31,2018,DeKalb,IN,Passenger,1,0,1,1,2,50
March,31,2018,Pacific,WA,Passenger,15,18,33,15463,15496,0.21
March,31,2018,Klickitat,WA,Truck,0,0,0,8045,8045,0
March,31,2018,Santa Rosa,FL,Passenger,1,0,1,100,101,0.99
March,31,2018,San Juan,WA,Passenger,140,50,190,13939,14129,1.34
March,31,2018,Prince William,VA,Passenger,0,4,4,266,270,1.48
March,31,2018,Maricopa,AZ,Passenger,2,1,3,1564,1567,0.19
March,31,2018,Kitsap,WA,Truck,1,0,1,52964,52965,0
March,31,2018,Shelby,TN,Passenger,0,1,1,101,102,0.98
March,31,2018,Bexar,TX,Passenger,2,2,4,789,793,0.5
March,31,2018,Garfield,WA,Passenger,1,0,1,1330,1331,0.08
March,31,2018,Dakota,MN,Passenger,0,2,2,37,39,5.13
March,31,2018,Madison,ID,Passenger,1,0,1,39,40,2.5
March,31,2018,Essex,NJ,Passenger,1,0,1,11,12,8.33
March,31,2018,Spokane,WA,Truck,1,0,1,91900,91901,0
March,31,2018,Hawaii,HI,Passenger,1,0,1,78,79,1.27
March,31,2018,Multnomah,OR,Passenger,3,4,7,817,824,0.85
March,31,2018,Marion,IN,Passenger,1,0,1,116,117,0.85
March,31,2018,Grant,WA,Truck,0,0,0,25746,25746,0
March,31,2018,Jefferson,WA,Truck,0,0,0,9515,9515,0
March,31,2018,Snohomish,WA,Truck,1,0,1,121231,121232,0
March,31,2018,San Juan,WA,Truck,0,0,0,5658,5658,0
March,31,2018,Palm Beach,FL,Passenger,0,1,1,85,86,1.16
March,31,2018,Grays Harbor,WA,Truck,0,0,0,20078,20078,0
March,31,2018,Asotin,WA,Truck,0,0,0,6593,6593,0
March,31,2018,Grant,WA,Passenger,32,42,74,62599,62673,0.12
March,31,2018,Mason,WA,Truck,0,0,0,19793,19793,0
March,31,2018,Gwinnett,GA,Passenger,0,1,1,78,79,1.27
March,31,2018,Lincoln,WA,Passenger,2,5,7,7578,7585,0.09
March,31,2018,Franklin,MA,Passenger,0,1,1,2,3,33.33
March,31,2018,Clay,FL,Passenger,0,1,1,102,103,0.97
March,31,2018,Norfolk,VA,Passenger,1,2,3,325,328,0.91
March,31,2018,Stevens,WA,Passenger,9,21,30,31603,31633,0.09
March,31,2018,Garfield,OK,Passenger,1,0,1,21,22,4.55
March,31,2018,Volusia,FL,Passenger,0,1,1,34,35,2.86
March,31,2018,Nantucket,MA,Passenger,1,0,1,4,5,20
March,31,2018,Dallas,TX,Passenger,0,1,1,187,188,0.53
March,31,2018,Prince George's,MD,Passenger,0,1,1,182,183,0.55
March,31,2018,Montgomery,TN,Passenger,1,0,1,267,268,0.37
March,31,2018,Grays Harbor,WA,Passenger,45,46,91,46091,46182,0.2
March,31,2018,Contra Costa,CA,Passenger,0,1,1,467,468,0.21
March,31,2018,Allegheny,PA,Passenger,1,0,1,77,78,1.28
March,31,2018,Lewis,WA,Passenger,55,47,102,57151,57253,0.18
March,31,2018,Fulton,GA,Passenger,1,0,1,99,100,1
March,31,2018,Sedgwick,KS,Passenger,0,1,1,104,105,0.95
March,31,2018,Manatee,FL,Passenger,1,0,1,37,38,2.63
March,31,2018,Kitsap,WA,Passenger,740,428,1168,176885,178053,0.66
March,31,2018,Snohomish,WA,Passenger,2133,1159,3292,517925,521217,0.63
March,31,2018,Brevard,FL,Passenger,0,1,1,100,101,0.99
March,31,2018,Washtenaw,MI,Passenger,1,0,1,39,40,2.5
March,31,2018,Nassau,NY,Passenger,1,0,1,35,36,2.78
March,31,2018,Moore,NC,Passenger,0,1,1,199,200,0.5
March,31,2018,Virginia Beach,VA,Passenger,2,1,3,682,685,0.44
March,31,2018,Okanogan,WA,Passenger,7,19,26,25733,25759,0.1
March,31,2018,Fairfax,VA,Passenger,2,2,4,824,828,0.48
March,31,2018,Lee,AL,Passenger,1,0,1,33,34,2.94
March,31,2018,Marin,CA,Passenger,1,0,1,54,55,1.82
March,31,2018,Deschutes,OR,Passenger,1,0,1,172,173,0.58
March,31,2018,Kent,MI,Passenger,0,1,1,34,35,2.86
March,31,2018,Skagit,WA,Passenger,173,154,327,89895,90222,0.36
March,31,2018,Clark,WA,Passenger,918,641,1559,306002,307561,0.51
March,31,2018,Ramsey,MN,Passenger,1,0,1,37,38,2.63
March,31,2018,Franklin,WA,Truck,0,0,0,18617,18617,0
March,31,2018,Skagit,WA,Truck,1,0,1,31922,31923,0
March,31,2018,Clark,NV,Passenger,1,2,3,744,747,0.4
March,31,2018,Richland,SC,Passenger,0,1,1,172,173,0.58
March,31,2018,Benton,WA,Passenger,176,187,363,130785,131148,0.28
March,31,2018,New London,CT,Passenger,1,1,2,249,251,0.8
March,31,2018,Benton,WA,Truck,0,0,0,40794,40794,0
March,31,2018,Island,WA,Passenger,175,178,353,62057,62410,0.57
March,31,2018,Wahkiakum,WA,Passenger,1,2,3,2871,2874,0.1
March,31,2018,Orange,FL,Passenger,2,1,3,169,172,1.74
March,31,2018,District of Columbia,DC,Passenger,0,3,3,195,198,1.52
March,31,2018,St. Lucie,FL,Passenger,1,0,1,27,28,3.57
March,31,2018,Caddo,LA,Passenger,0,1,1,22,23,4.35
March,31,2018,Ada,ID,Passenger,0,2,2,336,338,0.59
March,31,2018,Adams,WA,Passenger,5,4,9,12470,12479,0.07
March,31,2018,Spokane,WA,Passenger,304,273,577,301278,301855,0.19
March,31,2018,Latah,ID,Passenger,0,1,1,78,79,1.27
March,31,2018,Ventura,CA,Passenger,0,1,1,327,328,0.3
March,31,2018,Whitman,WA,Truck,0,0,0,8453,8453,0
March,31,2018,Okaloosa,FL,Passenger,1,0,1,175,176,0.57
March,31,2018,Northampton,PA,Passenger,0,1,1,63,64,1.56
March,31,2018,Portsmouth,VA,Passenger,0,1,1,72,73,1.37
March,31,2018,El Paso,TX,Passenger,1,0,1,524,525,0.19
March,31,2018,Tuolumne,CA,Passenger,0,1,1,14,15,6.67
March,31,2018,Clallam,WA,Passenger,119,104,223,49504,49727,0.45
March,31,2018,Thurston,WA,Truck,0,0,0,54007,54007,0
March,31,2018,Carroll,NH,Passenger,0,1,1,1,2,50
March,31,2018,Jefferson,CO,Passenger,0,1,1,75,76,1.32
March,31,2018,Wahkiakum,WA,Truck,0,0,0,1668,1668,0
May,31,2018,Canyon,ID,Passenger,0,1,1,87,88,1.14
May,31,2018,Wahkiakum,WA,Truck,0,0,0,1674,1674,0
May,31,2018,Whitman,WA,Truck,0,0,0,8470,8470,0
May,31,2018,Duval,FL,Passenger,1,2,3,382,385,0.78
May,31,2018,Skagit,WA,Passenger,198,163,361,90254,90615,0.4
May,31,2018,Nassau,NY,Passenger,1,0,1,36,37,2.7
May,31,2018,Lane,OR,Passenger,0,1,1,188,189,0.53
May,31,2018,Clackamas,OR,Passenger,0,1,1,227,228,0.44
May,31,2018,Montgomery,PA,Passenger,2,0,2,36,38,5.26
May,31,2018,Douglas,WA,Truck,0,0,0,11900,11900,0
May,31,2018,Maui,HI,Passenger,1,0,1,58,59,1.69
May,31,2018,Monterey,CA,Passenger,0,1,1,187,188,0.53
May,31,2018,Tarrant,TX,Passenger,1,0,1,215,216,0.46
May,31,2018,El Paso,TX,Passenger,1,0,1,522,523,0.19
May,31,2018,Pend Oreille,WA,Passenger,4,5,9,9508,9517,0.09
May,31,2018,Brevard,FL,Passenger,0,1,1,98,99,1.01
May,31,2018,Howard,MD,Passenger,0,1,1,86,87,1.15
May,31,2018,San Mateo,CA,Passenger,1,1,2,134,136,1.47
May,31,2018,Essex,NJ,Passenger,1,0,1,10,11,9.09
May,31,2018,Mason,WA,Passenger,77,93,170,45592,45762,0.37
May,31,2018,Whatcom,WA,Passenger,612,281,893,147196,148089,0.6
May,31,2018,Kittitas,WA,Truck,0,0,0,14024,14024,0
May,31,2018,Nantucket,MA,Passenger,1,0,1,4,5,20
May,31,2018,El Paso,CO,Passenger,2,1,3,751,754,0.4
May,31,2018,Norfolk,VA,Passenger,1,2,3,328,331,0.91
May,31,2018,Morris,NJ,Passenger,1,0,1,18,19,5.26
May,31,2018,Volusia,FL,Passenger,0,1,1,34,35,2.86
May,31,2018,Moore,NC,Passenger,0,1,1,196,197,0.51
May,31,2018,Okanogan,WA,Truck,0,0,0,16409,16409,0
May,31,2018,Whitman,WA,Passenger,19,27,46,22578,22624,0.2
May,31,2018,Okanogan,WA,Passenger,8,19,27,25886,25913,0.1
May,31,2018,,,Passenger,6,2,8,710,718,1.11
May,31,2018,Beaufort,SC,Passenger,1,0,1,37,38,2.63
May,31,2018,Wahkiakum,WA,Passenger,1,2,3,2901,2904,0.1
May,31,2018,Fulton,GA,Passenger,1,1,2,98,100,2
May,31,2018,Santa Clara,CA,Passenger,7,0,7,381,388,1.8
May,31,2018,Clark,WA,Passenger,963,696,1659,307153,308812,0.54
May,31,2018,Cook,IL,Passenger,1,0,1,269,270,0.37
May,31,2018,New London,CT,Passenger,0,1,1,252,253,0.4
May,31,2018,Manassas,VA,Passenger,0,1,1,9,10,10
May,31,2018,Nueces,TX,Passenger,1,1,2,92,94,2.13
May,31,2018,Juneau,AK,Passenger,0,1,1,47,48,2.08
May,31,2018,Cowlitz,WA,Truck,0,0,0,28359,28359,0
May,31,2018,Snohomish,WA,Truck,1,0,1,121479,121480,0
May,31,2018,Washington,OR,Passenger,0,1,1,476,477,0.21
May,31,2018,Grays Harbor,WA,Passenger,50,55,105,46409,46514,0.23
May,31,2018,Island,WA,Truck,0,0,0,20885,20885,0
May,31,2018,Santa Rosa,FL,Passenger,1,0,1,97,98,1.02
May,31,2018,Columbia,WA,Passenger,2,1,3,2412,2415,0.12
May,31,2018,Sumter,FL,Passenger,0,1,1,9,10,10
May,31,2018,Riverside,CA,Passenger,2,2,4,703,707,0.57
May,31,2018,Clark,NV,Passenger,1,2,3,744,747,0.4
May,31,2018,Hamilton,IN,Passenger,1,0,1,46,47,2.13
May,31,2018,New Haven,CT,Passenger,0,1,1,50,51,1.96
May,31,2018,Clark,WA,Truck,0,0,0,78917,78917,0
May,31,2018,Ramsey,MN,Passenger,1,0,1,40,41,2.44
May,31,2018,Walla Walla,WA,Passenger,34,42,76,35569,35645,0.21
May,31,2018,Kitsap,WA,Passenger,780,453,1233,177900,179133,0.69
May,31,2018,Lincoln,WA,Passenger,2,6,8,7644,7652,0.1
May,31,2018,Caddo,LA,Passenger,0,1,1,22,23,4.35
May,31,2018,Ferry,WA,Truck,0,0,0,3503,3503,0
May,31,2018,Stevens,WA,Passenger,11,25,36,31564,31600,0.11
May,31,2018,Washtenaw,MI,Passenger,1,0,1,38,39,2.56
May,31,2018,Thurston,WA,Passenger,548,468,1016,192389,193405,0.53
May,31,2018,Pinal,AZ,Passenger,2,0,2,205,207,0.97
May,31,2018,Sacramento,CA,Passenger,1,0,1,301,302,0.33
May,31,2018,Arlington,VA,Passenger,1,2,3,171,174,1.72
May,31,2018,Lewis,WA,Passenger,78,54,132,57567,57699,0.23
May,31,2018,Bexar,TX,Passenger,2,3,5,767,772,0.65
May,31,2018,Lincoln,WA,Truck,0,0,0,4537,4537,0
May,31,2018,Prince George's,MD,Passenger,1,1,2,183,185,1.08
May,31,2018,Skagit,WA,Truck,1,0,1,32044,32045,0
May,31,2018,Kootenai,ID,Passenger,0,1,1,220,221,0.45
May,31,2018,Monroe,IL,Passenger,1,0,1,5,6,16.67
May,31,2018,Charles,MD,Passenger,0,1,1,84,85,1.18
May,31,2018,Gwinnett,GA,Passenger,0,1,1,82,83,1.2
May,31,2018,Mason,WA,Truck,0,0,0,19874,19874,0
May,31,2018,Grays Harbor,WA,Truck,0,0,0,20185,20185,0
May,31,2018,Garfield,WA,Truck,0,0,0,956,956,0
May,31,2018,Thurston,WA,Truck,0,0,0,54199,54199,0
May,31,2018,Jefferson,NY,Passenger,1,1,2,226,228,0.88
May,31,2018,Ferry,WA,Passenger,2,3,5,4417,4422,0.11
May,31,2018,Pierce,WA,Passenger,1185,1125,2310,530476,532786,0.43
May,31,2018,Grant,WA,Truck,0,0,0,25863,25863,0
May,31,2018,Allegheny,PA,Passenger,1,0,1,75,76,1.32
May,31,2018,Clallam,WA,Passenger,119,110,229,49783,50012,0.46
May,31,2018,Portsmouth,VA,Passenger,0,1,1,72,73,1.37
May,31,2018,Jefferson,CO,Passenger,0,1,1,70,71,1.41
May,31,2018,Klickitat,WA,Truck,0,0,0,8084,8084,0
May,31,2018,Ada,ID,Passenger,0,2,2,331,333,0.6
May,31,2018,Klickitat,WA,Passenger,25,30,55,15106,15161,0.36
May,31,2018,Pima,AZ,Passenger,1,1,2,412,414,0.48
May,31,2018,Santa Fe,NM,Passenger,0,1,1,42,43,2.33
May,31,2018,Hawaii,HI,Passenger,1,0,1,74,75,1.33
May,31,2018,Snohomish,WA,Passenger,2281,1223,3504,520051,523555,0.67
May,31,2018,Ventura,CA,Passenger,0,1,1,315,316,0.32
May,31,2018,Skamania,WA,Passenger,12,9,21,8704,8725,0.24
May,31,2018,District of Columbia,DC,Passenger,0,3,3,190,193,1.55
May,31,2018,Pend Oreille,WA,Truck,0,0,0,5671,5671,0
May,31,2018,Williamson,TX,Passenger,0,1,1,163,164,0.61
May,31,2018,Latah,ID,Passenger,0,1,1,76,77,1.3
May,31,2018,Lumpkin,GA,Passenger,1,0,1,7,8,12.5
May,31,2018,Multnomah,OR,Passenger,3,4,7,807,814,0.86
May,31,2018,Cowlitz,WA,Passenger,58,75,133,71515,71648,0.19
May,31,2018,DeKalb,IN,Passenger,1,0,1,1,2,50
May,31,2018,Frederick,MD,Passenger,0,1,1,86,87,1.15
May,31,2018,Garfield,WA,Passenger,1,1,2,1326,1328,0.15
May,31,2018,Jefferson,WA,Passenger,138,91,229,24389,24618,0.93
May,31,2018,Madison,ID,Passenger,1,0,1,38,39,2.56
May,31,2018,Broward,FL,Passenger,1,1,2,130,132,1.52
May,31,2018,Marin,CA,Passenger,1,0,1,56,57,1.75
May,31,2018,San Juan,WA,Truck,0,0,0,5702,5702,0
May,31,2018,Franklin,MA,Passenger,0,1,1,2,3,33.33
May,31,2018,St. Lucie,FL,Passenger,1,0,1,28,29,3.45
May,31,2018,Spokane,WA,Truck,1,0,1,92371,92372,0
May,31,2018,Hamilton,TN,Passenger,1,0,1,23,24,4.17
May,31,2018,Jefferson,WA,Truck,0,0,0,9539,9539,0
May,31,2018,Asotin,WA,Passenger,8,6,14,12602,12616,0.11
May,31,2018,Clallam,WA,Truck,0,0,0,21412,21412,0
May,31,2018,Pacific,WA,Truck,0,0,0,7588,7588,0
May,31,2018,Dallas,TX,Passenger,0,1,1,190,191,0.52
May,31,2018,Grant,WA,Passenger,30,44,74,63010,63084,0.12
May,31,2018,Manatee,FL,Passenger,1,0,1,37,38,2.63
May,31,2018,Chelan,WA,Truck,0,0,0,21823,21823,0
May,31,2018,Island,WA,Passenger,187,177,364,62446,62810,0.58
May,31,2018,Saratoga,NY,Passenger,1,1,2,64,66,3.03
May,31,2018,Okaloosa,FL,Passenger,1,0,1,171,172,0.58
May,31,2018,Hardin,KY,Passenger,0,1,1,119,120,0.83
May,31,2018,Prince George,VA,Passenger,0,1,1,73,74,1.35
May,31,2018,Adams,WA,Truck,0,0,0,5158,5158,0
May,31,2018,Garfield,OK,Passenger,1,0,1,18,19,5.26
May,31,2018,DuPage,IL,Passenger,1,0,1,64,65,1.54
May,31,2018,Kittitas,WA,Passenger,44,32,76,28906,28982,0.26
May,31,2018,Benton,WA,Truck,0,0,0,40984,40984,0
May,31,2018,Franklin,WA,Truck,0,0,0,18644,18644,0
May,31,2018,Northampton,PA,Passenger,0,1,1,64,65,1.54
May,31,2018,Yakima,WA,Passenger,62,84,146,163646,163792,0.09
May,31,2018,Pacific,WA,Passenger,16,19,35,15552,15587,0.22
May,31,2018,Utah,UT,Passenger,0,1,1,133,134,0.75
May,31,2018,King,WA,Passenger,12744,5480,18224,1369589,1387813,1.31
May,31,2018,Montgomery,TX,Passenger,1,0,1,64,65,1.54
May,31,2018,St. Clair,IL,Passenger,0,1,1,152,153,0.65
May,31,2018,Palm Beach,FL,Passenger,0,1,1,83,84,1.19
May,31,2018,San Francisco,CA,Passenger,0,1,1,128,129,0.78
May,31,2018,Skamania,WA,Truck,0,0,0,3917,3917,0
May,31,2018,San Diego,CA,Passenger,7,1,8,2576,2584,0.31
May,31,2018,Marion,IN,Passenger,1,0,1,117,118,0.85
May,31,2018,Benton,WA,Passenger,188,195,383,131301,131684,0.29
May,31,2018,Deschutes,OR,Passenger,1,0,1,169,170,0.59
May,31,2018,Twin Falls,ID,Passenger,0,1,1,23,24,4.17
May,31,2018,Contra Costa,CA,Passenger,0,1,1,451,452,0.22
May,31,2018,Queens,NY,Passenger,1,0,1,63,64,1.56
May,31,2018,Orange,FL,Passenger,2,1,3,171,174,1.72
May,31,2018,Sedgwick,KS,Passenger,0,1,1,97,98,1.02
May,31,2018,Kent,MI,Passenger,0,1,1,30,31,3.23
May,31,2018,Fairfax,VA,Passenger,2,2,4,834,838,0.48
May,31,2018,Franklin,WA,Passenger,38,63,101,57692,57793,0.17
May,31,2018,Collin,TX,Passenger,1,0,1,152,153,0.65
May,31,2018,Spokane,WA,Passenger,324,302,626,302459,303085,0.21
May,31,2018,Shelby,TN,Passenger,0,1,1,103,104,0.96
May,31,2018,Travis,TX,Passenger,0,1,1,191,192,0.52
May,31,2018,DeKalb,GA,Passenger,1,0,1,81,82,1.22
May,31,2018,Pierce,WA,Truck,0,0,0,137544,137544,0
May,31,2018,King,WA,Truck,7,1,8,183157,183165,0
May,31,2018,Prince William,VA,Passenger,0,4,4,266,270,1.48
May,31,2018,Carroll,NH,Passenger,0,1,1,1,2,50
May,31,2018,Dale,AL,Passenger,0,1,1,59,60,1.67
May,31,2018,Orange,CA,Passenger,4,1,5,562,567,0.88
May,31,2018,Montgomery,MD,Passenger,1,0,1,288,289,0.35
May,31,2018,Alameda,CA,Passenger,0,1,1,348,349,0.29
May,31,2018,Sangamon,IL,Passenger,1,0,1,11,12,8.33
May,31,2018,Cape May,NJ,Passenger,0,1,1,21,22,4.55
May,31,2018,Stevens,WA,Truck,0,0,0,18590,18590,0
May,31,2018,Virginia Beach,VA,Passenger,2,1,3,688,691,0.43
May,31,2018,Tulsa,OK,Passenger,0,1,1,48,49,2.04
May,31,2018,Chelan,WA,Passenger,103,49,152,53497,53649,0.28
May,31,2018,Klamath,OR,Passenger,1,0,1,34,35,2.86
May,31,2018,Tuolumne,CA,Passenger,0,1,1,12,13,7.69
May,31,2018,Whatcom,WA,Truck,2,0,2,42191,42193,0
May,31,2018,Flathead,MT,Passenger,1,0,1,50,51,1.96
May,31,2018,Walla Walla,WA,Truck,0,0,0,13389,13389,0
May,31,2018,San Juan,WA,Passenger,141,56,197,14046,14243,1.38
May,31,2018,Polk,FL,Passenger,1,0,1,64,65,1.54
May,31,2018,Lee,FL,Passenger,1,0,1,57,58,1.72
May,31,2018,Douglas,WA,Passenger,44,31,75,27541,27616,0.27
May,31,2018,Norfolk,MA,Passenger,1,0,1,37,38,2.63
May,31,2018,Los Angeles,CA,Passenger,7,4,11,1157,1168,0.94
May,31,2018,Columbia,WA,Truck,0,0,0,1526,1526,0
May,31,2018,Dakota,MN,Passenger,0,2,2,37,39,5.13
May,31,2018,Anne Arundel,MD,Passenger,0,2,2,445,447,0.45
May,31,2018,Richmond,GA,Passenger,0,1,1,91,92,1.09
May,31,2018,Yakima,WA,Truck,0,0,0,58338,58338,0
May,31,2018,Orleans,LA,Passenger,0,1,1,46,47,2.13
May,31,2018,Asotin,WA,Truck,0,0,0,6631,6631,0
May,31,2018,Richland,SC,Passenger,0,1,1,171,172,0.58
May,31,2018,Clay,FL,Passenger,0,1,1,94,95,1.05
May,31,2018,Kitsap,WA,Truck,1,0,1,53093,53094,0
May,31,2018,Lee,AL,Passenger,1,0,1,33,34,2.94
May,31,2018,Adams,WA,Passenger,5,5,10,12597,12607,0.08
May,31,2018,Charleston,SC,Passenger,1,0,1,127,128,0.78
May,31,2018,Maricopa,AZ,Passenger,2,1,3,1575,1578,0.19
May,31,2018,Honolulu,HI,Passenger,2,2,4,529,533,0.75
May,31,2018,Lewis,WA,Truck,0,0,0,25406,25406,0
November,30,2018,Moore,NC,Passenger,0,1,1,193,194,0.52
November,30,2018,Lee,AL,Passenger,1,0,1,36,37,2.7
November,30,2018,Richland,SC,Passenger,0,1,1,163,164,0.61
November,30,2018,Kittitas,WA,Passenger,61,34,95,29286,29381,0.32
November,30,2018,Polk,FL,Passenger,1,0,1,63,64,1.56
November,30,2018,,,Passenger,7,2,9,784,793,1.13
November,30,2018,Carroll,NH,Passenger,0,1,1,1,2,50
November,30,2018,Albemarle,VA,Passenger,1,0,1,27,28,3.57
November,30,2018,Williamson,TX,Passenger,0,1,1,148,149,0.67
November,30,2018,Whatcom,WA,Passenger,730,355,1085,149134,150219,0.72
November,30,2018,Madison,ID,Passenger,1,0,1,37,38,2.63
November,30,2018,New London,CT,Passenger,0,1,1,253,254,0.39
November,30,2018,El Paso,TX,Passenger,1,0,1,496,497,0.2
November,30,2018,Adams,WA,Truck,0,0,0,5160,5160,0
November,30,2018,Sangamon,IL,Passenger,1,0,1,9,10,10
November,30,2018,Ada,ID,Passenger,0,2,2,314,316,0.63
November,30,2018,Manatee,FL,Passenger,1,0,1,39,40,2.5
November,30,2018,Honolulu,HI,Passenger,1,3,4,517,521,0.77
November,30,2018,Mason,WA,Truck,0,0,0,20190,20190,0
November,30,2018,San Juan,WA,Truck,0,0,0,5805,5805,0
November,30,2018,Lane,OR,Passenger,0,1,1,174,175,0.57
November,30,2018,Asotin,WA,Truck,0,0,0,6620,6620,0
November,30,2018,Whatcom,WA,Truck,2,0,2,42656,42658,0
November,30,2018,Volusia,FL,Passenger,0,1,1,36,37,2.7
November,30,2018,Juneau,AK,Passenger,0,1,1,43,44,2.27
November,30,2018,Cape May,NJ,Passenger,0,1,1,21,22,4.55
November,30,2018,Garfield,WA,Passenger,1,1,2,1331,1333,0.15
November,30,2018,Morris,NJ,Passenger,1,0,1,18,19,5.26
November,30,2018,Rogers,OK,Passenger,1,0,1,6,7,14.29
November,30,2018,Pierce,WA,Truck,0,0,0,139061,139061,0
November,30,2018,Pend Oreille,WA,Passenger,5,5,10,9557,9567,0.1
November,30,2018,Camden,NJ,Passenger,0,1,1,26,27,3.7
November,30,2018,Garfield,OK,Passenger,1,0,1,13,14,7.14
November,30,2018,Wahkiakum,WA,Truck,0,0,0,1704,1704,0
November,30,2018,Valencia,NM,Passenger,1,0,1,10,11,9.09
November,30,2018,Montgomery,TX,Passenger,2,0,2,62,64,3.12
November,30,2018,Hennepin,MN,Passenger,2,0,2,109,111,1.8
November,30,2018,Whitman,WA,Truck,0,0,0,8531,8531,0
November,30,2018,Chelan,WA,Passenger,135,60,195,54064,54259,0.36
November,30,2018,Spokane,WA,Passenger,408,358,766,306895,307661,0.25
November,30,2018,Clallam,WA,Truck,0,0,0,21613,21613,0
November,30,2018,Travis,TX,Passenger,0,1,1,198,199,0.5
November,30,2018,Skamania,WA,Passenger,18,14,32,8731,8763,0.37
November,30,2018,King,WA,Passenger,15784,6398,22182,1377200,1399382,1.59
November,30,2018,Broward,FL,Passenger,2,1,3,133,136,2.21
November,30,2018,Adams,WA,Passenger,5,5,10,12749,12759,0.08
November,30,2018,Yakima,WA,Truck,0,0,0,58751,58751,0
November,30,2018,Snohomish,WA,Passenger,2789,1415,4204,526785,530989,0.79
November,30,2018,Prince George's,MD,Passenger,1,1,2,182,184,1.09
November,30,2018,Marion,OR,Passenger,1,0,1,119,120,0.83
November,30,2018,Randolph,NC,Passenger,1,0,1,5,6,16.67
November,30,2018,San Juan,PR,Passenger,0,1,1,5,6,16.67
November,30,2018,Clallam,WA,Passenger,147,121,268,50323,50591,0.53
November,30,2018,Columbia,WA,Truck,0,0,0,1516,1516,0
November,30,2018,Dallas,TX,Passenger,0,1,1,198,199,0.5
November,30,2018,Clackamas,OR,Passenger,1,1,2,217,219,0.91
November,30,2018,Anne Arundel,MD,Passenger,0,2,2,451,453,0.44
November,30,2018,Lewis,WA,Passenger,89,71,160,58211,58371,0.27
November,30,2018,Charles,MD,Passenger,0,1,1,78,79,1.27
November,30,2018,Hawaii,HI,Passenger,1,0,1,65,66,1.52
November,30,2018,Kitsap,WA,Truck,1,0,1,53652,53653,0
November,30,2018,Douglas,WA,Passenger,49,33,82,27967,28049,0.29
November,30,2018,Spokane,WA,Truck,1,0,1,93666,93667,0
November,30,2018,Franklin,WA,Truck,0,0,0,18987,18987,0
November,30,2018,Deschutes,OR,Passenger,2,0,2,163,165,1.21
November,30,2018,Richmond,GA,Passenger,0,1,1,92,93,1.08
November,30,2018,Cook,IL,Passenger,1,0,1,250,251,0.4
November,30,2018,Lincoln,WA,Truck,0,0,0,4630,4630,0
November,30,2018,Franklin,MA,Passenger,0,1,1,1,2,50
November,30,2018,Santa Clara,CA,Passenger,8,1,9,373,382,2.36
November,30,2018,Twin Falls,ID,Passenger,0,1,1,23,24,4.17
November,30,2018,St. Clair,IL,Passenger,0,1,1,164,165,0.61
November,30,2018,Wahkiakum,WA,Passenger,1,1,2,2984,2986,0.07
November,30,2018,Charleston,SC,Passenger,1,0,1,125,126,0.79
November,30,2018,San Diego,CA,Passenger,8,2,10,2565,2575,0.39
November,30,2018,Monroe,IL,Passenger,1,0,1,4,5,20
November,30,2018,Sedgwick,KS,Passenger,0,1,1,99,100,1
November,30,2018,Santa Cruz,CA,Passenger,1,0,1,40,41,2.44
November,30,2018,Chelan,WA,Truck,0,0,0,22082,22082,0
November,30,2018,Ferry,WA,Passenger,3,2,5,4383,4388,0.11
November,30,2018,Montgomery,PA,Passenger,2,0,2,35,37,5.41
November,30,2018,Okanogan,WA,Passenger,15,22,37,26132,26169,0.14
November,30,2018,Harnett,NC,Passenger,1,0,1,235,236,0.42
November,30,2018,Grays Harbor,WA,Passenger,61,68,129,47373,47502,0.27
November,30,2018,Island,WA,Truck,0,0,0,21178,21178,0
November,30,2018,Benton,WA,Truck,0,0,0,41442,41442,0
November,30,2018,Nueces,TX,Passenger,1,1,2,93,95,2.11
November,30,2018,New Haven,CT,Passenger,0,1,1,48,49,2.04
November,30,2018,Portsmouth,VA,Passenger,0,1,1,79,80,1.25
November,30,2018,Kent,MI,Passenger,0,1,1,23,24,4.17
November,30,2018,Whitman,WA,Passenger,20,35,55,22795,22850,0.24
November,30,2018,Lincoln,WA,Passenger,2,6,8,7771,7779,0.1
November,30,2018,DeKalb,IN,Passenger,1,0,1,1,2,50
November,30,2018,Skagit,WA,Passenger,249,184,433,91187,91620,0.47
November,30,2018,Carson City,NV,Passenger,1,0,1,15,16,6.25
November,30,2018,DuPage,IL,Passenger,1,0,1,57,58,1.72
November,30,2018,Clark,WA,Truck,0,0,0,79742,79742,0
November,30,2018,Thurston,WA,Truck,0,0,0,54923,54923,0
November,30,2018,Dakota,MN,Passenger,0,2,2,34,36,5.56
November,30,2018,San Mateo,CA,Passenger,2,1,3,128,131,2.29
November,30,2018,El Paso,CO,Passenger,3,1,4,764,768,0.52
November,30,2018,King,WA,Truck,6,1,7,182760,182767,0
November,30,2018,Douglas,WA,Truck,0,0,0,12123,12123,0
November,30,2018,Ramsey,MN,Passenger,1,0,1,40,41,2.44
November,30,2018,Skamania,WA,Truck,0,0,0,4005,4005,0
November,30,2018,Kitsap,WA,Passenger,916,522,1438,180341,181779,0.79
November,30,2018,Shasta,CA,Passenger,1,0,1,42,43,2.33
November,30,2018,Manassas,VA,Passenger,0,1,1,9,10,10
November,30,2018,Goochland,VA,Passenger,0,1,1,244,245,0.41
November,30,2018,Orange,CA,Passenger,5,2,7,544,551,1.27
November,30,2018,Frederick,MD,Passenger,0,1,1,82,83,1.2
November,30,2018,Maricopa,AZ,Passenger,3,2,5,1540,1545,0.32
November,30,2018,Santa Fe,NM,Passenger,0,1,1,43,44,2.27
November,30,2018,Washington,OR,Passenger,0,1,1,470,471,0.21
November,30,2018,Bergen,NJ,Passenger,1,0,1,27,28,3.57
November,30,2018,District of Columbia,DC,Passenger,1,3,4,193,197,2.03
November,30,2018,Lumpkin,GA,Passenger,1,0,1,7,8,12.5
November,30,2018,Santa Rosa,FL,Passenger,1,0,1,88,89,1.12
November,30,2018,Tarrant,TX,Passenger,1,0,1,207,208,0.48
November,30,2018,Nassau,NY,Passenger,3,0,3,36,39,7.69
November,30,2018,Bexar,TX,Passenger,3,4,7,719,726,0.96
November,30,2018,Washtenaw,MI,Passenger,1,0,1,39,40,2.5
November,30,2018,Mecklenburg,NC,Passenger,1,0,1,79,80,1.25
November,30,2018,Denver,CO,Passenger,1,0,1,130,131,0.76
November,30,2018,Stevens,WA,Truck,0,0,0,18731,18731,0
November,30,2018,Beaufort,SC,Passenger,1,0,1,34,35,2.86
November,30,2018,Pend Oreille,WA,Truck,0,0,0,5742,5742,0
November,30,2018,Skagit,WA,Truck,1,0,1,32338,32339,0
November,30,2018,Fairfax,VA,Passenger,1,2,3,806,809,0.37
November,30,2018,St. Lucie,FL,Passenger,1,0,1,29,30,3.33
November,30,2018,Guadalupe,TX,Passenger,1,0,1,80,81,1.23
November,30,2018,Grays Harbor,WA,Truck,0,0,0,20338,20338,0
November,30,2018,Kootenai,ID,Passenger,1,1,2,220,222,0.9
November,30,2018,Orange,FL,Passenger,2,1,3,163,166,1.81
November,30,2018,Caddo,LA,Passenger,0,1,1,23,24,4.17
November,30,2018,Lee,FL,Passenger,1,0,1,52,53,1.89
November,30,2018,Jefferson,NY,Passenger,0,1,1,230,231,0.43
November,30,2018,Norfolk,VA,Passenger,2,2,4,342,346,1.16
November,30,2018,Yakima,WA,Passenger,78,98,176,164686,164862,0.11
November,30,2018,Suffolk,MA,Passenger,0,1,1,43,44,2.27
November,30,2018,Montgomery,MD,Passenger,1,0,1,275,276,0.36
November,30,2018,Jefferson,CO,Passenger,0,2,2,63,65,3.08
November,30,2018,Klickitat,WA,Truck,0,0,0,8183,8183,0
November,30,2018,Maui,HI,Passenger,1,0,1,52,53,1.89
November,30,2018,Fulton,GA,Passenger,1,2,3,107,110,2.73
November,30,2018,Tuolumne,CA,Passenger,0,1,1,12,13,7.69
November,30,2018,Riverside,CA,Passenger,2,2,4,683,687,0.58
November,30,2018,Douglas,NE,Passenger,0,1,1,66,67,1.49
November,30,2018,Columbia,WA,Passenger,2,2,4,2437,2441,0.16
November,30,2018,Walla Walla,WA,Passenger,38,52,90,36092,36182,0.25
November,30,2018,Stevens,WA,Passenger,16,27,43,31791,31834,0.14
November,30,2018,DeKalb,GA,Passenger,1,0,1,77,78,1.28
November,30,2018,Multnomah,OR,Passenger,3,5,8,755,763,1.05
November,30,2018,Thurston,WA,Passenger,707,567,1274,195458,196732,0.65
November,30,2018,San Juan,WA,Passenger,176,68,244,14214,14458,1.69
November,30,2018,Monterey,CA,Passenger,0,1,1,190,191,0.52
November,30,2018,Flathead,MT,Passenger,1,0,1,55,56,1.79
November,30,2018,Alameda,CA,Passenger,0,2,2,327,329,0.61
November,30,2018,Howard,MD,Passenger,0,1,1,86,87,1.15
November,30,2018,Clark,NV,Passenger,2,2,4,721,725,0.55
November,30,2018,Island,WA,Passenger,266,224,490,63109,63599,0.77
November,30,2018,Ventura,CA,Passenger,0,2,2,318,320,0.62
November,30,2018,Benton,WA,Passenger,210,224,434,132792,133226,0.33
November,30,2018,Franklin,WA,Passenger,38,64,102,58943,59045,0.17
November,30,2018,Walla Walla,WA,Truck,0,0,0,13518,13518,0
November,30,2018,Pacific,WA,Passenger,20,23,43,15810,15853,0.27
November,30,2018,Clay,FL,Passenger,0,1,1,88,89,1.12
November,30,2018,San Francisco,CA,Passenger,2,1,3,118,121,2.48
November,30,2018,Dale,AL,Passenger,0,1,1,57,58,1.72
November,30,2018,Jefferson,WA,Passenger,169,104,273,24795,25068,1.09
November,30,2018,Snohomish,WA,Truck,1,0,1,121952,121953,0
November,30,2018,Collin,TX,Passenger,1,1,2,146,148,1.35
November,30,2018,Garfield,WA,Truck,0,0,0,964,964,0
November,30,2018,Okanogan,WA,Truck,0,0,0,16492,16492,0
November,30,2018,Pima,AZ,Passenger,1,1,2,399,401,0.5
November,30,2018,Grant,WA,Passenger,32,52,84,64032,64116,0.13
November,30,2018,Marion,IN,Passenger,1,0,1,120,121,0.83
November,30,2018,Middlesex,MA,Passenger,0,1,1,135,136,0.74
November,30,2018,Brevard,FL,Passenger,0,1,1,95,96,1.04
November,30,2018,Houston,GA,Passenger,1,0,1,52,53,1.89
November,30,2018,Contra Costa,CA,Passenger,0,2,2,416,418,0.48
November,30,2018,Pinal,AZ,Passenger,2,0,2,201,203,0.99
November,30,2018,Klickitat,WA,Passenger,23,32,55,15421,15476,0.36
November,30,2018,Bucks,PA,Passenger,1,0,1,16,17,5.88
November,30,2018,Clark,WA,Passenger,1188,830,2018,310997,313015,0.64
November,30,2018,Ferry,WA,Truck,0,0,0,3582,3582,0
November,30,2018,Klamath,OR,Passenger,1,0,1,36,37,2.7
November,30,2018,Oldham,KY,Passenger,0,1,1,5,6,16.67
November,30,2018,Washoe,NV,Passenger,1,0,1,107,108,0.93
November,30,2018,Larimer,CO,Passenger,1,0,1,61,62,1.61
November,30,2018,Cowlitz,WA,Passenger,69,91,160,72372,72532,0.22
November,30,2018,Los Angeles,CA,Passenger,7,5,12,1126,1138,1.05
November,30,2018,Norfolk,MA,Passenger,1,0,1,36,37,2.7
November,30,2018,Hamilton,IN,Passenger,1,0,1,46,47,2.13
November,30,2018,Kittitas,WA,Truck,0,0,0,14162,14162,0
November,30,2018,Sumter,FL,Passenger,0,1,1,10,11,9.09
November,30,2018,Mason,WA,Passenger,103,110,213,46427,46640,0.46
November,30,2018,Cumberland,NC,Passenger,0,1,1,520,521,0.19
November,30,2018,Duval,FL,Passenger,1,2,3,381,384,0.78
November,30,2018,Lewis,WA,Truck,0,0,0,25625,25625,0
November,30,2018,Prince William,VA,Passenger,0,4,4,257,261,1.53
November,30,2018,Grant,WA,Truck,0,0,0,26159,26159,0
November,30,2018,Hardin,KY,Passenger,0,1,1,111,112,0.89
November,30,2018,Cowlitz,WA,Truck,0,0,0,28723,28723,0
November,30,2018,Allegheny,PA,Passenger,1,0,1,84,85,1.18
November,30,2018,Shelby,TN,Passenger,0,1,1,102,103,0.97
November,30,2018,Arlington,VA,Passenger,1,1,2,166,168,1.19
November,30,2018,Virginia Beach,VA,Passenger,2,1,3,697,700,0.43
November,30,2018,Gwinnett,GA,Passenger,0,1,1,77,78,1.28
November,30,2018,Cochise,AZ,Passenger,0,1,1,119,120,0.83
November,30,2018,Jefferson,WA,Truck,0,0,0,9615,9615,0
November,30,2018,Palm Beach,FL,Passenger,0,1,1,93,94,1.06
November,30,2018,Pacific,WA,Truck,0,0,0,7611,7611,0
November,30,2018,Asotin,WA,Passenger,12,9,21,12726,12747,0.16
November,30,2018,Saratoga,NY,Passenger,1,0,1,62,63,1.59
November,30,2018,Pierce,WA,Passenger,1470,1339,2809,538424,541233,0.52
November,30,2018,Tulsa,OK,Passenger,1,1,2,47,49,4.08
November,30,2018,St. Mary's,MD,Passenger,1,0,1,218,219,0.46
November,30,2018,Fresno,CA,Passenger,1,0,1,189,190,0.53
November,30,2018,Nantucket,MA,Passenger,1,0,1,4,5,20
October,31,2018,Brevard,FL,Passenger,0,1,1,92,93,1.08
October,31,2018,Palm Beach,FL,Passenger,0,1,1,90,91,1.1
October,31,2018,Collin,TX,Passenger,1,1,2,151,153,1.31
October,31,2018,Island,WA,Truck,0,0,0,21130,21130,0
October,31,2018,Kent,MI,Passenger,0,1,1,25,26,3.85
October,31,2018,San Mateo,CA,Passenger,1,1,2,128,130,1.54
October,31,2018,Virginia Beach,VA,Passenger,2,1,3,696,699,0.43
October,31,2018,Carson City,NV,Passenger,1,0,1,14,15,6.67
October,31,2018,Columbia,WA,Passenger,2,2,4,2432,2436,0.16
October,31,2018,Polk,FL,Passenger,1,0,1,62,63,1.59
October,31,2018,Manatee,FL,Passenger,1,0,1,39,40,2.5
October,31,2018,Franklin,WA,Passenger,35,66,101,58751,58852,0.17
October,31,2018,Lewis,WA,Truck,0,0,0,25611,25611,0
October,31,2018,Dale,AL,Passenger,0,1,1,58,59,1.69
October,31,2018,St. Clair,IL,Passenger,0,1,1,162,163,0.61
October,31,2018,Snohomish,WA,Passenger,2637,1378,4015,525955,529970,0.76
October,31,2018,Nantucket,MA,Passenger,1,0,1,4,5,20
October,31,2018,Whitman,WA,Truck,0,0,0,8531,8531,0
October,31,2018,Honolulu,HI,Passenger,1,2,3,517,520,0.58
October,31,2018,Sumter,FL,Passenger,0,1,1,10,11,9.09
October,31,2018,Adams,WA,Truck,0,0,0,5151,5151,0
October,31,2018,Hennepin,MN,Passenger,2,0,2,112,114,1.75
October,31,2018,District of Columbia,DC,Passenger,0,3,3,192,195,1.54
October,31,2018,Riverside,CA,Passenger,2,2,4,678,682,0.59
October,31,2018,Columbia,WA,Truck,0,0,0,1518,1518,0
October,31,2018,Yakima,WA,Truck,0,0,0,58757,58757,0
October,31,2018,Richland,SC,Passenger,0,1,1,165,166,0.6
October,31,2018,Nassau,NY,Passenger,3,0,3,36,39,7.69
October,31,2018,Utah,UT,Passenger,0,1,1,137,138,0.72
October,31,2018,Manassas,VA,Passenger,0,1,1,9,10,10
October,31,2018,Orange,CA,Passenger,5,1,6,547,553,1.08
October,31,2018,Prince William,VA,Passenger,0,4,4,258,262,1.53
October,31,2018,Marion,IN,Passenger,1,0,1,119,120,0.83
October,31,2018,Cowlitz,WA,Passenger,69,86,155,72155,72310,0.21
October,31,2018,Oldham,KY,Passenger,0,1,1,5,6,16.67
October,31,2018,Walla Walla,WA,Passenger,36,50,86,35994,36080,0.24
October,31,2018,Cape May,NJ,Passenger,0,1,1,21,22,4.55
October,31,2018,Sangamon,IL,Passenger,1,0,1,11,12,8.33
October,31,2018,Broward,FL,Passenger,2,1,3,136,139,2.16
October,31,2018,Lee,AL,Passenger,1,0,1,36,37,2.7
October,31,2018,Maricopa,AZ,Passenger,3,1,4,1564,1568,0.26
October,31,2018,Dallas,TX,Passenger,0,1,1,197,198,0.51
October,31,2018,New Haven,CT,Passenger,0,1,1,46,47,2.13
October,31,2018,Los Angeles,CA,Passenger,6,5,11,1134,1145,0.96
October,31,2018,Santa Cruz,CA,Passenger,1,0,1,40,41,2.44
October,31,2018,Washington,OR,Passenger,0,1,1,475,476,0.21
October,31,2018,Mason,WA,Truck,0,0,0,20174,20174,0
October,31,2018,Shasta,CA,Passenger,1,0,1,43,44,2.27
October,31,2018,Jefferson,WA,Truck,0,0,0,9612,9612,0
October,31,2018,Charles,MD,Passenger,0,1,1,81,82,1.22
October,31,2018,Guadalupe,TX,Passenger,1,0,1,80,81,1.23
October,31,2018,Grays Harbor,WA,Truck,0,0,0,20286,20286,0
October,31,2018,Orange,FL,Passenger,2,1,3,164,167,1.8
October,31,2018,Marion,OR,Passenger,1,0,1,121,122,0.82
October,31,2018,Skagit,WA,Passenger,240,180,420,91010,91430,0.46
October,31,2018,Pinal,AZ,Passenger,2,0,2,204,206,0.97
October,31,2018,Yakima,WA,Passenger,71,96,167,164423,164590,0.1
October,31,2018,Asotin,WA,Truck,0,0,0,6636,6636,0
October,31,2018,Jefferson,WA,Passenger,163,101,264,24781,25045,1.05
October,31,2018,Rogers,OK,Passenger,1,0,1,6,7,14.29
October,31,2018,Volusia,FL,Passenger,0,1,1,37,38,2.63
October,31,2018,Thurston,WA,Truck,0,0,0,54803,54803,0
October,31,2018,Skamania,WA,Truck,0,0,0,3983,3983,0
October,31,2018,Nueces,TX,Passenger,1,1,2,90,92,2.17
October,31,2018,Cochise,AZ,Passenger,0,1,1,121,122,0.82
October,31,2018,Juneau,AK,Passenger,0,1,1,43,44,2.27
October,31,2018,Douglas,WA,Passenger,47,33,80,27894,27974,0.29
October,31,2018,Cowlitz,WA,Truck,0,0,0,28666,28666,0
October,31,2018,Hardin,KY,Passenger,0,1,1,116,117,0.85
October,31,2018,Snohomish,WA,Truck,1,0,1,121864,121865,0
October,31,2018,Suffolk,MA,Passenger,0,1,1,43,44,2.27
October,31,2018,Grant,WA,Passenger,32,50,82,63918,64000,0.13
October,31,2018,Caddo,LA,Passenger,0,1,1,24,25,4
October,31,2018,Lane,OR,Passenger,0,1,1,174,175,0.57
October,31,2018,Carroll,NH,Passenger,0,1,1,1,2,50
October,31,2018,Cook,IL,Passenger,1,0,1,252,253,0.4
October,31,2018,St. Lucie,FL,Passenger,1,0,1,29,30,3.33
October,31,2018,Monroe,IL,Passenger,1,0,1,4,5,20
October,31,2018,Williamson,TX,Passenger,0,1,1,158,159,0.63
October,31,2018,Benton,WA,Passenger,192,217,409,132576,132985,0.31
October,31,2018,Larimer,CO,Passenger,1,0,1,60,61,1.64
October,31,2018,Pacific,WA,Passenger,19,23,42,15765,15807,0.27
October,31,2018,Chelan,WA,Passenger,126,59,185,53932,54117,0.34
October,31,2018,Chelan,WA,Truck,0,0,0,22058,22058,0
October,31,2018,Montgomery,PA,Passenger,2,0,2,36,38,5.26
October,31,2018,Maui,HI,Passenger,1,0,1,54,55,1.82
October,31,2018,Saratoga,NY,Passenger,1,0,1,60,61,1.64
October,31,2018,San Juan,WA,Passenger,169,69,238,14212,14450,1.65
October,31,2018,Montgomery,MD,Passenger,1,0,1,279,280,0.36
October,31,2018,Whatcom,WA,Passenger,700,341,1041,148806,149847,0.69
October,31,2018,Spokane,WA,Passenger,383,352,735,306205,306940,0.24
October,31,2018,Clallam,WA,Truck,0,0,0,21569,21569,0
October,31,2018,El Paso,CO,Passenger,3,1,4,758,762,0.52
October,31,2018,Klamath,OR,Passenger,1,0,1,34,35,2.86
October,31,2018,Garfield,OK,Passenger,1,0,1,14,15,6.67
October,31,2018,Norfolk,VA,Passenger,2,2,4,336,340,1.18
October,31,2018,San Diego,CA,Passenger,8,2,10,2561,2571,0.39
October,31,2018,Santa Clara,CA,Passenger,8,0,8,373,381,2.1
October,31,2018,Okanogan,WA,Truck,0,0,0,16501,16501,0
October,31,2018,Ventura,CA,Passenger,0,2,2,314,316,0.63
October,31,2018,Prince George,VA,Passenger,0,1,1,78,79,1.27
October,31,2018,Clallam,WA,Passenger,136,119,255,50301,50556,0.5
October,31,2018,Fulton,GA,Passenger,1,2,3,107,110,2.73
October,31,2018,Multnomah,OR,Passenger,3,4,7,758,765,0.92
October,31,2018,Thurston,WA,Passenger,663,552,1215,195071,196286,0.62
October,31,2018,Skamania,WA,Passenger,18,12,30,8728,8758,0.34
October,31,2018,Walla Walla,WA,Truck,0,0,0,13507,13507,0
October,31,2018,Pierce,WA,Truck,0,0,0,138782,138782,0
October,31,2018,Monterey,CA,Passenger,0,1,1,190,191,0.52
October,31,2018,New London,CT,Passenger,0,1,1,254,255,0.39
October,31,2018,Garfield,WA,Truck,0,0,0,960,960,0
October,31,2018,Middlesex,MA,Passenger,0,1,1,138,139,0.72
October,31,2018,Washtenaw,MI,Passenger,1,0,1,38,39,2.56
October,31,2018,Jefferson,CO,Passenger,0,1,1,63,64,1.56
October,31,2018,Pend Oreille,WA,Passenger,6,5,11,9588,9599,0.11
October,31,2018,Arlington,VA,Passenger,1,1,2,166,168,1.19
October,31,2018,Whatcom,WA,Truck,2,0,2,42555,42557,0
October,31,2018,Prince George's,MD,Passenger,1,1,2,180,182,1.1
October,31,2018,Douglas,WA,Truck,0,0,0,12077,12077,0
October,31,2018,Gwinnett,GA,Passenger,0,1,1,79,80,1.25
October,31,2018,Adams,WA,Passenger,5,5,10,12720,12730,0.08
October,31,2018,Richmond,GA,Passenger,0,1,1,92,93,1.08
October,31,2018,Sedgwick,KS,Passenger,0,1,1,99,100,1
October,31,2018,Denver,CO,Passenger,1,0,1,128,129,0.78
October,31,2018,Contra Costa,CA,Passenger,0,2,2,419,421,0.48
October,31,2018,Grays Harbor,WA,Passenger,60,66,126,47272,47398,0.27
October,31,2018,Albemarle,VA,Passenger,1,0,1,27,28,3.57
October,31,2018,Mason,WA,Passenger,101,108,209,46356,46565,0.45
October,31,2018,Stevens,WA,Truck,0,0,0,18721,18721,0
October,31,2018,Lincoln,WA,Passenger,2,6,8,7740,7748,0.1
October,31,2018,Santa Fe,NM,Passenger,0,1,1,43,44,2.27
October,31,2018,Jefferson,NY,Passenger,0,1,1,224,225,0.44
October,31,2018,Island,WA,Passenger,244,216,460,63045,63505,0.72
October,31,2018,Benton,WA,Truck,0,0,0,41429,41429,0
October,31,2018,Cumberland,NC,Passenger,0,1,1,523,524,0.19
October,31,2018,Tuolumne,CA,Passenger,0,1,1,12,13,7.69
October,31,2018,Bexar,TX,Passenger,3,4,7,731,738,0.95
October,31,2018,Twin Falls,ID,Passenger,0,1,1,22,23,4.35
October,31,2018,Ramsey,MN,Passenger,1,0,1,40,41,2.44
October,31,2018,Alameda,CA,Passenger,0,2,2,333,335,0.6
October,31,2018,Clark,NV,Passenger,2,2,4,729,733,0.55
October,31,2018,Fresno,CA,Passenger,1,0,1,185,186,0.54
October,31,2018,Lumpkin,GA,Passenger,1,0,1,7,8,12.5
October,31,2018,Whitman,WA,Passenger,19,33,52,22745,22797,0.23
October,31,2018,Skagit,WA,Truck,1,0,1,32334,32335,0
October,31,2018,Okanogan,WA,Passenger,15,21,36,26108,26144,0.14
October,31,2018,DeKalb,IN,Passenger,1,0,1,1,2,50
October,31,2018,Wahkiakum,WA,Passenger,1,1,2,2984,2986,0.07
October,31,2018,Frederick,MD,Passenger,0,1,1,83,84,1.19
October,31,2018,DeKalb,GA,Passenger,1,0,1,78,79,1.27
October,31,2018,Shelby,TN,Passenger,0,1,1,103,104,0.96
October,31,2018,Duval,FL,Passenger,1,2,3,383,386,0.78
October,31,2018,Pima,AZ,Passenger,1,1,2,405,407,0.49
October,31,2018,Pend Oreille,WA,Truck,0,0,0,5752,5752,0
October,31,2018,Kittitas,WA,Passenger,57,35,92,29279,29371,0.31
October,31,2018,Ferry,WA,Truck,0,0,0,3566,3566,0
October,31,2018,Charleston,SC,Passenger,1,0,1,128,129,0.78
October,31,2018,Clark,WA,Passenger,1149,814,1963,310425,312388,0.63
October,31,2018,Norfolk,MA,Passenger,1,0,1,37,38,2.63
October,31,2018,Deschutes,OR,Passenger,2,0,2,161,163,1.23
October,31,2018,Santa Rosa,FL,Passenger,1,0,1,89,90,1.11
October,31,2018,Lewis,WA,Passenger,88,70,158,58040,58198,0.27
October,31,2018,Clark,WA,Truck,0,0,0,79579,79579,0
October,31,2018,King,WA,Passenger,15034,6221,21255,1376342,1397597,1.52
October,31,2018,Mecklenburg,NC,Passenger,1,0,1,81,82,1.22
October,31,2018,Portsmouth,VA,Passenger,0,1,1,77,78,1.28
October,31,2018,Dakota,MN,Passenger,0,2,2,33,35,5.71
October,31,2018,Lee,FL,Passenger,1,0,1,56,57,1.75
October,31,2018,Fairfax,VA,Passenger,1,2,3,809,812,0.37
October,31,2018,Kootenai,ID,Passenger,1,1,2,218,220,0.91
October,31,2018,Garfield,WA,Passenger,1,1,2,1330,1332,0.15
October,31,2018,Asotin,WA,Passenger,12,9,21,12713,12734,0.16
October,31,2018,Kitsap,WA,Passenger,880,507,1387,179926,181313,0.76
October,31,2018,Flathead,MT,Passenger,1,0,1,53,54,1.85
October,31,2018,Morris,NJ,Passenger,1,0,1,17,18,5.56
October,31,2018,Hamilton,IN,Passenger,1,0,1,47,48,2.08
October,31,2018,Valencia,NM,Passenger,1,0,1,10,11,9.09
October,31,2018,Klickitat,WA,Truck,0,0,0,8154,8154,0
October,31,2018,San Francisco,CA,Passenger,1,1,2,115,117,1.71
October,31,2018,El Paso,TX,Passenger,1,0,1,501,502,0.2
October,31,2018,Grant,WA,Truck,0,0,0,26085,26085,0
October,31,2018,Pacific,WA,Truck,0,0,0,7630,7630,0
October,31,2018,Camden,NJ,Passenger,0,1,1,27,28,3.57
October,31,2018,St. Mary's,MD,Passenger,1,0,1,219,220,0.45
October,31,2018,Wahkiakum,WA,Truck,0,0,0,1701,1701,0
October,31,2018,Lincoln,WA,Truck,0,0,0,4608,4608,0
October,31,2018,Montgomery,TX,Passenger,2,0,2,61,63,3.17
October,31,2018,Klickitat,WA,Passenger,24,32,56,15389,15445,0.36
October,31,2018,Anne Arundel,MD,Passenger,0,1,1,451,452,0.22
October,31,2018,DuPage,IL,Passenger,1,0,1,56,57,1.75
October,31,2018,Beaufort,SC,Passenger,1,0,1,35,36,2.78
October,31,2018,Spokane,WA,Truck,1,0,1,93433,93434,0
October,31,2018,Ada,ID,Passenger,0,2,2,313,315,0.63
October,31,2018,,,Passenger,7,2,9,778,787,1.14
October,31,2018,Kitsap,WA,Truck,1,0,1,53622,53623,0
October,31,2018,Stevens,WA,Passenger,14,28,42,31809,31851,0.13
October,31,2018,Allegheny,PA,Passenger,1,0,1,83,84,1.19
October,31,2018,Clackamas,OR,Passenger,0,1,1,214,215,0.47
October,31,2018,Pierce,WA,Passenger,1405,1305,2710,537166,539876,0.5
October,31,2018,Madison,ID,Passenger,1,0,1,37,38,2.63
October,31,2018,Randolph,NC,Passenger,1,0,1,5,6,16.67
October,31,2018,Hawaii,HI,Passenger,1,0,1,67,68,1.47
October,31,2018,Franklin,WA,Truck,0,0,0,18952,18952,0
October,31,2018,Kittitas,WA,Truck,0,0,0,14126,14126,0
October,31,2018,Clay,FL,Passenger,0,1,1,91,92,1.09
October,31,2018,Douglas,NE,Passenger,0,1,1,68,69,1.45
October,31,2018,Houston,GA,Passenger,1,0,1,53,54,1.85
October,31,2018,San Juan,WA,Truck,0,0,0,5787,5787,0
October,31,2018,Tarrant,TX,Passenger,1,0,1,206,207,0.48
October,31,2018,Franklin,MA,Passenger,0,1,1,1,2,50
October,31,2018,Howard,MD,Passenger,0,1,1,87,88,1.14
October,31,2018,Moore,NC,Passenger,0,1,1,195,196,0.51
October,31,2018,Washoe,NV,Passenger,1,0,1,108,109,0.92
October,31,2018,Tulsa,OK,Passenger,1,1,2,47,49,4.08
October,31,2018,San Juan,PR,Passenger,0,1,1,4,5,20
October,31,2018,King,WA,Truck,7,1,8,182837,182845,0
October,31,2018,Ferry,WA,Passenger,3,2,5,4406,4411,0.11
September,30,2018,Volusia,FL,Passenger,0,1,1,38,39,2.56
September,30,2018,Cowlitz,WA,Passenger,63,85,148,72024,72172,0.21
September,30,2018,Cumberland,NC,Passenger,0,1,1,526,527,0.19
September,30,2018,Walla Walla,WA,Truck,0,0,0,13492,13492,0
September,30,2018,Skagit,WA,Passenger,222,176,398,90860,91258,0.44
September,30,2018,Collin,TX,Passenger,1,1,2,152,154,1.3
September,30,2018,Nantucket,MA,Passenger,1,0,1,4,5,20
September,30,2018,Maui,HI,Passenger,1,0,1,56,57,1.75
September,30,2018,El Paso,CO,Passenger,3,1,4,761,765,0.52
September,30,2018,Klickitat,WA,Passenger,24,32,56,15362,15418,0.36
September,30,2018,Brevard,FL,Passenger,0,1,1,92,93,1.08
September,30,2018,Palm Beach,FL,Passenger,0,1,1,88,89,1.12
September,30,2018,Ferry,WA,Truck,0,0,0,3559,3559,0
September,30,2018,Kootenai,ID,Passenger,0,1,1,216,217,0.46
September,30,2018,Whatcom,WA,Truck,2,0,2,42433,42435,0
September,30,2018,Carson City,NV,Passenger,1,0,1,14,15,6.67
September,30,2018,Chelan,WA,Passenger,117,59,176,53803,53979,0.33
September,30,2018,Snohomish,WA,Passenger,2516,1329,3845,524563,528408,0.73
September,30,2018,Guadalupe,TX,Passenger,1,0,1,83,84,1.19
September,30,2018,Shelby,TN,Passenger,0,1,1,102,103,0.97
September,30,2018,DuPage,IL,Passenger,1,0,1,56,57,1.75
September,30,2018,Bexar,TX,Passenger,3,4,7,732,739,0.95
September,30,2018,Williamson,TX,Passenger,0,1,1,160,161,0.62
September,30,2018,Franklin,MA,Passenger,0,1,1,1,2,50
September,30,2018,Wahkiakum,WA,Passenger,1,1,2,2980,2982,0.07
September,30,2018,St. Lucie,FL,Passenger,1,0,1,30,31,3.23
September,30,2018,Juneau,AK,Passenger,0,1,1,43,44,2.27
September,30,2018,Mecklenburg,NC,Passenger,1,0,1,82,83,1.2
September,30,2018,Skamania,WA,Truck,0,0,0,3967,3967,0
September,30,2018,Pacific,WA,Passenger,18,22,40,15733,15773,0.25
September,30,2018,Wahkiakum,WA,Truck,0,0,0,1691,1691,0
September,30,2018,Ada,ID,Passenger,0,2,2,315,317,0.63
September,30,2018,Madison,ID,Passenger,1,0,1,38,39,2.56
September,30,2018,Latah,ID,Passenger,0,1,1,72,73,1.37
September,30,2018,Stevens,WA,Truck,0,0,0,18680,18680,0
September,30,2018,Frederick,MD,Passenger,0,1,1,87,88,1.14
September,30,2018,St. Clair,IL,Passenger,0,1,1,158,159,0.63
September,30,2018,Duval,FL,Passenger,1,2,3,383,386,0.78
September,30,2018,New Haven,CT,Passenger,0,1,1,48,49,2.04
September,30,2018,Virginia Beach,VA,Passenger,2,1,3,697,700,0.43
September,30,2018,King,WA,Truck,7,1,8,182870,182878,0
September,30,2018,Jefferson,WA,Passenger,153,99,252,24693,24945,1.01
September,30,2018,Walla Walla,WA,Passenger,36,50,86,35925,36011,0.24
September,30,2018,Kent,MI,Passenger,0,1,1,27,28,3.57
September,30,2018,Jefferson,WA,Truck,0,0,0,9644,9644,0
September,30,2018,St. Mary's,MD,Passenger,1,0,1,217,218,0.46
September,30,2018,Washoe,NV,Passenger,1,0,1,111,112,0.89
September,30,2018,Montgomery,MD,Passenger,1,0,1,283,284,0.35
September,30,2018,Adams,WA,Truck,0,0,0,5158,5158,0
September,30,2018,Jefferson,NY,Passenger,0,1,1,225,226,0.44
September,30,2018,Houston,GA,Passenger,1,0,1,54,55,1.82
September,30,2018,Mason,WA,Passenger,94,100,194,46187,46381,0.42
September,30,2018,Kittitas,WA,Truck,0,0,0,14105,14105,0
September,30,2018,Klamath,OR,Passenger,1,0,1,35,36,2.78
September,30,2018,Montgomery,PA,Passenger,2,0,2,36,38,5.26
September,30,2018,Norfolk,MA,Passenger,1,0,1,37,38,2.63
September,30,2018,Washington,OR,Passenger,0,1,1,469,470,0.21
September,30,2018,Gwinnett,GA,Passenger,0,1,1,84,85,1.18
September,30,2018,Manatee,FL,Passenger,1,0,1,37,38,2.63
September,30,2018,Carroll,NH,Passenger,0,1,1,1,2,50
September,30,2018,Grant,WA,Truck,0,0,0,26068,26068,0
September,30,2018,Clark,WA,Passenger,1089,784,1873,309720,311593,0.6
September,30,2018,Hawaii,HI,Passenger,1,0,1,70,71,1.41
September,30,2018,Hardin,KY,Passenger,0,1,1,121,122,0.82
September,30,2018,DeKalb,IN,Passenger,1,0,1,1,2,50
September,30,2018,Anne Arundel,MD,Passenger,0,1,1,450,451,0.22
September,30,2018,Arlington,VA,Passenger,1,1,2,170,172,1.16
September,30,2018,Columbia,WA,Passenger,2,2,4,2429,2433,0.16
September,30,2018,Marion,IN,Passenger,1,0,1,118,119,0.84
September,30,2018,Los Angeles,CA,Passenger,7,5,12,1130,1142,1.05
September,30,2018,Nassau,NY,Passenger,2,0,2,37,39,5.13
September,30,2018,Richland,SC,Passenger,0,1,1,167,168,0.6
September,30,2018,Lewis,WA,Truck,0,0,0,25568,25568,0
September,30,2018,Tarrant,TX,Passenger,1,0,1,210,211,0.47
September,30,2018,Clark,WA,Truck,0,0,0,79366,79366,0
September,30,2018,San Juan,PR,Passenger,0,1,1,4,5,20
September,30,2018,Clallam,WA,Passenger,129,122,251,50164,50415,0.5
September,30,2018,Benton,WA,Passenger,188,209,397,132434,132831,0.3
September,30,2018,Orange,CA,Passenger,4,1,5,549,554,0.9
September,30,2018,Okanogan,WA,Truck,0,0,0,16497,16497,0
September,30,2018,New London,CT,Passenger,0,1,1,253,254,0.39
September,30,2018,Grays Harbor,WA,Passenger,55,65,120,47163,47283,0.25
September,30,2018,Santa Fe,NM,Passenger,0,1,1,44,45,2.22
September,30,2018,Tuolumne,CA,Passenger,0,1,1,12,13,7.69
September,30,2018,Yakima,WA,Passenger,67,93,160,164243,164403,0.1
September,30,2018,Sangamon,IL,Passenger,1,0,1,11,12,8.33
September,30,2018,Multnomah,OR,Passenger,3,4,7,775,782,0.9
September,30,2018,Charles,MD,Passenger,0,1,1,82,83,1.2
September,30,2018,Santa Clara,CA,Passenger,8,0,8,373,381,2.1
September,30,2018,Island,WA,Truck,0,0,0,21101,21101,0
September,30,2018,Middlesex,MA,Passenger,0,1,1,139,140,0.71
September,30,2018,San Diego,CA,Passenger,7,2,9,2558,2567,0.35
September,30,2018,Caddo,LA,Passenger,0,1,1,23,24,4.17
September,30,2018,Camden,NJ,Passenger,0,1,1,27,28,3.57
September,30,2018,Skamania,WA,Passenger,15,11,26,8710,8736,0.3
September,30,2018,Columbia,WA,Truck,0,0,0,1521,1521,0
September,30,2018,Monroe,IL,Passenger,1,0,1,5,6,16.67
September,30,2018,Lee,AL,Passenger,1,0,1,37,38,2.63
September,30,2018,Flathead,MT,Passenger,1,0,1,51,52,1.92
September,30,2018,Monterey,CA,Passenger,0,1,1,189,190,0.53
September,30,2018,Whitman,WA,Passenger,20,32,52,22690,22742,0.23
September,30,2018,Klickitat,WA,Truck,0,0,0,8137,8137,0
September,30,2018,Pierce,WA,Passenger,1325,1267,2592,535571,538163,0.48
September,30,2018,Grant,WA,Passenger,33,50,83,63766,63849,0.13
September,30,2018,Sumter,FL,Passenger,0,1,1,10,11,9.09
September,30,2018,Cochise,AZ,Passenger,0,1,1,120,121,0.83
September,30,2018,Douglas,NE,Passenger,0,1,1,68,69,1.45
September,30,2018,Fairfax,VA,Passenger,2,2,4,809,813,0.49
September,30,2018,Hamilton,IN,Passenger,1,0,1,47,48,2.08
September,30,2018,Oldham,KY,Passenger,0,1,1,5,6,16.67
September,30,2018,Snohomish,WA,Truck,1,0,1,121775,121776,0
September,30,2018,Norfolk,VA,Passenger,2,2,4,331,335,1.19
September,30,2018,Kitsap,WA,Passenger,841,499,1340,179462,180802,0.74
September,30,2018,Whatcom,WA,Passenger,666,335,1001,148503,149504,0.67
September,30,2018,Dallas,TX,Passenger,0,1,1,196,197,0.51
September,30,2018,Clallam,WA,Truck,0,0,0,21492,21492,0
September,30,2018,King,WA,Passenger,14203,6079,20282,1373990,1394272,1.45
September,30,2018,Clackamas,OR,Passenger,0,1,1,217,218,0.46
September,30,2018,Lincoln,WA,Truck,0,0,0,4580,4580,0
September,30,2018,Allegheny,PA,Passenger,1,0,1,80,81,1.23
September,30,2018,Kitsap,WA,Truck,1,0,1,53537,53538,0
September,30,2018,Benton,WA,Truck,0,0,0,41347,41347,0
September,30,2018,Pend Oreille,WA,Passenger,5,5,10,9589,9599,0.1
September,30,2018,Montgomery,TX,Passenger,2,0,2,61,63,3.17
September,30,2018,Maricopa,AZ,Passenger,2,1,3,1561,1564,0.19
September,30,2018,Island,WA,Passenger,227,208,435,62869,63304,0.69
September,30,2018,Pinal,AZ,Passenger,2,0,2,201,203,0.99
September,30,2018,District of Columbia,DC,Passenger,0,3,3,197,200,1.5
September,30,2018,Ferry,WA,Passenger,2,2,4,4406,4410,0.09
September,30,2018,Prince George,VA,Passenger,0,1,1,76,77,1.3
September,30,2018,Contra Costa,CA,Passenger,0,2,2,423,425,0.47
September,30,2018,Fulton,GA,Passenger,1,2,3,107,110,2.73
September,30,2018,Morris,NJ,Passenger,1,0,1,17,18,5.56
September,30,2018,Denver,CO,Passenger,1,0,1,134,135,0.74
September,30,2018,Okanogan,WA,Passenger,10,20,30,26057,26087,0.11
September,30,2018,Howard,MD,Passenger,0,1,1,87,88,1.14
September,30,2018,Orange,FL,Passenger,2,1,3,165,168,1.79
September,30,2018,Douglas,WA,Passenger,48,33,81,27849,27930,0.29
September,30,2018,Alameda,CA,Passenger,0,2,2,333,335,0.6
September,30,2018,Utah,UT,Passenger,0,1,1,138,139,0.72
September,30,2018,Washtenaw,MI,Passenger,1,0,1,38,39,2.56
September,30,2018,Clay,FL,Passenger,0,1,1,91,92,1.09
September,30,2018,Beaufort,SC,Passenger,1,0,1,37,38,2.63
September,30,2018,Cowlitz,WA,Truck,0,0,0,28600,28600,0
September,30,2018,Saratoga,NY,Passenger,1,0,1,62,63,1.59
September,30,2018,Twin Falls,ID,Passenger,0,1,1,21,22,4.55
September,30,2018,Lewis,WA,Passenger,84,66,150,57934,58084,0.26
September,30,2018,Dale,AL,Passenger,0,1,1,57,58,1.72
September,30,2018,Prince George's,MD,Passenger,1,1,2,180,182,1.1
September,30,2018,Garfield,WA,Passenger,1,1,2,1320,1322,0.15
September,30,2018,Pima,AZ,Passenger,1,1,2,410,412,0.49
September,30,2018,Lincoln,WA,Passenger,2,6,8,7748,7756,0.1
September,30,2018,Stevens,WA,Passenger,13,27,40,31699,31739,0.13
September,30,2018,Moore,NC,Passenger,0,1,1,196,197,0.51
September,30,2018,Spokane,WA,Passenger,359,344,703,305145,305848,0.23
September,30,2018,Grays Harbor,WA,Truck,0,0,0,20307,20307,0
September,30,2018,Asotin,WA,Passenger,11,8,19,12678,12697,0.15
September,30,2018,Ramsey,MN,Passenger,1,0,1,40,41,2.44
September,30,2018,Deschutes,OR,Passenger,2,0,2,162,164,1.22
September,30,2018,Polk,FL,Passenger,1,0,1,63,64,1.56
September,30,2018,,,Passenger,6,2,8,768,776,1.03
September,30,2018,Thurston,WA,Truck,0,0,0,54640,54640,0
September,30,2018,Douglas,WA,Truck,0,0,0,12012,12012,0
September,30,2018,Jefferson,CO,Passenger,0,1,1,64,65,1.54
September,30,2018,Honolulu,HI,Passenger,1,2,3,524,527,0.57
September,30,2018,Cape May,NJ,Passenger,0,1,1,22,23,4.35
September,30,2018,Garfield,OK,Passenger,1,0,1,15,16,6.25
September,30,2018,Marion,OR,Passenger,1,0,1,122,123,0.81
September,30,2018,Spokane,WA,Truck,1,0,1,93185,93186,0
September,30,2018,Portsmouth,VA,Passenger,0,1,1,76,77,1.3
September,30,2018,Whitman,WA,Truck,0,0,0,8517,8517,0
September,30,2018,Thurston,WA,Passenger,621,527,1148,194606,195754,0.59
September,30,2018,San Francisco,CA,Passenger,1,1,2,117,119,1.68
September,30,2018,Ventura,CA,Passenger,0,2,2,311,313,0.64
September,30,2018,Suffolk,MA,Passenger,0,1,1,43,44,2.27
September,30,2018,Dakota,MN,Passenger,0,2,2,33,35,5.71
September,30,2018,Richmond,GA,Passenger,0,1,1,92,93,1.08
September,30,2018,Pacific,WA,Truck,0,0,0,7632,7632,0
September,30,2018,Pend Oreille,WA,Truck,0,0,0,5744,5744,0
September,30,2018,Lee,FL,Passenger,1,0,1,57,58,1.72
September,30,2018,Yakima,WA,Truck,0,0,0,58690,58690,0
September,30,2018,Prince William,VA,Passenger,0,4,4,260,264,1.52
September,30,2018,Franklin,WA,Passenger,37,65,102,58512,58614,0.17
September,30,2018,Cook,IL,Passenger,1,0,1,256,257,0.39
September,30,2018,Riverside,CA,Passenger,2,2,4,688,692,0.58
September,30,2018,Mason,WA,Truck,0,0,0,20090,20090,0
September,30,2018,Broward,FL,Passenger,1,1,2,135,137,1.46
September,30,2018,Sedgwick,KS,Passenger,0,1,1,97,98,1.02
September,30,2018,San Juan,WA,Truck,0,0,0,5761,5761,0
September,30,2018,Asotin,WA,Truck,0,0,0,6631,6631,0
September,30,2018,Manassas,VA,Passenger,0,1,1,9,10,10
September,30,2018,Lumpkin,GA,Passenger,1,0,1,7,8,12.5
September,30,2018,Charleston,SC,Passenger,1,0,1,129,130,0.77
September,30,2018,San Juan,WA,Passenger,161,68,229,14183,14412,1.59
September,30,2018,Lane,OR,Passenger,0,1,1,177,178,0.56
September,30,2018,Chelan,WA,Truck,0,0,0,22027,22027,0
September,30,2018,DeKalb,GA,Passenger,1,0,1,78,79,1.27
September,30,2018,Skagit,WA,Truck,1,0,1,32261,32262,0
September,30,2018,Hennepin,MN,Passenger,1,0,1,110,111,0.9
September,30,2018,Santa Rosa,FL,Passenger,1,0,1,89,90,1.11
September,30,2018,Fresno,CA,Passenger,1,0,1,191,192,0.52
September,30,2018,Garfield,WA,Truck,0,0,0,966,966,0
September,30,2018,Nueces,TX,Passenger,1,1,2,88,90,2.22
September,30,2018,Queens,NY,Passenger,1,0,1,61,62,1.61
September,30,2018,Larimer,CO,Passenger,1,0,1,61,62,1.61
September,30,2018,Franklin,WA,Truck,0,0,0,18876,18876,0
September,30,2018,Clark,NV,Passenger,1,2,3,732,735,0.41
September,30,2018,Tulsa,OK,Passenger,1,1,2,47,49,4.08
September,30,2018,Pierce,WA,Truck,0,0,0,138460,138460,0
September,30,2018,El Paso,TX,Passenger,1,0,1,498,499,0.2
September,30,2018,Adams,WA,Passenger,5,5,10,12682,12692,0.08
September,30,2018,Kittitas,WA,Passenger,55,36,91,29200,29291,0.31
September,30,2018,San Mateo,CA,Passenger,1,1,2,132,134,1.49
April,30,2019,Pierce,WA,Passenger,1692,1486,3178,540913,544091,0.58
April,30,2019,New London,CT,Passenger,0,2,2,250,252,0.79
April,30,2019,Clark,WA,Truck,0,0,0,80105,80105,0
April,30,2019,Grant,WA,Truck,0,0,0,26430,26430,0
April,30,2019,Anne Arundel,MD,Passenger,0,2,2,448,450,0.44
April,30,2019,Wahkiakum,WA,Truck,0,0,0,1733,1733,0
April,30,2019,Travis,TX,Passenger,2,1,3,196,199,1.51
April,30,2019,Jefferson,NY,Passenger,0,2,2,219,221,0.9
April,30,2019,Wahkiakum,WA,Passenger,1,1,2,3014,3016,0.07
April,30,2019,Hennepin,MN,Passenger,2,0,2,103,105,1.9
April,30,2019,Yakima,WA,Passenger,93,103,196,164616,164812,0.12
April,30,2019,Douglas,NE,Passenger,0,1,1,63,64,1.56
April,30,2019,Montgomery,PA,Passenger,2,0,2,38,40,5
April,30,2019,Nueces,TX,Passenger,1,1,2,96,98,2.04
April,30,2019,Whitman,WA,Passenger,29,45,74,22711,22785,0.32
April,30,2019,Skamania,WA,Truck,0,0,0,4039,4039,0
April,30,2019,San Juan,PR,Passenger,0,1,1,3,4,25
April,30,2019,Benton,WA,Passenger,248,263,511,133307,133818,0.38
April,30,2019,Whitman,WA,Truck,0,0,0,8517,8517,0
April,30,2019,Manassas,VA,Passenger,0,1,1,8,9,11.11
April,30,2019,Nantucket,MA,Passenger,1,0,1,3,4,25
April,30,2019,Norfolk,VA,Passenger,2,2,4,352,356,1.12
April,30,2019,Jefferson,WA,Passenger,187,118,305,24901,25206,1.21
April,30,2019,Walla Walla,WA,Passenger,46,57,103,36137,36240,0.28
April,30,2019,Lake,FL,Passenger,1,0,1,19,20,5
April,30,2019,St. Clair,IL,Passenger,0,1,1,160,161,0.62
April,30,2019,Ramsey,MN,Passenger,1,0,1,43,44,2.27
April,30,2019,Owyhee,ID,Passenger,1,0,1,5,6,16.67
April,30,2019,San Mateo,CA,Passenger,2,1,3,122,125,2.4
April,30,2019,Brevard,FL,Passenger,0,1,1,85,86,1.16
April,30,2019,Cochise,AZ,Passenger,0,1,1,116,117,0.85
April,30,2019,Pinal,AZ,Passenger,2,0,2,195,197,1.02
April,30,2019,Chelan,WA,Truck,0,0,0,22173,22173,0
April,30,2019,Cape May,NJ,Passenger,0,1,1,17,18,5.56
April,30,2019,Pierce,WA,Truck,0,0,0,139350,139350,0
April,30,2019,Columbia,WA,Passenger,2,2,4,2441,2445,0.16
April,30,2019,Honolulu,HI,Passenger,2,3,5,503,508,0.98
April,30,2019,Charleston,SC,Passenger,1,0,1,119,120,0.83
April,30,2019,Arlington,VA,Passenger,1,2,3,160,163,1.84
April,30,2019,Dale,AL,Passenger,0,1,1,56,57,1.75
April,30,2019,Yakima,WA,Truck,0,0,0,58948,58948,0
April,30,2019,Skamania,WA,Passenger,21,16,37,8713,8750,0.42
April,30,2019,Allegheny,PA,Passenger,1,0,1,84,85,1.18
April,30,2019,San Joaquin,CA,Passenger,1,0,1,133,134,0.75
April,30,2019,Sedgwick,KS,Passenger,0,1,1,102,103,0.97
April,30,2019,Washtenaw,MI,Passenger,1,0,1,37,38,2.63
April,30,2019,Bucks,PA,Passenger,1,0,1,17,18,5.56
April,30,2019,Okanogan,WA,Passenger,20,22,42,26020,26062,0.16
April,30,2019,Garfield,WA,Truck,0,0,0,958,958,0
April,30,2019,Duval,FL,Passenger,1,2,3,382,385,0.78
April,30,2019,Clark,WA,Passenger,1414,896,2310,312581,314891,0.73
April,30,2019,San Diego,CA,Passenger,10,3,13,2654,2667,0.49
April,30,2019,Cowlitz,WA,Truck,0,0,0,28852,28852,0
April,30,2019,Ventura,CA,Passenger,0,2,2,311,313,0.64
April,30,2019,Kern,CA,Passenger,0,1,1,225,226,0.44
April,30,2019,Montgomery,MD,Passenger,1,0,1,272,273,0.37
April,30,2019,Palm Beach,FL,Passenger,0,1,1,92,93,1.08
April,30,2019,Caddo,LA,Passenger,0,1,1,23,24,4.17
April,30,2019,Charles,MD,Passenger,0,1,1,82,83,1.2
April,30,2019,DeKalb,GA,Passenger,1,0,1,80,81,1.23
April,30,2019,Alexandria,VA,Passenger,1,0,1,154,155,0.65
April,30,2019,Multnomah,OR,Passenger,4,5,9,749,758,1.19
April,30,2019,St. Lucie,FL,Passenger,1,0,1,30,31,3.23
April,30,2019,,,Passenger,8,2,10,790,800,1.25
April,30,2019,Bexar,TX,Passenger,3,4,7,677,684,1.02
April,30,2019,Montgomery,AL,Passenger,0,1,1,44,45,2.22
April,30,2019,Shasta,CA,Passenger,1,0,1,40,41,2.44
April,30,2019,Sumter,FL,Passenger,0,1,1,10,11,9.09
April,30,2019,Richmond,GA,Passenger,0,1,1,93,94,1.06
April,30,2019,Los Angeles,CA,Passenger,8,5,13,1095,1108,1.17
April,30,2019,Orange,CA,Passenger,6,1,7,529,536,1.31
April,30,2019,Harnett,NC,Passenger,1,1,2,214,216,0.93
April,30,2019,Asotin,WA,Passenger,12,8,20,12659,12679,0.16
April,30,2019,Cascade,MT,Passenger,0,1,1,58,59,1.69
April,30,2019,King,WA,Passenger,18277,6871,25148,1384099,1409247,1.78
April,30,2019,Whatcom,WA,Truck,2,0,2,42771,42773,0
April,30,2019,Whatcom,WA,Passenger,823,394,1217,150081,151298,0.8
April,30,2019,Santa Rosa,FL,Passenger,1,0,1,87,88,1.14
April,30,2019,Deschutes,OR,Passenger,2,0,2,154,156,1.28
April,30,2019,Santa Fe,NM,Passenger,0,1,1,40,41,2.44
April,30,2019,Broward,FL,Passenger,2,1,3,128,131,2.29
April,30,2019,Penobscot,ME,Passenger,0,1,1,13,14,7.14
April,30,2019,Douglas,WA,Truck,0,0,0,12176,12176,0
April,30,2019,Sangamon,IL,Passenger,2,0,2,7,9,22.22
April,30,2019,Pacific,WA,Truck,0,0,0,7660,7660,0
April,30,2019,Chelan,WA,Passenger,147,66,213,54294,54507,0.39
April,30,2019,Pend Oreille,WA,Truck,0,0,0,5753,5753,0
April,30,2019,Dakota,MN,Passenger,0,2,2,36,38,5.26
April,30,2019,Grant,WA,Passenger,35,60,95,64382,64477,0.15
April,30,2019,Klickitat,WA,Passenger,33,33,66,15507,15573,0.42
April,30,2019,Fresno,CA,Passenger,1,0,1,187,188,0.53
April,30,2019,Volusia,FL,Passenger,0,1,1,36,37,2.7
April,30,2019,Walla Walla,WA,Truck,0,0,0,13603,13603,0
April,30,2019,Howard,MD,Passenger,0,1,1,77,78,1.28
April,30,2019,Richland,SC,Passenger,0,1,1,161,162,0.62
April,30,2019,Fairfax,VA,Passenger,3,2,5,781,786,0.64
April,30,2019,Kitsap,WA,Passenger,1009,575,1584,180200,181784,0.87
April,30,2019,DuPage,IL,Passenger,1,0,1,60,61,1.64
April,30,2019,Tulsa,OK,Passenger,1,1,2,46,48,4.17
April,30,2019,Mecklenburg,NC,Passenger,1,0,1,83,84,1.19
April,30,2019,Santa Clara,CA,Passenger,8,1,9,362,371,2.43
April,30,2019,Portsmouth,VA,Passenger,0,1,1,75,76,1.32
April,30,2019,Kittitas,WA,Passenger,71,35,106,29489,29595,0.36
April,30,2019,Mason,WA,Truck,0,0,0,20326,20326,0
April,30,2019,Pend Oreille,WA,Passenger,4,5,9,9505,9514,0.09
April,30,2019,Franklin,MA,Passenger,0,1,1,1,2,50
April,30,2019,Clay,FL,Passenger,0,1,1,87,88,1.14
April,30,2019,Thurston,WA,Passenger,821,613,1434,196770,198204,0.72
April,30,2019,Saratoga,NY,Passenger,1,0,1,58,59,1.69
April,30,2019,Tarrant,TX,Passenger,2,0,2,200,202,0.99
April,30,2019,Asotin,WA,Truck,0,0,0,6629,6629,0
April,30,2019,Berkshire,MA,Passenger,0,1,1,4,5,20
April,30,2019,Spokane,WA,Truck,1,0,1,94382,94383,0
April,30,2019,Clallam,WA,Passenger,160,132,292,50458,50750,0.58
April,30,2019,Oldham,KY,Passenger,0,1,1,5,6,16.67
April,30,2019,King,WA,Truck,5,1,6,181820,181826,0
April,30,2019,New Haven,CT,Passenger,0,2,2,49,51,3.92
April,30,2019,El Paso,TX,Passenger,3,0,3,486,489,0.61
April,30,2019,Stevens,WA,Truck,0,0,0,18683,18683,0
April,30,2019,Klamath,OR,Passenger,1,0,1,38,39,2.56
April,30,2019,St. Mary's,MD,Passenger,1,0,1,210,211,0.47
April,30,2019,Thurston,WA,Truck,0,0,0,55024,55024,0
April,30,2019,Adams,WA,Passenger,5,6,11,12657,12668,0.09
April,30,2019,Ferry,WA,Passenger,4,2,6,4370,4376,0.14
April,30,2019,Washoe,NV,Passenger,2,0,2,110,112,1.79
April,30,2019,Lee,AL,Passenger,1,0,1,35,36,2.78
April,30,2019,Rogers,OK,Passenger,1,0,1,5,6,16.67
April,30,2019,Bergen,NJ,Passenger,1,0,1,26,27,3.7
April,30,2019,Santa Cruz,CA,Passenger,1,0,1,39,40,2.5
April,30,2019,Harris,TX,Passenger,0,1,1,248,249,0.4
April,30,2019,Polk,FL,Passenger,1,0,1,65,66,1.52
April,30,2019,Tuolumne,CA,Passenger,0,1,1,12,13,7.69
April,30,2019,Frederick,MD,Passenger,1,1,2,78,80,2.5
April,30,2019,Benton,WA,Truck,0,0,0,41655,41655,0
April,30,2019,Lincoln,WA,Truck,0,0,0,4700,4700,0
April,30,2019,Randolph,NC,Passenger,1,0,1,6,7,14.29
April,30,2019,Riverside,CA,Passenger,2,2,4,663,667,0.6
April,30,2019,Calvert,MD,Passenger,0,2,2,86,88,2.27
April,30,2019,Norfolk,MA,Passenger,1,0,1,37,38,2.63
April,30,2019,Contra Costa,CA,Passenger,2,2,4,389,393,1.02
April,30,2019,Moore,NC,Passenger,0,1,1,181,182,0.55
April,30,2019,San Juan,WA,Truck,0,0,0,5834,5834,0
April,30,2019,Larimer,CO,Passenger,1,0,1,58,59,1.69
April,30,2019,Lumpkin,GA,Passenger,1,0,1,6,7,14.29
April,30,2019,Carson City,NV,Passenger,1,0,1,14,15,6.67
April,30,2019,Grays Harbor,WA,Truck,0,0,0,20395,20395,0
April,30,2019,Middlesex,MA,Passenger,1,1,2,116,118,1.69
April,30,2019,Klickitat,WA,Truck,0,0,0,8222,8222,0
April,30,2019,Ada,ID,Passenger,0,2,2,309,311,0.64
April,30,2019,Williamson,TX,Passenger,0,1,1,143,144,0.69
April,30,2019,Maricopa,AZ,Passenger,6,2,8,1537,1545,0.52
April,30,2019,Okanogan,WA,Truck,0,0,0,16478,16478,0
April,30,2019,Prince George's,MD,Passenger,1,1,2,185,187,1.07
April,30,2019,Flathead,MT,Passenger,1,0,1,60,61,1.64
April,30,2019,DeKalb,IN,Passenger,1,0,1,1,2,50
April,30,2019,Spokane,WA,Passenger,512,407,919,309575,310494,0.3
April,30,2019,Kent,MI,Passenger,0,1,1,22,23,4.35
April,30,2019,Lee,FL,Passenger,1,0,1,53,54,1.85
April,30,2019,Cowlitz,WA,Passenger,89,101,190,72747,72937,0.26
April,30,2019,Alameda,CA,Passenger,3,2,5,311,316,1.58
April,30,2019,Mason,WA,Passenger,117,118,235,46864,47099,0.5
April,30,2019,Stevens,WA,Passenger,19,27,46,31638,31684,0.15
April,30,2019,Kootenai,ID,Passenger,1,1,2,215,217,0.92
April,30,2019,Snohomish,WA,Truck,1,0,1,122012,122013,0
April,30,2019,Grays Harbor,WA,Passenger,70,84,154,47665,47819,0.32
April,30,2019,Prince William,VA,Passenger,1,4,5,257,262,1.91
April,30,2019,Island,WA,Passenger,310,241,551,63255,63806,0.86
April,30,2019,Pacific,WA,Passenger,23,28,51,15922,15973,0.32
April,30,2019,Island,WA,Truck,0,0,0,21247,21247,0
April,30,2019,Pima,AZ,Passenger,1,1,2,398,400,0.5
April,30,2019,Lewis,WA,Truck,0,0,0,25826,25826,0
April,30,2019,San Francisco,CA,Passenger,2,1,3,111,114,2.63
April,30,2019,Suffolk,MA,Passenger,0,1,1,40,41,2.44
April,30,2019,District of Columbia,DC,Passenger,1,1,2,207,209,0.96
April,30,2019,Lincoln,WA,Passenger,3,6,9,7756,7765,0.12
April,30,2019,Camden,NJ,Passenger,0,1,1,25,26,3.85
April,30,2019,Franklin,WA,Truck,0,0,0,19218,19218,0
April,30,2019,Franklin,WA,Passenger,53,67,120,59469,59589,0.2
April,30,2019,Collin,TX,Passenger,1,1,2,132,134,1.49
April,30,2019,Marion,OR,Passenger,1,0,1,115,116,0.86
April,30,2019,San Juan,WA,Passenger,204,69,273,14332,14605,1.87
April,30,2019,Shelby,TN,Passenger,0,1,1,94,95,1.05
April,30,2019,Monroe,IL,Passenger,1,0,1,4,5,20
April,30,2019,Hawaii,HI,Passenger,1,0,1,61,62,1.61
April,30,2019,Wayne,MI,Passenger,0,1,1,69,70,1.43
April,30,2019,Valencia,NM,Passenger,1,0,1,8,9,11.11
April,30,2019,Guadalupe,TX,Passenger,1,0,1,76,77,1.3
April,30,2019,Douglas,WA,Passenger,55,34,89,27972,28061,0.32
April,30,2019,Virginia Beach,VA,Passenger,1,1,2,702,704,0.28
April,30,2019,Cumberland,NC,Passenger,0,2,2,507,509,0.39
April,30,2019,Clark,NV,Passenger,3,2,5,690,695,0.72
April,30,2019,Jefferson,WA,Truck,0,0,0,9652,9652,0
April,30,2019,Snohomish,WA,Passenger,3292,1539,4831,529161,533992,0.9
April,30,2019,Jefferson,CO,Passenger,0,2,2,59,61,3.28
April,30,2019,Denver,CO,Passenger,1,0,1,130,131,0.76
April,30,2019,Montgomery,TX,Passenger,2,0,2,59,61,3.28
April,30,2019,Adams,WA,Truck,0,0,0,5104,5104,0
April,30,2019,Ferry,WA,Truck,0,0,0,3592,3592,0
April,30,2019,Skagit,WA,Passenger,292,197,489,91537,92026,0.53
April,30,2019,Vigo,IN,Passenger,1,0,1,5,6,16.67
April,30,2019,Clallam,WA,Truck,0,0,0,21681,21681,0
April,30,2019,Fulton,GA,Passenger,1,2,3,112,115,2.61
April,30,2019,Carroll,NH,Passenger,0,1,1,2,3,33.33
April,30,2019,Kitsap,WA,Truck,1,0,1,53874,53875,0
April,30,2019,Nassau,NY,Passenger,3,0,3,40,43,6.98
April,30,2019,Lewis,WA,Passenger,95,91,186,58821,59007,0.32
April,30,2019,Spartanburg,SC,Passenger,0,1,1,33,34,2.94
April,30,2019,Kittitas,WA,Truck,0,0,0,14296,14296,0
April,30,2019,Twin Falls,ID,Passenger,0,1,1,22,23,4.35
April,30,2019,Garfield,WA,Passenger,1,1,2,1298,1300,0.15
April,30,2019,Clackamas,OR,Passenger,1,1,2,206,208,0.96
April,30,2019,Maui,HI,Passenger,1,0,1,47,48,2.08
April,30,2019,Goochland,VA,Passenger,1,1,2,251,253,0.79
April,30,2019,El Paso,CO,Passenger,3,2,5,751,756,0.66
April,30,2019,Skagit,WA,Truck,1,0,1,32325,32326,0
April,30,2019,Albemarle,VA,Passenger,1,0,1,25,26,3.85
April,30,2019,Manatee,FL,Passenger,1,0,1,32,33,3.03
April,30,2019,Columbia,WA,Truck,0,0,0,1531,1531,0
April,30,2019,Juneau,AK,Passenger,0,2,2,32,34,5.88
April,30,2019,Cook,IL,Passenger,1,0,1,241,242,0.41
April,30,2019,Houston,GA,Passenger,1,0,1,54,55,1.82
August,31,2019,Grays Harbor,WA,Truck,0,0,0,20570,20570,0
August,31,2019,Mason,WA,Passenger,130,127,257,47429,47686,0.54
August,31,2019,Stevens,WA,Passenger,22,29,51,31707,31758,0.16
August,31,2019,Lake,FL,Passenger,1,0,1,20,21,4.76
August,31,2019,Fulton,GA,Passenger,0,2,2,102,104,1.92
August,31,2019,Multnomah,OR,Passenger,5,6,11,744,755,1.46
August,31,2019,Portsmouth,VA,Passenger,0,1,1,79,80,1.25
August,31,2019,Carson City,NV,Passenger,1,0,1,11,12,8.33
August,31,2019,Cascade,MT,Passenger,0,1,1,60,61,1.64
August,31,2019,Franklin,WA,Truck,0,0,0,19494,19494,0
August,31,2019,Brevard,FL,Passenger,0,1,1,84,85,1.18
August,31,2019,Clark,NV,Passenger,4,2,6,691,697,0.86
August,31,2019,Montgomery,PA,Passenger,2,0,2,37,39,5.13
August,31,2019,Norfolk,MA,Passenger,1,0,1,38,39,2.56
August,31,2019,New Haven,CT,Passenger,0,2,2,48,50,4
August,31,2019,Randolph,NC,Passenger,1,0,1,6,7,14.29
August,31,2019,Chelan,WA,Passenger,165,70,235,54453,54688,0.43
August,31,2019,San Juan,WA,Passenger,225,73,298,14441,14739,2.02
August,31,2019,Volusia,FL,Passenger,0,1,1,38,39,2.56
August,31,2019,Williamson,TX,Passenger,0,2,2,145,147,1.36
August,31,2019,Whitman,WA,Truck,0,0,0,8627,8627,0
August,31,2019,Ferry,WA,Truck,0,0,0,3579,3579,0
August,31,2019,Monroe,IL,Passenger,1,0,1,5,6,16.67
August,31,2019,Garfield,WA,Passenger,0,1,1,1306,1307,0.08
August,31,2019,Whatcom,WA,Passenger,902,450,1352,151212,152564,0.89
August,31,2019,Alexandria,VA,Passenger,1,0,1,147,148,0.68
August,31,2019,Collin,TX,Passenger,1,1,2,129,131,1.53
August,31,2019,Adams,WA,Truck,0,0,0,5138,5138,0
August,31,2019,Powhatan,VA,Passenger,1,0,1,0,1,100
August,31,2019,Adams,WA,Passenger,5,5,10,12843,12853,0.08
August,31,2019,Solano,CA,Passenger,1,0,1,208,209,0.48
August,31,2019,Fresno,CA,Passenger,1,0,1,193,194,0.52
August,31,2019,Houston,GA,Passenger,1,0,1,55,56,1.79
August,31,2019,Dale,AL,Passenger,0,1,1,56,57,1.75
August,31,2019,Charleston,SC,Passenger,1,0,1,114,115,0.87
August,31,2019,Riverside,CA,Passenger,3,2,5,653,658,0.76
August,31,2019,Charles,MD,Passenger,0,1,1,87,88,1.14
August,31,2019,Pend Oreille,WA,Passenger,5,6,11,9495,9506,0.12
August,31,2019,Palm Beach,FL,Passenger,0,1,1,86,87,1.15
August,31,2019,Juneau,AK,Passenger,0,2,2,31,33,6.06
August,31,2019,Thurston,WA,Passenger,927,661,1588,198371,199959,0.79
August,31,2019,Cumberland,NC,Passenger,0,2,2,492,494,0.4
August,31,2019,Hawaii,HI,Passenger,1,0,1,57,58,1.72
August,31,2019,Carroll,NH,Passenger,0,1,1,3,4,25
August,31,2019,Lincoln,WA,Truck,0,0,0,4683,4683,0
August,31,2019,,,Passenger,8,4,12,842,854,1.41
August,31,2019,Moore,NC,Passenger,0,1,1,182,183,0.55
August,31,2019,San Diego,CA,Passenger,10,3,13,2757,2770,0.47
August,31,2019,Lewis,WA,Truck,0,0,0,25986,25986,0
August,31,2019,Dakota,MN,Passenger,0,1,1,38,39,2.56
August,31,2019,Spartanburg,SC,Passenger,0,1,1,38,39,2.56
August,31,2019,Jones,GA,Passenger,1,0,1,1,2,50
August,31,2019,Pima,AZ,Passenger,1,1,2,389,391,0.51
August,31,2019,Travis,TX,Passenger,2,1,3,200,203,1.48
August,31,2019,Valencia,NM,Passenger,1,0,1,6,7,14.29
August,31,2019,Lee,FL,Passenger,1,0,1,51,52,1.92
August,31,2019,Jefferson,NY,Passenger,0,2,2,214,216,0.93
August,31,2019,Okanogan,WA,Truck,0,0,0,16479,16479,0
August,31,2019,Asotin,WA,Truck,0,0,0,6684,6684,0
August,31,2019,Greene,MO,Passenger,0,1,1,33,34,2.94
August,31,2019,Snohomish,WA,Truck,0,0,0,122863,122863,0
August,31,2019,Bexar,TX,Passenger,2,5,7,650,657,1.07
August,31,2019,Broward,FL,Passenger,2,1,3,128,131,2.29
August,31,2019,Yakima,WA,Truck,0,0,0,59390,59390,0
August,31,2019,Rogers,OK,Passenger,1,0,1,5,6,16.67
August,31,2019,Benton,WA,Passenger,280,291,571,134343,134914,0.42
August,31,2019,Deschutes,OR,Passenger,2,0,2,154,156,1.28
August,31,2019,Pacific,WA,Passenger,23,29,52,16045,16097,0.32
August,31,2019,Allegheny,PA,Passenger,1,0,1,79,80,1.25
August,31,2019,Kent,MI,Passenger,0,1,1,23,24,4.17
August,31,2019,Sangamon,IL,Passenger,1,0,1,6,7,14.29
August,31,2019,Grant,WA,Passenger,45,61,106,65169,65275,0.16
August,31,2019,Lake,IL,Passenger,1,0,1,165,166,0.6
August,31,2019,Goochland,VA,Passenger,1,1,2,259,261,0.77
August,31,2019,Kitsap,WA,Truck,1,0,1,54161,54162,0
August,31,2019,Santa Cruz,CA,Passenger,1,0,1,38,39,2.56
August,31,2019,Spokane,WA,Truck,1,0,1,95528,95529,0
August,31,2019,Oklahoma,OK,Passenger,0,1,1,125,126,0.79
August,31,2019,Skamania,WA,Passenger,25,18,43,8755,8798,0.49
August,31,2019,El Paso,TX,Passenger,3,0,3,480,483,0.62
August,31,2019,Virginia Beach,VA,Passenger,1,0,1,701,702,0.14
August,31,2019,Anne Arundel,MD,Passenger,1,2,3,438,441,0.68
August,31,2019,El Paso,CO,Passenger,2,1,3,737,740,0.41
August,31,2019,District of Columbia,DC,Passenger,1,1,2,210,212,0.94
August,31,2019,Franklin,WA,Passenger,51,72,123,60233,60356,0.2
August,31,2019,Prince George's,MD,Passenger,1,1,2,179,181,1.1
August,31,2019,Harris,TX,Passenger,1,1,2,249,251,0.8
August,31,2019,Spokane,WA,Passenger,575,439,1014,313142,314156,0.32
August,31,2019,Bergen,NJ,Passenger,1,0,1,26,27,3.7
August,31,2019,Walla Walla,WA,Truck,0,0,0,13652,13652,0
August,31,2019,Cochise,AZ,Passenger,0,1,1,107,108,0.93
August,31,2019,Grant,WA,Truck,0,0,0,26739,26739,0
August,31,2019,Kittitas,WA,Truck,0,0,0,14523,14523,0
August,31,2019,Osceola,FL,Passenger,1,0,1,41,42,2.38
August,31,2019,Prince William,VA,Passenger,1,3,4,251,255,1.57
August,31,2019,St. Mary's,MD,Passenger,1,0,1,217,218,0.46
August,31,2019,Asotin,WA,Passenger,12,7,19,12642,12661,0.15
August,31,2019,Sumter,FL,Passenger,0,1,1,9,10,10
August,31,2019,Saratoga,NY,Passenger,1,0,1,52,53,1.89
August,31,2019,Stafford,VA,Passenger,1,1,2,98,100,2
August,31,2019,Sedgwick,KS,Passenger,1,1,2,98,100,2
August,31,2019,Vigo,IN,Passenger,1,0,1,6,7,14.29
August,31,2019,Nantucket,MA,Passenger,1,0,1,2,3,33.33
August,31,2019,Yakima,WA,Passenger,112,108,220,165635,165855,0.13
August,31,2019,Santa Rosa,FL,Passenger,1,0,1,87,88,1.14
August,31,2019,Pinal,AZ,Passenger,2,0,2,192,194,1.03
August,31,2019,Kern,CA,Passenger,0,1,1,223,224,0.45
August,31,2019,Franklin,MA,Passenger,0,1,1,1,2,50
August,31,2019,Caddo,LA,Passenger,0,1,1,19,20,5
August,31,2019,Maui,HI,Passenger,1,0,1,43,44,2.27
August,31,2019,Tarrant,TX,Passenger,2,0,2,201,203,0.99
August,31,2019,Cowlitz,WA,Passenger,107,108,215,73286,73501,0.29
August,31,2019,Albemarle,VA,Passenger,1,0,1,21,22,4.55
August,31,2019,Camden,NJ,Passenger,0,1,1,24,25,4
August,31,2019,San Joaquin,CA,Passenger,1,0,1,131,132,0.76
August,31,2019,Snohomish,WA,Passenger,3641,1640,5281,533107,538388,0.98
August,31,2019,Suffolk,MA,Passenger,0,1,1,37,38,2.63
August,31,2019,Douglas,WA,Passenger,61,36,97,28181,28278,0.34
August,31,2019,Garfield,WA,Truck,0,0,0,959,959,0
August,31,2019,Fairbanks North Star,AK,Passenger,0,1,1,98,99,1.01
August,31,2019,Shelby,OH,Passenger,0,1,1,1,2,50
August,31,2019,DuPage,IL,Passenger,3,0,3,59,62,4.84
August,31,2019,Kittitas,WA,Passenger,79,44,123,29744,29867,0.41
August,31,2019,Penobscot,ME,Passenger,0,1,1,13,14,7.14
August,31,2019,Alameda,CA,Passenger,4,1,5,294,299,1.67
August,31,2019,Pacific,WA,Truck,0,0,0,7681,7681,0
August,31,2019,Montgomery,TX,Passenger,1,0,1,60,61,1.64
August,31,2019,Boone,MO,Passenger,0,1,1,10,11,9.09
August,31,2019,Clallam,WA,Truck,1,0,1,21824,21825,0
August,31,2019,Island,WA,Truck,0,0,0,21275,21275,0
August,31,2019,Jefferson,CO,Passenger,0,2,2,59,61,3.28
August,31,2019,Sarasota,FL,Passenger,1,0,1,27,28,3.57
August,31,2019,Norfolk,VA,Passenger,2,2,4,347,351,1.14
August,31,2019,Middlesex,MA,Passenger,1,1,2,113,115,1.74
August,31,2019,San Mateo,CA,Passenger,2,1,3,115,118,2.54
August,31,2019,Duval,FL,Passenger,1,2,3,374,377,0.8
August,31,2019,Clackamas,OR,Passenger,1,1,2,215,217,0.92
August,31,2019,DeKalb,IN,Passenger,1,0,1,1,2,50
August,31,2019,New London,CT,Passenger,0,2,2,241,243,0.82
August,31,2019,Frederick,MD,Passenger,1,1,2,80,82,2.44
August,31,2019,Ramsey,MN,Passenger,1,0,1,38,39,2.56
August,31,2019,Island,WA,Passenger,335,244,579,63461,64040,0.9
August,31,2019,Ada,ID,Passenger,0,2,2,305,307,0.65
August,31,2019,Cape May,NJ,Passenger,0,1,1,14,15,6.67
August,31,2019,Shasta,CA,Passenger,1,0,1,40,41,2.44
August,31,2019,Clallam,WA,Passenger,184,148,332,50729,51061,0.65
August,31,2019,Pinellas,FL,Passenger,1,1,2,115,117,1.71
August,31,2019,Wayne,MI,Passenger,0,1,1,64,65,1.54
August,31,2019,Tulsa,OK,Passenger,1,1,2,47,49,4.08
August,31,2019,Walla Walla,WA,Passenger,56,63,119,36230,36349,0.33
August,31,2019,Columbia,WA,Passenger,2,2,4,2455,2459,0.16
August,31,2019,Kitsap,WA,Passenger,1114,633,1747,181513,183260,0.95
August,31,2019,Stevens,WA,Truck,0,0,0,18717,18717,0
August,31,2019,DeKalb,GA,Passenger,1,0,1,78,79,1.27
August,31,2019,Santa Fe,NM,Passenger,0,1,1,39,40,2.5
August,31,2019,Honolulu,HI,Passenger,4,2,6,487,493,1.22
August,31,2019,Flathead,MT,Passenger,1,0,1,65,66,1.52
August,31,2019,Skagit,WA,Passenger,310,209,519,92306,92825,0.56
August,31,2019,Santa Clara,CA,Passenger,4,2,6,365,371,1.62
August,31,2019,Lincoln,WA,Passenger,2,10,12,7786,7798,0.15
August,31,2019,Cowlitz,WA,Truck,0,0,0,28900,28900,0
August,31,2019,Richmond,GA,Passenger,0,1,1,93,94,1.06
August,31,2019,Manatee,FL,Passenger,1,0,1,34,35,2.86
August,31,2019,Bucks,PA,Passenger,1,0,1,23,24,4.17
August,31,2019,Dallas,TX,Passenger,1,0,1,207,208,0.48
August,31,2019,Whitman,WA,Passenger,34,44,78,22711,22789,0.34
August,31,2019,Wahkiakum,WA,Truck,0,0,0,1763,1763,0
August,31,2019,Pierce,WA,Truck,0,0,0,140335,140335,0
August,31,2019,Skagit,WA,Truck,1,0,1,32553,32554,0
August,31,2019,Ventura,CA,Passenger,0,2,2,309,311,0.64
August,31,2019,Okanogan,WA,Passenger,25,26,51,26190,26241,0.19
August,31,2019,Guadalupe,TX,Passenger,1,0,1,70,71,1.41
August,31,2019,Maricopa,AZ,Passenger,7,4,11,1531,1542,0.71
August,31,2019,San Juan,WA,Truck,0,0,0,5891,5891,0
August,31,2019,Klickitat,WA,Passenger,37,35,72,15624,15696,0.46
August,31,2019,Contra Costa,CA,Passenger,2,2,4,368,372,1.08
August,31,2019,Chelan,WA,Truck,0,0,0,22366,22366,0
August,31,2019,Harrison,MS,Passenger,1,0,1,62,63,1.59
August,31,2019,Howard,MD,Passenger,0,1,1,74,75,1.33
August,31,2019,King,WA,Passenger,20005,7202,27207,1393126,1420333,1.92
August,31,2019,Douglas,NE,Passenger,0,1,1,59,60,1.67
August,31,2019,Calvert,MD,Passenger,0,2,2,89,91,2.2
August,31,2019,Clark,WA,Truck,0,0,0,80861,80861,0
August,31,2019,Pend Oreille,WA,Truck,0,0,0,5721,5721,0
August,31,2019,Whatcom,WA,Truck,2,0,2,42997,42999,0
August,31,2019,Putnam,TN,Passenger,0,1,1,3,4,25
August,31,2019,Grays Harbor,WA,Passenger,88,85,173,48116,48289,0.36
August,31,2019,Wahkiakum,WA,Passenger,2,2,4,3026,3030,0.13
August,31,2019,Oldham,KY,Passenger,0,1,1,5,6,16.67
August,31,2019,Larimer,CO,Passenger,1,0,1,58,59,1.69
August,31,2019,Hennepin,MN,Passenger,3,1,4,105,109,3.67
August,31,2019,Clay,FL,Passenger,0,1,1,84,85,1.18
August,31,2019,Manassas,VA,Passenger,0,1,1,8,9,11.11
August,31,2019,Saginaw,MI,Passenger,1,0,1,12,13,7.69
August,31,2019,Nueces,TX,Passenger,1,1,2,92,94,2.13
August,31,2019,Arlington,VA,Passenger,0,2,2,155,157,1.27
August,31,2019,Columbia,WA,Truck,0,0,0,1531,1531,0
August,31,2019,Fairfax,VA,Passenger,3,2,5,761,766,0.65
August,31,2019,Denver,CO,Passenger,1,0,1,128,129,0.78
August,31,2019,Kootenai,ID,Passenger,1,1,2,220,222,0.9
August,31,2019,King,WA,Truck,6,1,7,182265,182272,0
August,31,2019,Polk,FL,Passenger,1,0,1,68,69,1.45
August,31,2019,Thurston,WA,Truck,0,0,0,55440,55440,0
August,31,2019,Washoe,NV,Passenger,2,0,2,109,111,1.8
August,31,2019,Skamania,WA,Truck,0,0,0,4075,4075,0
August,31,2019,Berkshire,MA,Passenger,0,1,1,4,5,20
August,31,2019,San Francisco,CA,Passenger,2,1,3,106,109,2.75
August,31,2019,Ferry,WA,Passenger,5,2,7,4414,4421,0.16
August,31,2019,Jefferson,WA,Truck,0,0,0,9675,9675,0
August,31,2019,Pierce,WA,Passenger,1930,1584,3514,544791,548305,0.64
August,31,2019,Los Angeles,CA,Passenger,8,6,14,1104,1118,1.25
August,31,2019,Lewis,WA,Passenger,105,96,201,59363,59564,0.34
August,31,2019,Mason,WA,Truck,0,0,0,20413,20413,0
August,31,2019,Richland,SC,Passenger,0,1,1,159,160,0.62
August,31,2019,Loudoun,VA,Passenger,1,0,1,94,95,1.05
August,31,2019,Montgomery,AL,Passenger,0,1,1,41,42,2.38
August,31,2019,Douglas,WA,Truck,0,0,0,12264,12264,0
August,31,2019,Jefferson,WA,Passenger,205,122,327,25074,25401,1.29
August,31,2019,Wilson,TX,Passenger,0,1,1,6,7,14.29
August,31,2019,Cook,IL,Passenger,1,0,1,240,241,0.41
August,31,2019,Shelby,TN,Passenger,0,1,1,92,93,1.08
August,31,2019,Benton,WA,Truck,0,0,0,42177,42177,0
August,31,2019,Orange,CA,Passenger,6,3,9,523,532,1.69
August,31,2019,Klickitat,WA,Truck,0,0,0,8292,8292,0
August,31,2019,Owyhee,ID,Passenger,1,0,1,4,5,20
August,31,2019,Nassau,NY,Passenger,4,0,4,38,42,9.52
August,31,2019,Clark,WA,Passenger,1647,959,2606,315547,318153,0.82
August,31,2019,Twin Falls,ID,Passenger,0,1,1,26,27,3.7
August,31,2019,RÃ­o Grande,PR,Passenger,1,0,1,1,2,50
August,31,2019,Klamath,OR,Passenger,1,0,1,39,40,2.5
August,31,2019,Tuolumne,CA,Passenger,0,1,1,11,12,8.33
August,31,2019,Harnett,NC,Passenger,1,1,2,210,212,0.94
August,31,2019,Washtenaw,MI,Passenger,1,0,1,41,42,2.38
August,31,2019,Placer,CA,Passenger,1,0,1,98,99,1.01
December,31,2019,Charleston,SC,Passenger,1,0,1,109,110,0.91
December,31,2019,Asotin,WA,Passenger,14,9,23,12679,12702,0.18
December,31,2019,Hennepin,MN,Passenger,3,1,4,101,105,3.81
December,31,2019,Jefferson,WA,Truck,0,0,0,9647,9647,0
December,31,2019,Howard,MD,Passenger,0,1,1,74,75,1.33
December,31,2019,Clallam,WA,Passenger,196,157,353,50869,51222,0.69
December,31,2019,Lee,FL,Passenger,1,0,1,53,54,1.85
December,31,2019,Grant,WA,Truck,0,0,0,27002,27002,0
December,31,2019,Washtenaw,MI,Passenger,1,0,1,42,43,2.33
December,31,2019,Montgomery,TX,Passenger,1,0,1,55,56,1.79
December,31,2019,Douglas,WA,Passenger,67,38,105,28299,28404,0.37
December,31,2019,Houston,GA,Passenger,1,0,1,60,61,1.64
December,31,2019,Fulton,GA,Passenger,0,2,2,104,106,1.89
December,31,2019,Whitman,WA,Truck,0,0,0,8579,8579,0
December,31,2019,Honolulu,HI,Passenger,4,2,6,479,485,1.24
December,31,2019,Columbia,WA,Passenger,3,3,6,2449,2455,0.24
December,31,2019,Boone,MO,Passenger,0,1,1,11,12,8.33
December,31,2019,Bexar,TX,Passenger,1,5,6,646,652,0.92
December,31,2019,Calvert,MD,Passenger,0,2,2,91,93,2.15
December,31,2019,Dakota,MN,Passenger,0,1,1,33,34,2.94
December,31,2019,Clark,WA,Passenger,1843,1043,2886,317733,320619,0.9
December,31,2019,Cowlitz,WA,Passenger,118,107,225,73644,73869,0.3
December,31,2019,Kent,MI,Passenger,0,1,1,24,25,4
December,31,2019,Ada,ID,Passenger,0,1,1,290,291,0.34
December,31,2019,Carson City,NV,Passenger,1,0,1,10,11,9.09
December,31,2019,Wahkiakum,WA,Passenger,4,3,7,3041,3048,0.23
December,31,2019,Klickitat,WA,Passenger,46,38,84,15674,15758,0.53
December,31,2019,Wahkiakum,WA,Truck,0,0,0,1754,1754,0
December,31,2019,San Juan,WA,Truck,0,0,0,5935,5935,0
December,31,2019,Solano,CA,Passenger,1,0,1,207,208,0.48
December,31,2019,Clark,NV,Passenger,3,2,5,680,685,0.73
December,31,2019,Valencia,NM,Passenger,1,0,1,5,6,16.67
December,31,2019,DeKalb,GA,Passenger,1,0,1,81,82,1.22
December,31,2019,Columbia,WA,Truck,0,0,0,1537,1537,0
December,31,2019,Berkshire,MA,Passenger,0,1,1,5,6,16.67
December,31,2019,Juneau,AK,Passenger,0,2,2,29,31,6.45
December,31,2019,Wayne,MI,Passenger,0,1,1,59,60,1.67
December,31,2019,Oldham,KY,Passenger,0,1,1,4,5,20
December,31,2019,Pend Oreille,WA,Truck,0,0,0,5771,5771,0
December,31,2019,Cape May,NJ,Passenger,0,1,1,13,14,7.14
December,31,2019,Cowlitz,WA,Truck,0,0,0,29035,29035,0
December,31,2019,Skagit,WA,Passenger,363,213,576,92637,93213,0.62
December,31,2019,San Diego,CA,Passenger,9,3,12,2797,2809,0.43
December,31,2019,Lewis,WA,Passenger,106,102,208,59556,59764,0.35
December,31,2019,Allegheny,PA,Passenger,1,0,1,74,75,1.33
December,31,2019,Prince George's,MD,Passenger,1,1,2,172,174,1.15
December,31,2019,Montgomery,OH,Passenger,0,1,1,47,48,2.08
December,31,2019,Clark,WA,Truck,0,0,0,81316,81316,0
December,31,2019,Anne Arundel,MD,Passenger,1,2,3,434,437,0.69
December,31,2019,Oklahoma,OK,Passenger,0,1,1,128,129,0.78
December,31,2019,Garfield,WA,Passenger,0,1,1,1306,1307,0.08
December,31,2019,Thurston,WA,Passenger,1052,701,1753,199236,200989,0.87
December,31,2019,El Paso,CO,Passenger,2,1,3,742,745,0.4
December,31,2019,Okanogan,WA,Truck,0,0,0,16550,16550,0
December,31,2019,Chelan,WA,Passenger,201,78,279,54622,54901,0.51
December,31,2019,Whatcom,WA,Truck,2,0,2,43188,43190,0
December,31,2019,Montgomery,AL,Passenger,0,1,1,39,40,2.5
December,31,2019,Ferry,WA,Passenger,5,2,7,4398,4405,0.16
December,31,2019,Greene,MO,Passenger,0,1,1,31,32,3.12
December,31,2019,Richland,SC,Passenger,0,1,1,157,158,0.63
December,31,2019,Tulsa,OK,Passenger,1,1,2,48,50,4
December,31,2019,Santa Cruz,CA,Passenger,1,0,1,36,37,2.7
December,31,2019,Frederick,MD,Passenger,1,1,2,81,83,2.41
December,31,2019,King,WA,Truck,6,1,7,182216,182223,0
December,31,2019,Placer,CA,Passenger,1,0,1,95,96,1.04
December,31,2019,Maricopa,AZ,Passenger,7,5,12,1498,1510,0.79
December,31,2019,Duval,FL,Passenger,1,2,3,362,365,0.82
December,31,2019,Lewis,WA,Truck,0,0,0,26087,26087,0
December,31,2019,Middlesex,MA,Passenger,1,1,2,107,109,1.83
December,31,2019,Williamson,TX,Passenger,0,2,2,144,146,1.37
December,31,2019,Sedgwick,KS,Passenger,1,1,2,96,98,2.04
December,31,2019,Santa Clara,CA,Passenger,7,2,9,351,360,2.5
December,31,2019,Sarasota,FL,Passenger,2,0,2,25,27,7.41
December,31,2019,Kitsap,WA,Passenger,1199,652,1851,182349,184200,1
December,31,2019,San Joaquin,CA,Passenger,1,0,1,137,138,0.72
December,31,2019,Virginia Beach,VA,Passenger,1,0,1,695,696,0.14
December,31,2019,Asotin,WA,Truck,0,0,0,6709,6709,0
December,31,2019,Putnam,TN,Passenger,0,1,1,3,4,25
December,31,2019,Walla Walla,WA,Truck,0,0,0,13663,13663,0
December,31,2019,Contra Costa,CA,Passenger,3,2,5,343,348,1.44
December,31,2019,Island,WA,Truck,1,0,1,21356,21357,0
December,31,2019,Harnett,NC,Passenger,1,1,2,206,208,0.96
December,31,2019,Clallam,WA,Truck,1,0,1,21871,21872,0
December,31,2019,Pacific,WA,Truck,0,0,0,7721,7721,0
December,31,2019,Guadalupe,TX,Passenger,1,0,1,66,67,1.49
December,31,2019,Multnomah,OR,Passenger,4,6,10,726,736,1.36
December,31,2019,Spokane,WA,Passenger,643,471,1114,315064,316178,0.35
December,31,2019,Chesapeake,VA,Passenger,0,2,2,431,433,0.46
December,31,2019,Pierce,WA,Passenger,2127,1651,3778,547907,551685,0.68
December,31,2019,San Mateo,CA,Passenger,1,1,2,119,121,1.65
December,31,2019,Pacific,WA,Passenger,30,30,60,16120,16180,0.37
December,31,2019,Pinal,AZ,Passenger,1,0,1,190,191,0.52
December,31,2019,Pierce,WA,Truck,0,0,0,140864,140864,0
December,31,2019,Harrison,MS,Passenger,1,0,1,57,58,1.72
December,31,2019,Albemarle,VA,Passenger,1,0,1,25,26,3.85
December,31,2019,Stevens,WA,Passenger,31,31,62,31609,31671,0.2
December,31,2019,Yakima,WA,Truck,0,0,0,59618,59618,0
December,31,2019,Fairbanks North Star,AK,Passenger,0,1,1,99,100,1
December,31,2019,Jones,GA,Passenger,1,0,1,1,2,50
December,31,2019,Saginaw,MI,Passenger,1,0,1,11,12,8.33
December,31,2019,District of Columbia,DC,Passenger,1,1,2,213,215,0.93
December,31,2019,Montgomery,PA,Passenger,2,0,2,35,37,5.41
December,31,2019,Skagit,WA,Truck,1,0,1,32566,32567,0
December,31,2019,DeKalb,IN,Passenger,1,0,1,1,2,50
December,31,2019,Snohomish,WA,Passenger,4021,1709,5730,536109,541839,1.06
December,31,2019,Goochland,VA,Passenger,2,1,3,263,266,1.13
December,31,2019,Bucks,PA,Passenger,1,0,1,21,22,4.55
December,31,2019,Los Angeles,CA,Passenger,7,9,16,1062,1078,1.48
December,31,2019,Island,WA,Passenger,375,253,628,63608,64236,0.98
December,31,2019,Carroll,NH,Passenger,0,1,1,4,5,20
December,31,2019,Polk,FL,Passenger,1,0,1,65,66,1.52
December,31,2019,Ventura,CA,Passenger,0,3,3,299,302,0.99
December,31,2019,Manassas,VA,Passenger,0,1,1,6,7,14.29
December,31,2019,Norfolk,VA,Passenger,1,2,3,348,351,0.85
December,31,2019,Broward,FL,Passenger,2,1,3,125,128,2.34
December,31,2019,Prince William,VA,Passenger,1,3,4,234,238,1.68
December,31,2019,Nueces,TX,Passenger,1,1,2,85,87,2.3
December,31,2019,Deschutes,OR,Passenger,3,0,3,149,152,1.97
December,31,2019,Shelby,TN,Passenger,0,1,1,95,96,1.04
December,31,2019,Arapahoe,CO,Passenger,1,0,1,141,142,0.7
December,31,2019,Fresno,CA,Passenger,1,0,1,188,189,0.53
December,31,2019,Jefferson,WA,Passenger,217,134,351,25187,25538,1.37
December,31,2019,Adams,WA,Passenger,6,7,13,12936,12949,0.1
December,31,2019,Hudson,NJ,Passenger,1,0,1,38,39,2.56
December,31,2019,Douglas,WA,Truck,0,0,0,12308,12308,0
December,31,2019,Rogers,OK,Passenger,1,0,1,5,6,16.67
December,31,2019,Okanogan,WA,Passenger,30,30,60,26236,26296,0.23
December,31,2019,Vigo,IN,Passenger,1,0,1,6,7,14.29
December,31,2019,Osceola,FL,Passenger,1,0,1,42,43,2.33
December,31,2019,Clay,FL,Passenger,0,1,1,86,87,1.15
December,31,2019,Skamania,WA,Truck,0,0,0,4099,4099,0
December,31,2019,Suffolk,VA,Passenger,1,0,1,124,125,0.8
December,31,2019,Collin,TX,Passenger,1,1,2,131,133,1.5
December,31,2019,Travis,TX,Passenger,2,1,3,198,201,1.49
December,31,2019,Alameda,CA,Passenger,5,1,6,292,298,2.01
December,31,2019,Randolph,NC,Passenger,1,0,1,7,8,12.5
December,31,2019,Grays Harbor,WA,Passenger,105,100,205,48394,48599,0.42
December,31,2019,Boulder,CO,Passenger,0,1,1,50,51,1.96
December,31,2019,Yakima,WA,Passenger,116,114,230,166298,166528,0.14
December,31,2019,Washoe,NV,Passenger,1,0,1,108,109,0.92
December,31,2019,Klickitat,WA,Truck,0,0,0,8318,8318,0
December,31,2019,Norfolk,MA,Passenger,1,0,1,36,37,2.7
December,31,2019,Denver,CO,Passenger,1,0,1,127,128,0.78
December,31,2019,Snohomish,WA,Truck,0,0,0,123277,123277,0
December,31,2019,Jefferson,CO,Passenger,0,2,2,58,60,3.33
December,31,2019,Thurston,WA,Truck,0,0,0,55729,55729,0
December,31,2019,Lake,IL,Passenger,1,0,1,162,163,0.61
December,31,2019,Camden,NJ,Passenger,0,2,2,21,23,8.7
December,31,2019,Riverside,CA,Passenger,4,1,5,637,642,0.78
December,31,2019,Penobscot,ME,Passenger,0,1,1,13,14,7.14
December,31,2019,Twin Falls,ID,Passenger,0,1,1,28,29,3.45
December,31,2019,Benton,WA,Truck,0,0,0,42486,42486,0
December,31,2019,Ferry,WA,Truck,0,0,0,3580,3580,0
December,31,2019,,,Passenger,9,6,15,864,879,1.71
December,31,2019,Lincoln,WA,Truck,0,0,0,4683,4683,0
December,31,2019,Kittitas,WA,Passenger,90,46,136,30054,30190,0.45
December,31,2019,El Paso,TX,Passenger,3,0,3,455,458,0.66
December,31,2019,Santa Rosa,FL,Passenger,1,0,1,86,87,1.15
December,31,2019,Loudoun,VA,Passenger,1,0,1,93,94,1.06
December,31,2019,Jefferson,NY,Passenger,0,2,2,218,220,0.91
December,31,2019,Nassau,NY,Passenger,4,0,4,39,43,9.3
December,31,2019,Cumberland,NC,Passenger,0,2,2,487,489,0.41
December,31,2019,Garfield,WA,Truck,0,0,0,969,969,0
December,31,2019,Hawaii,HI,Passenger,1,0,1,60,61,1.64
December,31,2019,Flathead,MT,Passenger,1,0,1,63,64,1.56
December,31,2019,Adams,WA,Truck,0,0,0,5198,5198,0
December,31,2019,Shasta,CA,Passenger,1,0,1,37,38,2.63
December,31,2019,Queens,NY,Passenger,1,0,1,52,53,1.89
December,31,2019,RÃ­o Grande,PR,Passenger,1,0,1,1,2,50
December,31,2019,Larimer,CO,Passenger,1,0,1,55,56,1.79
December,31,2019,Spokane,WA,Truck,1,0,1,96378,96379,0
December,31,2019,Spartanburg,SC,Passenger,0,1,1,43,44,2.27
December,31,2019,Grant,WA,Passenger,55,68,123,65625,65748,0.19
December,31,2019,King,WA,Passenger,21951,7543,29494,1394823,1424317,2.07
December,31,2019,Mason,WA,Truck,0,0,0,20527,20527,0
December,31,2019,Sumter,FL,Passenger,0,1,1,9,10,10
December,31,2019,Franklin,WA,Passenger,54,76,130,60982,61112,0.21
December,31,2019,Kootenai,ID,Passenger,1,1,2,226,228,0.88
December,31,2019,Washington,OR,Passenger,1,0,1,454,455,0.22
December,31,2019,Maui,HI,Passenger,1,0,1,38,39,2.56
December,31,2019,Tarrant,TX,Passenger,2,0,2,192,194,1.03
December,31,2019,Kittitas,WA,Truck,0,0,0,14624,14624,0
December,31,2019,San Francisco,CA,Passenger,2,1,3,100,103,2.91
December,31,2019,Harris,TX,Passenger,1,0,1,240,241,0.41
December,31,2019,Wilson,TX,Passenger,0,1,1,8,9,11.11
December,31,2019,Moore,NC,Passenger,0,1,1,164,165,0.61
December,31,2019,Stafford,VA,Passenger,1,1,2,94,96,2.08
December,31,2019,Mason,WA,Passenger,142,135,277,47637,47914,0.58
December,31,2019,San Juan,WA,Passenger,253,79,332,14407,14739,2.25
December,31,2019,Cochise,AZ,Passenger,0,1,1,105,106,0.94
December,31,2019,DuPage,IL,Passenger,3,0,3,63,66,4.55
December,31,2019,Benton,WA,Passenger,315,308,623,135242,135865,0.46
December,31,2019,New Haven,CT,Passenger,0,2,2,46,48,4.17
December,31,2019,Walla Walla,WA,Passenger,63,60,123,36306,36429,0.34
December,31,2019,Arlington,VA,Passenger,0,2,2,152,154,1.3
December,31,2019,Owyhee,ID,Passenger,1,0,1,3,4,25
December,31,2019,Fairfax,VA,Passenger,4,2,6,753,759,0.79
December,31,2019,Shelby,OH,Passenger,0,1,1,1,2,50
December,31,2019,Richmond,GA,Passenger,0,1,1,91,92,1.09
December,31,2019,Brevard,FL,Passenger,0,1,1,88,89,1.12
December,31,2019,Fort Bend,TX,Passenger,1,0,1,47,48,2.08
December,31,2019,Cascade,MT,Passenger,0,1,1,55,56,1.79
December,31,2019,Orange,CA,Passenger,7,2,9,504,513,1.75
December,31,2019,Monroe,IL,Passenger,1,0,1,4,5,20
December,31,2019,Lincoln,WA,Passenger,1,11,12,7804,7816,0.15
December,31,2019,Dallas,TX,Passenger,1,0,1,207,208,0.48
December,31,2019,Klamath,OR,Passenger,1,0,1,37,38,2.63
December,31,2019,Douglas,NE,Passenger,0,1,1,57,58,1.72
December,31,2019,Whatcom,WA,Passenger,987,477,1464,151703,153167,0.96
December,31,2019,Kern,CA,Passenger,0,1,1,222,223,0.45
December,31,2019,New London,CT,Passenger,0,2,2,246,248,0.81
December,31,2019,Whitman,WA,Passenger,42,46,88,22678,22766,0.39
December,31,2019,Palm Beach,FL,Passenger,0,1,1,83,84,1.19
December,31,2019,Pend Oreille,WA,Passenger,7,7,14,9514,9528,0.15
December,31,2019,Charles,MD,Passenger,0,1,1,83,84,1.19
December,31,2019,Lake,FL,Passenger,1,0,1,21,22,4.55
December,31,2019,Tuolumne,CA,Passenger,0,1,1,11,12,8.33
December,31,2019,Clackamas,OR,Passenger,2,1,3,210,213,1.41
December,31,2019,Portsmouth,VA,Passenger,0,1,1,81,82,1.22
December,31,2019,Kitsap,WA,Truck,1,0,1,54446,54447,0
December,31,2019,Stevens,WA,Truck,0,0,0,18761,18761,0
December,31,2019,Skamania,WA,Passenger,26,19,45,8767,8812,0.51
December,31,2019,Ramsey,MN,Passenger,1,0,1,39,40,2.5
December,31,2019,Alexandria,VA,Passenger,1,0,1,147,148,0.68
December,31,2019,Pinellas,FL,Passenger,1,1,2,108,110,1.82
December,31,2019,Powhatan,VA,Passenger,1,0,1,0,1,100
December,31,2019,St. Mary's,MD,Passenger,1,0,1,217,218,0.46
December,31,2019,Suffolk,MA,Passenger,0,1,1,34,35,2.86
December,31,2019,Franklin,WA,Truck,0,0,0,19779,19779,0
December,31,2019,Grays Harbor,WA,Truck,0,0,0,20770,20770,0
December,31,2019,Chelan,WA,Truck,0,0,0,22549,22549,0
December,31,2019,Pima,AZ,Passenger,3,1,4,369,373,1.07
February,28,2019,Grays Harbor,WA,Truck,0,0,0,20318,20318,0
February,28,2019,Garfield,WA,Truck,0,0,0,961,961,0
February,28,2019,Larimer,CO,Passenger,1,0,1,57,58,1.72
February,28,2019,Benton,WA,Passenger,233,245,478,132999,133477,0.36
February,28,2019,Whatcom,WA,Passenger,785,380,1165,149641,150806,0.77
February,28,2019,Richmond,GA,Passenger,0,1,1,89,90,1.11
February,28,2019,Jefferson,NY,Passenger,0,2,2,222,224,0.89
February,28,2019,Juneau,AK,Passenger,0,1,1,38,39,2.56
February,28,2019,Montgomery,AL,Passenger,0,1,1,44,45,2.22
February,28,2019,Calvert,MD,Passenger,0,1,1,87,88,1.14
February,28,2019,Douglas,NE,Passenger,0,1,1,66,67,1.49
February,28,2019,New Haven,CT,Passenger,0,1,1,49,50,2
February,28,2019,Benton,WA,Truck,0,0,0,41547,41547,0
February,28,2019,Howard,MD,Passenger,0,1,1,82,83,1.2
February,28,2019,Cumberland,NC,Passenger,0,2,2,511,513,0.39
February,28,2019,Island,WA,Truck,0,0,0,21171,21171,0
February,28,2019,Douglas,WA,Truck,0,0,0,12166,12166,0
February,28,2019,Clackamas,OR,Passenger,1,1,2,211,213,0.94
February,28,2019,Bergen,NJ,Passenger,1,0,1,25,26,3.85
February,28,2019,Okanogan,WA,Truck,0,0,0,16468,16468,0
February,28,2019,Cape May,NJ,Passenger,0,1,1,19,20,5
February,28,2019,Grant,WA,Truck,0,0,0,26315,26315,0
February,28,2019,Whitman,WA,Passenger,25,40,65,22756,22821,0.28
February,28,2019,San Diego,CA,Passenger,9,3,12,2628,2640,0.45
February,28,2019,Manatee,FL,Passenger,1,0,1,35,36,2.78
February,28,2019,Owyhee,ID,Passenger,1,0,1,5,6,16.67
February,28,2019,Tuolumne,CA,Passenger,0,1,1,12,13,7.69
February,28,2019,Brevard,FL,Passenger,0,1,1,89,90,1.11
February,28,2019,Pierce,WA,Truck,0,0,0,138931,138931,0
February,28,2019,Ada,ID,Passenger,0,2,2,307,309,0.65
February,28,2019,Clay,FL,Passenger,0,1,1,84,85,1.18
February,28,2019,Tarrant,TX,Passenger,1,0,1,206,207,0.48
February,28,2019,Monroe,IL,Passenger,1,0,1,4,5,20
February,28,2019,District of Columbia,DC,Passenger,1,1,2,207,209,0.96
February,28,2019,Fresno,CA,Passenger,1,0,1,187,188,0.53
February,28,2019,Yakima,WA,Truck,0,0,0,58797,58797,0
February,28,2019,Tulsa,OK,Passenger,1,1,2,48,50,4
February,28,2019,Island,WA,Passenger,294,231,525,63179,63704,0.82
February,28,2019,Spartanburg,SC,Passenger,0,1,1,33,34,2.94
February,28,2019,Kittitas,WA,Passenger,73,37,110,29446,29556,0.37
February,28,2019,DeKalb,GA,Passenger,1,0,1,77,78,1.28
February,28,2019,Lewis,WA,Truck,0,0,0,25698,25698,0
February,28,2019,Montgomery,PA,Passenger,2,0,2,36,38,5.26
February,28,2019,Denver,CO,Passenger,1,0,1,129,130,0.77
February,28,2019,Honolulu,HI,Passenger,2,3,5,502,507,0.99
February,28,2019,Pend Oreille,WA,Passenger,5,5,10,9483,9493,0.11
February,28,2019,Asotin,WA,Passenger,12,9,21,12682,12703,0.17
February,28,2019,,,Passenger,6,2,8,784,792,1.01
February,28,2019,Kootenai,ID,Passenger,1,1,2,210,212,0.94
February,28,2019,DeKalb,IN,Passenger,1,0,1,1,2,50
February,28,2019,Lincoln,WA,Truck,0,0,0,4667,4667,0
February,28,2019,Jefferson,WA,Passenger,179,113,292,24863,25155,1.16
February,28,2019,Dale,AL,Passenger,0,1,1,57,58,1.72
February,28,2019,Allegheny,PA,Passenger,1,0,1,84,85,1.18
February,28,2019,San Francisco,CA,Passenger,2,1,3,114,117,2.56
February,28,2019,Jefferson,CO,Passenger,0,2,2,60,62,3.23
February,28,2019,Skamania,WA,Passenger,20,15,35,8715,8750,0.4
February,28,2019,San Juan,PR,Passenger,0,1,1,3,4,25
February,28,2019,Charles,MD,Passenger,0,1,1,77,78,1.28
February,28,2019,Wahkiakum,WA,Passenger,1,1,2,3020,3022,0.07
February,28,2019,El Paso,TX,Passenger,2,0,2,497,499,0.4
February,28,2019,Saratoga,NY,Passenger,1,0,1,62,63,1.59
February,28,2019,Sumter,FL,Passenger,0,1,1,10,11,9.09
February,28,2019,Cowlitz,WA,Truck,0,0,0,28726,28726,0
February,28,2019,Skagit,WA,Passenger,278,187,465,91208,91673,0.51
February,28,2019,Collin,TX,Passenger,1,1,2,137,139,1.44
February,28,2019,Washoe,NV,Passenger,2,0,2,106,108,1.85
February,28,2019,Shasta,CA,Passenger,1,0,1,45,46,2.17
February,28,2019,Harnett,NC,Passenger,1,0,1,217,218,0.46
February,28,2019,Beaufort,SC,Passenger,1,0,1,36,37,2.7
February,28,2019,Clark,NV,Passenger,3,2,5,709,714,0.7
February,28,2019,Broward,FL,Passenger,2,1,3,126,129,2.33
February,28,2019,Yakima,WA,Passenger,86,101,187,164464,164651,0.11
February,28,2019,Dakota,MN,Passenger,0,2,2,34,36,5.56
February,28,2019,Snohomish,WA,Passenger,3146,1498,4644,527664,532308,0.87
February,28,2019,Stevens,WA,Passenger,18,28,46,31733,31779,0.14
February,28,2019,Nassau,NY,Passenger,3,0,3,37,40,7.5
February,28,2019,Montgomery,MD,Passenger,1,0,1,277,278,0.36
February,28,2019,Randolph,NC,Passenger,1,0,1,6,7,14.29
February,28,2019,Franklin,WA,Truck,0,0,0,19115,19115,0
February,28,2019,Ferry,WA,Truck,0,0,0,3592,3592,0
February,28,2019,Charleston,SC,Passenger,1,0,1,120,121,0.83
February,28,2019,Sangamon,IL,Passenger,2,0,2,7,9,22.22
February,28,2019,Lee,FL,Passenger,1,0,1,52,53,1.89
February,28,2019,Houston,GA,Passenger,1,0,1,54,55,1.82
February,28,2019,Garfield,WA,Passenger,1,1,2,1324,1326,0.15
February,28,2019,Mason,WA,Passenger,109,117,226,46675,46901,0.48
February,28,2019,Cochise,AZ,Passenger,0,1,1,117,118,0.85
February,28,2019,Santa Fe,NM,Passenger,0,1,1,41,42,2.38
February,28,2019,Maricopa,AZ,Passenger,6,2,8,1545,1553,0.52
February,28,2019,Fairfax,VA,Passenger,3,2,5,798,803,0.62
February,28,2019,King,WA,Passenger,17528,6762,24290,1379846,1404136,1.73
February,28,2019,Ferry,WA,Passenger,3,2,5,4377,4382,0.11
February,28,2019,Deschutes,OR,Passenger,2,0,2,163,165,1.21
February,28,2019,Duval,FL,Passenger,1,2,3,381,384,0.78
February,28,2019,DuPage,IL,Passenger,1,0,1,61,62,1.61
February,28,2019,Thurston,WA,Truck,0,0,0,54906,54906,0
February,28,2019,Clallam,WA,Truck,0,0,0,21577,21577,0
February,28,2019,Anne Arundel,MD,Passenger,0,2,2,446,448,0.45
February,28,2019,Valencia,NM,Passenger,1,0,1,9,10,10
February,28,2019,Harris,TX,Passenger,0,1,1,252,253,0.4
February,28,2019,Skamania,WA,Truck,0,0,0,3990,3990,0
February,28,2019,St. Mary's,MD,Passenger,1,0,1,210,211,0.47
February,28,2019,Flathead,MT,Passenger,1,0,1,58,59,1.69
February,28,2019,Twin Falls,ID,Passenger,0,1,1,20,21,4.76
February,28,2019,Carroll,NH,Passenger,0,1,1,2,3,33.33
February,28,2019,Pima,AZ,Passenger,1,1,2,401,403,0.5
February,28,2019,Arlington,VA,Passenger,1,2,3,161,164,1.83
February,28,2019,Franklin,WA,Passenger,50,70,120,59299,59419,0.2
February,28,2019,Spokane,WA,Truck,1,0,1,93888,93889,0
February,28,2019,Snohomish,WA,Truck,1,0,1,121877,121878,0
February,28,2019,Contra Costa,CA,Passenger,1,2,3,393,396,0.76
February,28,2019,Lee,AL,Passenger,1,0,1,34,35,2.86
February,28,2019,Nueces,TX,Passenger,1,1,2,90,92,2.17
February,28,2019,Wahkiakum,WA,Truck,0,0,0,1720,1720,0
February,28,2019,Klickitat,WA,Passenger,30,32,62,15450,15512,0.4
February,28,2019,Frederick,MD,Passenger,1,1,2,80,82,2.44
February,28,2019,Kern,CA,Passenger,0,1,1,233,234,0.43
February,28,2019,Ventura,CA,Passenger,0,2,2,312,314,0.64
February,28,2019,Carson City,NV,Passenger,1,0,1,14,15,6.67
February,28,2019,Richland,SC,Passenger,0,1,1,163,164,0.61
February,28,2019,Suffolk,MA,Passenger,0,1,1,41,42,2.38
February,28,2019,Gwinnett,GA,Passenger,0,1,1,76,77,1.3
February,28,2019,Columbia,WA,Truck,0,0,0,1525,1525,0
February,28,2019,Clallam,WA,Passenger,153,127,280,50344,50624,0.55
February,28,2019,Riverside,CA,Passenger,2,2,4,657,661,0.61
February,28,2019,Klickitat,WA,Truck,0,0,0,8221,8221,0
February,28,2019,Cascade,MT,Passenger,0,1,1,55,56,1.79
February,28,2019,Los Angeles,CA,Passenger,6,5,11,1086,1097,1
February,28,2019,Fulton,GA,Passenger,1,2,3,108,111,2.7
February,28,2019,Klamath,OR,Passenger,1,0,1,37,38,2.63
February,28,2019,Thurston,WA,Passenger,782,594,1376,195890,197266,0.7
February,28,2019,Penobscot,ME,Passenger,0,1,1,12,13,7.69
February,28,2019,Lumpkin,GA,Passenger,1,0,1,6,7,14.29
February,28,2019,Prince George's,MD,Passenger,1,1,2,184,186,1.08
February,28,2019,Walla Walla,WA,Truck,0,0,0,13543,13543,0
February,28,2019,Multnomah,OR,Passenger,4,5,9,759,768,1.17
February,28,2019,Marion,IN,Passenger,1,0,1,112,113,0.88
February,28,2019,Clark,WA,Truck,0,0,0,79977,79977,0
February,28,2019,Walla Walla,WA,Passenger,43,54,97,36066,36163,0.27
February,28,2019,Santa Cruz,CA,Passenger,1,0,1,41,42,2.38
February,28,2019,Mecklenburg,NC,Passenger,1,0,1,79,80,1.25
February,28,2019,San Juan,WA,Truck,0,0,0,5799,5799,0
February,28,2019,Pacific,WA,Truck,0,0,0,7634,7634,0
February,28,2019,Rogers,OK,Passenger,1,0,1,4,5,20
February,28,2019,Kitsap,WA,Truck,1,0,1,53701,53702,0
February,28,2019,Jefferson,WA,Truck,0,0,0,9623,9623,0
February,28,2019,Volusia,FL,Passenger,0,1,1,37,38,2.63
February,28,2019,Nantucket,MA,Passenger,1,0,1,4,5,20
February,28,2019,San Mateo,CA,Passenger,2,1,3,125,128,2.34
February,28,2019,Pend Oreille,WA,Truck,0,0,0,5738,5738,0
February,28,2019,Caddo,LA,Passenger,0,1,1,22,23,4.35
February,28,2019,King,WA,Truck,6,1,7,182021,182028,0
February,28,2019,Bexar,TX,Passenger,3,4,7,694,701,1
February,28,2019,Washington,OR,Passenger,0,1,1,467,468,0.21
February,28,2019,Guadalupe,TX,Passenger,1,0,1,78,79,1.27
February,28,2019,San Juan,WA,Passenger,193,69,262,14274,14536,1.8
February,28,2019,Whitman,WA,Truck,0,0,0,8490,8490,0
February,28,2019,Portsmouth,VA,Passenger,0,1,1,80,81,1.23
February,28,2019,Kittitas,WA,Truck,0,0,0,14260,14260,0
February,28,2019,Pierce,WA,Passenger,1611,1428,3039,538910,541949,0.56
February,28,2019,Adams,WA,Passenger,4,6,10,12671,12681,0.08
February,28,2019,Skagit,WA,Truck,1,0,1,32291,32292,0
February,28,2019,Alameda,CA,Passenger,1,2,3,318,321,0.93
February,28,2019,Cowlitz,WA,Passenger,82,100,182,72440,72622,0.25
February,28,2019,Clark,WA,Passenger,1337,866,2203,311844,314047,0.7
February,28,2019,Santa Clara,CA,Passenger,8,1,9,367,376,2.39
February,28,2019,Kent,MI,Passenger,0,1,1,22,23,4.35
February,28,2019,Kitsap,WA,Passenger,988,571,1559,179782,181341,0.86
February,28,2019,Sedgwick,KS,Passenger,0,1,1,101,102,0.98
February,28,2019,St. Lucie,FL,Passenger,1,0,1,30,31,3.23
February,28,2019,Asotin,WA,Truck,0,0,0,6644,6644,0
February,28,2019,Washtenaw,MI,Passenger,1,0,1,38,39,2.56
February,28,2019,Lincoln,WA,Passenger,3,5,8,7735,7743,0.1
February,28,2019,Pacific,WA,Passenger,22,26,48,15864,15912,0.3
February,28,2019,Bucks,PA,Passenger,1,0,1,17,18,5.56
February,28,2019,Albemarle,VA,Passenger,1,0,1,24,25,4
February,28,2019,Mason,WA,Truck,0,0,0,20229,20229,0
February,28,2019,Goochland,VA,Passenger,1,1,2,244,246,0.81
February,28,2019,Hennepin,MN,Passenger,2,0,2,105,107,1.87
February,28,2019,Camden,NJ,Passenger,0,1,1,27,28,3.57
February,28,2019,Montgomery,TX,Passenger,2,0,2,61,63,3.17
February,28,2019,Norfolk,VA,Passenger,2,2,4,346,350,1.14
February,28,2019,Prince William,VA,Passenger,0,4,4,255,259,1.54
February,28,2019,Oldham,KY,Passenger,0,1,1,5,6,16.67
February,28,2019,Norfolk,MA,Passenger,1,0,1,35,36,2.78
February,28,2019,Chelan,WA,Passenger,145,66,211,54157,54368,0.39
February,28,2019,Grant,WA,Passenger,33,55,88,64279,64367,0.14
February,28,2019,Stevens,WA,Truck,0,0,0,18757,18757,0
February,28,2019,Manassas,VA,Passenger,0,1,1,9,10,10
February,28,2019,Marion,OR,Passenger,1,0,1,115,116,0.86
February,28,2019,Polk,FL,Passenger,1,0,1,65,66,1.52
February,28,2019,Orange,CA,Passenger,5,2,7,533,540,1.3
February,28,2019,New London,CT,Passenger,0,2,2,246,248,0.81
February,28,2019,Virginia Beach,VA,Passenger,2,1,3,698,701,0.43
February,28,2019,Moore,NC,Passenger,0,1,1,183,184,0.54
February,28,2019,Douglas,WA,Passenger,52,35,87,27939,28026,0.31
February,28,2019,Ramsey,MN,Passenger,1,0,1,39,40,2.5
February,28,2019,Lewis,WA,Passenger,96,84,180,58309,58489,0.31
February,28,2019,Franklin,MA,Passenger,0,1,1,1,2,50
February,28,2019,Okanogan,WA,Passenger,19,21,40,25964,26004,0.15
February,28,2019,Spokane,WA,Passenger,481,386,867,307236,308103,0.28
February,28,2019,Williamson,TX,Passenger,0,1,1,150,151,0.66
February,28,2019,Hawaii,HI,Passenger,1,0,1,62,63,1.59
February,28,2019,St. Clair,IL,Passenger,0,1,1,166,167,0.6
February,28,2019,Hardin,KY,Passenger,0,1,1,105,106,0.94
February,28,2019,Adams,WA,Truck,0,0,0,5109,5109,0
February,28,2019,Pinal,AZ,Passenger,2,0,2,203,205,0.98
February,28,2019,Shelby,TN,Passenger,0,1,1,96,97,1.03
February,28,2019,Travis,TX,Passenger,2,1,3,200,203,1.48
February,28,2019,Cook,IL,Passenger,1,0,1,240,241,0.41
February,28,2019,Columbia,WA,Passenger,2,2,4,2430,2434,0.16
February,28,2019,El Paso,CO,Passenger,3,2,5,757,762,0.66
February,28,2019,Whatcom,WA,Truck,2,0,2,42708,42710,0
February,28,2019,Santa Rosa,FL,Passenger,1,0,1,89,90,1.11
February,28,2019,Alexandria,VA,Passenger,1,0,1,159,160,0.62
February,28,2019,Palm Beach,FL,Passenger,0,1,1,92,93,1.08
February,28,2019,Middlesex,MA,Passenger,1,1,2,120,122,1.64
February,28,2019,Chelan,WA,Truck,0,0,0,22097,22097,0
February,28,2019,Grays Harbor,WA,Passenger,66,79,145,47455,47600,0.3
February,28,2019,Maui,HI,Passenger,1,0,1,50,51,1.96
January,31,2019,Portsmouth,VA,Passenger,0,1,1,80,81,1.23
January,31,2019,San Juan,WA,Truck,0,0,0,5802,5802,0
January,31,2019,Ferry,WA,Passenger,3,2,5,4388,4393,0.11
January,31,2019,Okanogan,WA,Truck,0,0,0,16477,16477,0
January,31,2019,Ventura,CA,Passenger,0,2,2,314,316,0.63
January,31,2019,Stevens,WA,Truck,0,0,0,18768,18768,0
January,31,2019,Island,WA,Truck,0,0,0,21211,21211,0
January,31,2019,Jefferson,CO,Passenger,0,2,2,61,63,3.17
January,31,2019,Charles,MD,Passenger,0,1,1,75,76,1.32
January,31,2019,Montgomery,AL,Passenger,0,1,1,45,46,2.17
January,31,2019,Marion,IN,Passenger,1,0,1,117,118,0.85
January,31,2019,San Juan,PR,Passenger,0,1,1,5,6,16.67
January,31,2019,Adams,WA,Truck,0,0,0,5142,5142,0
January,31,2019,King,WA,Truck,6,1,7,182396,182403,0
January,31,2019,Cowlitz,WA,Truck,0,0,0,28728,28728,0
January,31,2019,Honolulu,HI,Passenger,1,3,4,517,521,0.77
January,31,2019,Harnett,NC,Passenger,1,0,1,221,222,0.45
January,31,2019,Lee,FL,Passenger,1,0,1,52,53,1.89
January,31,2019,Pacific,WA,Truck,0,0,0,7615,7615,0
January,31,2019,Albemarle,VA,Passenger,1,0,1,24,25,4
January,31,2019,Duval,FL,Passenger,1,2,3,382,385,0.78
January,31,2019,Asotin,WA,Truck,0,0,0,6645,6645,0
January,31,2019,Hawaii,HI,Passenger,1,0,1,60,61,1.64
January,31,2019,DeKalb,IN,Passenger,1,0,1,1,2,50
January,31,2019,Klamath,OR,Passenger,1,0,1,37,38,2.63
January,31,2019,Grant,WA,Passenger,33,53,86,64365,64451,0.13
January,31,2019,Cowlitz,WA,Passenger,79,96,175,72557,72732,0.24
January,31,2019,Adams,WA,Passenger,5,6,11,12742,12753,0.09
January,31,2019,Clark,WA,Passenger,1313,868,2181,312092,314273,0.69
January,31,2019,Carson City,NV,Passenger,1,0,1,14,15,6.67
January,31,2019,Franklin,WA,Passenger,49,68,117,59324,59441,0.2
January,31,2019,Hennepin,MN,Passenger,2,0,2,106,108,1.85
January,31,2019,Wahkiakum,WA,Passenger,1,1,2,3006,3008,0.07
January,31,2019,Guadalupe,TX,Passenger,1,0,1,78,79,1.27
January,31,2019,Franklin,WA,Truck,0,0,0,19128,19128,0
January,31,2019,DuPage,IL,Passenger,1,0,1,60,61,1.64
January,31,2019,Lumpkin,GA,Passenger,1,0,1,6,7,14.29
January,31,2019,Bergen,NJ,Passenger,1,0,1,27,28,3.57
January,31,2019,Benton,WA,Passenger,232,243,475,133224,133699,0.36
January,31,2019,Nassau,NY,Passenger,3,0,3,36,39,7.69
January,31,2019,Pend Oreille,WA,Passenger,5,5,10,9538,9548,0.1
January,31,2019,Columbia,WA,Passenger,2,2,4,2423,2427,0.16
January,31,2019,Asotin,WA,Passenger,12,9,21,12729,12750,0.16
January,31,2019,Kootenai,ID,Passenger,1,1,2,214,216,0.93
January,31,2019,El Paso,TX,Passenger,2,0,2,501,503,0.4
January,31,2019,Walla Walla,WA,Passenger,42,54,96,36138,36234,0.26
January,31,2019,Calvert,MD,Passenger,0,1,1,88,89,1.12
January,31,2019,Kent,MI,Passenger,0,1,1,23,24,4.17
January,31,2019,Oldham,KY,Passenger,0,1,1,5,6,16.67
January,31,2019,Middlesex,MA,Passenger,1,1,2,121,123,1.63
January,31,2019,Snohomish,WA,Passenger,3075,1488,4563,528288,532851,0.86
January,31,2019,Clallam,WA,Truck,0,0,0,21632,21632,0
January,31,2019,Travis,TX,Passenger,2,1,3,200,203,1.48
January,31,2019,Allegheny,PA,Passenger,1,0,1,85,86,1.16
January,31,2019,Kittitas,WA,Passenger,69,36,105,29465,29570,0.36
January,31,2019,Pima,AZ,Passenger,1,1,2,403,405,0.49
January,31,2019,Alameda,CA,Passenger,0,2,2,316,318,0.63
January,31,2019,Clark,WA,Truck,0,0,0,79967,79967,0
January,31,2019,Whitman,WA,Passenger,24,40,64,22845,22909,0.28
January,31,2019,Pend Oreille,WA,Truck,0,0,0,5743,5743,0
January,31,2019,Frederick,MD,Passenger,0,1,1,80,81,1.23
January,31,2019,Manatee,FL,Passenger,1,0,1,36,37,2.7
January,31,2019,Collin,TX,Passenger,1,1,2,143,145,1.38
January,31,2019,Clallam,WA,Passenger,152,128,280,50402,50682,0.55
January,31,2019,Klickitat,WA,Truck,0,0,0,8228,8228,0
January,31,2019,Monroe,IL,Passenger,1,0,1,4,5,20
January,31,2019,Nueces,TX,Passenger,1,1,2,90,92,2.17
January,31,2019,Palm Beach,FL,Passenger,0,1,1,91,92,1.09
January,31,2019,Maricopa,AZ,Passenger,5,2,7,1551,1558,0.45
January,31,2019,Grays Harbor,WA,Truck,0,0,0,20319,20319,0
January,31,2019,Caddo,LA,Passenger,0,1,1,21,22,4.55
January,31,2019,Grant,WA,Truck,0,0,0,26324,26324,0
January,31,2019,Pinal,AZ,Passenger,2,0,2,203,205,0.98
January,31,2019,Benton,WA,Truck,0,0,0,41617,41617,0
January,31,2019,Yakima,WA,Passenger,84,100,184,164930,165114,0.11
January,31,2019,Klickitat,WA,Passenger,29,32,61,15485,15546,0.39
January,31,2019,Cook,IL,Passenger,1,0,1,245,246,0.41
January,31,2019,Chelan,WA,Truck,0,0,0,22107,22107,0
January,31,2019,Fulton,GA,Passenger,1,2,3,107,110,2.73
January,31,2019,Mason,WA,Truck,0,0,0,20224,20224,0
January,31,2019,Snohomish,WA,Truck,1,0,1,122005,122006,0
January,31,2019,Montgomery,PA,Passenger,2,0,2,35,37,5.41
January,31,2019,Sangamon,IL,Passenger,1,0,1,8,9,11.11
January,31,2019,Carroll,NH,Passenger,0,1,1,1,2,50
January,31,2019,Kern,CA,Passenger,0,1,1,232,233,0.43
January,31,2019,Penobscot,ME,Passenger,0,1,1,12,13,7.69
January,31,2019,San Diego,CA,Passenger,9,2,11,2582,2593,0.42
January,31,2019,Dale,AL,Passenger,0,1,1,56,57,1.75
January,31,2019,Island,WA,Passenger,288,229,517,63253,63770,0.81
January,31,2019,Lewis,WA,Truck,0,0,0,25661,25661,0
January,31,2019,Bexar,TX,Passenger,3,4,7,706,713,0.98
January,31,2019,Norfolk,MA,Passenger,1,0,1,36,37,2.7
January,31,2019,Santa Rosa,FL,Passenger,1,0,1,89,90,1.11
January,31,2019,Houston,GA,Passenger,1,0,1,51,52,1.92
January,31,2019,El Paso,CO,Passenger,3,1,4,761,765,0.52
January,31,2019,Clackamas,OR,Passenger,1,1,2,212,214,0.93
January,31,2019,Walla Walla,WA,Truck,0,0,0,13535,13535,0
January,31,2019,Jefferson,WA,Truck,0,0,0,9619,9619,0
January,31,2019,Saratoga,NY,Passenger,1,0,1,61,62,1.61
January,31,2019,Lee,AL,Passenger,1,0,1,35,36,2.78
January,31,2019,Multnomah,OR,Passenger,3,5,8,768,776,1.03
January,31,2019,Kittitas,WA,Truck,0,0,0,14237,14237,0
January,31,2019,Skagit,WA,Truck,1,0,1,32319,32320,0
January,31,2019,Richland,SC,Passenger,0,1,1,163,164,0.61
January,31,2019,Okanogan,WA,Passenger,18,21,39,26053,26092,0.15
January,31,2019,Clark,NV,Passenger,2,2,4,719,723,0.55
January,31,2019,Santa Fe,NM,Passenger,0,1,1,41,42,2.38
January,31,2019,Madison,ID,Passenger,1,0,1,36,37,2.7
January,31,2019,Goochland,VA,Passenger,0,1,1,245,246,0.41
January,31,2019,Sumter,FL,Passenger,0,1,1,10,11,9.09
January,31,2019,Santa Clara,CA,Passenger,8,1,9,370,379,2.37
January,31,2019,Flathead,MT,Passenger,1,0,1,59,60,1.67
January,31,2019,Denver,CO,Passenger,1,0,1,130,131,0.76
January,31,2019,Moore,NC,Passenger,0,1,1,187,188,0.53
January,31,2019,Santa Cruz,CA,Passenger,1,0,1,42,43,2.33
January,31,2019,Camden,NJ,Passenger,0,1,1,27,28,3.57
January,31,2019,Gwinnett,GA,Passenger,0,1,1,75,76,1.32
January,31,2019,DeKalb,GA,Passenger,1,0,1,77,78,1.28
January,31,2019,Juneau,AK,Passenger,0,1,1,39,40,2.5
January,31,2019,Whatcom,WA,Truck,2,0,2,42739,42741,0
January,31,2019,Ramsey,MN,Passenger,1,0,1,38,39,2.56
January,31,2019,Alexandria,VA,Passenger,1,0,1,163,164,0.61
January,31,2019,Norfolk,VA,Passenger,2,2,4,340,344,1.16
January,31,2019,Skamania,WA,Passenger,18,15,33,8741,8774,0.38
January,31,2019,Larimer,CO,Passenger,1,0,1,58,59,1.69
January,31,2019,District of Columbia,DC,Passenger,1,3,4,203,207,1.93
January,31,2019,Jefferson,WA,Passenger,175,112,287,24852,25139,1.14
January,31,2019,Kitsap,WA,Passenger,981,556,1537,179937,181474,0.85
January,31,2019,,,Passenger,7,2,9,788,797,1.13
January,31,2019,Twin Falls,ID,Passenger,0,1,1,20,21,4.76
January,31,2019,Deschutes,OR,Passenger,2,0,2,164,166,1.2
January,31,2019,St. Mary's,MD,Passenger,1,0,1,211,212,0.47
January,31,2019,Thurston,WA,Passenger,771,590,1361,196046,197407,0.69
January,31,2019,Shasta,CA,Passenger,1,0,1,43,44,2.27
January,31,2019,New Haven,CT,Passenger,0,1,1,49,50,2
January,31,2019,Whatcom,WA,Passenger,778,375,1153,149711,150864,0.76
January,31,2019,Garfield,WA,Passenger,1,1,2,1332,1334,0.15
January,31,2019,Columbia,WA,Truck,0,0,0,1529,1529,0
January,31,2019,Valencia,NM,Passenger,1,0,1,9,10,10
January,31,2019,Richmond,GA,Passenger,0,1,1,90,91,1.1
January,31,2019,Pierce,WA,Truck,0,0,0,139124,139124,0
January,31,2019,Howard,MD,Passenger,0,1,1,82,83,1.2
January,31,2019,Los Angeles,CA,Passenger,7,5,12,1096,1108,1.08
January,31,2019,Douglas,NE,Passenger,0,1,1,67,68,1.47
January,31,2019,Montgomery,MD,Passenger,1,0,1,276,277,0.36
January,31,2019,Garfield,OK,Passenger,1,0,1,13,14,7.14
January,31,2019,Maui,HI,Passenger,1,0,1,50,51,1.96
January,31,2019,Charleston,SC,Passenger,1,0,1,122,123,0.81
January,31,2019,Broward,FL,Passenger,2,1,3,128,131,2.29
January,31,2019,Douglas,WA,Passenger,51,35,86,28011,28097,0.31
January,31,2019,Skamania,WA,Truck,0,0,0,4008,4008,0
January,31,2019,Thurston,WA,Truck,0,0,0,54922,54922,0
January,31,2019,San Francisco,CA,Passenger,2,1,3,114,117,2.56
January,31,2019,Mecklenburg,NC,Passenger,1,0,1,80,81,1.23
January,31,2019,Fresno,CA,Passenger,1,0,1,187,188,0.53
January,31,2019,Tuolumne,CA,Passenger,0,1,1,12,13,7.69
January,31,2019,Washoe,NV,Passenger,2,0,2,107,109,1.83
January,31,2019,Volusia,FL,Passenger,0,1,1,37,38,2.63
January,31,2019,Beaufort,SC,Passenger,1,0,1,36,37,2.7
January,31,2019,Cape May,NJ,Passenger,0,1,1,20,21,4.76
January,31,2019,Williamson,TX,Passenger,0,1,1,149,150,0.67
January,31,2019,Mason,WA,Passenger,108,115,223,46659,46882,0.48
January,31,2019,Montgomery,TX,Passenger,2,0,2,60,62,3.23
January,31,2019,Rogers,OK,Passenger,1,0,1,5,6,16.67
January,31,2019,Chelan,WA,Passenger,140,64,204,54205,54409,0.37
January,31,2019,Washington,OR,Passenger,0,1,1,471,472,0.21
January,31,2019,Pierce,WA,Passenger,1581,1423,3004,539770,542774,0.55
January,31,2019,Jefferson,NY,Passenger,0,1,1,229,230,0.43
January,31,2019,Douglas,WA,Truck,0,0,0,12172,12172,0
January,31,2019,Anne Arundel,MD,Passenger,0,2,2,450,452,0.44
January,31,2019,Contra Costa,CA,Passenger,1,2,3,405,408,0.74
January,31,2019,Sedgwick,KS,Passenger,0,1,1,99,100,1
January,31,2019,Washtenaw,MI,Passenger,1,0,1,39,40,2.5
January,31,2019,Dakota,MN,Passenger,0,2,2,33,35,5.71
January,31,2019,Wahkiakum,WA,Truck,0,0,0,1711,1711,0
January,31,2019,Tulsa,OK,Passenger,1,1,2,48,50,4
January,31,2019,Stevens,WA,Passenger,18,28,46,31816,31862,0.14
January,31,2019,Skagit,WA,Passenger,270,186,456,91360,91816,0.5
January,31,2019,Ada,ID,Passenger,0,2,2,310,312,0.64
January,31,2019,Lincoln,WA,Passenger,2,5,7,7755,7762,0.09
January,31,2019,Prince George's,MD,Passenger,1,1,2,183,185,1.08
January,31,2019,Spokane,WA,Passenger,471,380,851,307611,308462,0.28
January,31,2019,Whitman,WA,Truck,0,0,0,8512,8512,0
January,31,2019,Garfield,WA,Truck,0,0,0,962,962,0
January,31,2019,Spartanburg,SC,Passenger,0,1,1,33,34,2.94
January,31,2019,Ferry,WA,Truck,0,0,0,3590,3590,0
January,31,2019,San Mateo,CA,Passenger,2,1,3,126,129,2.33
January,31,2019,Spokane,WA,Truck,1,0,1,93943,93944,0
January,31,2019,Orange,CA,Passenger,5,2,7,538,545,1.28
January,31,2019,Kitsap,WA,Truck,1,0,1,53730,53731,0
January,31,2019,Harris,TX,Passenger,0,1,1,254,255,0.39
January,31,2019,Prince William,VA,Passenger,0,4,4,256,260,1.54
January,31,2019,Virginia Beach,VA,Passenger,2,1,3,698,701,0.43
January,31,2019,Tarrant,TX,Passenger,1,0,1,203,204,0.49
January,31,2019,Marion,OR,Passenger,1,0,1,117,118,0.85
January,31,2019,Polk,FL,Passenger,1,0,1,66,67,1.49
January,31,2019,New London,CT,Passenger,0,2,2,248,250,0.8
January,31,2019,Lincoln,WA,Truck,0,0,0,4666,4666,0
January,31,2019,Pacific,WA,Passenger,22,26,48,15882,15930,0.3
January,31,2019,San Juan,WA,Passenger,190,68,258,14255,14513,1.78
January,31,2019,Lewis,WA,Passenger,95,82,177,58367,58544,0.3
January,31,2019,King,WA,Passenger,17167,6678,23845,1381057,1404902,1.7
January,31,2019,Fairfax,VA,Passenger,3,2,5,801,806,0.62
January,31,2019,Yakima,WA,Truck,0,0,0,58929,58929,0
January,31,2019,Franklin,MA,Passenger,0,1,1,1,2,50
January,31,2019,Nantucket,MA,Passenger,1,0,1,4,5,20
January,31,2019,Clay,FL,Passenger,0,1,1,86,87,1.15
January,31,2019,Arlington,VA,Passenger,1,2,3,162,165,1.82
January,31,2019,Grays Harbor,WA,Passenger,67,76,143,47449,47592,0.3
January,31,2019,Manassas,VA,Passenger,0,1,1,9,10,10
January,31,2019,Cumberland,NC,Passenger,0,2,2,522,524,0.38
January,31,2019,Brevard,FL,Passenger,0,1,1,90,91,1.1
January,31,2019,Cochise,AZ,Passenger,0,1,1,118,119,0.84
January,31,2019,Suffolk,MA,Passenger,0,1,1,40,41,2.44
January,31,2019,Riverside,CA,Passenger,2,2,4,669,673,0.59
January,31,2019,Bucks,PA,Passenger,1,0,1,16,17,5.88
January,31,2019,Shelby,TN,Passenger,0,1,1,96,97,1.03
January,31,2019,Hardin,KY,Passenger,0,1,1,104,105,0.95
January,31,2019,Randolph,NC,Passenger,1,0,1,6,7,14.29
January,31,2019,St. Lucie,FL,Passenger,1,0,1,30,31,3.23
January,31,2019,St. Clair,IL,Passenger,0,1,1,167,168,0.6
July,31,2019,Juneau,AK,Passenger,0,2,2,31,33,6.06
July,31,2019,Lake,IL,Passenger,1,0,1,166,167,0.6
July,31,2019,Riverside,CA,Passenger,3,2,5,653,658,0.76
July,31,2019,Whatcom,WA,Truck,2,0,2,42929,42931,0
July,31,2019,San Diego,CA,Passenger,10,3,13,2733,2746,0.47
July,31,2019,Pend Oreille,WA,Truck,0,0,0,5730,5730,0
July,31,2019,DuPage,IL,Passenger,3,0,3,57,60,5
July,31,2019,Fresno,CA,Passenger,1,0,1,193,194,0.52
July,31,2019,Albemarle,VA,Passenger,1,0,1,22,23,4.35
July,31,2019,Montgomery,MD,Passenger,1,0,1,279,280,0.36
July,31,2019,Walla Walla,WA,Passenger,52,61,113,36208,36321,0.31
July,31,2019,Wayne,MI,Passenger,0,1,1,66,67,1.49
July,31,2019,Nassau,NY,Passenger,4,0,4,38,42,9.52
July,31,2019,Owyhee,ID,Passenger,1,0,1,5,6,16.67
July,31,2019,Montgomery,PA,Passenger,2,0,2,37,39,5.13
July,31,2019,Walla Walla,WA,Truck,0,0,0,13617,13617,0
July,31,2019,Moore,NC,Passenger,0,1,1,183,184,0.54
July,31,2019,Norfolk,MA,Passenger,1,0,1,38,39,2.56
July,31,2019,Columbia,WA,Passenger,2,2,4,2454,2458,0.16
July,31,2019,Charleston,SC,Passenger,1,0,1,114,115,0.87
July,31,2019,Jefferson,NY,Passenger,0,2,2,214,216,0.93
July,31,2019,Ada,ID,Passenger,0,2,2,306,308,0.65
July,31,2019,Prince George's,MD,Passenger,1,1,2,177,179,1.12
July,31,2019,DeKalb,IN,Passenger,1,0,1,1,2,50
July,31,2019,Maui,HI,Passenger,1,0,1,45,46,2.17
July,31,2019,Kittitas,WA,Passenger,79,41,120,29679,29799,0.4
July,31,2019,Monroe,IL,Passenger,1,0,1,5,6,16.67
July,31,2019,Denver,CO,Passenger,1,0,1,128,129,0.78
July,31,2019,Thurston,WA,Truck,0,0,0,55259,55259,0
July,31,2019,Manassas,VA,Passenger,0,1,1,9,10,10
July,31,2019,Pinal,AZ,Passenger,2,0,2,191,193,1.04
July,31,2019,Saratoga,NY,Passenger,1,0,1,54,55,1.82
July,31,2019,Douglas,NE,Passenger,0,1,1,61,62,1.61
July,31,2019,Columbia,WA,Truck,0,0,0,1529,1529,0
July,31,2019,Garfield,WA,Passenger,1,1,2,1298,1300,0.15
July,31,2019,Norfolk,VA,Passenger,2,2,4,351,355,1.13
July,31,2019,Yakima,WA,Passenger,109,107,216,165397,165613,0.13
July,31,2019,San Juan,WA,Passenger,220,72,292,14446,14738,1.98
July,31,2019,Lewis,WA,Truck,0,0,0,25966,25966,0
July,31,2019,Alexandria,VA,Passenger,1,0,1,147,148,0.68
July,31,2019,Hawaii,HI,Passenger,1,0,1,59,60,1.67
July,31,2019,Fairbanks North Star,AK,Passenger,0,1,1,98,99,1.01
July,31,2019,El Paso,TX,Passenger,3,0,3,484,487,0.62
July,31,2019,Skamania,WA,Passenger,25,18,43,8739,8782,0.49
July,31,2019,Shelby,OH,Passenger,0,1,1,1,2,50
July,31,2019,Pierce,WA,Truck,0,0,0,140021,140021,0
July,31,2019,Cowlitz,WA,Passenger,106,107,213,73140,73353,0.29
July,31,2019,Thurston,WA,Passenger,905,652,1557,198166,199723,0.78
July,31,2019,Harnett,NC,Passenger,1,1,2,212,214,0.93
July,31,2019,San Mateo,CA,Passenger,2,1,3,117,120,2.5
July,31,2019,Richland,SC,Passenger,0,1,1,161,162,0.62
July,31,2019,Skagit,WA,Truck,1,0,1,32524,32525,0
July,31,2019,Los Angeles,CA,Passenger,8,5,13,1110,1123,1.16
July,31,2019,Charles,MD,Passenger,0,1,1,88,89,1.12
July,31,2019,Montgomery,AL,Passenger,0,1,1,43,44,2.27
July,31,2019,Middlesex,MA,Passenger,1,1,2,114,116,1.72
July,31,2019,Jefferson,CO,Passenger,0,2,2,57,59,3.39
July,31,2019,Carson City,NV,Passenger,1,0,1,11,12,8.33
July,31,2019,Clark,WA,Passenger,1588,944,2532,314921,317453,0.8
July,31,2019,Lincoln,WA,Truck,0,0,0,4684,4684,0
July,31,2019,New London,CT,Passenger,0,2,2,242,244,0.82
July,31,2019,Cowlitz,WA,Truck,0,0,0,28867,28867,0
July,31,2019,Clay,FL,Passenger,0,1,1,87,88,1.14
July,31,2019,Oklahoma,OK,Passenger,0,1,1,125,126,0.79
July,31,2019,Skagit,WA,Passenger,307,210,517,92211,92728,0.56
July,31,2019,Deschutes,OR,Passenger,2,0,2,155,157,1.27
July,31,2019,Houston,GA,Passenger,1,0,1,54,55,1.82
July,31,2019,Shasta,CA,Passenger,1,0,1,40,41,2.44
July,31,2019,Loudoun,VA,Passenger,1,0,1,96,97,1.03
July,31,2019,Clackamas,OR,Passenger,1,1,2,213,215,0.93
July,31,2019,Placer,CA,Passenger,1,0,1,99,100,1
July,31,2019,Clark,WA,Truck,0,0,0,80613,80613,0
July,31,2019,,,Passenger,8,3,11,813,824,1.33
July,31,2019,El Paso,CO,Passenger,2,1,3,737,740,0.41
July,31,2019,Fairfax,VA,Passenger,3,2,5,781,786,0.64
July,31,2019,Klickitat,WA,Truck,0,0,0,8255,8255,0
July,31,2019,King,WA,Truck,5,1,6,182265,182271,0
July,31,2019,Asotin,WA,Truck,0,0,0,6660,6660,0
July,31,2019,New Haven,CT,Passenger,0,2,2,47,49,4.08
July,31,2019,Benton,WA,Passenger,270,289,559,134166,134725,0.41
July,31,2019,Ramsey,MN,Passenger,1,0,1,39,40,2.5
July,31,2019,Kent,MI,Passenger,0,1,1,21,22,4.55
July,31,2019,Valencia,NM,Passenger,1,0,1,6,7,14.29
July,31,2019,Flathead,MT,Passenger,1,0,1,62,63,1.59
July,31,2019,Wilson,TX,Passenger,0,1,1,6,7,14.29
July,31,2019,Jefferson,WA,Truck,0,0,0,9683,9683,0
July,31,2019,Twin Falls,ID,Passenger,0,1,1,24,25,4
July,31,2019,Santa Fe,NM,Passenger,0,1,1,39,40,2.5
July,31,2019,Bexar,TX,Passenger,2,5,7,658,665,1.05
July,31,2019,Putnam,TN,Passenger,0,1,1,3,4,25
July,31,2019,Skamania,WA,Truck,0,0,0,4063,4063,0
July,31,2019,Mason,WA,Passenger,127,126,253,47316,47569,0.53
July,31,2019,Dallas,TX,Passenger,1,0,1,203,204,0.49
July,31,2019,Marion,OR,Passenger,1,0,1,117,118,0.85
July,31,2019,Osceola,FL,Passenger,1,0,1,41,42,2.38
July,31,2019,Solano,CA,Passenger,1,0,1,215,216,0.46
July,31,2019,Randolph,NC,Passenger,1,0,1,6,7,14.29
July,31,2019,St. Clair,IL,Passenger,0,1,1,158,159,0.63
July,31,2019,Clallam,WA,Truck,1,0,1,21812,21813,0
July,31,2019,Jefferson,WA,Passenger,202,118,320,25065,25385,1.26
July,31,2019,Bergen,NJ,Passenger,1,0,1,26,27,3.7
July,31,2019,Dale,AL,Passenger,0,1,1,59,60,1.67
July,31,2019,Ferry,WA,Truck,0,0,0,3580,3580,0
July,31,2019,Nantucket,MA,Passenger,1,0,1,2,3,33.33
July,31,2019,Powhatan,VA,Passenger,1,0,1,0,1,100
July,31,2019,Maricopa,AZ,Passenger,7,4,11,1530,1541,0.71
July,31,2019,Sedgwick,KS,Passenger,1,1,2,99,101,1.98
July,31,2019,Clark,NV,Passenger,4,2,6,690,696,0.86
July,31,2019,Pima,AZ,Passenger,0,1,1,392,393,0.25
July,31,2019,Sumter,FL,Passenger,0,1,1,10,11,9.09
July,31,2019,Washtenaw,MI,Passenger,1,0,1,41,42,2.38
July,31,2019,Snohomish,WA,Truck,0,0,0,122619,122619,0
July,31,2019,Brevard,FL,Passenger,0,1,1,83,84,1.19
July,31,2019,Palm Beach,FL,Passenger,0,1,1,85,86,1.16
July,31,2019,Spartanburg,SC,Passenger,0,1,1,37,38,2.63
July,31,2019,Asotin,WA,Passenger,12,8,20,12658,12678,0.16
July,31,2019,Calvert,MD,Passenger,0,2,2,89,91,2.2
July,31,2019,Suffolk,MA,Passenger,0,1,1,37,38,2.63
July,31,2019,Harris,TX,Passenger,1,1,2,249,251,0.8
July,31,2019,Benton,WA,Truck,0,0,0,42072,42072,0
July,31,2019,DeKalb,GA,Passenger,1,0,1,77,78,1.28
July,31,2019,Bucks,PA,Passenger,1,0,1,21,22,4.55
July,31,2019,Mecklenburg,NC,Passenger,1,0,1,88,89,1.12
July,31,2019,Dakota,MN,Passenger,0,1,1,37,38,2.63
July,31,2019,RÃ­o Grande,PR,Passenger,1,0,1,1,2,50
July,31,2019,Sarasota,FL,Passenger,1,0,1,24,25,4
July,31,2019,Chelan,WA,Truck,0,0,0,22349,22349,0
July,31,2019,Alameda,CA,Passenger,4,2,6,303,309,1.94
July,31,2019,Cumberland,NC,Passenger,0,2,2,498,500,0.4
July,31,2019,Frederick,MD,Passenger,1,1,2,81,83,2.41
July,31,2019,Boone,MO,Passenger,0,1,1,10,11,9.09
July,31,2019,Snohomish,WA,Passenger,3556,1617,5173,532742,537915,0.96
July,31,2019,Island,WA,Truck,0,0,0,21312,21312,0
July,31,2019,Franklin,WA,Passenger,53,71,124,60145,60269,0.21
July,31,2019,Tarrant,TX,Passenger,2,0,2,201,203,0.99
July,31,2019,Tulsa,OK,Passenger,1,1,2,45,47,4.26
July,31,2019,Duval,FL,Passenger,1,2,3,372,375,0.8
July,31,2019,Santa Rosa,FL,Passenger,1,0,1,90,91,1.1
July,31,2019,Allegheny,PA,Passenger,1,0,1,78,79,1.27
July,31,2019,Kitsap,WA,Truck,1,0,1,54128,54129,0
July,31,2019,Lewis,WA,Passenger,100,96,196,59368,59564,0.33
July,31,2019,Harrison,MS,Passenger,1,0,1,62,63,1.59
July,31,2019,Penobscot,ME,Passenger,0,1,1,13,14,7.14
July,31,2019,Saginaw,MI,Passenger,1,0,1,11,12,8.33
July,31,2019,Grant,WA,Truck,0,0,0,26703,26703,0
July,31,2019,Franklin,WA,Truck,0,0,0,19368,19368,0
July,31,2019,Lake,FL,Passenger,1,0,1,19,20,5
July,31,2019,Portsmouth,VA,Passenger,0,1,1,78,79,1.27
July,31,2019,Nueces,TX,Passenger,1,1,2,93,95,2.11
July,31,2019,Adams,WA,Passenger,5,6,11,12835,12846,0.09
July,31,2019,Cochise,AZ,Passenger,0,1,1,111,112,0.89
July,31,2019,Cook,IL,Passenger,1,0,1,240,241,0.41
July,31,2019,Spokane,WA,Passenger,557,435,992,312718,313710,0.32
July,31,2019,Wahkiakum,WA,Passenger,2,2,4,3007,3011,0.13
July,31,2019,Broward,FL,Passenger,2,1,3,126,129,2.33
July,31,2019,Yakima,WA,Truck,0,0,0,59260,59260,0
July,31,2019,Manatee,FL,Passenger,1,0,1,31,32,3.12
July,31,2019,Contra Costa,CA,Passenger,2,2,4,377,381,1.05
July,31,2019,Grant,WA,Passenger,43,61,104,65017,65121,0.16
July,31,2019,Klickitat,WA,Passenger,35,33,68,15579,15647,0.43
July,31,2019,Carroll,NH,Passenger,0,1,1,3,4,25
July,31,2019,San Juan,WA,Truck,0,0,0,5890,5890,0
July,31,2019,Arlington,VA,Passenger,0,2,2,157,159,1.26
July,31,2019,Stevens,WA,Passenger,19,30,49,31721,31770,0.15
July,31,2019,Goochland,VA,Passenger,1,1,2,259,261,0.77
July,31,2019,Pend Oreille,WA,Passenger,4,6,10,9537,9547,0.1
July,31,2019,Guadalupe,TX,Passenger,1,0,1,73,74,1.35
July,31,2019,Larimer,CO,Passenger,1,0,1,57,58,1.72
July,31,2019,Orange,CA,Passenger,6,1,7,521,528,1.33
July,31,2019,District of Columbia,DC,Passenger,1,1,2,211,213,0.94
July,31,2019,Cascade,MT,Passenger,0,1,1,61,62,1.61
July,31,2019,Adams,WA,Truck,0,0,0,5132,5132,0
July,31,2019,St. Mary's,MD,Passenger,1,0,1,217,218,0.46
July,31,2019,Kern,CA,Passenger,0,1,1,218,219,0.46
July,31,2019,Montgomery,TX,Passenger,1,0,1,59,60,1.67
July,31,2019,Shelby,TN,Passenger,0,1,1,90,91,1.1
July,31,2019,Grays Harbor,WA,Truck,0,0,0,20535,20535,0
July,31,2019,Vigo,IN,Passenger,1,0,1,6,7,14.29
July,31,2019,Santa Cruz,CA,Passenger,1,0,1,39,40,2.5
July,31,2019,Spokane,WA,Truck,1,0,1,95241,95242,0
July,31,2019,Kootenai,ID,Passenger,1,1,2,221,223,0.9
July,31,2019,Grays Harbor,WA,Passenger,82,85,167,47997,48164,0.35
July,31,2019,Ferry,WA,Passenger,5,2,7,4399,4406,0.16
July,31,2019,Collin,TX,Passenger,1,1,2,134,136,1.47
July,31,2019,Travis,TX,Passenger,2,1,3,199,202,1.49
July,31,2019,Kittitas,WA,Truck,0,0,0,14488,14488,0
July,31,2019,Rogers,OK,Passenger,1,0,1,5,6,16.67
July,31,2019,Wahkiakum,WA,Truck,0,0,0,1761,1761,0
July,31,2019,Washoe,NV,Passenger,2,0,2,111,113,1.77
July,31,2019,Prince William,VA,Passenger,1,3,4,248,252,1.59
July,31,2019,Howard,MD,Passenger,0,1,1,74,75,1.33
July,31,2019,Polk,FL,Passenger,1,0,1,66,67,1.49
July,31,2019,Mason,WA,Truck,0,0,0,20412,20412,0
July,31,2019,San Francisco,CA,Passenger,2,1,3,105,108,2.78
July,31,2019,Lee,FL,Passenger,1,0,1,51,52,1.92
July,31,2019,Okanogan,WA,Truck,0,0,0,16490,16490,0
July,31,2019,Oldham,KY,Passenger,0,1,1,5,6,16.67
July,31,2019,Island,WA,Passenger,328,243,571,63488,64059,0.89
July,31,2019,Stevens,WA,Truck,0,0,0,18704,18704,0
July,31,2019,Pacific,WA,Passenger,24,30,54,16029,16083,0.34
July,31,2019,Virginia Beach,VA,Passenger,1,0,1,709,710,0.14
July,31,2019,Garfield,WA,Truck,0,0,0,961,961,0
July,31,2019,Lincoln,WA,Passenger,2,10,12,7793,7805,0.15
July,31,2019,Camden,NJ,Passenger,0,1,1,25,26,3.85
July,31,2019,Okanogan,WA,Passenger,23,26,49,26123,26172,0.19
July,31,2019,Franklin,MA,Passenger,0,1,1,1,2,50
July,31,2019,Williamson,TX,Passenger,0,2,2,144,146,1.37
July,31,2019,Pierce,WA,Passenger,1877,1570,3447,544359,547806,0.63
July,31,2019,Clallam,WA,Passenger,177,144,321,50640,50961,0.63
July,31,2019,Pinellas,FL,Passenger,1,0,1,113,114,0.88
July,31,2019,Fulton,GA,Passenger,0,2,2,102,104,1.92
July,31,2019,Ventura,CA,Passenger,0,2,2,311,313,0.64
July,31,2019,Richmond,GA,Passenger,0,1,1,91,92,1.09
July,31,2019,Volusia,FL,Passenger,0,1,1,38,39,2.56
July,31,2019,Hennepin,MN,Passenger,2,1,3,104,107,2.8
July,31,2019,Douglas,WA,Passenger,60,37,97,28078,28175,0.34
July,31,2019,Douglas,WA,Truck,0,0,0,12221,12221,0
July,31,2019,Sangamon,IL,Passenger,1,0,1,6,7,14.29
July,31,2019,Anne Arundel,MD,Passenger,1,2,3,440,443,0.68
July,31,2019,Cape May,NJ,Passenger,0,1,1,15,16,6.25
July,31,2019,Multnomah,OR,Passenger,5,6,11,742,753,1.46
July,31,2019,Berkshire,MA,Passenger,0,1,1,4,5,20
July,31,2019,Whitman,WA,Truck,0,0,0,8629,8629,0
July,31,2019,Caddo,LA,Passenger,0,1,1,21,22,4.55
July,31,2019,Whatcom,WA,Passenger,883,436,1319,151115,152434,0.87
July,31,2019,Kitsap,WA,Passenger,1093,625,1718,181246,182964,0.94
July,31,2019,King,WA,Passenger,19627,7112,26739,1391293,1418032,1.89
July,31,2019,Pacific,WA,Truck,0,0,0,7669,7669,0
July,31,2019,Chelan,WA,Passenger,161,68,229,54431,54660,0.42
July,31,2019,San Joaquin,CA,Passenger,1,0,1,128,129,0.78
July,31,2019,Tuolumne,CA,Passenger,0,1,1,12,13,7.69
July,31,2019,Klamath,OR,Passenger,1,0,1,38,39,2.56
July,31,2019,Santa Clara,CA,Passenger,4,2,6,365,371,1.62
July,31,2019,Whitman,WA,Passenger,33,45,78,22702,22780,0.34
July,31,2019,Honolulu,HI,Passenger,3,3,6,492,498,1.2
June,30,2019,Santa Clara,CA,Passenger,5,2,7,364,371,1.89
June,30,2019,Brevard,FL,Passenger,0,1,1,85,86,1.16
June,30,2019,Polk,FL,Passenger,1,0,1,68,69,1.45
June,30,2019,Santa Fe,NM,Passenger,0,1,1,39,40,2.5
June,30,2019,Clark,NV,Passenger,3,2,5,690,695,0.72
June,30,2019,Franklin,WA,Passenger,52,70,122,59912,60034,0.2
June,30,2019,Williamson,TX,Passenger,0,1,1,142,143,0.7
June,30,2019,Norfolk,MA,Passenger,1,0,1,37,38,2.63
June,30,2019,Dallas,TX,Passenger,1,0,1,202,203,0.49
June,30,2019,Mason,WA,Passenger,124,122,246,47188,47434,0.52
June,30,2019,Marion,OR,Passenger,1,0,1,117,118,0.85
June,30,2019,Santa Cruz,CA,Passenger,1,0,1,41,42,2.38
June,30,2019,Chelan,WA,Truck,0,0,0,22281,22281,0
June,30,2019,Ramsey,MN,Passenger,1,0,1,43,44,2.27
June,30,2019,Alexandria,VA,Passenger,1,0,1,147,148,0.68
June,30,2019,Montgomery,MD,Passenger,1,0,1,277,278,0.36
June,30,2019,Saratoga,NY,Passenger,1,0,1,54,55,1.82
June,30,2019,Montgomery,AL,Passenger,0,1,1,43,44,2.27
June,30,2019,Stevens,WA,Passenger,19,31,50,31694,31744,0.16
June,30,2019,Washtenaw,MI,Passenger,1,0,1,40,41,2.44
June,30,2019,Douglas,WA,Truck,0,0,0,12182,12182,0
June,30,2019,Deschutes,OR,Passenger,2,0,2,156,158,1.27
June,30,2019,Solano,CA,Passenger,1,0,1,211,212,0.47
June,30,2019,Kootenai,ID,Passenger,1,1,2,220,222,0.9
June,30,2019,Collin,TX,Passenger,1,1,2,129,131,1.53
June,30,2019,Skagit,WA,Truck,1,0,1,32442,32443,0
June,30,2019,Contra Costa,CA,Passenger,2,2,4,386,390,1.03
June,30,2019,Tarrant,TX,Passenger,2,0,2,202,204,0.98
June,30,2019,Portsmouth,VA,Passenger,0,1,1,75,76,1.32
June,30,2019,San Mateo,CA,Passenger,2,1,3,115,118,2.54
June,30,2019,District of Columbia,DC,Passenger,1,1,2,205,207,0.97
June,30,2019,Klamath,OR,Passenger,1,0,1,38,39,2.56
June,30,2019,Chelan,WA,Passenger,157,68,225,54354,54579,0.41
June,30,2019,Skamania,WA,Truck,0,0,0,4062,4062,0
June,30,2019,Clark,WA,Truck,0,0,0,80332,80332,0
June,30,2019,Benton,WA,Passenger,259,279,538,133796,134334,0.4
June,30,2019,Ferry,WA,Passenger,5,2,7,4388,4395,0.16
June,30,2019,Prince George's,MD,Passenger,1,1,2,179,181,1.1
June,30,2019,Kent,MI,Passenger,0,1,1,21,22,4.55
June,30,2019,Kittitas,WA,Truck,0,0,0,14422,14422,0
June,30,2019,Pend Oreille,WA,Truck,0,0,0,5732,5732,0
June,30,2019,Guadalupe,TX,Passenger,1,0,1,73,74,1.35
June,30,2019,Charles,MD,Passenger,0,1,1,87,88,1.14
June,30,2019,Palm Beach,FL,Passenger,0,1,1,85,86,1.16
June,30,2019,Douglas,NE,Passenger,0,1,1,62,63,1.59
June,30,2019,Maui,HI,Passenger,1,0,1,45,46,2.17
June,30,2019,Spokane,WA,Passenger,539,433,972,311797,312769,0.31
June,30,2019,DeKalb,IN,Passenger,1,0,1,1,2,50
June,30,2019,Putnam,TN,Passenger,0,1,1,3,4,25
June,30,2019,Adams,WA,Passenger,5,6,11,12757,12768,0.09
June,30,2019,King,WA,Passenger,19080,7013,26093,1389199,1415292,1.84
June,30,2019,Adams,WA,Truck,0,0,0,5128,5128,0
June,30,2019,Klickitat,WA,Truck,0,0,0,8251,8251,0
June,30,2019,San Diego,CA,Passenger,10,3,13,2686,2699,0.48
June,30,2019,,,Passenger,8,2,10,796,806,1.24
June,30,2019,Shasta,CA,Passenger,1,0,1,42,43,2.33
June,30,2019,Wahkiakum,WA,Passenger,2,2,4,3009,3013,0.13
June,30,2019,Okanogan,WA,Passenger,22,25,47,26076,26123,0.18
June,30,2019,Multnomah,OR,Passenger,5,5,10,736,746,1.34
June,30,2019,Kitsap,WA,Truck,1,0,1,54095,54096,0
June,30,2019,Riverside,CA,Passenger,2,2,4,655,659,0.61
June,30,2019,Oklahoma,OK,Passenger,0,1,1,124,125,0.8
June,30,2019,Cascade,MT,Passenger,0,1,1,61,62,1.61
June,30,2019,Garfield,WA,Truck,0,0,0,964,964,0
June,30,2019,Ventura,CA,Passenger,0,2,2,314,316,0.63
June,30,2019,San Joaquin,CA,Passenger,1,0,1,126,127,0.79
June,30,2019,Klickitat,WA,Passenger,35,32,67,15557,15624,0.43
June,30,2019,Anne Arundel,MD,Passenger,1,2,3,440,443,0.68
June,30,2019,Fresno,CA,Passenger,1,0,1,190,191,0.52
June,30,2019,Hennepin,MN,Passenger,2,1,3,102,105,2.86
June,30,2019,Skamania,WA,Passenger,23,18,41,8725,8766,0.47
June,30,2019,DeKalb,GA,Passenger,1,0,1,79,80,1.25
June,30,2019,Randolph,NC,Passenger,1,0,1,6,7,14.29
June,30,2019,Asotin,WA,Truck,0,0,0,6667,6667,0
June,30,2019,Rogers,OK,Passenger,1,0,1,5,6,16.67
June,30,2019,Wahkiakum,WA,Truck,0,0,0,1755,1755,0
June,30,2019,Island,WA,Passenger,317,240,557,63386,63943,0.87
June,30,2019,Lewis,WA,Truck,0,0,0,25951,25951,0
June,30,2019,Columbia,WA,Truck,0,0,0,1532,1532,0
June,30,2019,Loudoun,VA,Passenger,1,0,1,96,97,1.03
June,30,2019,Lewis,WA,Passenger,99,92,191,59123,59314,0.32
June,30,2019,Sarasota,FL,Passenger,1,0,1,24,25,4
June,30,2019,Shelby,OH,Passenger,0,1,1,1,2,50
June,30,2019,Carroll,NH,Passenger,0,1,1,3,4,25
June,30,2019,Spokane,WA,Truck,1,0,1,94860,94861,0
June,30,2019,Broward,FL,Passenger,2,1,3,125,128,2.34
June,30,2019,Placer,CA,Passenger,1,0,1,103,104,0.96
June,30,2019,Carson City,NV,Passenger,1,0,1,11,12,8.33
June,30,2019,Lincoln,WA,Truck,0,0,0,4676,4676,0
June,30,2019,Pend Oreille,WA,Passenger,4,5,9,9531,9540,0.09
June,30,2019,Norfolk,VA,Passenger,2,1,3,348,351,0.85
June,30,2019,Nantucket,MA,Passenger,1,0,1,2,3,33.33
June,30,2019,Arlington,VA,Passenger,0,2,2,158,160,1.25
June,30,2019,Thurston,WA,Passenger,875,639,1514,197699,199213,0.76
June,30,2019,Pierce,WA,Truck,0,0,0,139794,139794,0
June,30,2019,Stevens,WA,Truck,0,0,0,18659,18659,0
June,30,2019,Howard,MD,Passenger,0,1,1,75,76,1.32
June,30,2019,Mason,WA,Truck,0,0,0,20361,20361,0
June,30,2019,St. Mary's,MD,Passenger,1,0,1,212,213,0.47
June,30,2019,Prince William,VA,Passenger,1,3,4,249,253,1.58
June,30,2019,Wayne,MI,Passenger,0,1,1,66,67,1.49
June,30,2019,Thurston,WA,Truck,0,0,0,55124,55124,0
June,30,2019,Bexar,TX,Passenger,3,5,8,664,672,1.19
June,30,2019,Allegheny,PA,Passenger,1,0,1,78,79,1.27
June,30,2019,New London,CT,Passenger,0,2,2,239,241,0.83
June,30,2019,Tuolumne,CA,Passenger,0,1,1,12,13,7.69
June,30,2019,Asotin,WA,Passenger,12,8,20,12641,12661,0.16
June,30,2019,Monroe,IL,Passenger,1,0,1,5,6,16.67
June,30,2019,Cook,IL,Passenger,1,0,1,241,242,0.41
June,30,2019,Travis,TX,Passenger,2,1,3,197,200,1.5
June,30,2019,Garfield,WA,Passenger,1,1,2,1298,1300,0.15
June,30,2019,Whatcom,WA,Passenger,853,428,1281,150709,151990,0.84
June,30,2019,RÃ­o Grande,PR,Passenger,1,0,1,1,2,50
June,30,2019,Ferry,WA,Truck,0,0,0,3570,3570,0
June,30,2019,New Haven,CT,Passenger,0,2,2,48,50,4
June,30,2019,Penobscot,ME,Passenger,0,1,1,12,13,7.69
June,30,2019,Pacific,WA,Passenger,25,29,54,15975,16029,0.34
June,30,2019,Pinellas,FL,Passenger,1,0,1,113,114,0.88
June,30,2019,Fairfax,VA,Passenger,3,2,5,772,777,0.64
June,30,2019,Moore,NC,Passenger,0,1,1,186,187,0.53
June,30,2019,Cape May,NJ,Passenger,0,1,1,15,16,6.25
June,30,2019,Grays Harbor,WA,Truck,0,0,0,20455,20455,0
June,30,2019,Sedgwick,KS,Passenger,1,1,2,102,104,1.92
June,30,2019,Harnett,NC,Passenger,1,1,2,217,219,0.91
June,30,2019,Kern,CA,Passenger,0,1,1,222,223,0.45
June,30,2019,Camden,NJ,Passenger,0,1,1,24,25,4
June,30,2019,Maricopa,AZ,Passenger,6,3,9,1526,1535,0.59
June,30,2019,Charleston,SC,Passenger,1,0,1,115,116,0.86
June,30,2019,Orange,CA,Passenger,6,1,7,528,535,1.31
June,30,2019,Bergen,NJ,Passenger,1,0,1,27,28,3.57
June,30,2019,Whitman,WA,Passenger,31,46,77,22712,22789,0.34
June,30,2019,Washoe,NV,Passenger,2,0,2,114,116,1.72
June,30,2019,Los Angeles,CA,Passenger,8,5,13,1099,1112,1.17
June,30,2019,Grays Harbor,WA,Passenger,73,85,158,47923,48081,0.33
June,30,2019,Jefferson,CO,Passenger,0,2,2,57,59,3.39
June,30,2019,Clark,WA,Passenger,1538,926,2464,313856,316320,0.78
June,30,2019,Clallam,WA,Passenger,173,141,314,50501,50815,0.62
June,30,2019,Mecklenburg,NC,Passenger,1,0,1,86,87,1.15
June,30,2019,Denver,CO,Passenger,1,0,1,133,134,0.75
June,30,2019,Grant,WA,Truck,0,0,0,26631,26631,0
June,30,2019,Houston,GA,Passenger,1,0,1,54,55,1.82
June,30,2019,Pinal,AZ,Passenger,2,0,2,195,197,1.02
June,30,2019,Clallam,WA,Truck,1,0,1,21740,21741,0
June,30,2019,San Juan,WA,Truck,0,0,0,5866,5866,0
June,30,2019,Okanogan,WA,Truck,0,0,0,16482,16482,0
June,30,2019,Wilson,TX,Passenger,0,1,1,6,7,14.29
June,30,2019,Jefferson,WA,Passenger,197,119,316,24995,25311,1.25
June,30,2019,Middlesex,MA,Passenger,1,1,2,117,119,1.68
June,30,2019,Nueces,TX,Passenger,1,1,2,99,101,1.98
June,30,2019,Calvert,MD,Passenger,0,2,2,87,89,2.25
June,30,2019,Whatcom,WA,Truck,2,0,2,42910,42912,0
June,30,2019,Lake,FL,Passenger,1,0,1,19,20,5
June,30,2019,Cowlitz,WA,Truck,0,0,0,28865,28865,0
June,30,2019,Goochland,VA,Passenger,1,1,2,257,259,0.77
June,30,2019,Pacific,WA,Truck,0,0,0,7654,7654,0
June,30,2019,Suffolk,MA,Passenger,0,1,1,39,40,2.5
June,30,2019,Yakima,WA,Passenger,105,104,209,165147,165356,0.13
June,30,2019,Twin Falls,ID,Passenger,0,1,1,23,24,4.17
June,30,2019,Richland,SC,Passenger,0,1,1,160,161,0.62
June,30,2019,Sumter,FL,Passenger,0,1,1,10,11,9.09
June,30,2019,Jefferson,NY,Passenger,0,2,2,214,216,0.93
June,30,2019,Skagit,WA,Passenger,298,200,498,91940,92438,0.54
June,30,2019,Nassau,NY,Passenger,4,0,4,38,42,9.52
June,30,2019,Vigo,IN,Passenger,1,0,1,6,7,14.29
June,30,2019,Pierce,WA,Passenger,1808,1556,3364,543069,546433,0.62
June,30,2019,Harris,TX,Passenger,1,1,2,246,248,0.81
June,30,2019,Ada,ID,Passenger,0,2,2,307,309,0.65
June,30,2019,San Juan,WA,Passenger,212,72,284,14409,14693,1.93
June,30,2019,Snohomish,WA,Passenger,3473,1593,5066,531506,536572,0.94
June,30,2019,Alameda,CA,Passenger,4,2,6,306,312,1.92
June,30,2019,Valencia,NM,Passenger,1,0,1,7,8,12.5
June,30,2019,Bucks,PA,Passenger,1,0,1,19,20,5
June,30,2019,Fulton,GA,Passenger,1,2,3,105,108,2.78
June,30,2019,Kitsap,WA,Passenger,1050,605,1655,180817,182472,0.91
June,30,2019,Cochise,AZ,Passenger,0,1,1,114,115,0.87
June,30,2019,Honolulu,HI,Passenger,3,3,6,501,507,1.18
June,30,2019,Montgomery,PA,Passenger,2,0,2,37,39,5.13
June,30,2019,Sangamon,IL,Passenger,1,0,1,6,7,14.29
June,30,2019,Cumberland,NC,Passenger,0,2,2,503,505,0.4
June,30,2019,Larimer,CO,Passenger,1,0,1,58,59,1.69
June,30,2019,Volusia,FL,Passenger,0,1,1,38,39,2.56
June,30,2019,Dale,AL,Passenger,0,1,1,59,60,1.67
June,30,2019,Franklin,MA,Passenger,0,1,1,1,2,50
June,30,2019,Yakima,WA,Truck,0,0,0,59138,59138,0
June,30,2019,Lee,FL,Passenger,1,0,1,52,53,1.89
June,30,2019,Walla Walla,WA,Passenger,49,61,110,36186,36296,0.3
June,30,2019,Pima,AZ,Passenger,0,1,1,393,394,0.25
June,30,2019,Jefferson,WA,Truck,0,0,0,9667,9667,0
June,30,2019,Saginaw,MI,Passenger,1,0,1,11,12,8.33
June,30,2019,Manassas,VA,Passenger,0,1,1,9,10,10
June,30,2019,Clackamas,OR,Passenger,1,1,2,212,214,0.93
June,30,2019,Shelby,TN,Passenger,0,1,1,92,93,1.08
June,30,2019,El Paso,TX,Passenger,3,0,3,481,484,0.62
June,30,2019,Island,WA,Truck,0,0,0,21261,21261,0
June,30,2019,Santa Rosa,FL,Passenger,1,0,1,88,89,1.12
June,30,2019,Columbia,WA,Passenger,2,2,4,2450,2454,0.16
June,30,2019,Virginia Beach,VA,Passenger,1,0,1,713,714,0.14
June,30,2019,San Francisco,CA,Passenger,2,1,3,105,108,2.78
June,30,2019,Walla Walla,WA,Truck,0,0,0,13593,13593,0
June,30,2019,King,WA,Truck,5,1,6,182076,182082,0
June,30,2019,Kittitas,WA,Passenger,81,38,119,29608,29727,0.4
June,30,2019,Owyhee,ID,Passenger,1,0,1,5,6,16.67
June,30,2019,Frederick,MD,Passenger,1,1,2,79,81,2.47
June,30,2019,Manatee,FL,Passenger,1,0,1,32,33,3.03
June,30,2019,Lincoln,WA,Passenger,2,8,10,7776,7786,0.13
June,30,2019,Spartanburg,SC,Passenger,0,1,1,36,37,2.7
June,30,2019,Flathead,MT,Passenger,1,0,1,62,63,1.59
June,30,2019,El Paso,CO,Passenger,2,1,3,731,734,0.41
June,30,2019,St. Clair,IL,Passenger,0,1,1,163,164,0.61
June,30,2019,Oldham,KY,Passenger,0,1,1,5,6,16.67
June,30,2019,Clay,FL,Passenger,0,1,1,88,89,1.12
June,30,2019,Benton,WA,Truck,0,0,0,41914,41914,0
June,30,2019,Richmond,GA,Passenger,0,1,1,93,94,1.06
June,30,2019,DuPage,IL,Passenger,2,0,2,61,63,3.17
June,30,2019,Whitman,WA,Truck,0,0,0,8584,8584,0
June,30,2019,Cowlitz,WA,Passenger,98,108,206,73013,73219,0.28
June,30,2019,Albemarle,VA,Passenger,1,0,1,23,24,4.17
June,30,2019,Franklin,WA,Truck,0,0,0,19271,19271,0
June,30,2019,Dakota,MN,Passenger,0,1,1,37,38,2.63
June,30,2019,Juneau,AK,Passenger,0,2,2,30,32,6.25
June,30,2019,Grant,WA,Passenger,41,61,102,64706,64808,0.16
June,30,2019,Duval,FL,Passenger,1,2,3,373,376,0.8
June,30,2019,Caddo,LA,Passenger,0,1,1,22,23,4.35
June,30,2019,Snohomish,WA,Truck,0,0,0,122375,122375,0
June,30,2019,Montgomery,TX,Passenger,2,0,2,60,62,3.23
June,30,2019,Tulsa,OK,Passenger,1,1,2,46,48,4.17
June,30,2019,Douglas,WA,Passenger,57,37,94,28032,28126,0.33
June,30,2019,Berkshire,MA,Passenger,0,1,1,4,5,20
June,30,2019,Hawaii,HI,Passenger,1,0,1,57,58,1.72
March,31,2019,Douglas,WA,Truck,0,0,0,12157,12157,0
March,31,2019,DeKalb,IN,Passenger,1,0,1,1,2,50
March,31,2019,Guadalupe,TX,Passenger,1,0,1,77,78,1.28
March,31,2019,Randolph,NC,Passenger,1,0,1,6,7,14.29
March,31,2019,Cook,IL,Passenger,1,0,1,244,245,0.41
March,31,2019,Camden,NJ,Passenger,0,1,1,26,27,3.7
March,31,2019,Washtenaw,MI,Passenger,1,0,1,37,38,2.63
March,31,2019,Anne Arundel,MD,Passenger,0,2,2,452,454,0.44
March,31,2019,Grays Harbor,WA,Passenger,69,80,149,47589,47738,0.31
March,31,2019,Portsmouth,VA,Passenger,0,1,1,76,77,1.3
March,31,2019,New London,CT,Passenger,0,2,2,249,251,0.8
March,31,2019,Lumpkin,GA,Passenger,1,0,1,6,7,14.29
March,31,2019,Owyhee,ID,Passenger,1,0,1,5,6,16.67
March,31,2019,Oldham,KY,Passenger,0,1,1,5,6,16.67
March,31,2019,Clark,WA,Truck,0,0,0,79992,79992,0
March,31,2019,Pima,AZ,Passenger,1,1,2,401,403,0.5
March,31,2019,Kent,MI,Passenger,0,1,1,21,22,4.55
March,31,2019,Goochland,VA,Passenger,1,1,2,248,250,0.8
March,31,2019,Lee,FL,Passenger,1,0,1,52,53,1.89
March,31,2019,New Haven,CT,Passenger,0,2,2,49,51,3.92
March,31,2019,Cumberland,NC,Passenger,0,2,2,506,508,0.39
March,31,2019,El Paso,TX,Passenger,2,0,2,493,495,0.4
March,31,2019,Sangamon,IL,Passenger,2,0,2,7,9,22.22
March,31,2019,Montgomery,PA,Passenger,2,0,2,37,39,5.13
March,31,2019,Middlesex,MA,Passenger,1,1,2,118,120,1.67
March,31,2019,Kern,CA,Passenger,0,1,1,225,226,0.44
March,31,2019,Howard,MD,Passenger,0,1,1,78,79,1.27
March,31,2019,Wahkiakum,WA,Passenger,1,1,2,3008,3010,0.07
March,31,2019,Jefferson,WA,Passenger,179,118,297,24880,25177,1.18
March,31,2019,Mecklenburg,NC,Passenger,1,0,1,79,80,1.25
March,31,2019,Pinal,AZ,Passenger,2,0,2,198,200,1
March,31,2019,St. Clair,IL,Passenger,0,1,1,162,163,0.61
March,31,2019,Kootenai,ID,Passenger,1,1,2,212,214,0.93
March,31,2019,Charleston,SC,Passenger,1,0,1,121,122,0.82
March,31,2019,Chelan,WA,Passenger,144,67,211,54156,54367,0.39
March,31,2019,Snohomish,WA,Passenger,3195,1519,4714,527994,532708,0.88
March,31,2019,San Juan,PR,Passenger,0,1,1,3,4,25
March,31,2019,Los Angeles,CA,Passenger,7,5,12,1089,1101,1.09
March,31,2019,Clallam,WA,Truck,0,0,0,21617,21617,0
March,31,2019,Columbia,WA,Truck,0,0,0,1527,1527,0
March,31,2019,Lewis,WA,Truck,0,0,0,25755,25755,0
March,31,2019,Honolulu,HI,Passenger,2,3,5,500,505,0.99
March,31,2019,Shasta,CA,Passenger,1,0,1,41,42,2.38
March,31,2019,King,WA,Truck,6,1,7,181762,181769,0
March,31,2019,Clark,WA,Passenger,1358,881,2239,311974,314213,0.71
March,31,2019,Fairfax,VA,Passenger,3,2,5,795,800,0.62
March,31,2019,Travis,TX,Passenger,2,1,3,202,205,1.46
March,31,2019,Garfield,WA,Passenger,1,1,2,1310,1312,0.15
March,31,2019,St. Mary's,MD,Passenger,1,0,1,213,214,0.47
March,31,2019,,,Passenger,8,2,10,787,797,1.25
March,31,2019,Whatcom,WA,Truck,2,0,2,42724,42726,0
March,31,2019,Stevens,WA,Passenger,18,27,45,31632,31677,0.14
March,31,2019,Santa Cruz,CA,Passenger,1,0,1,41,42,2.38
March,31,2019,Shelby,TN,Passenger,0,1,1,96,97,1.03
March,31,2019,St. Lucie,FL,Passenger,1,0,1,30,31,3.23
March,31,2019,Snohomish,WA,Truck,1,0,1,121910,121911,0
March,31,2019,Skagit,WA,Truck,1,0,1,32255,32256,0
March,31,2019,Pacific,WA,Passenger,23,26,49,15850,15899,0.31
March,31,2019,Richmond,GA,Passenger,0,1,1,93,94,1.06
March,31,2019,San Diego,CA,Passenger,10,3,13,2649,2662,0.49
March,31,2019,Clark,NV,Passenger,3,2,5,706,711,0.7
March,31,2019,Chelan,WA,Truck,0,0,0,22127,22127,0
March,31,2019,Benton,WA,Truck,0,0,0,41532,41532,0
March,31,2019,Thurston,WA,Passenger,802,598,1400,196182,197582,0.71
March,31,2019,Collin,TX,Passenger,1,1,2,134,136,1.47
March,31,2019,Walla Walla,WA,Passenger,44,56,100,36067,36167,0.28
March,31,2019,Spartanburg,SC,Passenger,0,1,1,33,34,2.94
March,31,2019,Alameda,CA,Passenger,3,2,5,317,322,1.55
March,31,2019,Yakima,WA,Passenger,89,102,191,164203,164394,0.12
March,31,2019,Pend Oreille,WA,Truck,0,0,0,5721,5721,0
March,31,2019,Ada,ID,Passenger,0,2,2,308,310,0.65
March,31,2019,Walla Walla,WA,Truck,0,0,0,13552,13552,0
March,31,2019,Klamath,OR,Passenger,1,0,1,38,39,2.56
March,31,2019,Maricopa,AZ,Passenger,6,2,8,1544,1552,0.52
March,31,2019,DuPage,IL,Passenger,1,0,1,61,62,1.61
March,31,2019,El Paso,CO,Passenger,3,2,5,752,757,0.66
March,31,2019,Juneau,AK,Passenger,0,1,1,33,34,2.94
March,31,2019,Hennepin,MN,Passenger,2,0,2,103,105,1.9
March,31,2019,DeKalb,GA,Passenger,1,0,1,80,81,1.23
March,31,2019,Kitsap,WA,Truck,1,0,1,53744,53745,0
March,31,2019,Fresno,CA,Passenger,1,0,1,188,189,0.53
March,31,2019,Kittitas,WA,Truck,0,0,0,14249,14249,0
March,31,2019,Arlington,VA,Passenger,1,2,3,162,165,1.82
March,31,2019,Bergen,NJ,Passenger,1,0,1,25,26,3.85
March,31,2019,Montgomery,MD,Passenger,1,0,1,274,275,0.36
March,31,2019,Fulton,GA,Passenger,1,2,3,110,113,2.65
March,31,2019,Volusia,FL,Passenger,0,1,1,36,37,2.7
March,31,2019,Columbia,WA,Passenger,2,2,4,2427,2431,0.16
March,31,2019,Larimer,CO,Passenger,1,0,1,58,59,1.69
March,31,2019,Okanogan,WA,Passenger,20,21,41,25907,25948,0.16
March,31,2019,Island,WA,Truck,0,0,0,21186,21186,0
March,31,2019,Sedgwick,KS,Passenger,0,1,1,103,104,0.96
March,31,2019,Ferry,WA,Passenger,3,2,5,4362,4367,0.11
March,31,2019,Clay,FL,Passenger,0,1,1,84,85,1.18
March,31,2019,Klickitat,WA,Truck,0,0,0,8207,8207,0
March,31,2019,Calvert,MD,Passenger,0,1,1,87,88,1.14
March,31,2019,Twin Falls,ID,Passenger,0,1,1,21,22,4.55
March,31,2019,Wayne,MI,Passenger,0,1,1,68,69,1.45
March,31,2019,Cascade,MT,Passenger,0,1,1,55,56,1.79
March,31,2019,Riverside,CA,Passenger,2,2,4,662,666,0.6
March,31,2019,Skamania,WA,Truck,0,0,0,4017,4017,0
March,31,2019,Suffolk,MA,Passenger,0,1,1,41,42,2.38
March,31,2019,Prince George's,MD,Passenger,1,1,2,182,184,1.09
March,31,2019,Flathead,MT,Passenger,1,0,1,60,61,1.64
March,31,2019,Island,WA,Passenger,300,234,534,63126,63660,0.84
March,31,2019,Allegheny,PA,Passenger,1,0,1,85,86,1.16
March,31,2019,Tuolumne,CA,Passenger,0,1,1,12,13,7.69
March,31,2019,Asotin,WA,Truck,0,0,0,6632,6632,0
March,31,2019,Caddo,LA,Passenger,0,1,1,23,24,4.17
March,31,2019,Denver,CO,Passenger,1,0,1,132,133,0.75
March,31,2019,Stevens,WA,Truck,0,0,0,18708,18708,0
March,31,2019,Gwinnett,GA,Passenger,0,1,1,76,77,1.3
March,31,2019,Palm Beach,FL,Passenger,0,1,1,93,94,1.06
March,31,2019,San Juan,WA,Truck,0,0,0,5811,5811,0
March,31,2019,Douglas,NE,Passenger,0,1,1,64,65,1.54
March,31,2019,Vigo,IN,Passenger,1,0,1,5,6,16.67
March,31,2019,Wahkiakum,WA,Truck,0,0,0,1725,1725,0
March,31,2019,Marion,OR,Passenger,1,0,1,116,117,0.85
March,31,2019,Tulsa,OK,Passenger,1,1,2,47,49,4.08
March,31,2019,Richland,SC,Passenger,0,1,1,164,165,0.61
March,31,2019,Spokane,WA,Truck,1,0,1,94016,94017,0
March,31,2019,San Francisco,CA,Passenger,2,1,3,111,114,2.63
March,31,2019,Cochise,AZ,Passenger,0,1,1,115,116,0.86
March,31,2019,Nassau,NY,Passenger,3,0,3,39,42,7.14
March,31,2019,Santa Clara,CA,Passenger,8,1,9,361,370,2.43
March,31,2019,Jefferson,WA,Truck,0,0,0,9645,9645,0
March,31,2019,Lincoln,WA,Truck,0,0,0,4683,4683,0
March,31,2019,Bexar,TX,Passenger,3,4,7,682,689,1.02
March,31,2019,Thurston,WA,Truck,0,0,0,54948,54948,0
March,31,2019,Klickitat,WA,Passenger,32,31,63,15424,15487,0.41
March,31,2019,King,WA,Passenger,17678,6779,24457,1381383,1405840,1.74
March,31,2019,Skagit,WA,Passenger,281,189,470,91327,91797,0.51
March,31,2019,Orange,CA,Passenger,5,1,6,532,538,1.12
March,31,2019,Montgomery,AL,Passenger,0,1,1,43,44,2.27
March,31,2019,Manatee,FL,Passenger,1,0,1,32,33,3.03
March,31,2019,Virginia Beach,VA,Passenger,1,1,2,698,700,0.29
March,31,2019,Tarrant,TX,Passenger,2,0,2,201,203,0.99
March,31,2019,Whitman,WA,Truck,0,0,0,8502,8502,0
March,31,2019,Montgomery,TX,Passenger,2,0,2,61,63,3.17
March,31,2019,Adams,WA,Truck,0,0,0,5105,5105,0
March,31,2019,Manassas,VA,Passenger,0,1,1,9,10,10
March,31,2019,Whatcom,WA,Passenger,792,386,1178,149745,150923,0.78
March,31,2019,Norfolk,MA,Passenger,1,0,1,36,37,2.7
March,31,2019,Monroe,IL,Passenger,1,0,1,4,5,20
March,31,2019,Charles,MD,Passenger,0,1,1,78,79,1.27
March,31,2019,Carroll,NH,Passenger,0,1,1,2,3,33.33
March,31,2019,Sumter,FL,Passenger,0,1,1,10,11,9.09
March,31,2019,Rogers,OK,Passenger,1,0,1,4,5,20
March,31,2019,Lincoln,WA,Passenger,3,6,9,7733,7742,0.12
March,31,2019,Washoe,NV,Passenger,2,0,2,107,109,1.83
March,31,2019,Lee,AL,Passenger,1,0,1,35,36,2.78
March,31,2019,Franklin,WA,Passenger,52,68,120,59371,59491,0.2
March,31,2019,Benton,WA,Passenger,236,251,487,132992,133479,0.36
March,31,2019,Kittitas,WA,Passenger,71,37,108,29440,29548,0.37
March,31,2019,Pierce,WA,Passenger,1635,1457,3092,539431,542523,0.57
March,31,2019,Hawaii,HI,Passenger,1,0,1,61,62,1.61
March,31,2019,Harris,TX,Passenger,0,1,1,251,252,0.4
March,31,2019,Spokane,WA,Passenger,491,393,884,307777,308661,0.29
March,31,2019,Cape May,NJ,Passenger,0,1,1,19,20,5
March,31,2019,Asotin,WA,Passenger,12,9,21,12660,12681,0.17
March,31,2019,Multnomah,OR,Passenger,4,5,9,747,756,1.19
March,31,2019,Clallam,WA,Passenger,154,129,283,50317,50600,0.56
March,31,2019,District of Columbia,DC,Passenger,1,1,2,204,206,0.97
March,31,2019,Dale,AL,Passenger,0,1,1,56,57,1.75
March,31,2019,Brevard,FL,Passenger,0,1,1,87,88,1.14
March,31,2019,Okanogan,WA,Truck,0,0,0,16439,16439,0
March,31,2019,San Mateo,CA,Passenger,2,1,3,126,129,2.33
March,31,2019,Frederick,MD,Passenger,1,1,2,81,83,2.41
March,31,2019,Prince William,VA,Passenger,0,4,4,257,261,1.53
March,31,2019,Polk,FL,Passenger,1,0,1,65,66,1.52
March,31,2019,Kitsap,WA,Passenger,997,569,1566,179919,181485,0.86
March,31,2019,Grant,WA,Passenger,34,55,89,64210,64299,0.14
March,31,2019,Douglas,WA,Passenger,53,34,87,27889,27976,0.31
March,31,2019,Bucks,PA,Passenger,1,0,1,17,18,5.56
March,31,2019,Norfolk,VA,Passenger,2,2,4,350,354,1.13
March,31,2019,Ramsey,MN,Passenger,1,0,1,42,43,2.33
March,31,2019,Mason,WA,Truck,0,0,0,20274,20274,0
March,31,2019,Clackamas,OR,Passenger,1,1,2,205,207,0.97
March,31,2019,Santa Rosa,FL,Passenger,1,0,1,87,88,1.14
March,31,2019,Yakima,WA,Truck,0,0,0,58746,58746,0
March,31,2019,Williamson,TX,Passenger,0,1,1,146,147,0.68
March,31,2019,Pacific,WA,Truck,0,0,0,7655,7655,0
March,31,2019,Hardin,KY,Passenger,0,1,1,103,104,0.96
March,31,2019,Grays Harbor,WA,Truck,0,0,0,20376,20376,0
March,31,2019,Broward,FL,Passenger,2,1,3,126,129,2.33
March,31,2019,Dakota,MN,Passenger,0,2,2,35,37,5.41
March,31,2019,Penobscot,ME,Passenger,0,1,1,13,14,7.14
March,31,2019,Santa Fe,NM,Passenger,0,1,1,39,40,2.5
March,31,2019,Cowlitz,WA,Passenger,84,101,185,72544,72729,0.25
March,31,2019,Skamania,WA,Passenger,21,15,36,8722,8758,0.41
March,31,2019,Moore,NC,Passenger,0,1,1,178,179,0.56
March,31,2019,Contra Costa,CA,Passenger,1,2,3,394,397,0.76
March,31,2019,Valencia,NM,Passenger,1,0,1,9,10,10
March,31,2019,Houston,GA,Passenger,1,0,1,55,56,1.79
March,31,2019,San Juan,WA,Passenger,197,70,267,14290,14557,1.83
March,31,2019,Alexandria,VA,Passenger,1,0,1,156,157,0.64
March,31,2019,Carson City,NV,Passenger,1,0,1,14,15,6.67
March,31,2019,Jefferson,CO,Passenger,0,2,2,58,60,3.33
March,31,2019,Duval,FL,Passenger,1,2,3,382,385,0.78
March,31,2019,Garfield,WA,Truck,0,0,0,954,954,0
March,31,2019,Whitman,WA,Passenger,27,41,68,22715,22783,0.3
March,31,2019,Jefferson,NY,Passenger,0,2,2,223,225,0.89
March,31,2019,Nantucket,MA,Passenger,1,0,1,4,5,20
March,31,2019,Berkshire,MA,Passenger,0,1,1,4,5,20
March,31,2019,Maui,HI,Passenger,1,0,1,49,50,2
March,31,2019,Franklin,MA,Passenger,0,1,1,1,2,50
March,31,2019,Deschutes,OR,Passenger,2,0,2,157,159,1.26
March,31,2019,Pierce,WA,Truck,0,0,0,139004,139004,0
March,31,2019,Harnett,NC,Passenger,1,0,1,216,217,0.46
March,31,2019,Adams,WA,Passenger,4,6,10,12632,12642,0.08
March,31,2019,Grant,WA,Truck,0,0,0,26337,26337,0
March,31,2019,Pend Oreille,WA,Passenger,5,5,10,9474,9484,0.11
March,31,2019,Lewis,WA,Passenger,95,90,185,58524,58709,0.32
March,31,2019,Saratoga,NY,Passenger,1,0,1,58,59,1.69
March,31,2019,Albemarle,VA,Passenger,1,0,1,23,24,4.17
March,31,2019,Ferry,WA,Truck,0,0,0,3594,3594,0
March,31,2019,Franklin,WA,Truck,0,0,0,19136,19136,0
March,31,2019,Mason,WA,Passenger,114,117,231,46714,46945,0.49
March,31,2019,Washington,OR,Passenger,0,1,1,463,464,0.22
March,31,2019,Cowlitz,WA,Truck,0,0,0,28781,28781,0
March,31,2019,Ventura,CA,Passenger,0,2,2,311,313,0.64
March,31,2019,Nueces,TX,Passenger,1,1,2,93,95,2.11
May,31,2019,Albemarle,VA,Passenger,1,0,1,24,25,4
May,31,2019,Skagit,WA,Passenger,292,200,492,91700,92192,0.53
May,31,2019,Cochise,AZ,Passenger,0,1,1,113,114,0.88
May,31,2019,Santa Clara,CA,Passenger,7,1,8,366,374,2.14
May,31,2019,Skamania,WA,Truck,0,0,0,4052,4052,0
May,31,2019,Snohomish,WA,Passenger,3372,1572,4944,530335,535279,0.92
May,31,2019,Sangamon,IL,Passenger,1,0,1,7,8,12.5
May,31,2019,Calvert,MD,Passenger,0,2,2,88,90,2.22
May,31,2019,Asotin,WA,Passenger,12,8,20,12675,12695,0.16
May,31,2019,Ada,ID,Passenger,0,2,2,309,311,0.64
May,31,2019,Grant,WA,Passenger,39,59,98,64561,64659,0.15
May,31,2019,Kent,MI,Passenger,0,1,1,21,22,4.55
May,31,2019,Ramsey,MN,Passenger,1,0,1,42,43,2.33
May,31,2019,Monroe,IL,Passenger,1,0,1,5,6,16.67
May,31,2019,Orange,CA,Passenger,6,1,7,527,534,1.31
May,31,2019,St. Lucie,FL,Passenger,1,0,1,29,30,3.33
May,31,2019,Denver,CO,Passenger,1,0,1,131,132,0.76
May,31,2019,Shasta,CA,Passenger,1,0,1,42,43,2.33
May,31,2019,Yakima,WA,Passenger,94,104,198,165012,165210,0.12
May,31,2019,Placer,CA,Passenger,1,0,1,105,106,0.94
May,31,2019,Washoe,NV,Passenger,2,0,2,110,112,1.79
May,31,2019,Clay,FL,Passenger,0,1,1,87,88,1.14
May,31,2019,San Juan,WA,Passenger,207,71,278,14357,14635,1.9
May,31,2019,District of Columbia,DC,Passenger,1,1,2,207,209,0.96
May,31,2019,Garfield,WA,Passenger,1,1,2,1293,1295,0.15
May,31,2019,Duval,FL,Passenger,1,2,3,371,374,0.8
May,31,2019,Nassau,NY,Passenger,3,0,3,38,41,7.32
May,31,2019,Berkshire,MA,Passenger,0,1,1,4,5,20
May,31,2019,Caddo,LA,Passenger,0,1,1,24,25,4
May,31,2019,Santa Rosa,FL,Passenger,1,0,1,88,89,1.12
May,31,2019,Polk,FL,Passenger,1,0,1,66,67,1.49
May,31,2019,Montgomery,AL,Passenger,0,1,1,43,44,2.27
May,31,2019,Prince George's,MD,Passenger,1,1,2,181,183,1.09
May,31,2019,Cumberland,NC,Passenger,0,2,2,501,503,0.4
May,31,2019,Carroll,NH,Passenger,0,1,1,3,4,25
May,31,2019,Harris,TX,Passenger,0,1,1,245,246,0.41
May,31,2019,Hawaii,HI,Passenger,1,0,1,62,63,1.59
May,31,2019,Walla Walla,WA,Truck,0,0,0,13613,13613,0
May,31,2019,Multnomah,OR,Passenger,5,5,10,746,756,1.32
May,31,2019,Lewis,WA,Passenger,97,93,190,59034,59224,0.32
May,31,2019,Portsmouth,VA,Passenger,0,1,1,74,75,1.33
May,31,2019,Riverside,CA,Passenger,2,2,4,658,662,0.6
May,31,2019,Jefferson,NY,Passenger,0,2,2,216,218,0.92
May,31,2019,Dallas,TX,Passenger,1,0,1,203,204,0.49
May,31,2019,Wahkiakum,WA,Passenger,2,2,4,3017,3021,0.13
May,31,2019,Carson City,NV,Passenger,1,0,1,13,14,7.14
May,31,2019,Skamania,WA,Passenger,23,17,40,8719,8759,0.46
May,31,2019,Marion,OR,Passenger,1,0,1,114,115,0.87
May,31,2019,Thurston,WA,Truck,0,0,0,55085,55085,0
May,31,2019,Alexandria,VA,Passenger,1,0,1,147,148,0.68
May,31,2019,Grant,WA,Truck,0,0,0,26531,26531,0
May,31,2019,Kittitas,WA,Passenger,72,35,107,29555,29662,0.36
May,31,2019,Juneau,AK,Passenger,0,2,2,31,33,6.06
May,31,2019,Pima,AZ,Passenger,0,1,1,397,398,0.25
May,31,2019,Island,WA,Truck,0,0,0,21242,21242,0
May,31,2019,Nueces,TX,Passenger,1,1,2,98,100,2
May,31,2019,Alameda,CA,Passenger,3,2,5,308,313,1.6
May,31,2019,Larimer,CO,Passenger,1,0,1,58,59,1.69
May,31,2019,Benton,WA,Passenger,253,272,525,133636,134161,0.39
May,31,2019,Lumpkin,GA,Passenger,1,0,1,4,5,20
May,31,2019,Charles,MD,Passenger,0,1,1,84,85,1.18
May,31,2019,Chelan,WA,Truck,0,0,0,22243,22243,0
May,31,2019,Benton,WA,Truck,0,0,0,41850,41850,0
May,31,2019,Wilson,TX,Passenger,0,1,1,6,7,14.29
May,31,2019,St. Mary's,MD,Passenger,1,0,1,211,212,0.47
May,31,2019,Deschutes,OR,Passenger,2,0,2,158,160,1.25
May,31,2019,Sumter,FL,Passenger,0,1,1,10,11,9.09
May,31,2019,Lee,FL,Passenger,1,0,1,50,51,1.96
May,31,2019,Montgomery,TX,Passenger,2,0,2,58,60,3.33
May,31,2019,Brevard,FL,Passenger,0,1,1,85,86,1.16
May,31,2019,Columbia,WA,Passenger,2,2,4,2443,2447,0.16
May,31,2019,Franklin,WA,Truck,0,0,0,19251,19251,0
May,31,2019,Collin,TX,Passenger,1,1,2,130,132,1.52
May,31,2019,Middlesex,MA,Passenger,1,1,2,117,119,1.68
May,31,2019,Pinellas,FL,Passenger,1,0,1,112,113,0.88
May,31,2019,Shelby,TN,Passenger,0,1,1,93,94,1.06
May,31,2019,Cowlitz,WA,Passenger,95,107,202,72910,73112,0.28
May,31,2019,Lincoln,WA,Truck,0,0,0,4695,4695,0
May,31,2019,Spartanburg,SC,Passenger,0,1,1,35,36,2.78
May,31,2019,Oldham,KY,Passenger,0,1,1,5,6,16.67
May,31,2019,Okanogan,WA,Passenger,21,23,44,26072,26116,0.17
May,31,2019,Pierce,WA,Passenger,1751,1520,3271,542054,545325,0.6
May,31,2019,Ferry,WA,Passenger,5,2,7,4381,4388,0.16
May,31,2019,Saratoga,NY,Passenger,1,0,1,55,56,1.79
May,31,2019,Douglas,WA,Passenger,56,36,92,28005,28097,0.33
May,31,2019,Stevens,WA,Truck,0,0,0,18677,18677,0
May,31,2019,Ferry,WA,Truck,0,0,0,3589,3589,0
May,31,2019,St. Clair,IL,Passenger,0,1,1,159,160,0.62
May,31,2019,Snohomish,WA,Truck,1,0,1,122076,122077,0
May,31,2019,Cape May,NJ,Passenger,0,1,1,15,16,6.25
May,31,2019,Flathead,MT,Passenger,1,0,1,61,62,1.61
May,31,2019,DeKalb,IN,Passenger,1,0,1,1,2,50
May,31,2019,New London,CT,Passenger,0,2,2,247,249,0.8
May,31,2019,Guadalupe,TX,Passenger,1,0,1,75,76,1.32
May,31,2019,Loudoun,VA,Passenger,1,0,1,96,97,1.03
May,31,2019,Hennepin,MN,Passenger,2,0,2,103,105,1.9
May,31,2019,Nantucket,MA,Passenger,1,0,1,2,3,33.33
May,31,2019,Adams,WA,Truck,0,0,0,5127,5127,0
May,31,2019,Ventura,CA,Passenger,0,2,2,313,315,0.63
May,31,2019,Charleston,SC,Passenger,1,0,1,117,118,0.85
May,31,2019,Maui,HI,Passenger,1,0,1,46,47,2.13
May,31,2019,Santa Cruz,CA,Passenger,1,0,1,40,41,2.44
May,31,2019,Camden,NJ,Passenger,0,1,1,23,24,4.17
May,31,2019,Owyhee,ID,Passenger,1,0,1,5,6,16.67
May,31,2019,Palm Beach,FL,Passenger,0,1,1,89,90,1.11
May,31,2019,Cascade,MT,Passenger,0,1,1,59,60,1.67
May,31,2019,Los Angeles,CA,Passenger,8,5,13,1098,1111,1.17
May,31,2019,Lincoln,WA,Passenger,3,8,11,7772,7783,0.14
May,31,2019,Manatee,FL,Passenger,1,0,1,31,32,3.12
May,31,2019,Cook,IL,Passenger,1,0,1,242,243,0.41
May,31,2019,Thurston,WA,Passenger,844,630,1474,197138,198612,0.74
May,31,2019,Allegheny,PA,Passenger,1,0,1,83,84,1.19
May,31,2019,Klamath,OR,Passenger,1,0,1,38,39,2.56
May,31,2019,Adams,WA,Passenger,5,6,11,12714,12725,0.09
May,31,2019,Mason,WA,Passenger,121,120,241,47012,47253,0.51
May,31,2019,Jefferson,WA,Truck,0,0,0,9668,9668,0
May,31,2019,Whatcom,WA,Passenger,837,413,1250,150441,151691,0.82
May,31,2019,Pacific,WA,Passenger,24,28,52,15952,16004,0.32
May,31,2019,Arlington,VA,Passenger,1,2,3,158,161,1.86
May,31,2019,Klickitat,WA,Truck,0,0,0,8237,8237,0
May,31,2019,Williamson,TX,Passenger,0,1,1,142,143,0.7
May,31,2019,Clallam,WA,Truck,0,0,0,21746,21746,0
May,31,2019,Anne Arundel,MD,Passenger,1,2,3,446,449,0.67
May,31,2019,Cowlitz,WA,Truck,0,0,0,28843,28843,0
May,31,2019,Grays Harbor,WA,Truck,0,0,0,20457,20457,0
May,31,2019,Asotin,WA,Truck,0,0,0,6652,6652,0
May,31,2019,Clark,NV,Passenger,3,2,5,690,695,0.72
May,31,2019,Garfield,WA,Truck,0,0,0,954,954,0
May,31,2019,Oklahoma,OK,Passenger,0,1,1,120,121,0.83
May,31,2019,Dakota,MN,Passenger,0,2,2,37,39,5.13
May,31,2019,Travis,TX,Passenger,2,1,3,201,204,1.47
May,31,2019,Clackamas,OR,Passenger,1,1,2,212,214,0.93
May,31,2019,Columbia,WA,Truck,0,0,0,1532,1532,0
May,31,2019,San Mateo,CA,Passenger,2,1,3,123,126,2.38
May,31,2019,Twin Falls,ID,Passenger,0,1,1,22,23,4.35
May,31,2019,Maricopa,AZ,Passenger,6,2,8,1536,1544,0.52
May,31,2019,Harnett,NC,Passenger,1,1,2,216,218,0.92
May,31,2019,Rogers,OK,Passenger,1,0,1,5,6,16.67
May,31,2019,Frederick,MD,Passenger,1,1,2,80,82,2.44
May,31,2019,Contra Costa,CA,Passenger,2,2,4,383,387,1.03
May,31,2019,,,Passenger,8,2,10,789,799,1.25
May,31,2019,Whitman,WA,Passenger,31,45,76,22710,22786,0.33
May,31,2019,Manassas,VA,Passenger,0,1,1,8,9,11.11
May,31,2019,Vigo,IN,Passenger,1,0,1,6,7,14.29
May,31,2019,Lewis,WA,Truck,0,0,0,25915,25915,0
May,31,2019,Honolulu,HI,Passenger,2,3,5,500,505,0.99
May,31,2019,Skagit,WA,Truck,1,0,1,32417,32418,0
May,31,2019,Yakima,WA,Truck,0,0,0,59084,59084,0
May,31,2019,Penobscot,ME,Passenger,0,1,1,13,14,7.14
May,31,2019,Tulsa,OK,Passenger,1,1,2,44,46,4.35
May,31,2019,Wahkiakum,WA,Truck,0,0,0,1743,1743,0
May,31,2019,Stevens,WA,Passenger,20,29,49,31678,31727,0.15
May,31,2019,Spokane,WA,Passenger,529,422,951,310923,311874,0.3
May,31,2019,Douglas,NE,Passenger,0,1,1,63,64,1.56
May,31,2019,Pend Oreille,WA,Truck,0,0,0,5743,5743,0
May,31,2019,Lake,FL,Passenger,1,0,1,19,20,5
May,31,2019,Whatcom,WA,Truck,2,0,2,42822,42824,0
May,31,2019,El Paso,TX,Passenger,3,0,3,481,484,0.62
May,31,2019,DuPage,IL,Passenger,1,0,1,62,63,1.59
May,31,2019,Clark,WA,Passenger,1475,913,2388,313255,315643,0.76
May,31,2019,Norfolk,MA,Passenger,1,0,1,35,36,2.78
May,31,2019,Saginaw,MI,Passenger,1,0,1,10,11,9.09
May,31,2019,Santa Fe,NM,Passenger,0,1,1,40,41,2.44
May,31,2019,Pinal,AZ,Passenger,2,0,2,194,196,1.02
May,31,2019,Dale,AL,Passenger,0,1,1,58,59,1.69
May,31,2019,Grays Harbor,WA,Passenger,73,84,157,47839,47996,0.33
May,31,2019,Norfolk,VA,Passenger,2,2,4,346,350,1.14
May,31,2019,Chelan,WA,Passenger,153,67,220,54336,54556,0.4
May,31,2019,San Diego,CA,Passenger,10,3,13,2672,2685,0.48
May,31,2019,San Francisco,CA,Passenger,2,1,3,107,110,2.73
May,31,2019,Richland,SC,Passenger,0,1,1,159,160,0.62
May,31,2019,Tarrant,TX,Passenger,2,0,2,203,205,0.98
May,31,2019,Fairfax,VA,Passenger,3,2,5,779,784,0.64
May,31,2019,El Paso,CO,Passenger,2,1,3,741,744,0.4
May,31,2019,Okanogan,WA,Truck,0,0,0,16506,16506,0
May,31,2019,Franklin,WA,Passenger,52,70,122,59788,59910,0.2
May,31,2019,Richmond,GA,Passenger,0,1,1,93,94,1.06
May,31,2019,Kitsap,WA,Truck,1,0,1,54018,54019,0
May,31,2019,Island,WA,Passenger,315,234,549,63346,63895,0.86
May,31,2019,Houston,GA,Passenger,1,0,1,54,55,1.82
May,31,2019,Pacific,WA,Truck,0,0,0,7661,7661,0
May,31,2019,Moore,NC,Passenger,0,1,1,186,187,0.53
May,31,2019,Pierce,WA,Truck,0,0,0,139646,139646,0
May,31,2019,Broward,FL,Passenger,2,1,3,125,128,2.34
May,31,2019,Washtenaw,MI,Passenger,1,0,1,38,39,2.56
May,31,2019,King,WA,Truck,5,1,6,181939,181945,0
May,31,2019,Wayne,MI,Passenger,0,1,1,68,69,1.45
May,31,2019,Jefferson,CO,Passenger,0,2,2,58,60,3.33
May,31,2019,Tuolumne,CA,Passenger,0,1,1,12,13,7.69
May,31,2019,Pend Oreille,WA,Passenger,4,5,9,9537,9546,0.09
May,31,2019,Spokane,WA,Truck,1,0,1,94607,94608,0
May,31,2019,Sedgwick,KS,Passenger,0,1,1,102,103,0.97
May,31,2019,Clark,WA,Truck,0,0,0,80186,80186,0
May,31,2019,Walla Walla,WA,Passenger,46,57,103,36164,36267,0.28
May,31,2019,Fulton,GA,Passenger,1,2,3,107,110,2.73
May,31,2019,Bucks,PA,Passenger,1,0,1,18,19,5.26
May,31,2019,Lee,AL,Passenger,1,0,1,34,35,2.86
May,31,2019,Montgomery,PA,Passenger,2,0,2,37,39,5.13
May,31,2019,Goochland,VA,Passenger,1,1,2,257,259,0.77
May,31,2019,Prince William,VA,Passenger,1,4,5,250,255,1.96
May,31,2019,Suffolk,MA,Passenger,0,1,1,39,40,2.5
May,31,2019,San Juan,WA,Truck,0,0,0,5850,5850,0
May,31,2019,Mason,WA,Truck,0,0,0,20364,20364,0
May,31,2019,Valencia,NM,Passenger,1,0,1,7,8,12.5
May,31,2019,Bexar,TX,Passenger,3,5,8,671,679,1.18
May,31,2019,Fresno,CA,Passenger,1,0,1,188,189,0.53
May,31,2019,Howard,MD,Passenger,0,1,1,76,77,1.3
May,31,2019,Randolph,NC,Passenger,1,0,1,6,7,14.29
May,31,2019,Kittitas,WA,Truck,0,0,0,14377,14377,0
May,31,2019,Kern,CA,Passenger,0,1,1,224,225,0.44
May,31,2019,Kitsap,WA,Passenger,1036,588,1624,180694,182318,0.89
May,31,2019,Solano,CA,Passenger,1,0,1,215,216,0.46
May,31,2019,Jefferson,WA,Passenger,191,119,310,25001,25311,1.22
May,31,2019,Franklin,MA,Passenger,0,1,1,1,2,50
May,31,2019,Volusia,FL,Passenger,0,1,1,38,39,2.56
May,31,2019,Bergen,NJ,Passenger,1,0,1,27,28,3.57
May,31,2019,Klickitat,WA,Passenger,35,33,68,15550,15618,0.44
May,31,2019,DeKalb,GA,Passenger,1,0,1,79,80,1.25
May,31,2019,King,WA,Passenger,18616,6948,25564,1387314,1412878,1.81
May,31,2019,San Joaquin,CA,Passenger,1,0,1,131,132,0.76
May,31,2019,Kootenai,ID,Passenger,1,1,2,217,219,0.91
May,31,2019,New Haven,CT,Passenger,0,2,2,48,50,4
May,31,2019,Clallam,WA,Passenger,167,137,304,50565,50869,0.6
May,31,2019,Montgomery,MD,Passenger,1,0,1,277,278,0.36
May,31,2019,Whitman,WA,Truck,0,0,0,8549,8549,0
May,31,2019,Douglas,WA,Truck,0,0,0,12182,12182,0
May,31,2019,Virginia Beach,VA,Passenger,1,1,2,709,711,0.28
May,31,2019,Mecklenburg,NC,Passenger,1,0,1,82,83,1.2
May,31,2019,San Juan,PR,Passenger,0,1,1,3,4,25
November,30,2019,Montgomery,OH,Passenger,0,1,1,48,49,2.04
November,30,2019,Hennepin,MN,Passenger,3,1,4,99,103,3.88
November,30,2019,Greene,MO,Passenger,0,1,1,31,32,3.12
November,30,2019,Broward,FL,Passenger,2,1,3,124,127,2.36
November,30,2019,Asotin,WA,Passenger,13,8,21,12655,12676,0.17
November,30,2019,Dallas,TX,Passenger,1,0,1,209,210,0.48
November,30,2019,Franklin,MA,Passenger,0,1,1,1,2,50
November,30,2019,Kootenai,ID,Passenger,1,1,2,226,228,0.88
November,30,2019,Richmond,GA,Passenger,0,1,1,93,94,1.06
November,30,2019,Wahkiakum,WA,Passenger,4,3,7,3037,3044,0.23
November,30,2019,Montgomery,PA,Passenger,2,0,2,36,38,5.26
November,30,2019,Grant,WA,Truck,0,0,0,26953,26953,0
November,30,2019,Moore,NC,Passenger,0,1,1,173,174,0.57
November,30,2019,Skamania,WA,Truck,0,0,0,4096,4096,0
November,30,2019,Ada,ID,Passenger,0,1,1,294,295,0.34
November,30,2019,Richland,SC,Passenger,0,1,1,158,159,0.63
November,30,2019,Portsmouth,VA,Passenger,0,1,1,79,80,1.25
November,30,2019,Shasta,CA,Passenger,1,0,1,38,39,2.56
November,30,2019,Wilson,TX,Passenger,0,1,1,8,9,11.11
November,30,2019,Jefferson,WA,Truck,0,0,0,9654,9654,0
November,30,2019,DuPage,IL,Passenger,3,0,3,63,66,4.55
November,30,2019,Pacific,WA,Passenger,29,30,59,16115,16174,0.36
November,30,2019,Whatcom,WA,Truck,2,0,2,43148,43150,0
November,30,2019,Pima,AZ,Passenger,2,1,3,372,375,0.8
November,30,2019,Kern,CA,Passenger,0,1,1,220,221,0.45
November,30,2019,Pinal,AZ,Passenger,1,0,1,191,192,0.52
November,30,2019,Polk,FL,Passenger,1,0,1,66,67,1.49
November,30,2019,Suffolk,VA,Passenger,1,0,1,124,125,0.8
November,30,2019,Tuolumne,CA,Passenger,0,1,1,11,12,8.33
November,30,2019,Lake,FL,Passenger,1,0,1,21,22,4.55
November,30,2019,Bexar,TX,Passenger,1,5,6,648,654,0.92
November,30,2019,Bucks,PA,Passenger,1,0,1,22,23,4.35
November,30,2019,Lincoln,WA,Truck,0,0,0,4695,4695,0
November,30,2019,Clallam,WA,Passenger,195,153,348,50908,51256,0.68
November,30,2019,Lewis,WA,Passenger,109,103,212,59509,59721,0.35
November,30,2019,El Paso,TX,Passenger,3,0,3,459,462,0.65
November,30,2019,Duval,FL,Passenger,1,2,3,367,370,0.81
November,30,2019,Harris,TX,Passenger,1,1,2,240,242,0.83
November,30,2019,Walla Walla,WA,Truck,0,0,0,13674,13674,0
November,30,2019,Wahkiakum,WA,Truck,0,0,0,1752,1752,0
November,30,2019,Sumter,FL,Passenger,0,1,1,9,10,10
November,30,2019,Boone,MO,Passenger,0,1,1,11,12,8.33
November,30,2019,Fairbanks North Star,AK,Passenger,0,1,1,98,99,1.01
November,30,2019,Multnomah,OR,Passenger,4,6,10,726,736,1.36
November,30,2019,Charleston,SC,Passenger,1,0,1,109,110,0.91
November,30,2019,Jefferson,WA,Passenger,212,132,344,25183,25527,1.35
November,30,2019,Hawaii,HI,Passenger,1,0,1,57,58,1.72
November,30,2019,Island,WA,Passenger,363,251,614,63666,64280,0.96
November,30,2019,Sedgwick,KS,Passenger,1,1,2,96,98,2.04
November,30,2019,Alexandria,VA,Passenger,1,0,1,147,148,0.68
November,30,2019,Cumberland,NC,Passenger,0,2,2,486,488,0.41
November,30,2019,Honolulu,HI,Passenger,4,2,6,482,488,1.23
November,30,2019,Santa Rosa,FL,Passenger,1,0,1,88,89,1.12
November,30,2019,Charles,MD,Passenger,0,1,1,84,85,1.18
November,30,2019,Nassau,NY,Passenger,4,0,4,39,43,9.3
November,30,2019,Ferry,WA,Passenger,5,2,7,4414,4421,0.16
November,30,2019,San Juan,WA,Truck,0,0,0,5929,5929,0
November,30,2019,Benton,WA,Truck,0,0,0,42413,42413,0
November,30,2019,Asotin,WA,Truck,0,0,0,6694,6694,0
November,30,2019,Sangamon,IL,Passenger,1,0,1,5,6,16.67
November,30,2019,Palm Beach,FL,Passenger,0,1,1,83,84,1.19
November,30,2019,RÃ­o Grande,PR,Passenger,1,0,1,1,2,50
November,30,2019,Houston,GA,Passenger,1,0,1,59,60,1.67
November,30,2019,Ventura,CA,Passenger,0,3,3,302,305,0.98
November,30,2019,Okanogan,WA,Passenger,27,30,57,26234,26291,0.22
November,30,2019,Kitsap,WA,Passenger,1190,649,1839,182242,184081,1
November,30,2019,Franklin,WA,Passenger,53,75,128,60785,60913,0.21
November,30,2019,Chelan,WA,Passenger,196,75,271,54642,54913,0.49
November,30,2019,Tarrant,TX,Passenger,2,0,2,195,197,1.02
November,30,2019,Skagit,WA,Passenger,347,210,557,92574,93131,0.6
November,30,2019,Ramsey,MN,Passenger,1,0,1,40,41,2.44
November,30,2019,Whitman,WA,Truck,0,0,0,8581,8581,0
November,30,2019,Spokane,WA,Truck,1,0,1,96217,96218,0
November,30,2019,Carson City,NV,Passenger,1,0,1,10,11,9.09
November,30,2019,Kitsap,WA,Truck,1,0,1,54405,54406,0
November,30,2019,Pend Oreille,WA,Truck,0,0,0,5733,5733,0
November,30,2019,Berkshire,MA,Passenger,0,1,1,5,6,16.67
November,30,2019,Santa Cruz,CA,Passenger,1,0,1,36,37,2.7
November,30,2019,Norfolk,VA,Passenger,1,2,3,347,350,0.86
November,30,2019,Middlesex,MA,Passenger,1,1,2,107,109,1.83
November,30,2019,Cowlitz,WA,Truck,0,0,0,29029,29029,0
November,30,2019,,,Passenger,9,5,14,861,875,1.6
November,30,2019,King,WA,Truck,6,1,7,182343,182350,0
November,30,2019,Denver,CO,Passenger,1,0,1,128,129,0.78
November,30,2019,Arlington,VA,Passenger,0,2,2,153,155,1.29
November,30,2019,Washtenaw,MI,Passenger,1,0,1,41,42,2.38
November,30,2019,Manassas,VA,Passenger,0,1,1,7,8,12.5
November,30,2019,Douglas,WA,Passenger,65,38,103,28288,28391,0.36
November,30,2019,Montgomery,TX,Passenger,1,0,1,56,57,1.75
November,30,2019,San Mateo,CA,Passenger,1,1,2,121,123,1.63
November,30,2019,Goochland,VA,Passenger,3,1,4,264,268,1.49
November,30,2019,Skamania,WA,Passenger,26,20,46,8789,8835,0.52
November,30,2019,Stevens,WA,Truck,0,0,0,18795,18795,0
November,30,2019,DeKalb,IN,Passenger,1,0,1,1,2,50
November,30,2019,Stevens,WA,Passenger,31,30,61,31606,31667,0.19
November,30,2019,Tulsa,OK,Passenger,1,1,2,48,50,4
November,30,2019,Adams,WA,Passenger,6,7,13,12928,12941,0.1
November,30,2019,Pierce,WA,Passenger,2083,1635,3718,547543,551261,0.67
November,30,2019,Juneau,AK,Passenger,0,2,2,28,30,6.67
November,30,2019,Douglas,NE,Passenger,0,1,1,59,60,1.67
November,30,2019,Frederick,MD,Passenger,1,1,2,83,85,2.35
November,30,2019,Pinellas,FL,Passenger,1,1,2,108,110,1.82
November,30,2019,Placer,CA,Passenger,1,0,1,96,97,1.03
November,30,2019,Osceola,FL,Passenger,1,0,1,43,44,2.27
November,30,2019,Cascade,MT,Passenger,0,1,1,56,57,1.75
November,30,2019,Clark,WA,Truck,0,0,0,81279,81279,0
November,30,2019,San Juan,WA,Passenger,243,78,321,14405,14726,2.18
November,30,2019,San Diego,CA,Passenger,9,3,12,2805,2817,0.43
November,30,2019,New Haven,CT,Passenger,0,2,2,47,49,4.08
November,30,2019,San Francisco,CA,Passenger,2,1,3,100,103,2.91
November,30,2019,Thurston,WA,Truck,0,0,0,55656,55656,0
November,30,2019,Orange,CA,Passenger,7,2,9,505,514,1.75
November,30,2019,Mason,WA,Passenger,140,130,270,47611,47881,0.56
November,30,2019,Benton,WA,Passenger,310,308,618,135108,135726,0.46
November,30,2019,Spartanburg,SC,Passenger,0,1,1,43,44,2.27
November,30,2019,Whatcom,WA,Passenger,964,470,1434,151593,153027,0.94
November,30,2019,Flathead,MT,Passenger,1,0,1,64,65,1.54
November,30,2019,Grays Harbor,WA,Truck,0,0,0,20750,20750,0
November,30,2019,Whitman,WA,Passenger,41,46,87,22704,22791,0.38
November,30,2019,Travis,TX,Passenger,2,1,3,199,202,1.49
November,30,2019,Brevard,FL,Passenger,0,1,1,88,89,1.12
November,30,2019,Vigo,IN,Passenger,1,0,1,6,7,14.29
November,30,2019,Saginaw,MI,Passenger,1,0,1,11,12,8.33
November,30,2019,Volusia,FL,Passenger,0,1,1,41,42,2.38
November,30,2019,Grant,WA,Passenger,53,65,118,65498,65616,0.18
November,30,2019,Solano,CA,Passenger,1,0,1,204,205,0.49
November,30,2019,Montgomery,AL,Passenger,0,1,1,39,40,2.5
November,30,2019,Prince George's,MD,Passenger,1,1,2,174,176,1.14
November,30,2019,Jones,GA,Passenger,1,0,1,1,2,50
November,30,2019,Fairfax,VA,Passenger,4,2,6,755,761,0.79
November,30,2019,Garfield,WA,Passenger,0,1,1,1304,1305,0.08
November,30,2019,Lewis,WA,Truck,0,0,0,26110,26110,0
November,30,2019,Thurston,WA,Passenger,1035,700,1735,199127,200862,0.86
November,30,2019,King,WA,Passenger,21598,7457,29055,1395552,1424607,2.04
November,30,2019,Los Angeles,CA,Passenger,8,9,17,1065,1082,1.57
November,30,2019,Contra Costa,CA,Passenger,3,2,5,349,354,1.41
November,30,2019,Columbia,WA,Passenger,3,2,5,2443,2448,0.2
November,30,2019,Wayne,MI,Passenger,0,1,1,61,62,1.61
November,30,2019,Anne Arundel,MD,Passenger,1,2,3,435,438,0.68
November,30,2019,Camden,NJ,Passenger,0,1,1,22,23,4.35
November,30,2019,Clackamas,OR,Passenger,2,1,3,211,214,1.4
November,30,2019,Garfield,WA,Truck,0,0,0,965,965,0
November,30,2019,Cape May,NJ,Passenger,0,1,1,13,14,7.14
November,30,2019,Maricopa,AZ,Passenger,6,5,11,1507,1518,0.72
November,30,2019,Larimer,CO,Passenger,1,0,1,56,57,1.75
November,30,2019,Clark,WA,Passenger,1806,1025,2831,317525,320356,0.88
November,30,2019,Shelby,OH,Passenger,0,1,1,1,2,50
November,30,2019,Fresno,CA,Passenger,1,0,1,190,191,0.52
November,30,2019,Clark,NV,Passenger,4,2,6,683,689,0.87
November,30,2019,Lincoln,WA,Passenger,1,11,12,7798,7810,0.15
November,30,2019,Hudson,NJ,Passenger,1,0,1,38,39,2.56
November,30,2019,Maui,HI,Passenger,1,0,1,42,43,2.33
November,30,2019,Powhatan,VA,Passenger,1,0,1,0,1,100
November,30,2019,Arapahoe,CO,Passenger,1,0,1,145,146,0.68
November,30,2019,Queens,NY,Passenger,1,0,1,54,55,1.82
November,30,2019,Skagit,WA,Truck,1,0,1,32541,32542,0
November,30,2019,Chesapeake,VA,Passenger,0,2,2,439,441,0.45
November,30,2019,Monroe,IL,Passenger,1,0,1,4,5,20
November,30,2019,Cochise,AZ,Passenger,0,1,1,104,105,0.95
November,30,2019,Walla Walla,WA,Passenger,64,61,125,36282,36407,0.34
November,30,2019,Washoe,NV,Passenger,1,0,1,108,109,0.92
November,30,2019,Island,WA,Truck,1,0,1,21317,21318,0
November,30,2019,Owyhee,ID,Passenger,1,0,1,3,4,25
November,30,2019,Kittitas,WA,Passenger,89,46,135,30012,30147,0.45
November,30,2019,Harrison,MS,Passenger,1,0,1,58,59,1.69
November,30,2019,Snohomish,WA,Truck,0,0,0,123166,123166,0
November,30,2019,Yakima,WA,Truck,0,0,0,59589,59589,0
November,30,2019,Jefferson,CO,Passenger,0,2,2,59,61,3.28
November,30,2019,Cook,IL,Passenger,1,0,1,230,231,0.43
November,30,2019,Alameda,CA,Passenger,5,1,6,291,297,2.02
November,30,2019,Pacific,WA,Truck,0,0,0,7740,7740,0
November,30,2019,Dakota,MN,Passenger,0,1,1,34,35,2.86
November,30,2019,Harnett,NC,Passenger,1,1,2,208,210,0.95
November,30,2019,Fulton,GA,Passenger,0,2,2,105,107,1.87
November,30,2019,Klickitat,WA,Passenger,45,38,83,15673,15756,0.53
November,30,2019,Kittitas,WA,Truck,0,0,0,14619,14619,0
November,30,2019,St. Mary's,MD,Passenger,1,0,1,218,219,0.46
November,30,2019,Oldham,KY,Passenger,0,1,1,5,6,16.67
November,30,2019,Riverside,CA,Passenger,4,1,5,636,641,0.78
November,30,2019,Pend Oreille,WA,Passenger,7,7,14,9516,9530,0.15
November,30,2019,Lake,IL,Passenger,1,0,1,166,167,0.6
November,30,2019,District of Columbia,DC,Passenger,1,1,2,212,214,0.93
November,30,2019,Norfolk,MA,Passenger,1,0,1,36,37,2.7
November,30,2019,Sarasota,FL,Passenger,2,0,2,25,27,7.41
November,30,2019,Williamson,TX,Passenger,0,2,2,146,148,1.35
November,30,2019,Cowlitz,WA,Passenger,114,106,220,73591,73811,0.3
November,30,2019,Loudoun,VA,Passenger,1,0,1,95,96,1.04
November,30,2019,Spokane,WA,Passenger,631,470,1101,314632,315733,0.35
November,30,2019,San Joaquin,CA,Passenger,1,0,1,135,136,0.74
November,30,2019,Douglas,WA,Truck,0,0,0,12301,12301,0
November,30,2019,Jefferson,NY,Passenger,0,2,2,214,216,0.93
November,30,2019,Deschutes,OR,Passenger,3,0,3,147,150,2
November,30,2019,Oklahoma,OK,Passenger,0,1,1,126,127,0.79
November,30,2019,Ferry,WA,Truck,0,0,0,3581,3581,0
November,30,2019,Grays Harbor,WA,Passenger,99,99,198,48351,48549,0.41
November,30,2019,Howard,MD,Passenger,0,1,1,73,74,1.35
November,30,2019,Franklin,WA,Truck,0,0,0,19729,19729,0
November,30,2019,Penobscot,ME,Passenger,0,1,1,13,14,7.14
November,30,2019,Stafford,VA,Passenger,1,1,2,95,97,2.06
November,30,2019,DeKalb,GA,Passenger,1,0,1,81,82,1.22
November,30,2019,Suffolk,MA,Passenger,0,1,1,36,37,2.7
November,30,2019,Chelan,WA,Truck,0,0,0,22517,22517,0
November,30,2019,Klamath,OR,Passenger,1,0,1,37,38,2.63
November,30,2019,Allegheny,PA,Passenger,1,0,1,77,78,1.28
November,30,2019,Putnam,TN,Passenger,0,1,1,3,4,25
November,30,2019,Calvert,MD,Passenger,0,2,2,92,94,2.13
November,30,2019,Albemarle,VA,Passenger,1,0,1,25,26,3.85
November,30,2019,Columbia,WA,Truck,0,0,0,1535,1535,0
November,30,2019,Snohomish,WA,Passenger,3943,1706,5649,535420,541069,1.04
November,30,2019,Valencia,NM,Passenger,1,0,1,5,6,16.67
November,30,2019,Okanogan,WA,Truck,0,0,0,16557,16557,0
November,30,2019,New London,CT,Passenger,0,2,2,244,246,0.81
November,30,2019,Adams,WA,Truck,0,0,0,5184,5184,0
November,30,2019,Guadalupe,TX,Passenger,1,0,1,67,68,1.47
November,30,2019,Collin,TX,Passenger,1,1,2,130,132,1.52
November,30,2019,Clallam,WA,Truck,1,0,1,21847,21848,0
November,30,2019,Pierce,WA,Truck,0,0,0,140707,140707,0
November,30,2019,Kent,MI,Passenger,0,1,1,24,25,4
November,30,2019,Clay,FL,Passenger,0,1,1,87,88,1.14
November,30,2019,Rogers,OK,Passenger,1,0,1,5,6,16.67
November,30,2019,Twin Falls,ID,Passenger,0,1,1,28,29,3.45
November,30,2019,El Paso,CO,Passenger,2,1,3,740,743,0.4
November,30,2019,Virginia Beach,VA,Passenger,1,0,1,701,702,0.14
November,30,2019,Randolph,NC,Passenger,1,0,1,7,8,12.5
November,30,2019,Nueces,TX,Passenger,1,1,2,88,90,2.22
November,30,2019,Boulder,CO,Passenger,0,1,1,50,51,1.96
November,30,2019,Yakima,WA,Passenger,117,116,233,166000,166233,0.14
November,30,2019,Carroll,NH,Passenger,0,1,1,3,4,25
November,30,2019,Klickitat,WA,Truck,0,0,0,8306,8306,0
November,30,2019,Lee,FL,Passenger,1,0,1,53,54,1.85
November,30,2019,Shelby,TN,Passenger,0,1,1,96,97,1.03
November,30,2019,Mason,WA,Truck,0,0,0,20508,20508,0
November,30,2019,Santa Clara,CA,Passenger,6,2,8,360,368,2.17
November,30,2019,Prince William,VA,Passenger,1,3,4,232,236,1.69
October,31,2019,Cowlitz,WA,Truck,0,0,0,29023,29023,0
October,31,2019,Sarasota,FL,Passenger,2,0,2,26,28,7.14
October,31,2019,Douglas,WA,Passenger,63,38,101,28272,28373,0.36
October,31,2019,Richland,SC,Passenger,0,1,1,159,160,0.62
October,31,2019,Calvert,MD,Passenger,0,2,2,92,94,2.13
October,31,2019,RÃ­o Grande,PR,Passenger,1,0,1,1,2,50
October,31,2019,Whatcom,WA,Passenger,949,470,1419,151478,152897,0.93
October,31,2019,New London,CT,Passenger,0,2,2,244,246,0.81
October,31,2019,Spartanburg,SC,Passenger,0,1,1,41,42,2.38
October,31,2019,Asotin,WA,Passenger,12,8,20,12644,12664,0.16
October,31,2019,DeKalb,GA,Passenger,1,0,1,80,81,1.23
October,31,2019,Fulton,GA,Passenger,0,2,2,102,104,1.92
October,31,2019,Clark,WA,Passenger,1782,1016,2798,316964,319762,0.88
October,31,2019,Shasta,CA,Passenger,1,0,1,40,41,2.44
October,31,2019,Douglas,NE,Passenger,0,1,1,58,59,1.69
October,31,2019,Ferry,WA,Passenger,5,2,7,4425,4432,0.16
October,31,2019,Virginia Beach,VA,Passenger,1,0,1,696,697,0.14
October,31,2019,Santa Cruz,CA,Passenger,1,0,1,36,37,2.7
October,31,2019,Harnett,NC,Passenger,1,1,2,211,213,0.94
October,31,2019,Chesapeake,VA,Passenger,0,1,1,444,445,0.22
October,31,2019,Cape May,NJ,Passenger,0,1,1,13,14,7.14
October,31,2019,Denver,CO,Passenger,1,0,1,131,132,0.76
October,31,2019,Washoe,NV,Passenger,2,0,2,107,109,1.83
October,31,2019,Lee,FL,Passenger,1,0,1,53,54,1.85
October,31,2019,Kitsap,WA,Truck,1,0,1,54352,54353,0
October,31,2019,Cowlitz,WA,Passenger,112,106,218,73568,73786,0.3
October,31,2019,Lake,FL,Passenger,1,0,1,21,22,4.55
October,31,2019,Clay,FL,Passenger,0,1,1,86,87,1.15
October,31,2019,Monroe,IL,Passenger,1,0,1,5,6,16.67
October,31,2019,Bexar,TX,Passenger,1,5,6,649,655,0.92
October,31,2019,Richmond,GA,Passenger,0,1,1,91,92,1.09
October,31,2019,Cochise,AZ,Passenger,0,1,1,106,107,0.93
October,31,2019,Tulsa,OK,Passenger,1,1,2,48,50,4
October,31,2019,Boulder,CO,Passenger,0,1,1,51,52,1.92
October,31,2019,Franklin,WA,Passenger,53,76,129,60628,60757,0.21
October,31,2019,Spokane,WA,Passenger,616,464,1080,314332,315412,0.34
October,31,2019,Clackamas,OR,Passenger,2,1,3,212,215,1.4
October,31,2019,San Mateo,CA,Passenger,1,1,2,120,122,1.64
October,31,2019,Prince William,VA,Passenger,1,3,4,234,238,1.68
October,31,2019,Valencia,NM,Passenger,1,0,1,6,7,14.29
October,31,2019,Hudson,NJ,Passenger,1,0,1,39,40,2.5
October,31,2019,Stevens,WA,Passenger,29,28,57,31624,31681,0.18
October,31,2019,Fairfax,VA,Passenger,4,2,6,760,766,0.78
October,31,2019,Okanogan,WA,Passenger,24,28,52,26251,26303,0.2
October,31,2019,Adams,WA,Passenger,6,6,12,12912,12924,0.09
October,31,2019,Travis,TX,Passenger,2,1,3,202,205,1.46
October,31,2019,Montgomery,PA,Passenger,2,0,2,36,38,5.26
October,31,2019,Ramsey,MN,Passenger,1,0,1,40,41,2.44
October,31,2019,Hawaii,HI,Passenger,1,0,1,58,59,1.69
October,31,2019,Dakota,MN,Passenger,0,1,1,36,37,2.7
October,31,2019,Cumberland,NC,Passenger,0,2,2,491,493,0.41
October,31,2019,Grant,WA,Truck,0,0,0,26891,26891,0
October,31,2019,Stafford,VA,Passenger,1,1,2,95,97,2.06
October,31,2019,Pierce,WA,Passenger,2058,1629,3687,546972,550659,0.67
October,31,2019,Albemarle,VA,Passenger,1,0,1,25,26,3.85
October,31,2019,Pinal,AZ,Passenger,1,0,1,189,190,0.53
October,31,2019,Santa Rosa,FL,Passenger,1,0,1,87,88,1.14
October,31,2019,Clark,NV,Passenger,4,2,6,686,692,0.87
October,31,2019,Grays Harbor,WA,Truck,0,0,0,20730,20730,0
October,31,2019,St. Mary's,MD,Passenger,1,0,1,218,219,0.46
October,31,2019,Flathead,MT,Passenger,1,0,1,63,64,1.56
October,31,2019,Solano,CA,Passenger,1,0,1,205,206,0.49
October,31,2019,Osceola,FL,Passenger,1,0,1,39,40,2.5
October,31,2019,Clallam,WA,Truck,1,0,1,21846,21847,0
October,31,2019,Portsmouth,VA,Passenger,0,1,1,79,80,1.25
October,31,2019,Anne Arundel,MD,Passenger,1,2,3,438,441,0.68
October,31,2019,Clallam,WA,Passenger,194,150,344,50936,51280,0.67
October,31,2019,Sangamon,IL,Passenger,1,0,1,5,6,16.67
October,31,2019,Lincoln,WA,Passenger,2,11,13,7831,7844,0.17
October,31,2019,Thurston,WA,Passenger,1005,686,1691,199109,200800,0.84
October,31,2019,Berkshire,MA,Passenger,0,1,1,4,5,20
October,31,2019,Pima,AZ,Passenger,2,1,3,378,381,0.79
October,31,2019,Santa Fe,NM,Passenger,0,1,1,41,42,2.38
October,31,2019,Pacific,WA,Passenger,30,29,59,16110,16169,0.36
October,31,2019,Putnam,TN,Passenger,0,1,1,3,4,25
October,31,2019,Snohomish,WA,Truck,0,0,0,123012,123012,0
October,31,2019,Houston,GA,Passenger,1,0,1,57,58,1.72
October,31,2019,Jefferson,NY,Passenger,0,2,2,213,215,0.93
October,31,2019,New Haven,CT,Passenger,0,2,2,48,50,4
October,31,2019,Island,WA,Passenger,362,250,612,63634,64246,0.95
October,31,2019,Vigo,IN,Passenger,1,0,1,6,7,14.29
October,31,2019,Sedgwick,KS,Passenger,1,1,2,96,98,2.04
October,31,2019,Ventura,CA,Passenger,0,3,3,304,307,0.98
October,31,2019,Penobscot,ME,Passenger,0,1,1,13,14,7.14
October,31,2019,Asotin,WA,Truck,0,0,0,6694,6694,0
October,31,2019,Santa Clara,CA,Passenger,6,2,8,364,372,2.15
October,31,2019,King,WA,Truck,6,1,7,182394,182401,0
October,31,2019,DuPage,IL,Passenger,3,0,3,60,63,4.76
October,31,2019,Pend Oreille,WA,Passenger,7,6,13,9493,9506,0.14
October,31,2019,Okanogan,WA,Truck,0,0,0,16523,16523,0
October,31,2019,Harrison,MS,Passenger,1,0,1,58,59,1.69
October,31,2019,Skagit,WA,Passenger,336,210,546,92600,93146,0.59
October,31,2019,Kootenai,ID,Passenger,1,1,2,224,226,0.88
October,31,2019,Whitman,WA,Truck,0,0,0,8596,8596,0
October,31,2019,Cascade,MT,Passenger,0,1,1,57,58,1.72
October,31,2019,Grant,WA,Passenger,55,64,119,65376,65495,0.18
October,31,2019,Riverside,CA,Passenger,4,1,5,646,651,0.77
October,31,2019,Stevens,WA,Truck,0,0,0,18773,18773,0
October,31,2019,DeKalb,IN,Passenger,1,0,1,1,2,50
October,31,2019,Allegheny,PA,Passenger,1,0,1,77,78,1.28
October,31,2019,Clark,WA,Truck,0,0,0,81150,81150,0
October,31,2019,Benton,WA,Truck,0,0,0,42370,42370,0
October,31,2019,Loudoun,VA,Passenger,1,0,1,94,95,1.05
October,31,2019,Wahkiakum,WA,Truck,0,0,0,1752,1752,0
October,31,2019,Douglas,WA,Truck,0,0,0,12295,12295,0
October,31,2019,Alameda,CA,Passenger,5,1,6,296,302,1.99
October,31,2019,Yakima,WA,Truck,0,0,0,59494,59494,0
October,31,2019,Garfield,WA,Truck,0,0,0,963,963,0
October,31,2019,Thurston,WA,Truck,0,0,0,55645,55645,0
October,31,2019,Placer,CA,Passenger,1,0,1,95,96,1.04
October,31,2019,Kitsap,WA,Passenger,1177,645,1822,182157,183979,0.99
October,31,2019,Walla Walla,WA,Passenger,62,62,124,36327,36451,0.34
October,31,2019,Klamath,OR,Passenger,1,0,1,39,40,2.5
October,31,2019,Norfolk,MA,Passenger,1,0,1,36,37,2.7
October,31,2019,San Juan,WA,Truck,0,0,0,5924,5924,0
October,31,2019,Pend Oreille,WA,Truck,0,0,0,5739,5739,0
October,31,2019,Volusia,FL,Passenger,0,1,1,41,42,2.38
October,31,2019,Jefferson,WA,Truck,0,0,0,9672,9672,0
October,31,2019,Skamania,WA,Truck,0,0,0,4101,4101,0
October,31,2019,Tuolumne,CA,Passenger,0,1,1,12,13,7.69
October,31,2019,Multnomah,OR,Passenger,4,6,10,726,736,1.36
October,31,2019,Suffolk,MA,Passenger,0,1,1,38,39,2.56
October,31,2019,Charleston,SC,Passenger,1,0,1,113,114,0.88
October,31,2019,Boone,MO,Passenger,0,1,1,11,12,8.33
October,31,2019,Collin,TX,Passenger,1,1,2,130,132,1.52
October,31,2019,Carroll,NH,Passenger,0,1,1,3,4,25
October,31,2019,Jefferson,CO,Passenger,0,2,2,59,61,3.28
October,31,2019,Dallas,TX,Passenger,1,0,1,211,212,0.47
October,31,2019,Benton,WA,Passenger,307,302,609,134942,135551,0.45
October,31,2019,Orange,CA,Passenger,7,3,10,510,520,1.92
October,31,2019,Williamson,TX,Passenger,0,2,2,143,145,1.38
October,31,2019,Shelby,OH,Passenger,0,1,1,1,2,50
October,31,2019,Oldham,KY,Passenger,0,1,1,5,6,16.67
October,31,2019,Mason,WA,Passenger,140,129,269,47564,47833,0.56
October,31,2019,Franklin,MA,Passenger,0,1,1,1,2,50
October,31,2019,Camden,NJ,Passenger,0,1,1,23,24,4.17
October,31,2019,Queens,NY,Passenger,1,0,1,52,53,1.89
October,31,2019,Twin Falls,ID,Passenger,0,1,1,26,27,3.7
October,31,2019,Adams,WA,Truck,0,0,0,5154,5154,0
October,31,2019,Yakima,WA,Passenger,115,114,229,165908,166137,0.14
October,31,2019,Palm Beach,FL,Passenger,0,1,1,84,85,1.18
October,31,2019,Larimer,CO,Passenger,1,0,1,59,60,1.67
October,31,2019,Nueces,TX,Passenger,1,1,2,92,94,2.13
October,31,2019,Montgomery,TX,Passenger,1,0,1,58,59,1.69
October,31,2019,Wahkiakum,WA,Passenger,4,3,7,3049,3056,0.23
October,31,2019,Manassas,VA,Passenger,0,1,1,7,8,12.5
October,31,2019,Maricopa,AZ,Passenger,6,5,11,1515,1526,0.72
October,31,2019,Jefferson,WA,Passenger,210,126,336,25159,25495,1.32
October,31,2019,San Francisco,CA,Passenger,2,1,3,100,103,2.91
October,31,2019,King,WA,Passenger,21367,7391,28758,1396136,1424894,2.02
October,31,2019,Bucks,PA,Passenger,1,0,1,24,25,4
October,31,2019,Arlington,VA,Passenger,0,2,2,151,153,1.31
October,31,2019,Montgomery,AL,Passenger,0,1,1,40,41,2.44
October,31,2019,Ada,ID,Passenger,0,2,2,300,302,0.66
October,31,2019,Cook,IL,Passenger,1,0,1,232,233,0.43
October,31,2019,District of Columbia,DC,Passenger,1,1,2,210,212,0.94
October,31,2019,San Juan,WA,Passenger,236,76,312,14410,14722,2.12
October,31,2019,Pacific,WA,Truck,0,0,0,7726,7726,0
October,31,2019,Kittitas,WA,Truck,0,0,0,14618,14618,0
October,31,2019,Arapahoe,CO,Passenger,1,0,1,146,147,0.68
October,31,2019,Contra Costa,CA,Passenger,2,2,4,356,360,1.11
October,31,2019,Juneau,AK,Passenger,0,2,2,28,30,6.67
October,31,2019,Garfield,WA,Passenger,0,1,1,1301,1302,0.08
October,31,2019,Franklin,WA,Truck,0,0,0,19656,19656,0
October,31,2019,Maui,HI,Passenger,1,0,1,43,44,2.27
October,31,2019,Mason,WA,Truck,0,0,0,20466,20466,0
October,31,2019,Polk,FL,Passenger,1,0,1,66,67,1.49
October,31,2019,Columbia,WA,Passenger,3,2,5,2435,2440,0.2
October,31,2019,Pierce,WA,Truck,0,0,0,140688,140688,0
October,31,2019,Howard,MD,Passenger,0,1,1,75,76,1.32
October,31,2019,Snohomish,WA,Passenger,3897,1683,5580,535121,540701,1.03
October,31,2019,Hennepin,MN,Passenger,3,1,4,99,103,3.88
October,31,2019,Ferry,WA,Truck,0,0,0,3575,3575,0
October,31,2019,Fairbanks North Star,AK,Passenger,0,1,1,101,102,0.98
October,31,2019,Prince George's,MD,Passenger,1,1,2,178,180,1.11
October,31,2019,Charles,MD,Passenger,0,1,1,82,83,1.2
October,31,2019,Norfolk,VA,Passenger,2,2,4,346,350,1.14
October,31,2019,El Paso,TX,Passenger,3,0,3,462,465,0.65
October,31,2019,Klickitat,WA,Passenger,43,37,80,15665,15745,0.51
October,31,2019,Saginaw,MI,Passenger,1,0,1,11,12,8.33
October,31,2019,San Diego,CA,Passenger,10,3,13,2804,2817,0.46
October,31,2019,Jones,GA,Passenger,1,0,1,1,2,50
October,31,2019,Wilson,TX,Passenger,0,1,1,7,8,12.5
October,31,2019,Island,WA,Truck,0,0,0,21320,21320,0
October,31,2019,Lewis,WA,Passenger,108,102,210,59447,59657,0.35
October,31,2019,Tarrant,TX,Passenger,2,0,2,198,200,1
October,31,2019,Kent,MI,Passenger,0,1,1,23,24,4.17
October,31,2019,Alexandria,VA,Passenger,1,0,1,147,148,0.68
October,31,2019,Powhatan,VA,Passenger,1,0,1,0,1,100
October,31,2019,Fresno,CA,Passenger,1,0,1,191,192,0.52
October,31,2019,Brevard,FL,Passenger,0,1,1,90,91,1.1
October,31,2019,Nassau,NY,Passenger,4,0,4,38,42,9.52
October,31,2019,Chelan,WA,Passenger,191,75,266,54655,54921,0.48
October,31,2019,Skamania,WA,Passenger,25,20,45,8803,8848,0.51
October,31,2019,Guadalupe,TX,Passenger,1,0,1,68,69,1.45
October,31,2019,Whatcom,WA,Truck,2,0,2,43096,43098,0
October,31,2019,Rogers,OK,Passenger,1,0,1,5,6,16.67
October,31,2019,Kittitas,WA,Passenger,87,45,132,29964,30096,0.44
October,31,2019,,,Passenger,9,4,13,857,870,1.49
October,31,2019,Columbia,WA,Truck,0,0,0,1533,1533,0
October,31,2019,Klickitat,WA,Truck,0,0,0,8311,8311,0
October,31,2019,Lewis,WA,Truck,0,0,0,26045,26045,0
October,31,2019,Walla Walla,WA,Truck,0,0,0,13670,13670,0
October,31,2019,Honolulu,HI,Passenger,4,2,6,487,493,1.22
October,31,2019,Deschutes,OR,Passenger,3,0,3,151,154,1.95
October,31,2019,Owyhee,ID,Passenger,1,0,1,3,4,25
October,31,2019,Middlesex,MA,Passenger,1,1,2,108,110,1.82
October,31,2019,Whitman,WA,Passenger,38,45,83,22717,22800,0.36
October,31,2019,Washtenaw,MI,Passenger,1,0,1,40,41,2.44
October,31,2019,Carson City,NV,Passenger,1,0,1,11,12,8.33
October,31,2019,Kern,CA,Passenger,0,1,1,222,223,0.45
October,31,2019,Grays Harbor,WA,Passenger,95,95,190,48305,48495,0.39
October,31,2019,Sumter,FL,Passenger,0,1,1,9,10,10
October,31,2019,Broward,FL,Passenger,2,1,3,124,127,2.36
October,31,2019,Spokane,WA,Truck,1,0,1,96090,96091,0
October,31,2019,Wayne,MI,Passenger,0,1,1,62,63,1.59
October,31,2019,El Paso,CO,Passenger,2,1,3,733,736,0.41
October,31,2019,Skagit,WA,Truck,1,0,1,32558,32559,0
October,31,2019,Greene,MO,Passenger,0,1,1,31,32,3.12
October,31,2019,Pinellas,FL,Passenger,1,1,2,109,111,1.8
October,31,2019,Oklahoma,OK,Passenger,0,1,1,130,131,0.76
October,31,2019,Duval,FL,Passenger,1,2,3,369,372,0.81
October,31,2019,Randolph,NC,Passenger,1,0,1,6,7,14.29
October,31,2019,Shelby,TN,Passenger,0,1,1,96,97,1.03
October,31,2019,Lake,IL,Passenger,1,0,1,166,167,0.6
October,31,2019,Frederick,MD,Passenger,1,1,2,85,87,2.3
October,31,2019,Los Angeles,CA,Passenger,9,8,17,1071,1088,1.56
October,31,2019,Chelan,WA,Truck,0,0,0,22495,22495,0
October,31,2019,San Joaquin,CA,Passenger,1,0,1,137,138,0.72
October,31,2019,Harris,TX,Passenger,1,1,2,244,246,0.81
October,31,2019,Goochland,VA,Passenger,3,1,4,267,271,1.48
October,31,2019,Moore,NC,Passenger,0,1,1,177,178,0.56
October,31,2019,Lincoln,WA,Truck,0,0,0,4691,4691,0
September,30,2019,Clark,NV,Passenger,4,2,6,684,690,0.87
September,30,2019,Franklin,MA,Passenger,0,1,1,1,2,50
September,30,2019,Twin Falls,ID,Passenger,0,1,1,26,27,3.7
September,30,2019,Cowlitz,WA,Passenger,106,106,212,73309,73521,0.29
September,30,2019,Anne Arundel,MD,Passenger,1,2,3,437,440,0.68
September,30,2019,Stafford,VA,Passenger,1,1,2,96,98,2.04
September,30,2019,King,WA,Passenger,20421,7282,27703,1394905,1422608,1.95
September,30,2019,Wahkiakum,WA,Passenger,2,3,5,3049,3054,0.16
September,30,2019,Duval,FL,Passenger,1,2,3,369,372,0.81
September,30,2019,District of Columbia,DC,Passenger,1,1,2,210,212,0.94
September,30,2019,Montgomery,TX,Passenger,1,0,1,58,59,1.69
September,30,2019,Pacific,WA,Truck,0,0,0,7676,7676,0
September,30,2019,Jones,GA,Passenger,1,0,1,1,2,50
September,30,2019,Jefferson,CO,Passenger,0,2,2,59,61,3.28
September,30,2019,Walla Walla,WA,Passenger,59,63,122,36254,36376,0.34
September,30,2019,Chesapeake,VA,Passenger,0,1,1,442,443,0.23
September,30,2019,Sedgwick,KS,Passenger,1,1,2,99,101,1.98
September,30,2019,Orange,CA,Passenger,7,3,10,513,523,1.91
September,30,2019,Sumter,FL,Passenger,0,1,1,9,10,10
September,30,2019,Osceola,FL,Passenger,1,0,1,40,41,2.44
September,30,2019,Snohomish,WA,Truck,0,0,0,122968,122968,0
September,30,2019,Kern,CA,Passenger,0,1,1,217,218,0.46
September,30,2019,Broward,FL,Passenger,2,1,3,128,131,2.29
September,30,2019,St. Mary's,MD,Passenger,1,0,1,218,219,0.46
September,30,2019,Fulton,GA,Passenger,0,2,2,102,104,1.92
September,30,2019,DuPage,IL,Passenger,3,0,3,61,64,4.69
September,30,2019,Manassas,VA,Passenger,0,1,1,7,8,12.5
September,30,2019,Riverside,CA,Passenger,4,1,5,650,655,0.76
September,30,2019,Moore,NC,Passenger,0,1,1,180,181,0.55
September,30,2019,Mason,WA,Passenger,133,129,262,47444,47706,0.55
September,30,2019,Shasta,CA,Passenger,1,0,1,39,40,2.5
September,30,2019,Wayne,MI,Passenger,0,1,1,63,64,1.56
September,30,2019,Nassau,NY,Passenger,4,0,4,37,41,9.76
September,30,2019,Deschutes,OR,Passenger,3,0,3,153,156,1.92
September,30,2019,Pacific,WA,Passenger,25,29,54,16078,16132,0.33
September,30,2019,Larimer,CO,Passenger,1,0,1,60,61,1.64
September,30,2019,Thurston,WA,Truck,0,0,0,55538,55538,0
September,30,2019,Santa Rosa,FL,Passenger,1,0,1,87,88,1.14
September,30,2019,Chelan,WA,Passenger,174,71,245,54511,54756,0.45
September,30,2019,Houston,GA,Passenger,1,0,1,56,57,1.75
September,30,2019,Tuolumne,CA,Passenger,0,1,1,11,12,8.33
September,30,2019,Snohomish,WA,Passenger,3740,1661,5401,533934,539335,1
September,30,2019,DeKalb,IN,Passenger,1,0,1,1,2,50
September,30,2019,Ramsey,MN,Passenger,1,0,1,40,41,2.44
September,30,2019,Clay,FL,Passenger,0,1,1,85,86,1.16
September,30,2019,Bexar,TX,Passenger,1,5,6,651,657,0.91
September,30,2019,Albemarle,VA,Passenger,1,0,1,23,24,4.17
September,30,2019,Guadalupe,TX,Passenger,1,0,1,70,71,1.41
September,30,2019,Frederick,MD,Passenger,1,1,2,80,82,2.44
September,30,2019,Lake,FL,Passenger,1,0,1,21,22,4.55
September,30,2019,Spokane,WA,Truck,1,0,1,95761,95762,0
September,30,2019,El Paso,CO,Passenger,2,1,3,739,742,0.4
September,30,2019,Whatcom,WA,Passenger,922,460,1382,151337,152719,0.9
September,30,2019,Columbia,WA,Truck,0,0,0,1536,1536,0
September,30,2019,Douglas,NE,Passenger,0,1,1,59,60,1.67
September,30,2019,Ferry,WA,Truck,0,0,0,3583,3583,0
September,30,2019,Lake,IL,Passenger,1,0,1,165,166,0.6
September,30,2019,Sarasota,FL,Passenger,1,0,1,26,27,3.7
September,30,2019,Cowlitz,WA,Truck,0,0,0,28959,28959,0
September,30,2019,Clallam,WA,Truck,1,0,1,21843,21844,0
September,30,2019,Solano,CA,Passenger,1,0,1,207,208,0.48
September,30,2019,Ferry,WA,Passenger,5,2,7,4423,4430,0.16
September,30,2019,Vigo,IN,Passenger,1,0,1,6,7,14.29
September,30,2019,Yakima,WA,Truck,0,0,0,59399,59399,0
September,30,2019,Nueces,TX,Passenger,1,1,2,92,94,2.13
September,30,2019,Lewis,WA,Passenger,107,101,208,59362,59570,0.35
September,30,2019,Richland,SC,Passenger,0,1,1,156,157,0.64
September,30,2019,Skagit,WA,Passenger,315,210,525,92513,93038,0.56
September,30,2019,Kitsap,WA,Passenger,1135,641,1776,181617,183393,0.97
September,30,2019,Carson City,NV,Passenger,1,0,1,10,11,9.09
September,30,2019,Clark,WA,Passenger,1700,982,2682,316090,318772,0.84
September,30,2019,Asotin,WA,Passenger,12,8,20,12631,12651,0.16
September,30,2019,Oldham,KY,Passenger,0,1,1,5,6,16.67
September,30,2019,Polk,FL,Passenger,1,0,1,66,67,1.49
September,30,2019,San Diego,CA,Passenger,10,3,13,2770,2783,0.47
September,30,2019,Island,WA,Passenger,346,249,595,63481,64076,0.93
September,30,2019,Asotin,WA,Truck,0,0,0,6682,6682,0
September,30,2019,San Mateo,CA,Passenger,2,1,3,119,122,2.46
September,30,2019,Cascade,MT,Passenger,0,1,1,58,59,1.69
September,30,2019,Charleston,SC,Passenger,1,0,1,113,114,0.88
September,30,2019,Lewis,WA,Truck,0,0,0,25970,25970,0
September,30,2019,Monroe,IL,Passenger,1,0,1,5,6,16.67
September,30,2019,Tarrant,TX,Passenger,2,0,2,195,197,1.02
September,30,2019,Dallas,TX,Passenger,1,0,1,209,210,0.48
September,30,2019,Cumberland,NC,Passenger,0,2,2,490,492,0.41
September,30,2019,Wilson,TX,Passenger,0,1,1,6,7,14.29
September,30,2019,El Paso,TX,Passenger,3,0,3,472,475,0.63
September,30,2019,Oklahoma,OK,Passenger,0,1,1,127,128,0.78
September,30,2019,Boone,MO,Passenger,0,1,1,10,11,9.09
September,30,2019,Dakota,MN,Passenger,0,1,1,37,38,2.63
September,30,2019,Kitsap,WA,Truck,1,0,1,54211,54212,0
September,30,2019,Kittitas,WA,Truck,0,0,0,14565,14565,0
September,30,2019,Fairbanks North Star,AK,Passenger,0,1,1,98,99,1.01
September,30,2019,Thurston,WA,Passenger,953,672,1625,198595,200220,0.81
September,30,2019,Pend Oreille,WA,Passenger,6,6,12,9472,9484,0.13
September,30,2019,Williamson,TX,Passenger,0,2,2,144,146,1.37
September,30,2019,Alexandria,VA,Passenger,1,0,1,147,148,0.68
September,30,2019,Grays Harbor,WA,Passenger,89,89,178,48096,48274,0.37
September,30,2019,Skamania,WA,Truck,0,0,0,4086,4086,0
September,30,2019,Norfolk,MA,Passenger,1,0,1,36,37,2.7
September,30,2019,Pima,AZ,Passenger,2,1,3,379,382,0.79
September,30,2019,Boulder,CO,Passenger,0,1,1,49,50,2
September,30,2019,Santa Clara,CA,Passenger,4,2,6,358,364,1.65
September,30,2019,Klickitat,WA,Passenger,38,36,74,15624,15698,0.47
September,30,2019,Maui,HI,Passenger,1,0,1,41,42,2.38
September,30,2019,Okanogan,WA,Passenger,24,26,50,26237,26287,0.19
September,30,2019,Rogers,OK,Passenger,1,0,1,5,6,16.67
September,30,2019,Klickitat,WA,Truck,0,0,0,8298,8298,0
September,30,2019,Travis,TX,Passenger,2,1,3,203,206,1.46
September,30,2019,Ventura,CA,Passenger,0,2,2,305,307,0.65
September,30,2019,Fairfax,VA,Passenger,3,2,5,759,764,0.65
September,30,2019,Alameda,CA,Passenger,4,1,5,295,300,1.67
September,30,2019,Allegheny,PA,Passenger,1,0,1,79,80,1.25
September,30,2019,San Francisco,CA,Passenger,2,1,3,105,108,2.78
September,30,2019,Pierce,WA,Passenger,1966,1602,3568,545437,549005,0.65
September,30,2019,Whitman,WA,Passenger,36,45,81,22710,22791,0.36
September,30,2019,Island,WA,Truck,0,0,0,21294,21294,0
September,30,2019,Maricopa,AZ,Passenger,7,4,11,1521,1532,0.72
September,30,2019,Garfield,WA,Truck,0,0,0,970,970,0
September,30,2019,Lincoln,WA,Passenger,2,10,12,7807,7819,0.15
September,30,2019,Los Angeles,CA,Passenger,9,7,16,1087,1103,1.45
September,30,2019,Grays Harbor,WA,Truck,0,0,0,20636,20636,0
September,30,2019,Prince William,VA,Passenger,1,3,4,242,246,1.63
September,30,2019,Suffolk,MA,Passenger,0,1,1,38,39,2.56
September,30,2019,Spartanburg,SC,Passenger,0,1,1,39,40,2.5
September,30,2019,Arlington,VA,Passenger,0,2,2,152,154,1.3
September,30,2019,Penobscot,ME,Passenger,0,1,1,13,14,7.14
September,30,2019,Juneau,AK,Passenger,0,2,2,28,30,6.67
September,30,2019,San Juan,WA,Truck,0,0,0,5916,5916,0
September,30,2019,Chelan,WA,Truck,0,0,0,22420,22420,0
September,30,2019,Fresno,CA,Passenger,1,0,1,194,195,0.51
September,30,2019,Whitman,WA,Truck,0,0,0,8604,8604,0
September,30,2019,Clackamas,OR,Passenger,2,1,3,211,214,1.4
September,30,2019,San Juan,WA,Passenger,229,73,302,14431,14733,2.05
September,30,2019,Pinellas,FL,Passenger,1,1,2,110,112,1.79
September,30,2019,Shelby,TN,Passenger,0,1,1,94,95,1.05
September,30,2019,Clallam,WA,Passenger,185,151,336,50854,51190,0.66
September,30,2019,Denver,CO,Passenger,1,0,1,129,130,0.77
September,30,2019,New London,CT,Passenger,0,2,2,242,244,0.82
September,30,2019,Carroll,NH,Passenger,0,1,1,3,4,25
September,30,2019,Ada,ID,Passenger,0,2,2,302,304,0.66
September,30,2019,Jefferson,NY,Passenger,0,2,2,216,218,0.92
September,30,2019,Powhatan,VA,Passenger,1,0,1,0,1,100
September,30,2019,Kootenai,ID,Passenger,1,1,2,222,224,0.89
September,30,2019,Pinal,AZ,Passenger,2,0,2,190,192,1.04
September,30,2019,Walla Walla,WA,Truck,0,0,0,13687,13687,0
September,30,2019,Yakima,WA,Passenger,111,113,224,165657,165881,0.14
September,30,2019,Washoe,NV,Passenger,2,0,2,107,109,1.83
September,30,2019,Cochise,AZ,Passenger,0,1,1,107,108,0.93
September,30,2019,Hawaii,HI,Passenger,1,0,1,57,58,1.72
September,30,2019,Pend Oreille,WA,Truck,0,0,0,5712,5712,0
September,30,2019,Richmond,GA,Passenger,0,1,1,92,93,1.08
September,30,2019,Camden,NJ,Passenger,0,1,1,24,25,4
September,30,2019,Lincoln,WA,Truck,0,0,0,4690,4690,0
September,30,2019,Benton,WA,Truck,0,0,0,42229,42229,0
September,30,2019,Harris,TX,Passenger,1,1,2,246,248,0.81
September,30,2019,Franklin,WA,Truck,0,0,0,19536,19536,0
September,30,2019,King,WA,Truck,6,1,7,182395,182402,0
September,30,2019,New Haven,CT,Passenger,0,2,2,47,49,4.08
September,30,2019,RÃ­o Grande,PR,Passenger,1,0,1,1,2,50
September,30,2019,Franklin,WA,Passenger,51,73,124,60363,60487,0.21
September,30,2019,Placer,CA,Passenger,1,0,1,96,97,1.03
September,30,2019,Multnomah,OR,Passenger,5,6,11,739,750,1.47
September,30,2019,Cape May,NJ,Passenger,0,1,1,13,14,7.14
September,30,2019,Kittitas,WA,Passenger,81,44,125,29832,29957,0.42
September,30,2019,Klamath,OR,Passenger,1,0,1,39,40,2.5
September,30,2019,Tulsa,OK,Passenger,1,1,2,49,51,3.92
September,30,2019,Jefferson,WA,Truck,0,0,0,9682,9682,0
September,30,2019,Goochland,VA,Passenger,2,1,3,264,267,1.12
September,30,2019,Santa Cruz,CA,Passenger,1,0,1,36,37,2.7
September,30,2019,Stevens,WA,Truck,0,0,0,18754,18754,0
September,30,2019,Skamania,WA,Passenger,26,18,44,8787,8831,0.5
September,30,2019,Washtenaw,MI,Passenger,1,0,1,41,42,2.38
September,30,2019,Volusia,FL,Passenger,0,1,1,38,39,2.56
September,30,2019,Calvert,MD,Passenger,0,2,2,91,93,2.15
September,30,2019,Flathead,MT,Passenger,1,0,1,64,65,1.54
September,30,2019,Prince George's,MD,Passenger,1,1,2,176,178,1.12
September,30,2019,Stevens,WA,Passenger,27,28,55,31672,31727,0.17
September,30,2019,Palm Beach,FL,Passenger,0,1,1,84,85,1.18
September,30,2019,Kent,MI,Passenger,0,1,1,23,24,4.17
September,30,2019,Valencia,NM,Passenger,1,0,1,6,7,14.29
September,30,2019,San Joaquin,CA,Passenger,1,0,1,135,136,0.74
September,30,2019,Santa Fe,NM,Passenger,0,1,1,42,43,2.33
September,30,2019,Cook,IL,Passenger,1,0,1,240,241,0.41
September,30,2019,Loudoun,VA,Passenger,1,0,1,94,95,1.05
September,30,2019,Montgomery,PA,Passenger,2,0,2,36,38,5.26
September,30,2019,Greene,MO,Passenger,0,1,1,31,32,3.12
September,30,2019,Virginia Beach,VA,Passenger,1,0,1,700,701,0.14
September,30,2019,Grant,WA,Truck,0,0,0,26789,26789,0
September,30,2019,Harrison,MS,Passenger,1,0,1,61,62,1.61
September,30,2019,Columbia,WA,Passenger,3,2,5,2446,2451,0.2
September,30,2019,Contra Costa,CA,Passenger,2,2,4,367,371,1.08
September,30,2019,Harnett,NC,Passenger,1,1,2,212,214,0.93
September,30,2019,Portsmouth,VA,Passenger,0,1,1,79,80,1.25
September,30,2019,Owyhee,ID,Passenger,1,0,1,4,5,20
September,30,2019,Middlesex,MA,Passenger,1,1,2,109,111,1.8
September,30,2019,Skagit,WA,Truck,1,0,1,32515,32516,0
September,30,2019,DeKalb,GA,Passenger,1,0,1,79,80,1.25
September,30,2019,Wahkiakum,WA,Truck,0,0,0,1760,1760,0
September,30,2019,Sangamon,IL,Passenger,1,0,1,6,7,14.29
September,30,2019,Hennepin,MN,Passenger,3,1,4,103,107,3.74
September,30,2019,Okanogan,WA,Truck,0,0,0,16497,16497,0
September,30,2019,Shelby,OH,Passenger,0,1,1,1,2,50
September,30,2019,Benton,WA,Passenger,291,297,588,134616,135204,0.43
September,30,2019,Brevard,FL,Passenger,0,1,1,87,88,1.14
September,30,2019,Honolulu,HI,Passenger,4,2,6,492,498,1.2
September,30,2019,Adams,WA,Passenger,5,5,10,12887,12897,0.08
September,30,2019,Putnam,TN,Passenger,0,1,1,3,4,25
September,30,2019,Garfield,WA,Passenger,0,1,1,1311,1312,0.08
September,30,2019,Pierce,WA,Truck,0,0,0,140471,140471,0
September,30,2019,Charles,MD,Passenger,0,1,1,86,87,1.15
September,30,2019,Randolph,NC,Passenger,1,0,1,6,7,14.29
September,30,2019,Howard,MD,Passenger,0,1,1,76,77,1.3
September,30,2019,Whatcom,WA,Truck,2,0,2,43030,43032,0
September,30,2019,Mason,WA,Truck,0,0,0,20438,20438,0
September,30,2019,Adams,WA,Truck,0,0,0,5139,5139,0
September,30,2019,Norfolk,VA,Passenger,2,2,4,344,348,1.15
September,30,2019,Douglas,WA,Truck,0,0,0,12275,12275,0
September,30,2019,,,Passenger,9,4,13,851,864,1.5
September,30,2019,Clark,WA,Truck,0,0,0,80968,80968,0
September,30,2019,Collin,TX,Passenger,1,1,2,128,130,1.54
September,30,2019,Spokane,WA,Passenger,596,445,1041,313551,314592,0.33
September,30,2019,Berkshire,MA,Passenger,0,1,1,4,5,20
September,30,2019,Saginaw,MI,Passenger,1,0,1,11,12,8.33
September,30,2019,Bucks,PA,Passenger,1,0,1,23,24,4.17
September,30,2019,Jefferson,WA,Passenger,207,126,333,25125,25458,1.31
September,30,2019,Lee,FL,Passenger,1,0,1,50,51,1.96
September,30,2019,Grant,WA,Passenger,48,63,111,65170,65281,0.17
September,30,2019,Montgomery,AL,Passenger,0,1,1,42,43,2.33
September,30,2019,Douglas,WA,Passenger,62,37,99,28207,28306,0.35
April,30,2020,Sumter,FL,Passenger,0,1,1,9,10,10
April,30,2020,Placer,CA,Passenger,2,0,2,89,91,2.2
April,30,2020,New Haven,CT,Passenger,0,2,2,41,43,4.65
April,30,2020,King,WA,Passenger,24085,7696,31781,1386024,1417805,2.24
April,30,2020,Pend Oreille,WA,Truck,0,0,0,5739,5739,0
April,30,2020,DeKalb,GA,Passenger,1,0,1,80,81,1.23
April,30,2020,Pierce,WA,Passenger,2347,1682,4029,548871,552900,0.73
April,30,2020,Garfield,WA,Truck,0,0,0,968,968,0
April,30,2020,Cowlitz,WA,Truck,0,0,0,28765,28765,0
April,30,2020,Frederick,MD,Passenger,1,1,2,76,78,2.56
April,30,2020,Shelby,OH,Passenger,0,1,1,1,2,50
April,30,2020,Tarrant,TX,Passenger,1,0,1,178,179,0.56
April,30,2020,San Diego,CA,Passenger,13,5,18,2764,2782,0.65
April,30,2020,Alexandria,VA,Passenger,1,0,1,140,141,0.71
April,30,2020,Camden,NJ,Passenger,0,2,2,21,23,8.7
April,30,2020,Dallas,TX,Passenger,1,0,1,202,203,0.49
April,30,2020,Adams,WA,Truck,0,0,0,5206,5206,0
April,30,2020,Montgomery,AL,Passenger,0,1,1,38,39,2.56
April,30,2020,Manassas,VA,Passenger,0,1,1,5,6,16.67
April,30,2020,Prince George's,MD,Passenger,1,1,2,164,166,1.2
April,30,2020,Rockingham,NH,Passenger,1,0,1,27,28,3.57
April,30,2020,Montgomery,OH,Passenger,0,1,1,46,47,2.13
April,30,2020,Yakima,WA,Passenger,129,115,244,165261,165505,0.15
April,30,2020,Williams,ND,Passenger,0,1,1,13,14,7.14
April,30,2020,Shelby,TN,Passenger,0,1,1,89,90,1.11
April,30,2020,DuPage,IL,Passenger,3,0,3,58,61,4.92
April,30,2020,Ferry,WA,Passenger,5,3,8,4331,4339,0.18
April,30,2020,Nassau,NY,Passenger,4,0,4,33,37,10.81
April,30,2020,St. Clair,IL,Passenger,1,0,1,139,140,0.71
April,30,2020,Hudson,NJ,Passenger,1,0,1,38,39,2.56
April,30,2020,Denton,TX,Passenger,1,0,1,90,91,1.1
April,30,2020,Mason,WA,Truck,0,0,0,20531,20531,0
April,30,2020,Fresno,CA,Passenger,1,0,1,183,184,0.54
April,30,2020,Hawaii,HI,Passenger,1,0,1,57,58,1.72
April,30,2020,Monroe,IL,Passenger,1,0,1,4,5,20
April,30,2020,Montgomery,PA,Passenger,1,0,1,31,32,3.12
April,30,2020,Klickitat,WA,Truck,0,0,0,8193,8193,0
April,30,2020,Palm Beach,FL,Passenger,0,1,1,80,81,1.23
April,30,2020,Ramsey,MN,Passenger,1,0,1,39,40,2.5
April,30,2020,Prince William,VA,Passenger,2,3,5,222,227,2.2
April,30,2020,Greene,MO,Passenger,0,1,1,31,32,3.12
April,30,2020,Whitman,WA,Passenger,44,48,92,22313,22405,0.41
April,30,2020,Ventura,CA,Passenger,0,3,3,287,290,1.03
April,30,2020,Asotin,WA,Truck,0,0,0,6617,6617,0
April,30,2020,Columbia,WA,Truck,0,0,0,1524,1524,0
April,30,2020,Shasta,CA,Passenger,1,0,1,37,38,2.63
April,30,2020,El Paso,TX,Passenger,3,0,3,436,439,0.68
April,30,2020,Kitsap,WA,Truck,1,0,1,53907,53908,0
April,30,2020,Virginia Beach,VA,Passenger,1,0,1,672,673,0.15
April,30,2020,Wahkiakum,WA,Passenger,6,5,11,2973,2984,0.37
April,30,2020,Pinellas,FL,Passenger,1,1,2,109,111,1.8
April,30,2020,Moore,NC,Passenger,0,1,1,162,163,0.61
April,30,2020,Duval,FL,Passenger,0,2,2,358,360,0.56
April,30,2020,Collin,TX,Passenger,1,1,2,124,126,1.59
April,30,2020,Benton,WA,Passenger,348,321,669,134556,135225,0.49
April,30,2020,Juneau,AK,Passenger,0,2,2,31,33,6.06
April,30,2020,Putnam,TN,Passenger,0,1,1,3,4,25
April,30,2020,Cascade,MT,Passenger,0,1,1,55,56,1.79
April,30,2020,Spokane,WA,Passenger,711,473,1184,316298,317482,0.37
April,30,2020,Houston,GA,Passenger,1,0,1,58,59,1.69
April,30,2020,Arlington,VA,Passenger,0,2,2,150,152,1.32
April,30,2020,Oldham,KY,Passenger,0,1,1,4,5,20
April,30,2020,Chelan,WA,Truck,0,0,0,22460,22460,0
April,30,2020,Valencia,NM,Passenger,1,0,1,5,6,16.67
April,30,2020,Washington,OR,Passenger,1,0,1,446,447,0.22
April,30,2020,Clallam,WA,Passenger,219,166,385,50341,50726,0.76
April,30,2020,District of Columbia,DC,Passenger,1,1,2,202,204,0.98
April,30,2020,Richland,SC,Passenger,0,1,1,156,157,0.64
April,30,2020,Clark,WA,Passenger,1992,1056,3048,318746,321794,0.95
April,30,2020,Washtenaw,MI,Passenger,1,0,1,36,37,2.7
April,30,2020,Cowlitz,WA,Passenger,136,115,251,72718,72969,0.34
April,30,2020,Skagit,WA,Truck,1,0,1,32387,32388,0
April,30,2020,Fort Bend,TX,Passenger,1,0,1,46,47,2.13
April,30,2020,Riverside,CA,Passenger,3,1,4,629,633,0.63
April,30,2020,Jefferson,WA,Passenger,234,142,376,24908,25284,1.49
April,30,2020,Middlesex,MA,Passenger,1,1,2,96,98,2.04
April,30,2020,Spartanburg,SC,Passenger,0,1,1,49,50,2
April,30,2020,Charles,MD,Passenger,0,1,1,74,75,1.33
April,30,2020,Skamania,WA,Passenger,29,17,46,8615,8661,0.53
April,30,2020,Stevens,WA,Truck,0,0,0,18611,18611,0
April,30,2020,Tulsa,OK,Passenger,1,1,2,43,45,4.44
April,30,2020,Polk,FL,Passenger,1,0,1,65,66,1.52
April,30,2020,Spokane,WA,Truck,1,0,1,97398,97399,0
April,30,2020,King,WA,Truck,5,1,6,181518,181524,0
April,30,2020,Denver,CO,Passenger,1,0,1,120,121,0.83
April,30,2020,Guadalupe,TX,Passenger,1,0,1,65,66,1.52
April,30,2020,Garfield,WA,Passenger,0,1,1,1341,1342,0.07
April,30,2020,Boone,MO,Passenger,0,1,1,12,13,7.69
April,30,2020,Anne Arundel,MD,Passenger,0,1,1,415,416,0.24
April,30,2020,Pierce,WA,Truck,0,0,0,141140,141140,0
April,30,2020,Ferry,WA,Truck,0,0,0,3543,3543,0
April,30,2020,Los Angeles,CA,Passenger,7,11,18,1001,1019,1.77
April,30,2020,Harris,TX,Passenger,1,0,1,233,234,0.43
April,30,2020,Ada,ID,Passenger,0,1,1,282,283,0.35
April,30,2020,Harrison,MS,Passenger,1,0,1,57,58,1.72
April,30,2020,Maui,HI,Passenger,1,0,1,34,35,2.86
April,30,2020,Walla Walla,WA,Passenger,69,63,132,36000,36132,0.37
April,30,2020,Lake,FL,Passenger,1,0,1,20,21,4.76
April,30,2020,Osceola,FL,Passenger,1,0,1,41,42,2.38
April,30,2020,Orange,CA,Passenger,7,2,9,493,502,1.79
April,30,2020,Thurston,WA,Truck,0,0,0,55499,55499,0
April,30,2020,San Juan,WA,Truck,0,0,0,5898,5898,0
April,30,2020,Carroll,NH,Passenger,0,1,1,4,5,20
April,30,2020,Richmond,GA,Passenger,0,1,1,86,87,1.15
April,30,2020,Grant,WA,Truck,0,0,0,26995,26995,0
April,30,2020,Penobscot,ME,Passenger,0,1,1,15,16,6.25
April,30,2020,Okanogan,WA,Passenger,34,31,65,25891,25956,0.25
April,30,2020,Harnett,NC,Passenger,1,0,1,201,202,0.5
April,30,2020,Stevens,WA,Passenger,33,33,66,30969,31035,0.21
April,30,2020,St. Mary's,MD,Passenger,1,0,1,217,218,0.46
April,30,2020,Deschutes,OR,Passenger,3,0,3,139,142,2.11
April,30,2020,Hamilton,IN,Passenger,1,0,1,40,41,2.44
April,30,2020,Kittitas,WA,Passenger,101,49,150,29857,30007,0.5
April,30,2020,Tuolumne,CA,Passenger,0,1,1,10,11,9.09
April,30,2020,Klamath,OR,Passenger,1,0,1,34,35,2.86
April,30,2020,San Mateo,CA,Passenger,0,1,1,116,117,0.85
April,30,2020,Jones,GA,Passenger,1,0,1,1,2,50
April,30,2020,Island,WA,Truck,1,0,1,21149,21150,0
April,30,2020,Clark,NV,Passenger,3,2,5,674,679,0.74
April,30,2020,Okanogan,WA,Truck,0,0,0,16384,16384,0
April,30,2020,Broward,FL,Passenger,3,1,4,115,119,3.36
April,30,2020,Mason,WA,Passenger,155,135,290,47212,47502,0.61
April,30,2020,Jefferson,CO,Passenger,0,1,1,58,59,1.69
April,30,2020,Lee,FL,Passenger,1,0,1,51,52,1.92
April,30,2020,Pacific,WA,Passenger,30,34,64,15837,15901,0.4
April,30,2020,Bexar,TX,Passenger,2,5,7,613,620,1.13
April,30,2020,Hennepin,MN,Passenger,3,1,4,90,94,4.26
April,30,2020,Clackamas,OR,Passenger,2,0,2,201,203,0.99
April,30,2020,Randolph,NC,Passenger,1,0,1,7,8,12.5
April,30,2020,San Francisco,CA,Passenger,2,1,3,98,101,2.97
April,30,2020,Ulster,NY,Passenger,1,0,1,8,9,11.11
April,30,2020,Cochise,AZ,Passenger,0,1,1,101,102,0.98
April,30,2020,,,Passenger,9,6,15,859,874,1.72
April,30,2020,DeKalb,IN,Passenger,1,0,1,1,2,50
April,30,2020,Kootenai,ID,Passenger,1,0,1,225,226,0.44
April,30,2020,Chelan,WA,Passenger,224,80,304,54232,54536,0.56
April,30,2020,Loudoun,VA,Passenger,1,0,1,89,90,1.11
April,30,2020,Alameda,CA,Passenger,3,1,4,277,281,1.42
April,30,2020,Benton,WA,Truck,0,0,0,42485,42485,0
April,30,2020,Williamson,TX,Passenger,0,2,2,139,141,1.42
April,30,2020,Cape May,NJ,Passenger,0,1,1,13,14,7.14
April,30,2020,Lewis,WA,Passenger,99,106,205,58652,58857,0.35
April,30,2020,Pacific,WA,Truck,0,0,0,7665,7665,0
April,30,2020,Queens,NY,Passenger,1,0,1,53,54,1.85
April,30,2020,Fulton,GA,Passenger,1,2,3,104,107,2.8
April,30,2020,Kent,MI,Passenger,0,1,1,23,24,4.17
April,30,2020,Clallam,WA,Truck,1,0,1,21696,21697,0
April,30,2020,Allegheny,PA,Passenger,1,0,1,74,75,1.33
April,30,2020,Bucks,PA,Passenger,1,0,1,20,21,4.76
April,30,2020,Chesapeake,VA,Passenger,0,2,2,422,424,0.47
April,30,2020,Island,WA,Passenger,405,270,675,62863,63538,1.06
April,30,2020,Franklin,WA,Truck,0,0,0,19844,19844,0
April,30,2020,St. Louis,MO,Passenger,1,0,1,99,100,1
April,30,2020,Rogers,OK,Passenger,1,0,1,5,6,16.67
April,30,2020,Charleston,SC,Passenger,1,0,1,105,106,0.94
April,30,2020,Multnomah,OR,Passenger,4,7,11,721,732,1.5
April,30,2020,Wahkiakum,WA,Truck,0,0,0,1760,1760,0
April,30,2020,Norfolk,VA,Passenger,2,2,4,347,351,1.14
April,30,2020,Carson City,NV,Passenger,1,0,1,11,12,8.33
April,30,2020,Clay,FL,Passenger,0,1,1,80,81,1.23
April,30,2020,Skamania,WA,Truck,0,0,0,4054,4054,0
April,30,2020,Grays Harbor,WA,Truck,0,0,0,20728,20728,0
April,30,2020,Erie,NY,Passenger,1,0,1,44,45,2.22
April,30,2020,Arapahoe,CO,Passenger,1,0,1,136,137,0.73
April,30,2020,Suffolk,MA,Passenger,0,2,2,36,38,5.26
April,30,2020,Santa Cruz,CA,Passenger,1,0,1,37,38,2.63
April,30,2020,Sacramento,CA,Passenger,1,0,1,268,269,0.37
April,30,2020,Whitman,WA,Truck,0,0,0,8532,8532,0
April,30,2020,Grant,WA,Passenger,59,71,130,65268,65398,0.2
April,30,2020,Santa Clara,CA,Passenger,7,2,9,318,327,2.75
April,30,2020,Vigo,IN,Passenger,1,0,1,5,6,16.67
April,30,2020,Solano,CA,Passenger,1,0,1,211,212,0.47
April,30,2020,Montgomery,TX,Passenger,1,0,1,52,53,1.89
April,30,2020,El Paso,CO,Passenger,2,0,2,722,724,0.28
April,30,2020,Twin Falls,ID,Passenger,0,1,1,28,29,3.45
April,30,2020,Thurston,WA,Passenger,1141,730,1871,197497,199368,0.94
April,30,2020,Lincoln,WA,Truck,0,0,0,4627,4627,0
April,30,2020,Pima,AZ,Passenger,3,1,4,351,355,1.13
April,30,2020,Kitsap,WA,Passenger,1312,676,1988,180568,182556,1.09
April,30,2020,Suffolk,VA,Passenger,1,0,1,126,127,0.79
April,30,2020,Walla Walla,WA,Truck,0,0,0,13622,13622,0
April,30,2020,Douglas,WA,Truck,0,0,0,12271,12271,0
April,30,2020,Cumberland,NC,Passenger,0,2,2,471,473,0.42
April,30,2020,Snohomish,WA,Truck,0,0,0,123316,123316,0
April,30,2020,Columbia,WA,Passenger,3,3,6,2407,2413,0.25
April,30,2020,Sedgwick,KS,Passenger,1,1,2,93,95,2.11
April,30,2020,Honolulu,HI,Passenger,4,2,6,457,463,1.3
April,30,2020,Boulder,CO,Passenger,0,1,1,46,47,2.13
April,30,2020,Pend Oreille,WA,Passenger,8,6,14,9257,9271,0.15
April,30,2020,Franklin,WA,Passenger,58,76,134,60733,60867,0.22
April,30,2020,Nueces,TX,Passenger,1,0,1,82,83,1.2
April,30,2020,Brevard,FL,Passenger,0,1,1,86,87,1.15
April,30,2020,Larimer,CO,Passenger,1,0,1,52,53,1.89
April,30,2020,Douglas,NE,Passenger,0,1,1,55,56,1.79
April,30,2020,Asotin,WA,Passenger,16,12,28,12444,12472,0.22
April,30,2020,Douglas,WA,Passenger,69,40,109,28017,28126,0.39
April,30,2020,Lake,IL,Passenger,1,0,1,164,165,0.61
April,30,2020,Travis,TX,Passenger,2,1,3,183,186,1.61
April,30,2020,Calvert,MD,Passenger,0,2,2,89,91,2.2
April,30,2020,Jefferson,WA,Truck,0,0,0,9531,9531,0
April,30,2020,Fairfax,VA,Passenger,4,3,7,740,747,0.94
April,30,2020,Portsmouth,VA,Passenger,0,1,1,79,80,1.25
April,30,2020,Washoe,NV,Passenger,1,0,1,106,107,0.93
April,30,2020,Howard,MD,Passenger,0,1,1,71,72,1.39
April,30,2020,Bartow,GA,Passenger,0,1,1,3,4,25
April,30,2020,Adams,WA,Passenger,7,7,14,12756,12770,0.11
April,30,2020,Sarasota,FL,Passenger,2,0,2,24,26,7.69
April,30,2020,Skagit,WA,Passenger,397,215,612,91480,92092,0.66
April,30,2020,Jefferson,NY,Passenger,0,1,1,212,213,0.47
April,30,2020,San Joaquin,CA,Passenger,1,0,1,130,131,0.76
April,30,2020,RÃ­o Grande,PR,Passenger,1,0,1,1,2,50
April,30,2020,Whatcom,WA,Passenger,1058,490,1548,150136,151684,1.02
April,30,2020,Fairbanks North Star,AK,Passenger,0,1,1,98,99,1.01
April,30,2020,Stafford,VA,Passenger,1,1,2,90,92,2.17
April,30,2020,New London,CT,Passenger,1,2,3,243,246,1.22
April,30,2020,Kern,CA,Passenger,0,1,1,225,226,0.44
April,30,2020,Kittitas,WA,Truck,0,0,0,14593,14593,0
April,30,2020,Saginaw,MI,Passenger,1,0,1,10,11,9.09
April,30,2020,Dakota,MN,Passenger,0,1,1,32,33,3.03
April,30,2020,Maricopa,AZ,Passenger,7,6,13,1447,1460,0.89
April,30,2020,Albemarle,VA,Passenger,1,0,1,21,22,4.55
April,30,2020,Lewis,WA,Truck,0,0,0,25979,25979,0
April,30,2020,Gwinnett,GA,Passenger,1,0,1,73,74,1.35
April,30,2020,Powhatan,VA,Passenger,1,0,1,0,1,100
April,30,2020,Wilson,TX,Passenger,0,1,1,7,8,12.5
April,30,2020,Yakima,WA,Truck,0,0,0,59516,59516,0
April,30,2020,Goochland,VA,Passenger,2,1,3,258,261,1.15
April,30,2020,Oklahoma,OK,Passenger,0,1,1,126,127,0.79
April,30,2020,Contra Costa,CA,Passenger,3,2,5,322,327,1.53
April,30,2020,Clark,WA,Truck,0,0,0,81837,81837,0
April,30,2020,Snohomish,WA,Passenger,4400,1751,6151,535202,541353,1.14
April,30,2020,Owyhee,ID,Passenger,1,0,1,3,4,25
April,30,2020,Flathead,MT,Passenger,1,0,1,63,64,1.56
April,30,2020,Grays Harbor,WA,Passenger,106,110,216,48072,48288,0.45
April,30,2020,Lincoln,WA,Passenger,4,12,16,7676,7692,0.21
April,30,2020,Klickitat,WA,Passenger,53,41,94,15425,15519,0.61
April,30,2020,Whatcom,WA,Truck,3,0,3,42832,42835,0.01
April,30,2020,Pinal,AZ,Passenger,1,0,1,185,186,0.54
April,30,2020,San Juan,WA,Passenger,295,88,383,14157,14540,2.63
August,31,2020,Kauai,HI,Passenger,1,0,1,13,14,7.14
August,31,2020,Klickitat,WA,Truck,0,0,0,8105,8105,0
August,31,2020,Alameda,CA,Passenger,2,0,2,266,268,0.75
August,31,2020,Bucks,PA,Passenger,1,0,1,20,21,4.76
August,31,2020,Pacific,WA,Truck,0,0,0,7724,7724,0
August,31,2020,Howard,MD,Passenger,0,1,1,68,69,1.45
August,31,2020,St. Louis,MO,Passenger,1,0,1,96,97,1.03
August,31,2020,King,WA,Truck,5,1,6,183316,183322,0
August,31,2020,Okaloosa,FL,Passenger,0,1,1,139,140,0.71
August,31,2020,Yakima,WA,Passenger,146,122,268,166128,166396,0.16
August,31,2020,Hudson,NJ,Passenger,1,0,1,38,39,2.56
August,31,2020,Maui,HI,Passenger,1,0,1,30,31,3.23
August,31,2020,Fairfax,VA,Passenger,4,3,7,741,748,0.94
August,31,2020,Collin,TX,Passenger,1,1,2,119,121,1.65
August,31,2020,Richland,SC,Passenger,0,1,1,146,147,0.68
August,31,2020,Allegheny,PA,Passenger,1,0,1,71,72,1.39
August,31,2020,Charleston,SC,Passenger,2,0,2,97,99,2.02
August,31,2020,Harrison,MS,Passenger,1,0,1,52,53,1.89
August,31,2020,Boone,MO,Passenger,0,1,1,10,11,9.09
August,31,2020,Lake,IL,Passenger,1,0,1,161,162,0.62
August,31,2020,Washoe,NV,Passenger,1,0,1,100,101,0.99
August,31,2020,Penobscot,ME,Passenger,0,1,1,14,15,6.67
August,31,2020,,,Passenger,9,6,15,935,950,1.58
August,31,2020,Utah,UT,Passenger,0,1,1,128,129,0.78
August,31,2020,DeKalb,IN,Passenger,1,0,1,1,2,50
August,31,2020,Klamath,OR,Passenger,1,0,1,32,33,3.03
August,31,2020,Skamania,WA,Passenger,31,22,53,8376,8429,0.63
August,31,2020,Rogers,OK,Passenger,1,0,1,4,5,20
August,31,2020,Multnomah,OR,Passenger,4,6,10,702,712,1.4
August,31,2020,Grant,WA,Passenger,66,75,141,65404,65545,0.22
August,31,2020,Williams,ND,Passenger,0,1,1,11,12,8.33
August,31,2020,Spokane,WA,Truck,1,0,1,99446,99447,0
August,31,2020,Frederick,MD,Passenger,1,1,2,74,76,2.63
August,31,2020,Harris,TX,Passenger,1,0,1,217,218,0.46
August,31,2020,Vigo,IN,Passenger,1,0,1,5,6,16.67
August,31,2020,RÃ­o Grande,PR,Passenger,1,0,1,1,2,50
August,31,2020,Richmond,GA,Passenger,0,1,1,82,83,1.2
August,31,2020,Erie,NY,Passenger,1,0,1,45,46,2.17
August,31,2020,Columbia,WA,Truck,0,0,0,1526,1526,0
August,31,2020,Albemarle,VA,Passenger,1,0,1,20,21,4.76
August,31,2020,Travis,TX,Passenger,2,1,3,171,174,1.72
August,31,2020,New Haven,CT,Passenger,0,2,2,35,37,5.41
August,31,2020,Lincoln,WA,Passenger,5,11,16,7625,7641,0.21
August,31,2020,Hamilton,IN,Passenger,1,0,1,39,40,2.5
August,31,2020,San Diego,CA,Passenger,15,5,20,2745,2765,0.72
August,31,2020,Prince William,VA,Passenger,2,2,4,222,226,1.77
August,31,2020,Santa Clara,CA,Passenger,8,2,10,274,284,3.52
August,31,2020,Cowlitz,WA,Passenger,152,120,272,72131,72403,0.38
August,31,2020,Lincoln,WA,Truck,0,0,0,4652,4652,0
August,31,2020,Calvert,MD,Passenger,0,2,2,87,89,2.25
August,31,2020,Whatcom,WA,Passenger,1111,512,1623,149201,150824,1.08
August,31,2020,Whatcom,WA,Truck,3,0,3,43278,43281,0.01
August,31,2020,Adams,WA,Truck,0,0,0,5303,5303,0
August,31,2020,Ulster,NY,Passenger,1,0,1,8,9,11.11
August,31,2020,Stafford,VA,Passenger,1,1,2,91,93,2.15
August,31,2020,Pierce,WA,Truck,0,0,0,143398,143398,0
August,31,2020,San Juan,WA,Passenger,320,100,420,13928,14348,2.93
August,31,2020,Prince George's,MD,Passenger,2,1,3,154,157,1.91
August,31,2020,El Paso,CO,Passenger,2,0,2,706,708,0.28
August,31,2020,Owyhee,ID,Passenger,1,0,1,3,4,25
August,31,2020,Franklin,WA,Truck,0,0,0,20187,20187,0
August,31,2020,Columbia,WA,Passenger,3,3,6,2423,2429,0.25
August,31,2020,Clark,NV,Passenger,2,2,4,665,669,0.6
August,31,2020,San Joaquin,CA,Passenger,1,0,1,121,122,0.82
August,31,2020,Grays Harbor,WA,Passenger,111,116,227,48357,48584,0.47
August,31,2020,Jefferson,WA,Truck,0,0,0,9539,9539,0
August,31,2020,Kittitas,WA,Passenger,110,47,157,29764,29921,0.52
August,31,2020,Portsmouth,VA,Passenger,0,1,1,75,76,1.32
August,31,2020,Sedgwick,KS,Passenger,1,1,2,89,91,2.2
August,31,2020,Brevard,FL,Passenger,0,1,1,81,82,1.22
August,31,2020,Palm Beach,FL,Passenger,0,1,1,79,80,1.25
August,31,2020,Pima,AZ,Passenger,3,1,4,328,332,1.2
August,31,2020,Douglas,NE,Passenger,0,1,1,49,50,2
August,31,2020,Carroll,MD,Passenger,0,1,1,20,21,4.76
August,31,2020,Spartanburg,SC,Passenger,0,1,1,48,49,2.04
August,31,2020,Manassas,VA,Passenger,0,1,1,5,6,16.67
August,31,2020,Okanogan,WA,Passenger,40,34,74,25977,26051,0.28
August,31,2020,Shelby,TN,Passenger,0,1,1,84,85,1.18
August,31,2020,Monroe,IL,Passenger,1,0,1,4,5,20
August,31,2020,Montgomery,PA,Passenger,1,0,1,27,28,3.57
August,31,2020,Twin Falls,ID,Passenger,0,1,1,22,23,4.35
August,31,2020,Orange,CA,Passenger,6,2,8,474,482,1.66
August,31,2020,Greene,MO,Passenger,0,1,1,33,34,2.94
August,31,2020,Denver,CO,Passenger,1,0,1,114,115,0.87
August,31,2020,Morris,NJ,Passenger,1,0,1,18,19,5.26
August,31,2020,Pinal,AZ,Passenger,1,0,1,177,178,0.56
August,31,2020,Garfield,WA,Truck,0,0,0,994,994,0
August,31,2020,Monterey,CA,Passenger,0,1,1,161,162,0.62
August,31,2020,Mason,WA,Passenger,162,133,295,47407,47702,0.62
August,31,2020,Boulder,CO,Passenger,0,1,1,41,42,2.38
August,31,2020,Houston,GA,Passenger,1,0,1,53,54,1.85
August,31,2020,Gwinnett,GA,Passenger,1,0,1,72,73,1.37
August,31,2020,Adams,WA,Passenger,9,7,16,12868,12884,0.12
August,31,2020,Jones,GA,Passenger,1,0,1,1,2,50
August,31,2020,Solano,CA,Passenger,1,0,1,207,208,0.48
August,31,2020,Rockingham,NH,Passenger,1,0,1,21,22,4.55
August,31,2020,Powhatan,VA,Passenger,1,0,1,0,1,100
August,31,2020,Duval,FL,Passenger,0,2,2,356,358,0.56
August,31,2020,Polk,FL,Passenger,1,0,1,61,62,1.61
August,31,2020,Asotin,WA,Truck,0,0,0,6667,6667,0
August,31,2020,San Francisco,CA,Passenger,2,1,3,90,93,3.23
August,31,2020,Cascade,MT,Passenger,0,1,1,53,54,1.85
August,31,2020,Kern,CA,Passenger,0,1,1,221,222,0.45
August,31,2020,Thurston,WA,Passenger,1194,752,1946,197105,199051,0.98
August,31,2020,Bartow,GA,Passenger,0,1,1,4,5,20
August,31,2020,Clackamas,OR,Passenger,2,0,2,184,186,1.08
August,31,2020,Grays Harbor,WA,Truck,0,0,0,21033,21033,0
August,31,2020,Chelan,WA,Truck,0,0,0,22677,22677,0
August,31,2020,Kings,NY,Passenger,1,0,1,63,64,1.56
August,31,2020,Charles,MD,Passenger,1,1,2,74,76,2.63
August,31,2020,Anne Arundel,MD,Passenger,0,1,1,400,401,0.25
August,31,2020,Hawaii,HI,Passenger,1,0,1,54,55,1.82
August,31,2020,Carson City,NV,Passenger,1,0,1,10,11,9.09
August,31,2020,King,WA,Passenger,25173,7814,32987,1370893,1403880,2.35
August,31,2020,Honolulu,HI,Passenger,4,2,6,433,439,1.37
August,31,2020,Randolph,NC,Passenger,1,0,1,7,8,12.5
August,31,2020,Alexandria,VA,Passenger,2,0,2,134,136,1.47
August,31,2020,Pinellas,FL,Passenger,1,1,2,104,106,1.89
August,31,2020,Benton,WA,Truck,0,0,0,43024,43024,0
August,31,2020,Fresno,CA,Passenger,1,0,1,172,173,0.58
August,31,2020,Pend Oreille,WA,Truck,0,0,0,5746,5746,0
August,31,2020,Lake,FL,Passenger,1,0,1,22,23,4.35
August,31,2020,Norfolk,VA,Passenger,2,2,4,343,347,1.15
August,31,2020,Okanogan,WA,Truck,0,0,0,16543,16543,0
August,31,2020,Lewis,WA,Truck,0,0,0,26362,26362,0
August,31,2020,District of Columbia,DC,Passenger,2,1,3,200,203,1.48
August,31,2020,Montgomery,AL,Passenger,0,1,1,39,40,2.5
August,31,2020,San Juan,WA,Truck,0,0,0,5838,5838,0
August,31,2020,Bradley,TN,Passenger,1,0,1,1,2,50
August,31,2020,Ada,ID,Passenger,0,1,1,256,257,0.39
August,31,2020,St. Mary's,MD,Passenger,1,0,1,217,218,0.46
August,31,2020,Harnett,NC,Passenger,1,0,1,196,197,0.51
August,31,2020,Franklin,WA,Passenger,66,77,143,60794,60937,0.23
August,31,2020,Deschutes,OR,Passenger,1,0,1,128,129,0.78
August,31,2020,Nassau,NY,Passenger,4,0,4,29,33,12.12
August,31,2020,Spokane,WA,Passenger,781,505,1286,317481,318767,0.4
August,31,2020,Riverside,CA,Passenger,3,0,3,609,612,0.49
August,31,2020,Middlesex,MA,Passenger,1,1,2,91,93,2.15
August,31,2020,Snohomish,WA,Truck,0,0,0,124595,124595,0
August,31,2020,Sumter,FL,Passenger,0,1,1,10,11,9.09
August,31,2020,Grant,WA,Truck,0,0,0,27237,27237,0
August,31,2020,Montgomery,OH,Passenger,0,1,1,47,48,2.08
August,31,2020,Ramsey,MN,Passenger,1,0,1,37,38,2.63
August,31,2020,Asotin,WA,Passenger,17,14,31,12356,12387,0.25
August,31,2020,Los Angeles,CA,Passenger,8,11,19,981,1000,1.9
August,31,2020,Nueces,TX,Passenger,1,0,1,83,84,1.19
August,31,2020,Pacific,WA,Passenger,32,33,65,15709,15774,0.41
August,31,2020,Shelby,OH,Passenger,0,1,1,1,2,50
August,31,2020,Benton,WA,Passenger,380,322,702,134321,135023,0.52
August,31,2020,Arapahoe,CO,Passenger,1,0,1,129,130,0.77
August,31,2020,Dakota,MN,Passenger,0,1,1,34,35,2.86
August,31,2020,New London,CT,Passenger,1,2,3,239,242,1.24
August,31,2020,Washington,OR,Passenger,1,0,1,432,433,0.23
August,31,2020,Stevens,WA,Truck,0,0,0,18653,18653,0
August,31,2020,Shasta,CA,Passenger,1,0,1,36,37,2.7
August,31,2020,Thurston,WA,Truck,0,0,0,55974,55974,0
August,31,2020,Contra Costa,CA,Passenger,4,3,7,302,309,2.27
August,31,2020,Sarasota,FL,Passenger,2,0,2,22,24,8.33
August,31,2020,Klickitat,WA,Passenger,57,42,99,15043,15142,0.65
August,31,2020,Kitsap,WA,Truck,0,0,0,54174,54174,0
August,31,2020,Kittitas,WA,Truck,0,0,0,14559,14559,0
August,31,2020,Whitman,WA,Truck,0,0,0,8480,8480,0
August,31,2020,San Mateo,CA,Passenger,0,1,1,105,106,0.94
August,31,2020,Skagit,WA,Truck,1,0,1,32634,32635,0
August,31,2020,Clark,WA,Passenger,2135,1076,3211,318235,321446,1
August,31,2020,Clallam,WA,Passenger,239,171,410,49948,50358,0.81
August,31,2020,Juneau,AK,Passenger,0,1,1,27,28,3.57
August,31,2020,Howard,IN,Passenger,0,1,1,3,4,25
August,31,2020,Lewis,WA,Passenger,112,117,229,58206,58435,0.39
August,31,2020,Lee,FL,Passenger,1,0,1,48,49,2.04
August,31,2020,Skamania,WA,Truck,0,0,0,4023,4023,0
August,31,2020,Douglas,WA,Truck,0,0,0,12339,12339,0
August,31,2020,Fort Bend,TX,Passenger,1,0,1,45,46,2.17
August,31,2020,Ventura,CA,Passenger,1,2,3,278,281,1.07
August,31,2020,Kootenai,ID,Passenger,1,0,1,216,217,0.46
August,31,2020,Jefferson,WA,Passenger,249,144,393,24652,25045,1.57
August,31,2020,Camden,NJ,Passenger,0,1,1,22,23,4.35
August,31,2020,St. Clair,IL,Passenger,1,0,1,140,141,0.71
August,31,2020,Carroll,NH,Passenger,0,1,1,5,6,16.67
August,31,2020,Chelan,WA,Passenger,248,80,328,54176,54504,0.6
August,31,2020,Maricopa,AZ,Passenger,5,7,12,1363,1375,0.87
August,31,2020,Stevens,WA,Passenger,35,36,71,30494,30565,0.23
August,31,2020,Pierce,WA,Passenger,2519,1704,4223,552476,556699,0.76
August,31,2020,Saginaw,MI,Passenger,1,0,1,9,10,10
August,31,2020,DuPage,IL,Passenger,3,0,3,57,60,5
August,31,2020,Jefferson,NY,Passenger,0,1,1,210,211,0.47
August,31,2020,Loudoun,VA,Passenger,1,0,1,82,83,1.2
August,31,2020,Fulton,GA,Passenger,1,2,3,100,103,2.91
August,31,2020,Dallas,TX,Passenger,1,0,1,186,187,0.53
August,31,2020,Island,WA,Passenger,434,273,707,62809,63516,1.11
August,31,2020,Putnam,TN,Passenger,0,1,1,3,4,25
August,31,2020,Kitsap,WA,Passenger,1400,699,2099,179638,181737,1.15
August,31,2020,Mason,WA,Truck,0,0,0,20779,20779,0
August,31,2020,Suffolk,VA,Passenger,1,0,1,125,126,0.79
August,31,2020,Walla Walla,WA,Truck,0,0,0,13750,13750,0
August,31,2020,Douglas,CO,Passenger,0,1,1,79,80,1.25
August,31,2020,Santa Cruz,CA,Passenger,1,0,1,32,33,3.03
August,31,2020,Arlington,VA,Passenger,0,2,2,148,150,1.33
August,31,2020,DeKalb,GA,Passenger,1,0,1,77,78,1.28
August,31,2020,Cape May,NJ,Passenger,0,1,1,13,14,7.14
August,31,2020,Garfield,WA,Passenger,0,1,1,1350,1351,0.07
August,31,2020,Whitman,WA,Passenger,46,48,94,22021,22115,0.43
August,31,2020,Kent,MI,Passenger,0,1,1,24,25,4
August,31,2020,Williamson,TX,Passenger,0,2,2,129,131,1.53
August,31,2020,Ferry,WA,Passenger,7,3,10,4309,4319,0.23
August,31,2020,Island,WA,Truck,1,0,1,21228,21229,0
August,31,2020,Pend Oreille,WA,Passenger,8,5,13,9230,9243,0.14
August,31,2020,Yakima,WA,Truck,0,0,0,60420,60420,0
August,31,2020,Skagit,WA,Passenger,432,222,654,91256,91910,0.71
August,31,2020,Placer,CA,Passenger,2,0,2,84,86,2.33
August,31,2020,Clark,WA,Truck,0,0,0,82716,82716,0
August,31,2020,Montgomery,TX,Passenger,1,0,1,49,50,2
August,31,2020,Wahkiakum,WA,Passenger,6,6,12,3028,3040,0.39
August,31,2020,Ferry,WA,Truck,0,0,0,3582,3582,0
August,31,2020,Hennepin,MN,Passenger,3,0,3,88,91,3.3
August,31,2020,Sacramento,CA,Passenger,1,0,1,255,256,0.39
August,31,2020,Snohomish,WA,Passenger,4645,1782,6427,536082,542509,1.18
August,31,2020,Larimer,CO,Passenger,1,0,1,51,52,1.92
August,31,2020,Clallam,WA,Truck,1,0,1,21704,21705,0
August,31,2020,Denton,TX,Passenger,1,0,1,89,90,1.11
August,31,2020,El Paso,TX,Passenger,3,0,3,414,417,0.72
August,31,2020,Queens,NY,Passenger,1,0,1,50,51,1.96
August,31,2020,Fairbanks North Star,AK,Passenger,0,1,1,95,96,1.04
August,31,2020,Chesapeake,VA,Passenger,0,2,2,415,417,0.48
August,31,2020,Moore,NC,Passenger,0,2,2,154,156,1.28
August,31,2020,Valencia,NM,Passenger,1,0,1,6,7,14.29
August,31,2020,Bexar,TX,Passenger,4,5,9,589,598,1.51
August,31,2020,Wilson,TX,Passenger,0,1,1,5,6,16.67
August,31,2020,Tulsa,OK,Passenger,1,1,2,42,44,4.55
August,31,2020,Suffolk,MA,Passenger,0,2,2,35,37,5.41
August,31,2020,Cowlitz,WA,Truck,0,0,0,28911,28911,0
August,31,2020,Flathead,MT,Passenger,1,0,1,55,56,1.79
August,31,2020,Broward,FL,Passenger,2,1,3,108,111,2.7
August,31,2020,Douglas,WA,Passenger,77,41,118,28010,28128,0.42
August,31,2020,Walla Walla,WA,Passenger,81,65,146,35891,36037,0.41
August,31,2020,Virginia Beach,VA,Passenger,1,0,1,659,660,0.15
August,31,2020,Goochland,VA,Passenger,3,2,5,250,255,1.96
August,31,2020,Washtenaw,MI,Passenger,1,0,1,36,37,2.7
August,31,2020,Cumberland,NC,Passenger,0,3,3,454,457,0.66
August,31,2020,Clay,FL,Passenger,0,1,1,81,82,1.22
August,31,2020,Wahkiakum,WA,Truck,0,0,0,1745,1745,0
August,31,2020,Jefferson,CO,Passenger,0,1,1,56,57,1.75
August,31,2020,Oldham,KY,Passenger,0,1,1,4,5,20
August,31,2020,Nassau,FL,Passenger,1,0,1,36,37,2.7
August,31,2020,Guadalupe,TX,Passenger,1,0,1,60,61,1.64
August,31,2020,Salt Lake,UT,Passenger,0,1,1,183,184,0.54
August,31,2020,New York,NY,Passenger,1,0,1,56,57,1.75
December,31,2020,DeKalb,IN,Passenger,1,0,1,0,1,100
December,31,2020,Lincoln,WA,Truck,0,0,0,4673,4673,0
December,31,2020,Clallam,WA,Truck,1,0,1,21831,21832,0
December,31,2020,Columbia,WA,Truck,0,0,0,1543,1543,0
December,31,2020,Broward,FL,Passenger,2,1,3,107,110,2.73
December,31,2020,Benton,WA,Truck,0,0,0,43207,43207,0
December,31,2020,Chelan,WA,Passenger,278,88,366,54504,54870,0.67
December,31,2020,Montgomery,MD,Passenger,1,0,1,227,228,0.44
December,31,2020,Cascade,MT,Passenger,0,1,1,54,55,1.82
December,31,2020,Charleston,SC,Passenger,2,0,2,89,91,2.2
December,31,2020,Hudson,NJ,Passenger,1,0,1,39,40,2.5
December,31,2020,Whitman,WA,Truck,0,0,0,8508,8508,0
December,31,2020,Hampshire,MA,Passenger,1,0,1,6,7,14.29
December,31,2020,Harrison,MS,Passenger,2,0,2,52,54,3.7
December,31,2020,Cumberland,NC,Passenger,0,3,3,442,445,0.67
December,31,2020,Collin,TX,Passenger,1,1,2,116,118,1.69
December,31,2020,Nassau,NY,Passenger,4,0,4,28,32,12.5
December,31,2020,Whitman,WA,Passenger,51,44,95,21905,22000,0.43
December,31,2020,Pierce,WA,Truck,0,0,0,144789,144789,0
December,31,2020,Larimer,CO,Passenger,1,0,1,54,55,1.82
December,31,2020,Duval,FL,Passenger,0,2,2,353,355,0.56
December,31,2020,Douglas,WA,Truck,0,0,0,12494,12494,0
December,31,2020,Vigo,IN,Passenger,1,0,1,6,7,14.29
December,31,2020,Kitsap,WA,Passenger,1556,756,2312,179832,182144,1.27
December,31,2020,Honolulu,HI,Passenger,5,2,7,416,423,1.65
December,31,2020,Franklin,WA,Passenger,85,83,168,61368,61536,0.27
December,31,2020,Kauai,HI,Passenger,1,0,1,15,16,6.25
December,31,2020,Boulder,CO,Passenger,0,1,1,44,45,2.22
December,31,2020,St. Clair,IL,Passenger,1,0,1,137,138,0.72
December,31,2020,Klickitat,WA,Truck,0,0,0,8088,8088,0
December,31,2020,Stevens,WA,Truck,0,0,0,18716,18716,0
December,31,2020,DuPage,IL,Passenger,2,0,2,53,55,3.64
December,31,2020,Denton,TX,Passenger,1,0,1,85,86,1.16
December,31,2020,San Francisco,CA,Passenger,1,1,2,90,92,2.17
December,31,2020,Bradley,TN,Passenger,1,0,1,0,1,100
December,31,2020,Skagit,WA,Passenger,497,238,735,91428,92163,0.8
December,31,2020,Douglas,NE,Passenger,0,1,1,51,52,1.92
December,31,2020,Dallas,TX,Passenger,1,0,1,171,172,0.58
December,31,2020,Kitsap,WA,Truck,0,0,0,54371,54371,0
December,31,2020,Santa Clara,CA,Passenger,7,2,9,267,276,3.26
December,31,2020,Lewis,WA,Passenger,123,122,245,58843,59088,0.41
December,31,2020,Portsmouth,VA,Passenger,0,1,1,77,78,1.28
December,31,2020,Los Angeles,CA,Passenger,10,11,21,939,960,2.19
December,31,2020,Columbia,WA,Passenger,5,3,8,2441,2449,0.33
December,31,2020,Grant,WA,Truck,0,0,0,27505,27505,0
December,31,2020,Maui,HI,Passenger,1,0,1,27,28,3.57
December,31,2020,Lewis,WA,Truck,0,0,0,26622,26622,0
December,31,2020,Dakota,MN,Passenger,0,1,1,26,27,3.7
December,31,2020,Lake,FL,Passenger,1,0,1,22,23,4.35
December,31,2020,Sacramento,CA,Passenger,2,0,2,234,236,0.85
December,31,2020,Lincoln,WA,Passenger,5,12,17,7644,7661,0.22
December,31,2020,San Mateo,CA,Passenger,1,1,2,107,109,1.83
December,31,2020,Carson City,NV,Passenger,1,0,1,12,13,7.69
December,31,2020,Shelby,OH,Passenger,0,1,1,1,2,50
December,31,2020,Plaquemines,LA,Passenger,0,1,1,13,14,7.14
December,31,2020,Mason,WA,Truck,0,0,0,20948,20948,0
December,31,2020,Clark,WA,Passenger,2356,1180,3536,319513,323049,1.09
December,31,2020,Anne Arundel,MD,Passenger,1,1,2,399,401,0.5
December,31,2020,Williams,ND,Passenger,0,1,1,10,11,9.09
December,31,2020,Bartow,GA,Passenger,0,1,1,4,5,20
December,31,2020,Wahkiakum,WA,Passenger,6,7,13,3036,3049,0.43
December,31,2020,Harris,TX,Passenger,1,1,2,214,216,0.93
December,31,2020,Flathead,MT,Passenger,1,0,1,50,51,1.96
December,31,2020,Garfield,WA,Passenger,0,2,2,1367,1369,0.15
December,31,2020,Yakima,WA,Passenger,170,128,298,167294,167592,0.18
December,31,2020,Sarasota,FL,Passenger,2,0,2,26,28,7.14
December,31,2020,Santa Cruz,CA,Passenger,1,0,1,27,28,3.57
December,31,2020,Kittitas,WA,Truck,0,0,0,14646,14646,0
December,31,2020,Charles,MD,Passenger,1,1,2,70,72,2.78
December,31,2020,Powhatan,VA,Passenger,1,0,1,1,2,50
December,31,2020,Thurston,WA,Truck,0,0,0,56389,56389,0
December,31,2020,Erie,NY,Passenger,1,0,1,42,43,2.33
December,31,2020,San Juan,WA,Passenger,365,111,476,14021,14497,3.28
December,31,2020,Richland,SC,Passenger,0,1,1,139,140,0.71
December,31,2020,Ada,ID,Passenger,0,1,1,243,244,0.41
December,31,2020,Walla Walla,WA,Truck,0,0,0,13871,13871,0
December,31,2020,Albemarle,VA,Passenger,1,0,1,21,22,4.55
December,31,2020,Anchorage,AK,Passenger,1,0,1,144,145,0.69
December,31,2020,Bexar,TX,Passenger,3,5,8,567,575,1.39
December,31,2020,,,Passenger,8,7,15,962,977,1.54
December,31,2020,Juneau,AK,Passenger,0,1,1,25,26,3.85
December,31,2020,Houston,GA,Passenger,1,0,1,51,52,1.92
December,31,2020,Deschutes,OR,Passenger,1,0,1,117,118,0.85
December,31,2020,Ferry,WA,Passenger,9,3,12,4361,4373,0.27
December,31,2020,Moore,NC,Passenger,0,1,1,147,148,0.68
December,31,2020,Jefferson,WA,Passenger,285,155,440,24813,25253,1.74
December,31,2020,Sumter,FL,Passenger,0,1,1,10,11,9.09
December,31,2020,Norfolk,VA,Passenger,2,3,5,338,343,1.46
December,31,2020,Kittitas,WA,Passenger,127,51,178,29824,30002,0.59
December,31,2020,Manassas,VA,Passenger,0,1,1,5,6,16.67
December,31,2020,Okanogan,WA,Passenger,55,36,91,26069,26160,0.35
December,31,2020,Rockingham,NH,Passenger,1,0,1,21,22,4.55
December,31,2020,Harnett,NC,Passenger,1,0,1,185,186,0.54
December,31,2020,Asotin,WA,Passenger,16,13,29,12413,12442,0.23
December,31,2020,Skamania,WA,Passenger,33,22,55,8352,8407,0.65
December,31,2020,Grays Harbor,WA,Truck,0,0,0,21205,21205,0
December,31,2020,King,WA,Passenger,26917,8171,35088,1370135,1405223,2.5
December,31,2020,Leavenworth,KS,Passenger,0,1,1,124,125,0.8
December,31,2020,San Diego,CA,Passenger,13,4,17,2708,2725,0.62
December,31,2020,Thurston,WA,Passenger,1321,780,2101,197406,199507,1.05
December,31,2020,Riverside,CA,Passenger,4,1,5,592,597,0.84
December,31,2020,Allegheny,PA,Passenger,1,1,2,66,68,2.94
December,31,2020,Cowlitz,WA,Passenger,177,127,304,72118,72422,0.42
December,31,2020,Sedgwick,KS,Passenger,1,1,2,89,91,2.2
December,31,2020,Okanogan,WA,Truck,0,0,0,16607,16607,0
December,31,2020,New London,CT,Passenger,1,2,3,232,235,1.28
December,31,2020,Maricopa,AZ,Passenger,6,6,12,1306,1318,0.91
December,31,2020,Okaloosa,FL,Passenger,0,1,1,132,133,0.75
December,31,2020,Placer,CA,Passenger,2,0,2,83,85,2.35
December,31,2020,Twin Falls,ID,Passenger,0,1,1,24,25,4
December,31,2020,Hawaii,HI,Passenger,1,0,1,53,54,1.85
December,31,2020,Rogers,OK,Passenger,1,0,1,3,4,25
December,31,2020,Oldham,KY,Passenger,0,1,1,4,5,20
December,31,2020,Jefferson,WA,Truck,0,0,0,9588,9588,0
December,31,2020,Miami-Dade,FL,Passenger,1,0,1,97,98,1.02
December,31,2020,Ventura,CA,Passenger,1,1,2,272,274,0.73
December,31,2020,Wichita,TX,Passenger,1,0,1,41,42,2.38
December,31,2020,Clark,WA,Truck,0,0,0,83498,83498,0
December,31,2020,Penobscot,ME,Passenger,0,1,1,9,10,10
December,31,2020,Kern,CA,Passenger,0,1,1,216,217,0.46
December,31,2020,Contra Costa,CA,Passenger,3,3,6,278,284,2.11
December,31,2020,Snohomish,WA,Truck,0,0,0,125700,125700,0
December,31,2020,San Joaquin,CA,Passenger,1,0,1,108,109,0.92
December,31,2020,Denver,CO,Passenger,1,0,1,115,116,0.86
December,31,2020,Kings,NY,Passenger,1,0,1,62,63,1.59
December,31,2020,Stevens,WA,Passenger,36,40,76,30234,30310,0.25
December,31,2020,Pennington,SD,Passenger,1,0,1,34,35,2.86
December,31,2020,Spartanburg,SC,Passenger,0,1,1,49,50,2
December,31,2020,Grays Harbor,WA,Passenger,127,122,249,48651,48900,0.51
December,31,2020,Douglas,CO,Passenger,0,1,1,78,79,1.27
December,31,2020,Pacific,WA,Truck,0,0,0,7792,7792,0
December,31,2020,Spokane,WA,Truck,0,0,0,100712,100712,0
December,31,2020,Fresno,CA,Passenger,1,0,1,169,170,0.59
December,31,2020,Queens,NY,Passenger,1,0,1,52,53,1.89
December,31,2020,Whatcom,WA,Passenger,1218,550,1768,150033,151801,1.16
December,31,2020,Adams,WA,Truck,0,0,0,5337,5337,0
December,31,2020,Prince George's,MD,Passenger,2,1,3,145,148,2.03
December,31,2020,Orange,CA,Passenger,4,3,7,446,453,1.55
December,31,2020,El Dorado,CA,Passenger,1,0,1,33,34,2.94
December,31,2020,Camden,NJ,Passenger,0,1,1,19,20,5
December,31,2020,Morris,NJ,Passenger,1,0,1,16,17,5.88
December,31,2020,Yakima,WA,Truck,0,0,0,60982,60982,0
December,31,2020,Pierce,WA,Passenger,2825,1771,4596,555647,560243,0.82
December,31,2020,Frederick,MD,Passenger,1,1,2,72,74,2.7
December,31,2020,Monroe,IL,Passenger,1,0,1,3,4,25
December,31,2020,Lee,FL,Passenger,1,0,1,43,44,2.27
December,31,2020,Howard,MD,Passenger,0,1,1,64,65,1.54
December,31,2020,Gwinnett,GA,Passenger,1,0,1,67,68,1.47
December,31,2020,Lake,IL,Passenger,2,0,2,158,160,1.25
December,31,2020,Ulster,NY,Passenger,1,0,1,8,9,11.11
December,31,2020,New Haven,CT,Passenger,0,2,2,36,38,5.26
December,31,2020,Garfield,WA,Truck,0,0,0,996,996,0
December,31,2020,Skagit,WA,Truck,1,0,1,32781,32782,0
December,31,2020,Suffolk,MA,Passenger,0,2,2,33,35,5.71
December,31,2020,Pinellas,FL,Passenger,1,1,2,97,99,2.02
December,31,2020,Ramsey,MN,Passenger,1,0,1,34,35,2.86
December,31,2020,Snohomish,WA,Passenger,5036,1848,6884,538610,545494,1.26
December,31,2020,Klamath,OR,Passenger,1,0,1,30,31,3.23
December,31,2020,Saginaw,MI,Passenger,2,0,2,9,11,18.18
December,31,2020,Fairbanks North Star,AK,Passenger,0,1,1,90,91,1.1
December,31,2020,Middlesex,MA,Passenger,1,1,2,94,96,2.08
December,31,2020,Kent,MI,Passenger,0,1,1,23,24,4.17
December,31,2020,Randolph,NC,Passenger,1,0,1,6,7,14.29
December,31,2020,Owyhee,ID,Passenger,1,0,1,3,4,25
December,31,2020,Island,WA,Truck,0,0,0,21369,21369,0
December,31,2020,Cowlitz,WA,Truck,0,0,0,28933,28933,0
December,31,2020,Pacific,WA,Passenger,34,35,69,15727,15796,0.44
December,31,2020,Salt Lake,UT,Passenger,0,1,1,172,173,0.58
December,31,2020,Montgomery,PA,Passenger,1,0,1,25,26,3.85
December,31,2020,Williamson,TX,Passenger,0,2,2,122,124,1.61
December,31,2020,El Paso,CO,Passenger,2,0,2,698,700,0.29
December,31,2020,San Juan,WA,Truck,0,0,0,5874,5874,0
December,31,2020,Orange,FL,Passenger,1,0,1,114,115,0.87
December,31,2020,Klickitat,WA,Passenger,62,43,105,14980,15085,0.7
December,31,2020,Palm Beach,FL,Passenger,0,1,1,73,74,1.35
December,31,2020,Virginia Beach,VA,Passenger,2,0,2,637,639,0.31
December,31,2020,Stafford,VA,Passenger,2,1,3,92,95,3.16
December,31,2020,District of Columbia,DC,Passenger,3,1,4,201,205,1.95
December,31,2020,St. Louis,MO,Passenger,1,0,1,96,97,1.03
December,31,2020,Calvert,MD,Passenger,0,2,2,85,87,2.3
December,31,2020,Arapahoe,CO,Passenger,1,0,1,120,121,0.83
December,31,2020,El Paso,TX,Passenger,3,0,3,396,399,0.75
December,31,2020,Solano,CA,Passenger,1,0,1,205,206,0.49
December,31,2020,Missoula,MT,Passenger,1,0,1,64,65,1.54
December,31,2020,Prince William,VA,Passenger,1,2,3,217,220,1.36
December,31,2020,Nueces,TX,Passenger,1,0,1,82,83,1.2
December,31,2020,Carroll,NH,Passenger,0,1,1,5,6,16.67
December,31,2020,Washtenaw,MI,Passenger,1,0,1,31,32,3.12
December,31,2020,Island,WA,Passenger,507,289,796,63011,63807,1.25
December,31,2020,Asotin,WA,Truck,0,0,0,6675,6675,0
December,31,2020,Bucks,PA,Passenger,1,0,1,18,19,5.26
December,31,2020,Montgomery,OH,Passenger,0,1,1,52,53,1.89
December,31,2020,Ferry,WA,Truck,0,0,0,3607,3607,0
December,31,2020,Philadelphia,PA,Passenger,1,0,1,60,61,1.64
December,31,2020,Washington,OR,Passenger,1,0,1,410,411,0.24
December,31,2020,Whatcom,WA,Truck,3,0,3,43545,43548,0.01
December,31,2020,Boone,MO,Passenger,0,1,1,10,11,9.09
December,31,2020,Chesapeake,VA,Passenger,0,3,3,404,407,0.74
December,31,2020,Fulton,GA,Passenger,1,2,3,89,92,3.26
December,31,2020,Jefferson,NY,Passenger,0,1,1,208,209,0.48
December,31,2020,St. Mary's,MD,Passenger,1,0,1,210,211,0.47
December,31,2020,Hamilton,IN,Passenger,2,0,2,34,36,5.56
December,31,2020,Fort Bend,TX,Passenger,1,0,1,42,43,2.33
December,31,2020,Utah,UT,Passenger,0,1,1,126,127,0.79
December,31,2020,Mason,WA,Passenger,173,133,306,47648,47954,0.64
December,31,2020,Hennepin,MN,Passenger,2,0,2,82,84,2.38
December,31,2020,Clark,NV,Passenger,3,2,5,649,654,0.76
December,31,2020,Grant,WA,Passenger,80,81,161,65927,66088,0.24
December,31,2020,Douglas,WA,Passenger,86,44,130,28191,28321,0.46
December,31,2020,Nassau,FL,Passenger,1,0,1,35,36,2.78
December,31,2020,Clallam,WA,Passenger,273,185,458,49921,50379,0.91
December,31,2020,Wilson,TX,Passenger,0,1,1,5,6,16.67
December,31,2020,Walla Walla,WA,Passenger,98,67,165,36134,36299,0.45
December,31,2020,Pend Oreille,WA,Truck,0,0,0,5715,5715,0
December,31,2020,Benton,WA,Passenger,440,355,795,134989,135784,0.59
December,31,2020,Skamania,WA,Truck,0,0,0,4004,4004,0
December,31,2020,RÃ­o Grande,PR,Passenger,1,0,1,1,2,50
December,31,2020,Chelan,WA,Truck,0,0,0,22804,22804,0
December,31,2020,Platte,MO,Passenger,1,0,1,17,18,5.56
December,31,2020,Cape May,NJ,Passenger,0,1,1,10,11,9.09
December,31,2020,Putnam,TN,Passenger,0,1,1,2,3,33.33
December,31,2020,Clackamas,OR,Passenger,3,0,3,180,183,1.64
December,31,2020,Pend Oreille,WA,Passenger,12,4,16,9171,9187,0.17
December,31,2020,Loudoun,VA,Passenger,1,0,1,75,76,1.32
December,31,2020,Travis,TX,Passenger,2,1,3,168,171,1.75
December,31,2020,Howard,IN,Passenger,0,1,1,3,4,25
December,31,2020,Goochland,VA,Passenger,4,3,7,245,252,2.78
December,31,2020,Montgomery,TX,Passenger,1,0,1,46,47,2.13
December,31,2020,Wahkiakum,WA,Truck,0,0,0,1770,1770,0
December,31,2020,Monterey,CA,Passenger,0,1,1,156,157,0.64
December,31,2020,New York,NY,Passenger,1,0,1,54,55,1.82
December,31,2020,Tulsa,OK,Passenger,1,1,2,39,41,4.88
December,31,2020,Pima,AZ,Passenger,2,1,3,320,323,0.93
December,31,2020,Franklin,WA,Truck,0,0,0,20434,20434,0
December,31,2020,Adams,WA,Passenger,10,7,17,12960,12977,0.13
December,31,2020,Alexandria,VA,Passenger,2,0,2,134,136,1.47
December,31,2020,King,WA,Truck,6,1,7,184370,184377,0
December,31,2020,Multnomah,OR,Passenger,3,6,9,685,694,1.3
December,31,2020,Fairfax,VA,Passenger,4,3,7,704,711,0.98
December,31,2020,Alameda,CA,Passenger,3,0,3,260,263,1.14
December,31,2020,Jones,GA,Passenger,1,0,1,1,2,50
December,31,2020,Washoe,NV,Passenger,1,0,1,101,102,0.98
December,31,2020,Arlington,VA,Passenger,0,2,2,140,142,1.41
December,31,2020,Richmond,GA,Passenger,0,1,1,77,78,1.28
December,31,2020,Carroll,MD,Passenger,0,1,1,21,22,4.55
December,31,2020,Polk,FL,Passenger,1,0,1,56,57,1.75
December,31,2020,DeKalb,GA,Passenger,1,0,1,69,70,1.43
December,31,2020,Spokane,WA,Passenger,886,547,1433,321109,322542,0.44
December,31,2020,Suffolk,VA,Passenger,1,0,1,124,125,0.8
December,31,2020,Greene,MO,Passenger,0,1,1,32,33,3.03
February,29,2020,Spartanburg,SC,Passenger,0,1,1,45,46,2.17
February,29,2020,Camden,NJ,Passenger,0,2,2,21,23,8.7
February,29,2020,Randolph,NC,Passenger,1,0,1,7,8,12.5
February,29,2020,Santa Cruz,CA,Passenger,1,0,1,36,37,2.7
February,29,2020,Williams,ND,Passenger,0,1,1,13,14,7.14
February,29,2020,Jones,GA,Passenger,1,0,1,1,2,50
February,29,2020,Prince George's,MD,Passenger,1,1,2,171,173,1.16
February,29,2020,San Diego,CA,Passenger,11,5,16,2780,2796,0.57
February,29,2020,Osceola,FL,Passenger,1,0,1,41,42,2.38
February,29,2020,Jefferson,CO,Passenger,0,1,1,60,61,1.64
February,29,2020,Alexandria,VA,Passenger,1,0,1,144,145,0.69
February,29,2020,Manassas,VA,Passenger,0,1,1,6,7,14.29
February,29,2020,Goochland,VA,Passenger,2,1,3,261,264,1.14
February,29,2020,Broward,FL,Passenger,2,1,3,119,122,2.46
February,29,2020,Fulton,GA,Passenger,1,2,3,104,107,2.8
February,29,2020,Dakota,MN,Passenger,0,1,1,32,33,3.03
February,29,2020,San Joaquin,CA,Passenger,1,0,1,135,136,0.74
February,29,2020,Saginaw,MI,Passenger,1,0,1,11,12,8.33
February,29,2020,Bucks,PA,Passenger,1,0,1,19,20,5
February,29,2020,Franklin,WA,Truck,0,0,0,19897,19897,0
February,29,2020,Skamania,WA,Truck,0,0,0,4102,4102,0
February,29,2020,Garfield,WA,Passenger,0,1,1,1349,1350,0.07
February,29,2020,RÃ­o Grande,PR,Passenger,1,0,1,1,2,50
February,29,2020,Queens,NY,Passenger,1,0,1,53,54,1.85
February,29,2020,Lake,IL,Passenger,1,0,1,164,165,0.61
February,29,2020,Portsmouth,VA,Passenger,0,1,1,78,79,1.27
February,29,2020,Jefferson,WA,Passenger,230,139,369,25171,25540,1.44
February,29,2020,Whitman,WA,Truck,0,0,0,8555,8555,0
February,29,2020,Denver,CO,Passenger,1,0,1,126,127,0.79
February,29,2020,Skagit,WA,Truck,1,0,1,32559,32560,0
February,29,2020,Riverside,CA,Passenger,3,1,4,643,647,0.62
February,29,2020,Okanogan,WA,Passenger,34,31,65,26121,26186,0.25
February,29,2020,Okanogan,WA,Truck,0,0,0,16498,16498,0
February,29,2020,Charles,MD,Passenger,0,1,1,76,77,1.3
February,29,2020,Honolulu,HI,Passenger,4,2,6,467,473,1.27
February,29,2020,El Paso,TX,Passenger,3,0,3,443,446,0.67
February,29,2020,Lee,FL,Passenger,1,0,1,52,53,1.89
February,29,2020,Pierce,WA,Passenger,2253,1684,3937,551186,555123,0.71
February,29,2020,Harrison,MS,Passenger,1,0,1,60,61,1.64
February,29,2020,Fort Bend,TX,Passenger,1,0,1,48,49,2.04
February,29,2020,Vigo,IN,Passenger,1,0,1,5,6,16.67
February,29,2020,San Mateo,CA,Passenger,0,1,1,116,117,0.85
February,29,2020,DeKalb,GA,Passenger,1,0,1,83,84,1.19
February,29,2020,Sedgwick,KS,Passenger,1,1,2,95,97,2.06
February,29,2020,Guadalupe,TX,Passenger,1,0,1,66,67,1.49
February,29,2020,Hennepin,MN,Passenger,3,1,4,98,102,3.92
February,29,2020,Orange,CA,Passenger,7,2,9,502,511,1.76
February,29,2020,District of Columbia,DC,Passenger,1,1,2,205,207,0.97
February,29,2020,Clark,WA,Passenger,1970,1058,3028,320541,323569,0.94
February,29,2020,Douglas,NE,Passenger,0,1,1,57,58,1.72
February,29,2020,Fairfax,VA,Passenger,4,3,7,752,759,0.92
February,29,2020,Fresno,CA,Passenger,1,0,1,188,189,0.53
February,29,2020,Albemarle,VA,Passenger,1,0,1,25,26,3.85
February,29,2020,Tarrant,TX,Passenger,2,0,2,186,188,1.06
February,29,2020,Cowlitz,WA,Passenger,128,111,239,73460,73699,0.32
February,29,2020,Juneau,AK,Passenger,0,2,2,32,34,5.88
February,29,2020,Pinal,AZ,Passenger,1,0,1,192,193,0.52
February,29,2020,Asotin,WA,Truck,0,0,0,6695,6695,0
February,29,2020,Owyhee,ID,Passenger,1,0,1,3,4,25
February,29,2020,Denton,TX,Passenger,1,0,1,89,90,1.11
February,29,2020,Klamath,OR,Passenger,1,0,1,37,38,2.63
February,29,2020,Lincoln,WA,Passenger,1,12,13,7781,7794,0.17
February,29,2020,Grays Harbor,WA,Truck,0,0,0,20809,20809,0
February,29,2020,Mason,WA,Passenger,150,135,285,47595,47880,0.6
February,29,2020,Polk,FL,Passenger,1,0,1,67,68,1.47
February,29,2020,Allegheny,PA,Passenger,1,0,1,73,74,1.35
February,29,2020,Clay,FL,Passenger,0,1,1,85,86,1.16
February,29,2020,Cumberland,NC,Passenger,0,2,2,478,480,0.42
February,29,2020,Placer,CA,Passenger,2,0,2,93,95,2.11
February,29,2020,Washtenaw,MI,Passenger,1,0,1,40,41,2.44
February,29,2020,Garfield,WA,Truck,0,0,0,965,965,0
February,29,2020,Williamson,TX,Passenger,0,2,2,142,144,1.39
February,29,2020,Contra Costa,CA,Passenger,3,2,5,331,336,1.49
February,29,2020,Spokane,WA,Passenger,696,469,1165,317560,318725,0.37
February,29,2020,Greene,MO,Passenger,0,1,1,30,31,3.23
February,29,2020,Sacramento,CA,Passenger,1,0,1,278,279,0.36
February,29,2020,Stafford,VA,Passenger,1,1,2,91,93,2.15
February,29,2020,Klickitat,WA,Truck,0,0,0,8301,8301,0
February,29,2020,Lewis,WA,Passenger,108,105,213,59582,59795,0.36
February,29,2020,Washington,OR,Passenger,1,0,1,459,460,0.22
February,29,2020,Boulder,CO,Passenger,0,1,1,48,49,2.04
February,29,2020,Kitsap,WA,Truck,1,0,1,54392,54393,0
February,29,2020,Arapahoe,CO,Passenger,1,0,1,141,142,0.7
February,29,2020,Clark,WA,Truck,0,0,0,81980,81980,0
February,29,2020,Ventura,CA,Passenger,0,3,3,294,297,1.01
February,29,2020,Moore,NC,Passenger,0,1,1,164,165,0.61
February,29,2020,Boone,MO,Passenger,0,1,1,11,12,8.33
February,29,2020,Grant,WA,Truck,0,0,0,27065,27065,0
February,29,2020,Cowlitz,WA,Truck,0,0,0,28994,28994,0
February,29,2020,Skagit,WA,Passenger,379,215,594,92466,93060,0.64
February,29,2020,Oklahoma,OK,Passenger,0,1,1,128,129,0.78
February,29,2020,Shasta,CA,Passenger,1,0,1,36,37,2.7
February,29,2020,DuPage,IL,Passenger,3,0,3,62,65,4.62
February,29,2020,Pend Oreille,WA,Passenger,8,7,15,9454,9469,0.16
February,29,2020,Maui,HI,Passenger,1,0,1,36,37,2.7
February,29,2020,Cape May,NJ,Passenger,0,1,1,13,14,7.14
February,29,2020,Hudson,NJ,Passenger,1,0,1,39,40,2.5
February,29,2020,Douglas,WA,Passenger,69,40,109,28271,28380,0.38
February,29,2020,Grant,WA,Passenger,58,70,128,65569,65697,0.19
February,29,2020,Brevard,FL,Passenger,0,1,1,88,89,1.12
February,29,2020,Maricopa,AZ,Passenger,8,6,14,1474,1488,0.94
February,29,2020,Kern,CA,Passenger,0,1,1,223,224,0.45
February,29,2020,Spokane,WA,Truck,1,0,1,97160,97161,0
February,29,2020,Wahkiakum,WA,Truck,0,0,0,1762,1762,0
February,29,2020,Montgomery,TX,Passenger,1,0,1,52,53,1.89
February,29,2020,Tuolumne,CA,Passenger,0,1,1,10,11,9.09
February,29,2020,Travis,TX,Passenger,2,1,3,187,190,1.58
February,29,2020,Grays Harbor,WA,Passenger,109,108,217,48374,48591,0.45
February,29,2020,Ada,ID,Passenger,0,1,1,287,288,0.35
February,29,2020,Yakima,WA,Passenger,122,116,238,165956,166194,0.14
February,29,2020,Lewis,WA,Truck,0,0,0,26101,26101,0
February,29,2020,Pierce,WA,Truck,0,0,0,141517,141517,0
February,29,2020,Clark,NV,Passenger,3,2,5,685,690,0.72
February,29,2020,Rockingham,NH,Passenger,1,0,1,28,29,3.45
February,29,2020,Suffolk,VA,Passenger,1,0,1,124,125,0.8
February,29,2020,Ferry,WA,Truck,0,0,0,3582,3582,0
February,29,2020,Duval,FL,Passenger,1,2,3,365,368,0.82
February,29,2020,Richland,SC,Passenger,0,1,1,159,160,0.62
February,29,2020,Walla Walla,WA,Truck,0,0,0,13701,13701,0
February,29,2020,Washoe,NV,Passenger,1,0,1,109,110,0.91
February,29,2020,Anne Arundel,MD,Passenger,1,2,3,424,427,0.7
February,29,2020,Cascade,MT,Passenger,0,1,1,55,56,1.79
February,29,2020,San Juan,WA,Passenger,279,82,361,14330,14691,2.46
February,29,2020,St. Mary's,MD,Passenger,1,0,1,216,217,0.46
February,29,2020,Harris,TX,Passenger,1,0,1,237,238,0.42
February,29,2020,Clallam,WA,Truck,1,0,1,21839,21840,0
February,29,2020,Klickitat,WA,Passenger,49,41,90,15686,15776,0.57
February,29,2020,King,WA,Truck,6,1,7,182612,182619,0
February,29,2020,Fairbanks North Star,AK,Passenger,0,1,1,99,100,1
February,29,2020,Lake,FL,Passenger,1,0,1,21,22,4.55
February,29,2020,King,WA,Passenger,23446,7675,31121,1400298,1431419,2.17
February,29,2020,Ulster,NY,Passenger,1,0,1,8,9,11.11
February,29,2020,Nassau,NY,Passenger,4,0,4,38,42,9.52
February,29,2020,Houston,GA,Passenger,1,0,1,58,59,1.69
February,29,2020,Pacific,WA,Passenger,30,32,62,16071,16133,0.38
February,29,2020,Ramsey,MN,Passenger,1,0,1,40,41,2.44
February,29,2020,Stevens,WA,Truck,0,0,0,18756,18756,0
February,29,2020,Island,WA,Passenger,401,263,664,63475,64139,1.04
February,29,2020,Arlington,VA,Passenger,0,2,2,154,156,1.28
February,29,2020,Mason,WA,Truck,0,0,0,20602,20602,0
February,29,2020,Carson City,NV,Passenger,1,0,1,10,11,9.09
February,29,2020,Lincoln,WA,Truck,0,0,0,4658,4658,0
February,29,2020,Whatcom,WA,Truck,3,0,3,43146,43149,0.01
February,29,2020,Tulsa,OK,Passenger,1,1,2,48,50,4
February,29,2020,Oldham,KY,Passenger,0,1,1,4,5,20
February,29,2020,Solano,CA,Passenger,1,0,1,211,212,0.47
February,29,2020,Adams,WA,Truck,0,0,0,5221,5221,0
February,29,2020,New London,CT,Passenger,0,2,2,250,252,0.79
February,29,2020,Flathead,MT,Passenger,1,0,1,63,64,1.56
February,29,2020,Thurston,WA,Truck,0,0,0,55720,55720,0
February,29,2020,Kittitas,WA,Passenger,94,49,143,30014,30157,0.47
February,29,2020,St. Clair,IL,Passenger,1,0,1,141,142,0.7
February,29,2020,Clackamas,OR,Passenger,2,1,3,214,217,1.38
February,29,2020,Wahkiakum,WA,Passenger,5,5,10,3017,3027,0.33
February,29,2020,Pend Oreille,WA,Truck,0,0,0,5763,5763,0
February,29,2020,Collin,TX,Passenger,1,1,2,129,131,1.53
February,29,2020,Ferry,WA,Passenger,5,2,7,4373,4380,0.16
February,29,2020,Powhatan,VA,Passenger,1,0,1,0,1,100
February,29,2020,Howard,MD,Passenger,0,1,1,71,72,1.39
February,29,2020,Yakima,WA,Truck,0,0,0,59625,59625,0
February,29,2020,Alameda,CA,Passenger,3,1,4,282,286,1.4
February,29,2020,Putnam,TN,Passenger,0,1,1,3,4,25
February,29,2020,Shelby,OH,Passenger,0,1,1,1,2,50
February,29,2020,Palm Beach,FL,Passenger,0,1,1,84,85,1.18
February,29,2020,Bexar,TX,Passenger,2,5,7,635,642,1.09
February,29,2020,San Juan,WA,Truck,0,0,0,5925,5925,0
February,29,2020,Whitman,WA,Passenger,42,48,90,22621,22711,0.4
February,29,2020,Columbia,WA,Passenger,3,3,6,2433,2439,0.25
February,29,2020,Virginia Beach,VA,Passenger,1,0,1,690,691,0.14
February,29,2020,Adams,WA,Passenger,7,7,14,12913,12927,0.11
February,29,2020,Island,WA,Truck,1,0,1,21333,21334,0
February,29,2020,Benton,WA,Passenger,338,320,658,135315,135973,0.48
February,29,2020,Kent,MI,Passenger,0,1,1,23,24,4.17
February,29,2020,Penobscot,ME,Passenger,0,1,1,15,16,6.25
February,29,2020,Stevens,WA,Passenger,33,33,66,31445,31511,0.21
February,29,2020,Nueces,TX,Passenger,1,0,1,83,84,1.19
February,29,2020,Douglas,WA,Truck,0,0,0,12320,12320,0
February,29,2020,Charleston,SC,Passenger,1,0,1,106,107,0.93
February,29,2020,Pima,AZ,Passenger,3,1,4,364,368,1.09
February,29,2020,DeKalb,IN,Passenger,1,0,1,1,2,50
February,29,2020,Columbia,WA,Truck,0,0,0,1535,1535,0
February,29,2020,Thurston,WA,Passenger,1109,725,1834,198984,200818,0.91
February,29,2020,Snohomish,WA,Truck,0,0,0,123728,123728,0
February,29,2020,Middlesex,MA,Passenger,1,1,2,101,103,1.94
February,29,2020,Suffolk,MA,Passenger,0,1,1,38,39,2.56
February,29,2020,Chelan,WA,Truck,0,0,0,22573,22573,0
February,29,2020,Shelby,TN,Passenger,0,1,1,93,94,1.06
February,29,2020,Benton,WA,Truck,0,0,0,42572,42572,0
February,29,2020,Valencia,NM,Passenger,1,0,1,5,6,16.67
February,29,2020,Deschutes,OR,Passenger,3,0,3,140,143,2.1
February,29,2020,Dallas,TX,Passenger,1,0,1,201,202,0.5
February,29,2020,New Haven,CT,Passenger,0,2,2,43,45,4.44
February,29,2020,Cochise,AZ,Passenger,0,1,1,102,103,0.97
February,29,2020,Santa Clara,CA,Passenger,7,2,9,334,343,2.62
February,29,2020,Richmond,GA,Passenger,0,1,1,89,90,1.11
February,29,2020,Montgomery,OH,Passenger,0,1,1,48,49,2.04
February,29,2020,Harnett,NC,Passenger,1,1,2,207,209,0.96
February,29,2020,Walla Walla,WA,Passenger,68,62,130,36314,36444,0.36
February,29,2020,Jefferson,NY,Passenger,0,1,1,218,219,0.46
February,29,2020,Los Angeles,CA,Passenger,8,11,19,1039,1058,1.8
February,29,2020,Norfolk,VA,Passenger,2,2,4,352,356,1.12
February,29,2020,El Paso,CO,Passenger,2,0,2,734,736,0.27
February,29,2020,Larimer,CO,Passenger,1,0,1,54,55,1.82
February,29,2020,Pacific,WA,Truck,0,0,0,7745,7745,0
February,29,2020,Chesapeake,VA,Passenger,0,2,2,432,434,0.46
February,29,2020,Twin Falls,ID,Passenger,0,1,1,29,30,3.33
February,29,2020,Wayne,MI,Passenger,0,1,1,58,59,1.69
February,29,2020,Whatcom,WA,Passenger,1042,486,1528,151612,153140,1
February,29,2020,Kitsap,WA,Passenger,1273,661,1934,182316,184250,1.05
February,29,2020,Sumter,FL,Passenger,0,1,1,9,10,10
February,29,2020,Monroe,IL,Passenger,1,0,1,4,5,20
February,29,2020,Franklin,WA,Passenger,58,76,134,61129,61263,0.22
February,29,2020,Rogers,OK,Passenger,1,0,1,5,6,16.67
February,29,2020,Multnomah,OR,Passenger,4,7,11,733,744,1.48
February,29,2020,Frederick,MD,Passenger,1,1,2,81,83,2.41
February,29,2020,Loudoun,VA,Passenger,1,0,1,90,91,1.1
February,29,2020,Wilson,TX,Passenger,0,1,1,7,8,12.5
February,29,2020,Asotin,WA,Passenger,16,11,27,12671,12698,0.21
February,29,2020,Montgomery,AL,Passenger,0,1,1,39,40,2.5
February,29,2020,San Francisco,CA,Passenger,2,1,3,100,103,2.91
February,29,2020,Sarasota,FL,Passenger,2,0,2,27,29,6.9
February,29,2020,Kootenai,ID,Passenger,1,1,2,229,231,0.87
February,29,2020,Prince William,VA,Passenger,2,3,5,232,237,2.11
February,29,2020,Chelan,WA,Passenger,216,78,294,54606,54900,0.54
February,29,2020,Snohomish,WA,Passenger,4302,1729,6031,538151,544182,1.11
February,29,2020,Jefferson,WA,Truck,0,0,0,9642,9642,0
February,29,2020,Calvert,MD,Passenger,0,2,2,90,92,2.17
February,29,2020,Santa Rosa,FL,Passenger,1,0,1,85,86,1.16
February,29,2020,Clallam,WA,Passenger,206,163,369,50804,51173,0.72
February,29,2020,Pinellas,FL,Passenger,1,1,2,110,112,1.79
February,29,2020,,,Passenger,9,6,15,870,885,1.69
February,29,2020,Hawaii,HI,Passenger,1,0,1,61,62,1.61
February,29,2020,Kittitas,WA,Truck,0,0,0,14649,14649,0
February,29,2020,Carroll,NH,Passenger,0,1,1,4,5,20
February,29,2020,Montgomery,PA,Passenger,2,0,2,35,37,5.41
February,29,2020,Skamania,WA,Passenger,28,19,47,8773,8820,0.53
January,31,2020,Los Angeles,CA,Passenger,8,11,19,1058,1077,1.76
January,31,2020,Charles,MD,Passenger,0,1,1,80,81,1.23
January,31,2020,Washington,OR,Passenger,1,0,1,457,458,0.22
January,31,2020,Carroll,NH,Passenger,0,1,1,4,5,20
January,31,2020,Rogers,OK,Passenger,1,0,1,5,6,16.67
January,31,2020,Riverside,CA,Passenger,4,1,5,641,646,0.77
January,31,2020,Prince George's,MD,Passenger,1,1,2,172,174,1.15
January,31,2020,Bexar,TX,Passenger,2,5,7,639,646,1.08
January,31,2020,San Diego,CA,Passenger,10,5,15,2781,2796,0.54
January,31,2020,Snohomish,WA,Truck,0,0,0,123641,123641,0
January,31,2020,Douglas,NE,Passenger,0,1,1,56,57,1.75
January,31,2020,Whitman,WA,Passenger,42,48,90,22664,22754,0.4
January,31,2020,Okanogan,WA,Passenger,32,30,62,26220,26282,0.24
January,31,2020,Frederick,MD,Passenger,1,1,2,81,83,2.41
January,31,2020,Fort Bend,TX,Passenger,1,0,1,49,50,2
January,31,2020,Lake,FL,Passenger,1,0,1,21,22,4.55
January,31,2020,Sedgwick,KS,Passenger,1,1,2,95,97,2.06
January,31,2020,Maricopa,AZ,Passenger,7,6,13,1484,1497,0.87
January,31,2020,Santa Cruz,CA,Passenger,1,0,1,34,35,2.86
January,31,2020,Grays Harbor,WA,Passenger,105,105,210,48505,48715,0.43
January,31,2020,Oldham,KY,Passenger,0,1,1,4,5,20
January,31,2020,Greene,MO,Passenger,0,1,1,30,31,3.23
January,31,2020,Calvert,MD,Passenger,0,2,2,91,93,2.15
January,31,2020,Whatcom,WA,Passenger,1032,486,1518,151794,153312,0.99
January,31,2020,Walla Walla,WA,Truck,0,0,0,13710,13710,0
January,31,2020,Rockingham,NH,Passenger,1,0,1,28,29,3.45
January,31,2020,Ada,ID,Passenger,0,1,1,288,289,0.35
January,31,2020,Alameda,CA,Passenger,4,1,5,285,290,1.72
January,31,2020,Montgomery,OH,Passenger,0,1,1,50,51,1.96
January,31,2020,Chelan,WA,Truck,0,0,0,22573,22573,0
January,31,2020,Clackamas,OR,Passenger,2,1,3,210,213,1.41
January,31,2020,Williamson,TX,Passenger,0,2,2,146,148,1.35
January,31,2020,Portsmouth,VA,Passenger,0,1,1,80,81,1.23
January,31,2020,Monroe,IL,Passenger,1,0,1,4,5,20
January,31,2020,Lee,FL,Passenger,1,0,1,52,53,1.89
January,31,2020,Stevens,WA,Truck,0,0,0,18790,18790,0
January,31,2020,Larimer,CO,Passenger,1,0,1,56,57,1.75
January,31,2020,Garfield,WA,Passenger,0,1,1,1321,1322,0.08
January,31,2020,Stafford,VA,Passenger,1,1,2,93,95,2.11
January,31,2020,Brevard,FL,Passenger,0,1,1,87,88,1.14
January,31,2020,Chelan,WA,Passenger,213,77,290,54617,54907,0.53
January,31,2020,Wahkiakum,WA,Passenger,4,5,9,3034,3043,0.3
January,31,2020,Benton,WA,Passenger,337,315,652,135323,135975,0.48
January,31,2020,DeKalb,IN,Passenger,1,0,1,1,2,50
January,31,2020,Pend Oreille,WA,Passenger,8,7,15,9470,9485,0.16
January,31,2020,King,WA,Passenger,23196,7620,30816,1399178,1429994,2.15
January,31,2020,Owyhee,ID,Passenger,1,0,1,3,4,25
January,31,2020,Hennepin,MN,Passenger,3,1,4,101,105,3.81
January,31,2020,Tarrant,TX,Passenger,2,0,2,187,189,1.06
January,31,2020,Travis,TX,Passenger,2,1,3,191,194,1.55
January,31,2020,Cascade,MT,Passenger,0,1,1,56,57,1.75
January,31,2020,Island,WA,Truck,1,0,1,21354,21355,0
January,31,2020,Montgomery,AL,Passenger,0,1,1,39,40,2.5
January,31,2020,Nueces,TX,Passenger,1,0,1,84,85,1.18
January,31,2020,Mason,WA,Passenger,150,135,285,47624,47909,0.59
January,31,2020,Douglas,WA,Passenger,69,39,108,28367,28475,0.38
January,31,2020,Manassas,VA,Passenger,0,1,1,6,7,14.29
January,31,2020,Suffolk,MA,Passenger,0,1,1,36,37,2.7
January,31,2020,Maui,HI,Passenger,1,0,1,38,39,2.56
January,31,2020,Juneau,AK,Passenger,0,2,2,30,32,6.25
January,31,2020,Clay,FL,Passenger,0,1,1,87,88,1.14
January,31,2020,Harrison,MS,Passenger,1,0,1,59,60,1.67
January,31,2020,Harnett,NC,Passenger,1,1,2,205,207,0.97
January,31,2020,Placer,CA,Passenger,1,0,1,93,94,1.06
January,31,2020,Klickitat,WA,Passenger,48,39,87,15683,15770,0.55
January,31,2020,Pacific,WA,Truck,0,0,0,7748,7748,0
January,31,2020,Hawaii,HI,Passenger,1,0,1,61,62,1.61
January,31,2020,Skagit,WA,Passenger,378,215,593,92622,93215,0.64
January,31,2020,Washtenaw,MI,Passenger,1,0,1,41,42,2.38
January,31,2020,Pinellas,FL,Passenger,1,1,2,110,112,1.79
January,31,2020,Charleston,SC,Passenger,1,0,1,110,111,0.9
January,31,2020,Fairbanks North Star,AK,Passenger,0,1,1,101,102,0.98
January,31,2020,Columbia,WA,Truck,0,0,0,1534,1534,0
January,31,2020,DuPage,IL,Passenger,3,0,3,63,66,4.55
January,31,2020,Skagit,WA,Truck,1,0,1,32593,32594,0
January,31,2020,Spokane,WA,Truck,1,0,1,96899,96900,0
January,31,2020,Clark,NV,Passenger,3,2,5,688,693,0.72
January,31,2020,Washoe,NV,Passenger,1,0,1,107,108,0.93
January,31,2020,Klamath,OR,Passenger,1,0,1,36,37,2.7
January,31,2020,Queens,NY,Passenger,1,0,1,52,53,1.89
January,31,2020,Loudoun,VA,Passenger,1,0,1,91,92,1.09
January,31,2020,Bucks,PA,Passenger,1,0,1,19,20,5
January,31,2020,Thurston,WA,Truck,0,0,0,55762,55762,0
January,31,2020,Clark,WA,Passenger,1940,1054,2994,319981,322975,0.93
January,31,2020,Fulton,GA,Passenger,1,2,3,105,108,2.78
January,31,2020,Sacramento,CA,Passenger,1,0,1,284,285,0.35
January,31,2020,Tulsa,OK,Passenger,1,1,2,48,50,4
January,31,2020,Solano,CA,Passenger,1,0,1,208,209,0.48
January,31,2020,Hudson,NJ,Passenger,1,0,1,39,40,2.5
January,31,2020,Osceola,FL,Passenger,1,0,1,41,42,2.38
January,31,2020,Clallam,WA,Truck,1,0,1,21855,21856,0
January,31,2020,Grant,WA,Passenger,58,71,129,65624,65753,0.2
January,31,2020,Denton,TX,Passenger,1,0,1,87,88,1.14
January,31,2020,Lincoln,WA,Passenger,1,11,12,7787,7799,0.15
January,31,2020,Pima,AZ,Passenger,3,1,4,367,371,1.08
January,31,2020,King,WA,Truck,6,1,7,182654,182661,0
January,31,2020,Yakima,WA,Passenger,120,115,235,166247,166482,0.14
January,31,2020,Fairfax,VA,Passenger,4,2,6,755,761,0.79
January,31,2020,Whatcom,WA,Truck,3,0,3,43229,43232,0.01
January,31,2020,Pend Oreille,WA,Truck,0,0,0,5778,5778,0
January,31,2020,Kittitas,WA,Passenger,93,47,140,30081,30221,0.46
January,31,2020,Grays Harbor,WA,Truck,0,0,0,20827,20827,0
January,31,2020,Palm Beach,FL,Passenger,0,1,1,85,86,1.16
January,31,2020,Norfolk,VA,Passenger,2,2,4,353,357,1.12
January,31,2020,Berkshire,MA,Passenger,0,1,1,5,6,16.67
January,31,2020,Dakota,MN,Passenger,0,1,1,33,34,2.94
January,31,2020,Jefferson,CO,Passenger,0,2,2,58,60,3.33
January,31,2020,Virginia Beach,VA,Passenger,1,0,1,696,697,0.14
January,31,2020,Moore,NC,Passenger,0,1,1,164,165,0.61
January,31,2020,Ramsey,MN,Passenger,1,0,1,39,40,2.5
January,31,2020,Anne Arundel,MD,Passenger,1,2,3,432,435,0.69
January,31,2020,,,Passenger,9,6,15,874,889,1.69
January,31,2020,Prince William,VA,Passenger,2,3,5,233,238,2.1
January,31,2020,Kootenai,ID,Passenger,1,1,2,232,234,0.85
January,31,2020,Cochise,AZ,Passenger,0,1,1,103,104,0.96
January,31,2020,Pierce,WA,Passenger,2229,1679,3908,550655,554563,0.7
January,31,2020,Twin Falls,ID,Passenger,0,1,1,28,29,3.45
January,31,2020,Kitsap,WA,Passenger,1258,656,1914,182446,184360,1.04
January,31,2020,Arlington,VA,Passenger,0,2,2,152,154,1.3
January,31,2020,Thurston,WA,Passenger,1093,719,1812,199295,201107,0.9
January,31,2020,Columbia,WA,Passenger,3,3,6,2447,2453,0.24
January,31,2020,Albemarle,VA,Passenger,1,0,1,25,26,3.85
January,31,2020,Tuolumne,CA,Passenger,0,1,1,11,12,8.33
January,31,2020,Guadalupe,TX,Passenger,1,0,1,67,68,1.47
January,31,2020,Asotin,WA,Passenger,17,11,28,12723,12751,0.22
January,31,2020,Garfield,WA,Truck,0,0,0,969,969,0
January,31,2020,Arapahoe,CO,Passenger,1,0,1,142,143,0.7
January,31,2020,Island,WA,Passenger,392,257,649,63598,64247,1.01
January,31,2020,Pacific,WA,Passenger,30,31,61,16096,16157,0.38
January,31,2020,San Mateo,CA,Passenger,1,1,2,116,118,1.69
January,31,2020,Houston,GA,Passenger,1,0,1,60,61,1.64
January,31,2020,Polk,FL,Passenger,1,0,1,65,66,1.52
January,31,2020,Randolph,NC,Passenger,1,0,1,7,8,12.5
January,31,2020,Franklin,WA,Passenger,57,76,133,61093,61226,0.22
January,31,2020,Honolulu,HI,Passenger,4,2,6,476,482,1.24
January,31,2020,Yakima,WA,Truck,0,0,0,59638,59638,0
January,31,2020,Ferry,WA,Passenger,5,2,7,4381,4388,0.16
January,31,2020,Clallam,WA,Passenger,203,163,366,50913,51279,0.71
January,31,2020,DeKalb,GA,Passenger,1,0,1,83,84,1.19
January,31,2020,San Juan,WA,Truck,0,0,0,5928,5928,0
January,31,2020,Wilson,TX,Passenger,0,1,1,7,8,12.5
January,31,2020,Penobscot,ME,Passenger,0,1,1,14,15,6.67
January,31,2020,Alexandria,VA,Passenger,1,0,1,147,148,0.68
January,31,2020,Skamania,WA,Truck,0,0,0,4106,4106,0
January,31,2020,Shasta,CA,Passenger,1,0,1,35,36,2.78
January,31,2020,Sarasota,FL,Passenger,2,0,2,26,28,7.14
January,31,2020,Wayne,MI,Passenger,0,1,1,58,59,1.69
January,31,2020,Pierce,WA,Truck,0,0,0,141347,141347,0
January,31,2020,Broward,FL,Passenger,2,1,3,122,125,2.4
January,31,2020,Benton,WA,Truck,0,0,0,42555,42555,0
January,31,2020,Jones,GA,Passenger,1,0,1,1,2,50
January,31,2020,Lewis,WA,Passenger,109,104,213,59601,59814,0.36
January,31,2020,El Paso,TX,Passenger,3,0,3,451,454,0.66
January,31,2020,Shelby,OH,Passenger,0,1,1,1,2,50
January,31,2020,Chesapeake,VA,Passenger,0,2,2,431,433,0.46
January,31,2020,New London,CT,Passenger,0,2,2,250,252,0.79
January,31,2020,Orange,CA,Passenger,7,2,9,506,515,1.75
January,31,2020,New Haven,CT,Passenger,0,2,2,45,47,4.26
January,31,2020,Klickitat,WA,Truck,0,0,0,8299,8299,0
January,31,2020,Kittitas,WA,Truck,0,0,0,14666,14666,0
January,31,2020,Powhatan,VA,Passenger,1,0,1,0,1,100
January,31,2020,Spokane,WA,Passenger,684,467,1151,316758,317909,0.36
January,31,2020,Franklin,WA,Truck,0,0,0,19851,19851,0
January,31,2020,Stevens,WA,Passenger,33,32,65,31499,31564,0.21
January,31,2020,Lewis,WA,Truck,0,0,0,26097,26097,0
January,31,2020,Boulder,CO,Passenger,0,1,1,51,52,1.92
January,31,2020,Jefferson,WA,Truck,0,0,0,9661,9661,0
January,31,2020,Shelby,TN,Passenger,0,1,1,96,97,1.03
January,31,2020,Adams,WA,Passenger,7,7,14,12913,12927,0.11
January,31,2020,Adams,WA,Truck,0,0,0,5211,5211,0
January,31,2020,Ventura,CA,Passenger,0,3,3,299,302,0.99
January,31,2020,Richland,SC,Passenger,0,1,1,157,158,0.63
January,31,2020,Carson City,NV,Passenger,1,0,1,9,10,10
January,31,2020,Duval,FL,Passenger,1,2,3,370,373,0.8
January,31,2020,Skamania,WA,Passenger,29,19,48,8769,8817,0.54
January,31,2020,Collin,TX,Passenger,1,1,2,128,130,1.54
January,31,2020,Pinal,AZ,Passenger,1,0,1,190,191,0.52
January,31,2020,Valencia,NM,Passenger,1,0,1,5,6,16.67
January,31,2020,Wahkiakum,WA,Truck,0,0,0,1759,1759,0
January,31,2020,Lincoln,WA,Truck,0,0,0,4671,4671,0
January,31,2020,Putnam,TN,Passenger,0,1,1,3,4,25
January,31,2020,Jefferson,WA,Passenger,224,139,363,25209,25572,1.42
January,31,2020,Middlesex,MA,Passenger,1,1,2,104,106,1.89
January,31,2020,Whitman,WA,Truck,0,0,0,8567,8567,0
January,31,2020,St. Clair,IL,Passenger,1,0,1,143,144,0.69
January,31,2020,Santa Clara,CA,Passenger,7,2,9,343,352,2.56
January,31,2020,Walla Walla,WA,Passenger,65,61,126,36352,36478,0.35
January,31,2020,Lake,IL,Passenger,1,0,1,161,162,0.62
January,31,2020,San Joaquin,CA,Passenger,1,0,1,136,137,0.73
January,31,2020,Contra Costa,CA,Passenger,3,2,5,336,341,1.47
January,31,2020,Flathead,MT,Passenger,1,0,1,61,62,1.61
January,31,2020,Saginaw,MI,Passenger,1,0,1,11,12,8.33
January,31,2020,Ferry,WA,Truck,0,0,0,3586,3586,0
January,31,2020,El Paso,CO,Passenger,2,1,3,735,738,0.41
January,31,2020,Nassau,NY,Passenger,4,0,4,39,43,9.3
January,31,2020,Jefferson,NY,Passenger,0,1,1,219,220,0.45
January,31,2020,District of Columbia,DC,Passenger,1,1,2,209,211,0.95
January,31,2020,Cape May,NJ,Passenger,0,1,1,13,14,7.14
January,31,2020,Goochland,VA,Passenger,2,1,3,263,266,1.13
January,31,2020,Fresno,CA,Passenger,1,0,1,190,191,0.52
January,31,2020,Cowlitz,WA,Passenger,127,111,238,73602,73840,0.32
January,31,2020,Santa Rosa,FL,Passenger,1,0,1,86,87,1.15
January,31,2020,Clark,WA,Truck,0,0,0,81767,81767,0
January,31,2020,Vigo,IN,Passenger,1,0,1,6,7,14.29
January,31,2020,Montgomery,TX,Passenger,1,0,1,56,57,1.75
January,31,2020,Multnomah,OR,Passenger,4,7,11,730,741,1.48
January,31,2020,Spartanburg,SC,Passenger,0,1,1,43,44,2.27
January,31,2020,Howard,MD,Passenger,0,1,1,74,75,1.33
January,31,2020,Cowlitz,WA,Truck,0,0,0,29028,29028,0
January,31,2020,Sumter,FL,Passenger,0,1,1,9,10,10
January,31,2020,Richmond,GA,Passenger,0,1,1,90,91,1.1
January,31,2020,Mason,WA,Truck,0,0,0,20563,20563,0
January,31,2020,Grant,WA,Truck,0,0,0,27036,27036,0
January,31,2020,RÃ­o Grande,PR,Passenger,1,0,1,1,2,50
January,31,2020,Kitsap,WA,Truck,1,0,1,54484,54485,0
January,31,2020,Montgomery,PA,Passenger,2,0,2,34,36,5.56
January,31,2020,Denver,CO,Passenger,1,0,1,124,125,0.8
January,31,2020,Douglas,WA,Truck,0,0,0,12312,12312,0
January,31,2020,Kern,CA,Passenger,0,1,1,225,226,0.44
January,31,2020,Dallas,TX,Passenger,1,0,1,208,209,0.48
January,31,2020,Suffolk,VA,Passenger,1,0,1,124,125,0.8
January,31,2020,Snohomish,WA,Passenger,4244,1718,5962,537912,543874,1.1
January,31,2020,Oklahoma,OK,Passenger,0,1,1,127,128,0.78
January,31,2020,Cumberland,NC,Passenger,0,2,2,488,490,0.41
January,31,2020,Harris,TX,Passenger,1,0,1,240,241,0.41
January,31,2020,Okanogan,WA,Truck,0,0,0,16557,16557,0
January,31,2020,Allegheny,PA,Passenger,1,0,1,74,75,1.33
January,31,2020,San Juan,WA,Passenger,265,83,348,14402,14750,2.36
January,31,2020,Kent,MI,Passenger,0,1,1,24,25,4
January,31,2020,Asotin,WA,Truck,0,0,0,6720,6720,0
January,31,2020,Boone,MO,Passenger,0,1,1,11,12,8.33
January,31,2020,San Francisco,CA,Passenger,2,1,3,101,104,2.88
January,31,2020,Deschutes,OR,Passenger,3,0,3,145,148,2.03
January,31,2020,St. Mary's,MD,Passenger,1,0,1,214,215,0.47
January,31,2020,Camden,NJ,Passenger,0,2,2,21,23,8.7
July,31,2020,Snohomish,WA,Passenger,4583,1775,6358,535609,541967,1.17
July,31,2020,Pacific,WA,Passenger,33,33,66,15766,15832,0.42
July,31,2020,Richmond,GA,Passenger,0,1,1,82,83,1.2
July,31,2020,Monterey,CA,Passenger,0,1,1,162,163,0.61
July,31,2020,Skamania,WA,Truck,0,0,0,4032,4032,0
July,31,2020,Fairbanks North Star,AK,Passenger,0,1,1,95,96,1.04
July,31,2020,Frederick,MD,Passenger,1,1,2,75,77,2.6
July,31,2020,Whitman,WA,Passenger,45,49,94,22124,22218,0.42
July,31,2020,San Diego,CA,Passenger,14,5,19,2756,2775,0.68
July,31,2020,Hamilton,IN,Passenger,1,0,1,40,41,2.44
July,31,2020,Sacramento,CA,Passenger,1,0,1,262,263,0.38
July,31,2020,Snohomish,WA,Truck,0,0,0,124342,124342,0
July,31,2020,Pierce,WA,Passenger,2467,1697,4164,551463,555627,0.75
July,31,2020,Whitman,WA,Truck,0,0,0,8507,8507,0
July,31,2020,Harnett,NC,Passenger,1,0,1,196,197,0.51
July,31,2020,Rockingham,NH,Passenger,1,0,1,21,22,4.55
July,31,2020,King,WA,Truck,7,1,8,182955,182963,0
July,31,2020,Harris,TX,Passenger,1,0,1,221,222,0.45
July,31,2020,Fresno,CA,Passenger,1,0,1,175,176,0.57
July,31,2020,Klickitat,WA,Truck,0,0,0,8117,8117,0
July,31,2020,Middlesex,MA,Passenger,1,1,2,92,94,2.13
July,31,2020,Ramsey,MN,Passenger,1,0,1,38,39,2.56
July,31,2020,Nassau,NY,Passenger,4,0,4,29,33,12.12
July,31,2020,Twin Falls,ID,Passenger,0,1,1,22,23,4.35
July,31,2020,Hudson,NJ,Passenger,1,0,1,37,38,2.63
July,31,2020,Montgomery,TX,Passenger,1,0,1,50,51,1.96
July,31,2020,Goochland,VA,Passenger,3,1,4,255,259,1.54
July,31,2020,Prince William,VA,Passenger,2,3,5,222,227,2.2
July,31,2020,Cascade,MT,Passenger,0,1,1,53,54,1.85
July,31,2020,Fort Bend,TX,Passenger,1,0,1,45,46,2.17
July,31,2020,Chesapeake,VA,Passenger,0,2,2,414,416,0.48
July,31,2020,Howard,MD,Passenger,0,1,1,69,70,1.43
July,31,2020,Skagit,WA,Passenger,423,223,646,91309,91955,0.7
July,31,2020,Cowlitz,WA,Truck,0,0,0,28879,28879,0
July,31,2020,Pacific,WA,Truck,0,0,0,7714,7714,0
July,31,2020,Putnam,TN,Passenger,0,1,1,3,4,25
July,31,2020,Chelan,WA,Truck,0,0,0,22628,22628,0
July,31,2020,Cumberland,NC,Passenger,0,3,3,461,464,0.65
July,31,2020,Walla Walla,WA,Passenger,77,65,142,35905,36047,0.39
July,31,2020,Thurston,WA,Truck,0,0,0,55895,55895,0
July,31,2020,New London,CT,Passenger,1,2,3,240,243,1.23
July,31,2020,Mason,WA,Truck,0,0,0,20714,20714,0
July,31,2020,Pinellas,FL,Passenger,1,1,2,108,110,1.82
July,31,2020,Williamson,TX,Passenger,0,2,2,135,137,1.46
July,31,2020,El Paso,CO,Passenger,2,0,2,716,718,0.28
July,31,2020,Lincoln,WA,Truck,0,0,0,4661,4661,0
July,31,2020,Anne Arundel,MD,Passenger,0,1,1,412,413,0.24
July,31,2020,Washtenaw,MI,Passenger,1,0,1,36,37,2.7
July,31,2020,Williams,ND,Passenger,0,1,1,11,12,8.33
July,31,2020,Tulsa,OK,Passenger,1,1,2,42,44,4.55
July,31,2020,Kootenai,ID,Passenger,1,0,1,217,218,0.46
July,31,2020,El Paso,TX,Passenger,3,0,3,417,420,0.71
July,31,2020,Nassau,FL,Passenger,1,0,1,35,36,2.78
July,31,2020,DeKalb,IN,Passenger,1,0,1,1,2,50
July,31,2020,Ulster,NY,Passenger,1,0,1,7,8,12.5
July,31,2020,Grays Harbor,WA,Passenger,109,112,221,48286,48507,0.46
July,31,2020,Guadalupe,TX,Passenger,1,0,1,60,61,1.64
July,31,2020,Kings,NY,Passenger,1,0,1,66,67,1.49
July,31,2020,Fairfax,VA,Passenger,4,3,7,734,741,0.94
July,31,2020,Larimer,CO,Passenger,1,0,1,51,52,1.92
July,31,2020,RÃ­o Grande,PR,Passenger,1,0,1,1,2,50
July,31,2020,Okanogan,WA,Truck,0,0,0,16492,16492,0
July,31,2020,Orange,CA,Passenger,7,2,9,482,491,1.83
July,31,2020,Alameda,CA,Passenger,2,0,2,264,266,0.75
July,31,2020,Franklin,WA,Passenger,65,79,144,60778,60922,0.24
July,31,2020,Lewis,WA,Passenger,107,115,222,58138,58360,0.38
July,31,2020,Wahkiakum,WA,Truck,0,0,0,1742,1742,0
July,31,2020,Island,WA,Passenger,430,272,702,62871,63573,1.1
July,31,2020,Denton,TX,Passenger,1,0,1,88,89,1.12
July,31,2020,Jefferson,CO,Passenger,0,1,1,57,58,1.72
July,31,2020,Lewis,WA,Truck,0,0,0,26284,26284,0
July,31,2020,Saginaw,MI,Passenger,1,0,1,10,11,9.09
July,31,2020,Douglas,WA,Truck,0,0,0,12352,12352,0
July,31,2020,Queens,NY,Passenger,1,0,1,50,51,1.96
July,31,2020,Cape May,NJ,Passenger,0,1,1,13,14,7.14
July,31,2020,Virginia Beach,VA,Passenger,1,0,1,665,666,0.15
July,31,2020,Washington,OR,Passenger,1,0,1,432,433,0.23
July,31,2020,Clallam,WA,Passenger,237,169,406,50056,50462,0.8
July,31,2020,Allegheny,PA,Passenger,1,0,1,72,73,1.37
July,31,2020,Stafford,VA,Passenger,1,1,2,91,93,2.15
July,31,2020,District of Columbia,DC,Passenger,2,1,3,203,206,1.46
July,31,2020,Pinal,AZ,Passenger,1,0,1,176,177,0.56
July,31,2020,Ferry,WA,Passenger,7,3,10,4330,4340,0.23
July,31,2020,Pierce,WA,Truck,0,0,0,142931,142931,0
July,31,2020,Columbia,WA,Truck,0,0,0,1541,1541,0
July,31,2020,Lake,FL,Passenger,1,0,1,22,23,4.35
July,31,2020,Boone,MO,Passenger,0,1,1,10,11,9.09
July,31,2020,Salt Lake,UT,Passenger,0,1,1,182,183,0.55
July,31,2020,St. Mary's,MD,Passenger,1,0,1,218,219,0.46
July,31,2020,Whatcom,WA,Passenger,1091,499,1590,149332,150922,1.05
July,31,2020,Nueces,TX,Passenger,1,0,1,83,84,1.19
July,31,2020,Skagit,WA,Truck,1,0,1,32590,32591,0
July,31,2020,Penobscot,ME,Passenger,0,1,1,14,15,6.67
July,31,2020,Manassas,VA,Passenger,0,1,1,5,6,16.67
July,31,2020,Jefferson,WA,Passenger,249,142,391,24737,25128,1.56
July,31,2020,Asotin,WA,Truck,0,0,0,6653,6653,0
July,31,2020,Clark,WA,Truck,0,0,0,82429,82429,0
July,31,2020,Montgomery,AL,Passenger,0,1,1,40,41,2.44
July,31,2020,DeKalb,GA,Passenger,1,0,1,76,77,1.3
July,31,2020,Powhatan,VA,Passenger,1,0,1,0,1,100
July,31,2020,Collin,TX,Passenger,1,1,2,119,121,1.65
July,31,2020,Grays Harbor,WA,Truck,0,0,0,20981,20981,0
July,31,2020,Grant,WA,Truck,0,0,0,27176,27176,0
July,31,2020,Stevens,WA,Passenger,37,35,72,30627,30699,0.23
July,31,2020,Travis,TX,Passenger,2,1,3,170,173,1.73
July,31,2020,Maui,HI,Passenger,1,0,1,32,33,3.03
July,31,2020,Broward,FL,Passenger,2,1,3,107,110,2.73
July,31,2020,Bradley,TN,Passenger,1,0,1,3,4,25
July,31,2020,Kent,MI,Passenger,0,1,1,23,24,4.17
July,31,2020,Asotin,WA,Passenger,16,12,28,12378,12406,0.23
July,31,2020,Santa Clara,CA,Passenger,8,2,10,284,294,3.4
July,31,2020,Moore,NC,Passenger,0,2,2,156,158,1.27
July,31,2020,San Francisco,CA,Passenger,2,1,3,91,94,3.19
July,31,2020,Pend Oreille,WA,Passenger,7,5,12,9246,9258,0.13
July,31,2020,Kittitas,WA,Truck,0,0,0,14564,14564,0
July,31,2020,Wilson,TX,Passenger,0,1,1,5,6,16.67
July,31,2020,Garfield,WA,Truck,0,0,0,988,988,0
July,31,2020,Cowlitz,WA,Passenger,146,117,263,72232,72495,0.36
July,31,2020,Harrison,MS,Passenger,1,0,1,51,52,1.92
July,31,2020,Charles,MD,Passenger,1,1,2,74,76,2.63
July,31,2020,Loudoun,VA,Passenger,1,0,1,83,84,1.19
July,31,2020,Jefferson,WA,Truck,0,0,0,9542,9542,0
July,31,2020,Charleston,SC,Passenger,2,0,2,98,100,2
July,31,2020,King,WA,Passenger,24904,7756,32660,1371156,1403816,2.33
July,31,2020,San Juan,WA,Truck,0,0,0,5844,5844,0
July,31,2020,Bartow,GA,Passenger,0,1,1,4,5,20
July,31,2020,Clark,NV,Passenger,2,2,4,671,675,0.59
July,31,2020,Shasta,CA,Passenger,1,0,1,38,39,2.56
July,31,2020,Sarasota,FL,Passenger,2,0,2,24,26,7.69
July,31,2020,Kitsap,WA,Truck,0,0,0,54144,54144,0
July,31,2020,Clark,WA,Passenger,2097,1066,3163,317956,321119,0.98
July,31,2020,Riverside,CA,Passenger,3,1,4,610,614,0.65
July,31,2020,Maricopa,AZ,Passenger,5,6,11,1401,1412,0.78
July,31,2020,St. Louis,MO,Passenger,1,0,1,97,98,1.02
July,31,2020,Santa Cruz,CA,Passenger,1,0,1,31,32,3.12
July,31,2020,Spokane,WA,Passenger,753,491,1244,316437,317681,0.39
July,31,2020,Palm Beach,FL,Passenger,0,1,1,80,81,1.23
July,31,2020,Utah,UT,Passenger,0,1,1,131,132,0.76
July,31,2020,Skamania,WA,Passenger,31,20,51,8428,8479,0.6
July,31,2020,Ventura,CA,Passenger,1,2,3,278,281,1.07
July,31,2020,Rogers,OK,Passenger,1,0,1,4,5,20
July,31,2020,Island,WA,Truck,1,0,1,21235,21236,0
July,31,2020,Franklin,WA,Truck,0,0,0,20096,20096,0
July,31,2020,Arapahoe,CO,Passenger,1,0,1,128,129,0.78
July,31,2020,Boulder,CO,Passenger,0,1,1,44,45,2.22
July,31,2020,Deschutes,OR,Passenger,2,0,2,130,132,1.52
July,31,2020,Dallas,TX,Passenger,1,0,1,188,189,0.53
July,31,2020,Carroll,NH,Passenger,0,1,1,4,5,20
July,31,2020,Calvert,MD,Passenger,0,2,2,89,91,2.2
July,31,2020,San Mateo,CA,Passenger,0,1,1,108,109,0.92
July,31,2020,Fulton,GA,Passenger,1,2,3,101,104,2.88
July,31,2020,Stevens,WA,Truck,0,0,0,18672,18672,0
July,31,2020,San Joaquin,CA,Passenger,1,0,1,125,126,0.79
July,31,2020,,,Passenger,9,5,14,900,914,1.53
July,31,2020,Sedgwick,KS,Passenger,1,1,2,96,98,2.04
July,31,2020,Shelby,OH,Passenger,0,1,1,1,2,50
July,31,2020,Garfield,WA,Passenger,0,1,1,1350,1351,0.07
July,31,2020,Okanogan,WA,Passenger,37,34,71,25923,25994,0.27
July,31,2020,Carson City,NV,Passenger,1,0,1,10,11,9.09
July,31,2020,Morris,NJ,Passenger,1,0,1,17,18,5.56
July,31,2020,Hawaii,HI,Passenger,1,0,1,55,56,1.79
July,31,2020,Honolulu,HI,Passenger,4,2,6,440,446,1.35
July,31,2020,Walla Walla,WA,Truck,0,0,0,13755,13755,0
July,31,2020,Kittitas,WA,Passenger,104,47,151,29761,29912,0.5
July,31,2020,Suffolk,MA,Passenger,0,2,2,36,38,5.26
July,31,2020,Yakima,WA,Passenger,139,119,258,165771,166029,0.16
July,31,2020,Douglas,NE,Passenger,0,1,1,50,51,1.96
July,31,2020,Whatcom,WA,Truck,3,0,3,43156,43159,0.01
July,31,2020,Yakima,WA,Truck,0,0,0,60200,60200,0
July,31,2020,DuPage,IL,Passenger,3,0,3,58,61,4.92
July,31,2020,Dakota,MN,Passenger,0,1,1,33,34,2.94
July,31,2020,Benton,WA,Truck,0,0,0,42882,42882,0
July,31,2020,Los Angeles,CA,Passenger,7,11,18,981,999,1.8
July,31,2020,Mason,WA,Passenger,160,134,294,47372,47666,0.62
July,31,2020,Jefferson,NY,Passenger,0,1,1,210,211,0.47
July,31,2020,Chelan,WA,Passenger,240,82,322,54232,54554,0.59
July,31,2020,Houston,GA,Passenger,1,0,1,55,56,1.79
July,31,2020,Albemarle,VA,Passenger,1,0,1,20,21,4.76
July,31,2020,Flathead,MT,Passenger,1,0,1,55,56,1.79
July,31,2020,Clay,FL,Passenger,0,1,1,82,83,1.2
July,31,2020,Oldham,KY,Passenger,0,1,1,4,5,20
July,31,2020,Placer,CA,Passenger,2,0,2,85,87,2.3
July,31,2020,Camden,NJ,Passenger,0,1,1,22,23,4.35
July,31,2020,Lee,FL,Passenger,1,0,1,50,51,1.96
July,31,2020,San Juan,WA,Passenger,311,94,405,13959,14364,2.82
July,31,2020,Clallam,WA,Truck,1,0,1,21697,21698,0
July,31,2020,Kitsap,WA,Passenger,1377,696,2073,179884,181957,1.14
July,31,2020,Adams,WA,Passenger,9,7,16,12866,12882,0.12
July,31,2020,Lake,IL,Passenger,1,0,1,163,164,0.61
July,31,2020,Juneau,AK,Passenger,0,1,1,29,30,3.33
July,31,2020,Klamath,OR,Passenger,1,0,1,33,34,2.94
July,31,2020,Duval,FL,Passenger,0,2,2,361,363,0.55
July,31,2020,Spartanburg,SC,Passenger,0,1,1,47,48,2.08
July,31,2020,Monroe,IL,Passenger,1,0,1,4,5,20
July,31,2020,Norfolk,VA,Passenger,2,2,4,346,350,1.14
July,31,2020,Montgomery,OH,Passenger,0,1,1,48,49,2.04
July,31,2020,Contra Costa,CA,Passenger,4,3,7,305,312,2.24
July,31,2020,Prince George's,MD,Passenger,1,1,2,156,158,1.27
July,31,2020,Greene,MO,Passenger,0,1,1,33,34,2.94
July,31,2020,Okaloosa,FL,Passenger,0,1,1,138,139,0.72
July,31,2020,Bexar,TX,Passenger,4,5,9,597,606,1.49
July,31,2020,Erie,NY,Passenger,1,0,1,45,46,2.17
July,31,2020,Pend Oreille,WA,Truck,0,0,0,5762,5762,0
July,31,2020,Polk,FL,Passenger,1,0,1,64,65,1.54
July,31,2020,Jones,GA,Passenger,1,0,1,1,2,50
July,31,2020,Columbia,WA,Passenger,4,3,7,2418,2425,0.29
July,31,2020,Vigo,IN,Passenger,1,0,1,5,6,16.67
July,31,2020,Owyhee,ID,Passenger,1,0,1,3,4,25
July,31,2020,Wahkiakum,WA,Passenger,6,6,12,3001,3013,0.4
July,31,2020,St. Clair,IL,Passenger,1,0,1,136,137,0.73
July,31,2020,Ada,ID,Passenger,0,1,1,261,262,0.38
July,31,2020,Benton,WA,Passenger,373,321,694,134304,134998,0.51
July,31,2020,Gwinnett,GA,Passenger,1,0,1,70,71,1.41
July,31,2020,Arlington,VA,Passenger,0,2,2,148,150,1.33
July,31,2020,Ferry,WA,Truck,0,0,0,3568,3568,0
July,31,2020,New Haven,CT,Passenger,0,2,2,36,38,5.26
July,31,2020,Brevard,FL,Passenger,0,1,1,84,85,1.18
July,31,2020,Sumter,FL,Passenger,0,1,1,9,10,10
July,31,2020,Solano,CA,Passenger,1,0,1,207,208,0.48
July,31,2020,Klickitat,WA,Passenger,56,43,99,15115,15214,0.65
July,31,2020,Portsmouth,VA,Passenger,0,1,1,75,76,1.32
July,31,2020,Washoe,NV,Passenger,1,0,1,100,101,0.99
July,31,2020,Richland,SC,Passenger,0,1,1,149,150,0.67
July,31,2020,Hennepin,MN,Passenger,3,0,3,89,92,3.26
July,31,2020,Suffolk,VA,Passenger,1,0,1,127,128,0.78
July,31,2020,Adams,WA,Truck,0,0,0,5283,5283,0
July,31,2020,Kern,CA,Passenger,0,1,1,223,224,0.45
July,31,2020,Montgomery,PA,Passenger,1,0,1,29,30,3.33
July,31,2020,Randolph,NC,Passenger,1,0,1,7,8,12.5
July,31,2020,Valencia,NM,Passenger,1,0,1,6,7,14.29
July,31,2020,Bucks,PA,Passenger,1,0,1,20,21,4.76
July,31,2020,Multnomah,OR,Passenger,4,7,11,707,718,1.53
July,31,2020,Pima,AZ,Passenger,3,1,4,334,338,1.18
July,31,2020,Alexandria,VA,Passenger,2,0,2,138,140,1.43
July,31,2020,Lincoln,WA,Passenger,5,11,16,7648,7664,0.21
July,31,2020,Clackamas,OR,Passenger,2,0,2,190,192,1.04
July,31,2020,Douglas,WA,Passenger,75,41,116,28050,28166,0.41
July,31,2020,Spokane,WA,Truck,1,0,1,98982,98983,0
July,31,2020,Grant,WA,Passenger,61,75,136,65284,65420,0.21
July,31,2020,Denver,CO,Passenger,1,0,1,116,117,0.85
July,31,2020,Thurston,WA,Passenger,1175,744,1919,197158,199077,0.96
July,31,2020,Shelby,TN,Passenger,0,1,1,85,86,1.16
July,31,2020,New York,NY,Passenger,1,0,1,57,58,1.72
June,30,2020,Pacific,WA,Passenger,33,33,66,15754,15820,0.42
June,30,2020,Wahkiakum,WA,Truck,0,0,0,1737,1737,0
June,30,2020,Utah,UT,Passenger,0,1,1,129,130,0.77
June,30,2020,Hennepin,MN,Passenger,3,0,3,85,88,3.41
June,30,2020,Franklin,WA,Passenger,60,76,136,60644,60780,0.22
June,30,2020,King,WA,Passenger,24109,7712,31821,1371025,1402846,2.27
June,30,2020,Island,WA,Truck,1,0,1,21212,21213,0
June,30,2020,Chesapeake,VA,Passenger,0,2,2,417,419,0.48
June,30,2020,Monroe,IL,Passenger,1,0,1,4,5,20
June,30,2020,Allegheny,PA,Passenger,1,0,1,71,72,1.39
June,30,2020,Arapahoe,CO,Passenger,1,0,1,129,130,0.77
June,30,2020,Boone,MO,Passenger,0,1,1,10,11,9.09
June,30,2020,Stafford,VA,Passenger,1,1,2,92,94,2.13
June,30,2020,Clark,WA,Truck,0,0,0,82225,82225,0
June,30,2020,Shelby,TN,Passenger,0,1,1,87,88,1.14
June,30,2020,Hamilton,IN,Passenger,1,0,1,40,41,2.44
June,30,2020,New London,CT,Passenger,1,2,3,245,248,1.21
June,30,2020,Solano,CA,Passenger,1,0,1,209,210,0.48
June,30,2020,Pierce,WA,Passenger,2380,1692,4072,549665,553737,0.74
June,30,2020,Fairfax,VA,Passenger,4,3,7,727,734,0.95
June,30,2020,San Joaquin,CA,Passenger,1,0,1,127,128,0.78
June,30,2020,San Juan,WA,Passenger,302,93,395,13968,14363,2.75
June,30,2020,Cascade,MT,Passenger,0,1,1,53,54,1.85
June,30,2020,Spokane,WA,Passenger,730,487,1217,315451,316668,0.38
June,30,2020,Williams,ND,Passenger,0,1,1,11,12,8.33
June,30,2020,Lewis,WA,Passenger,102,111,213,58176,58389,0.36
June,30,2020,Cumberland,NC,Passenger,0,3,3,460,463,0.65
June,30,2020,Cowlitz,WA,Truck,0,0,0,28868,28868,0
June,30,2020,Queens,NY,Passenger,1,0,1,50,51,1.96
June,30,2020,Honolulu,HI,Passenger,4,2,6,441,447,1.34
June,30,2020,Island,WA,Passenger,420,268,688,62807,63495,1.08
June,30,2020,Douglas,NE,Passenger,0,1,1,52,53,1.89
June,30,2020,Montgomery,OH,Passenger,0,1,1,48,49,2.04
June,30,2020,Ferry,WA,Passenger,5,3,8,4330,4338,0.18
June,30,2020,Oldham,KY,Passenger,0,1,1,4,5,20
June,30,2020,Grant,WA,Truck,0,0,0,27083,27083,0
June,30,2020,Loudoun,VA,Passenger,1,0,1,85,86,1.16
June,30,2020,Gwinnett,GA,Passenger,1,0,1,73,74,1.35
June,30,2020,Washington,OR,Passenger,1,0,1,436,437,0.23
June,30,2020,Mason,WA,Passenger,159,135,294,47272,47566,0.62
June,30,2020,Monterey,CA,Passenger,0,1,1,163,164,0.61
June,30,2020,Riverside,CA,Passenger,3,1,4,619,623,0.64
June,30,2020,Skamania,WA,Truck,0,0,0,4011,4011,0
June,30,2020,Norfolk,VA,Passenger,2,2,4,344,348,1.15
June,30,2020,Bexar,TX,Passenger,3,5,8,599,607,1.32
June,30,2020,Kitsap,WA,Truck,0,0,0,54064,54064,0
June,30,2020,Cape May,NJ,Passenger,0,1,1,13,14,7.14
June,30,2020,Portsmouth,VA,Passenger,0,1,1,76,77,1.3
June,30,2020,Denver,CO,Passenger,1,0,1,116,117,0.85
June,30,2020,,,Passenger,9,6,15,880,895,1.68
June,30,2020,Lake,IL,Passenger,1,0,1,163,164,0.61
June,30,2020,Kittitas,WA,Passenger,99,47,146,29805,29951,0.49
June,30,2020,Lincoln,WA,Passenger,5,12,17,7624,7641,0.22
June,30,2020,Brevard,FL,Passenger,0,1,1,83,84,1.19
June,30,2020,Calvert,MD,Passenger,0,2,2,90,92,2.17
June,30,2020,Denton,TX,Passenger,1,0,1,87,88,1.14
June,30,2020,Rockingham,NH,Passenger,1,0,1,23,24,4.17
June,30,2020,Chelan,WA,Passenger,231,78,309,54185,54494,0.57
June,30,2020,Ulster,NY,Passenger,1,0,1,7,8,12.5
June,30,2020,Frederick,MD,Passenger,1,1,2,75,77,2.6
June,30,2020,Broward,FL,Passenger,2,1,3,109,112,2.68
June,30,2020,Clay,FL,Passenger,0,1,1,81,82,1.22
June,30,2020,Ventura,CA,Passenger,1,2,3,278,281,1.07
June,30,2020,Stevens,WA,Truck,0,0,0,18645,18645,0
June,30,2020,Benton,WA,Truck,0,0,0,42703,42703,0
June,30,2020,Collin,TX,Passenger,1,1,2,118,120,1.67
June,30,2020,Charleston,SC,Passenger,1,0,1,103,104,0.96
June,30,2020,Erie,NY,Passenger,1,0,1,43,44,2.27
June,30,2020,King,WA,Truck,5,1,6,182171,182177,0
June,30,2020,Harris,TX,Passenger,1,0,1,227,228,0.44
June,30,2020,San Francisco,CA,Passenger,1,1,2,93,95,2.11
June,30,2020,Williamson,TX,Passenger,0,2,2,138,140,1.43
June,30,2020,Dallas,TX,Passenger,1,0,1,193,194,0.52
June,30,2020,Montgomery,TX,Passenger,1,0,1,50,51,1.96
June,30,2020,Dakota,MN,Passenger,0,1,1,33,34,2.94
June,30,2020,Kootenai,ID,Passenger,1,0,1,219,220,0.45
June,30,2020,San Diego,CA,Passenger,14,5,19,2757,2776,0.68
June,30,2020,Fresno,CA,Passenger,1,0,1,180,181,0.55
June,30,2020,Skagit,WA,Truck,1,0,1,32470,32471,0
June,30,2020,Owyhee,ID,Passenger,1,0,1,3,4,25
June,30,2020,Pinal,AZ,Passenger,1,0,1,180,181,0.55
June,30,2020,Pend Oreille,WA,Truck,0,0,0,5760,5760,0
June,30,2020,Flathead,MT,Passenger,1,0,1,59,60,1.67
June,30,2020,Bartow,GA,Passenger,0,1,1,4,5,20
June,30,2020,St. Clair,IL,Passenger,1,0,1,137,138,0.72
June,30,2020,Garfield,WA,Truck,0,0,0,974,974,0
June,30,2020,Carson City,NV,Passenger,1,0,1,10,11,9.09
June,30,2020,Columbia,WA,Passenger,4,3,7,2415,2422,0.29
June,30,2020,Fort Bend,TX,Passenger,1,0,1,46,47,2.13
June,30,2020,Clackamas,OR,Passenger,2,0,2,196,198,1.01
June,30,2020,Harnett,NC,Passenger,1,0,1,200,201,0.5
June,30,2020,Osceola,FL,Passenger,1,0,1,38,39,2.56
June,30,2020,Jones,GA,Passenger,1,0,1,1,2,50
June,30,2020,Kern,CA,Passenger,0,1,1,224,225,0.44
June,30,2020,Suffolk,MA,Passenger,0,2,2,35,37,5.41
June,30,2020,Mason,WA,Truck,0,0,0,20604,20604,0
June,30,2020,Skagit,WA,Passenger,407,221,628,91153,91781,0.68
June,30,2020,Stevens,WA,Passenger,36,33,69,30654,30723,0.22
June,30,2020,Yakima,WA,Passenger,132,119,251,165352,165603,0.15
June,30,2020,Anne Arundel,MD,Passenger,0,1,1,417,418,0.24
June,30,2020,Prince William,VA,Passenger,2,3,5,219,224,2.23
June,30,2020,Cowlitz,WA,Passenger,138,115,253,72319,72572,0.35
June,30,2020,Adams,WA,Truck,0,0,0,5263,5263,0
June,30,2020,Franklin,WA,Truck,0,0,0,19973,19973,0
June,30,2020,Arlington,VA,Passenger,0,2,2,149,151,1.32
June,30,2020,Spokane,WA,Truck,1,0,1,98330,98331,0
June,30,2020,Benton,WA,Passenger,359,321,680,134227,134907,0.5
June,30,2020,Kent,MI,Passenger,0,1,1,23,24,4.17
June,30,2020,Asotin,WA,Truck,0,0,0,6638,6638,0
June,30,2020,Duval,FL,Passenger,0,2,2,359,361,0.55
June,30,2020,Thurston,WA,Passenger,1143,736,1879,196906,198785,0.95
June,30,2020,Sumter,FL,Passenger,0,1,1,9,10,10
June,30,2020,Middlesex,MA,Passenger,1,1,2,94,96,2.08
June,30,2020,Washoe,NV,Passenger,1,0,1,103,104,0.96
June,30,2020,Sacramento,CA,Passenger,1,0,1,264,265,0.38
June,30,2020,Santa Cruz,CA,Passenger,1,0,1,32,33,3.03
June,30,2020,Richland,SC,Passenger,0,1,1,154,155,0.65
June,30,2020,Klickitat,WA,Passenger,53,41,94,15173,15267,0.62
June,30,2020,Fulton,GA,Passenger,1,2,3,100,103,2.91
June,30,2020,Clark,WA,Passenger,2014,1058,3072,317682,320754,0.96
June,30,2020,Los Angeles,CA,Passenger,7,11,18,984,1002,1.8
June,30,2020,Howard,MD,Passenger,0,1,1,72,73,1.37
June,30,2020,Alameda,CA,Passenger,2,0,2,268,270,0.74
June,30,2020,Pierce,WA,Truck,0,0,0,142167,142167,0
June,30,2020,Maricopa,AZ,Passenger,5,6,11,1410,1421,0.77
June,30,2020,Goochland,VA,Passenger,2,1,3,256,259,1.16
June,30,2020,Boulder,CO,Passenger,0,1,1,43,44,2.27
June,30,2020,St. Mary's,MD,Passenger,1,0,1,219,220,0.45
June,30,2020,RÃ­o Grande,PR,Passenger,1,0,1,1,2,50
June,30,2020,District of Columbia,DC,Passenger,2,1,3,205,208,1.44
June,30,2020,Valencia,NM,Passenger,1,0,1,5,6,16.67
June,30,2020,Pend Oreille,WA,Passenger,7,6,13,9243,9256,0.14
June,30,2020,Okanogan,WA,Truck,0,0,0,16445,16445,0
June,30,2020,Jefferson,WA,Passenger,236,139,375,24797,25172,1.49
June,30,2020,Grays Harbor,WA,Passenger,106,111,217,48145,48362,0.45
June,30,2020,Walla Walla,WA,Truck,0,0,0,13745,13745,0
June,30,2020,Albemarle,VA,Passenger,1,0,1,21,22,4.55
June,30,2020,Travis,TX,Passenger,2,1,3,177,180,1.67
June,30,2020,DeKalb,GA,Passenger,1,0,1,80,81,1.23
June,30,2020,Alexandria,VA,Passenger,1,0,1,140,141,0.71
June,30,2020,Fairbanks North Star,AK,Passenger,0,1,1,96,97,1.03
June,30,2020,Tulsa,OK,Passenger,1,1,2,43,45,4.44
June,30,2020,Palm Beach,FL,Passenger,0,1,1,79,80,1.25
June,30,2020,Moore,NC,Passenger,0,2,2,161,163,1.23
June,30,2020,Thurston,WA,Truck,0,0,0,55742,55742,0
June,30,2020,Montgomery,PA,Passenger,1,0,1,30,31,3.23
June,30,2020,Lake,FL,Passenger,1,0,1,22,23,4.35
June,30,2020,Jefferson,WA,Truck,0,0,0,9533,9533,0
June,30,2020,Sedgwick,KS,Passenger,1,1,2,92,94,2.13
June,30,2020,El Paso,CO,Passenger,2,0,2,715,717,0.28
June,30,2020,San Mateo,CA,Passenger,0,1,1,110,111,0.9
June,30,2020,Whatcom,WA,Truck,3,0,3,43006,43009,0.01
June,30,2020,Vigo,IN,Passenger,1,0,1,5,6,16.67
June,30,2020,Jefferson,NY,Passenger,0,1,1,210,211,0.47
June,30,2020,Greene,MO,Passenger,0,1,1,32,33,3.03
June,30,2020,Pacific,WA,Truck,0,0,0,7699,7699,0
June,30,2020,Camden,NJ,Passenger,0,1,1,21,22,4.55
June,30,2020,Bucks,PA,Passenger,1,0,1,19,20,5
June,30,2020,Powhatan,VA,Passenger,1,0,1,0,1,100
June,30,2020,Whatcom,WA,Passenger,1064,498,1562,149248,150810,1.04
June,30,2020,Shelby,OH,Passenger,0,1,1,1,2,50
June,30,2020,Multnomah,OR,Passenger,4,7,11,709,720,1.53
June,30,2020,Asotin,WA,Passenger,16,12,28,12321,12349,0.23
June,30,2020,New Haven,CT,Passenger,0,2,2,38,40,5
June,30,2020,Sarasota,FL,Passenger,2,0,2,25,27,7.41
June,30,2020,DeKalb,IN,Passenger,1,0,1,1,2,50
June,30,2020,Whitman,WA,Passenger,44,48,92,22140,22232,0.41
June,30,2020,Ramsey,MN,Passenger,1,0,1,39,40,2.5
June,30,2020,Santa Clara,CA,Passenger,7,2,9,298,307,2.93
June,30,2020,Klamath,OR,Passenger,1,0,1,33,34,2.94
June,30,2020,Kitsap,WA,Passenger,1330,686,2016,179815,181831,1.11
June,30,2020,Hawaii,HI,Passenger,1,0,1,56,57,1.75
June,30,2020,San Juan,WA,Truck,0,0,0,5854,5854,0
June,30,2020,Deschutes,OR,Passenger,3,0,3,133,136,2.21
June,30,2020,Charles,MD,Passenger,1,1,2,73,75,2.67
June,30,2020,Adams,WA,Passenger,9,7,16,12786,12802,0.12
June,30,2020,Houston,GA,Passenger,1,0,1,56,57,1.75
June,30,2020,Contra Costa,CA,Passenger,3,3,6,314,320,1.88
June,30,2020,Randolph,NC,Passenger,1,0,1,6,7,14.29
June,30,2020,Lewis,WA,Truck,0,0,0,26209,26209,0
June,30,2020,Yakima,WA,Truck,0,0,0,59894,59894,0
June,30,2020,Whitman,WA,Truck,0,0,0,8508,8508,0
June,30,2020,Ada,ID,Passenger,0,1,1,270,271,0.37
June,30,2020,Montgomery,AL,Passenger,0,1,1,39,40,2.5
June,30,2020,Shasta,CA,Passenger,1,0,1,36,37,2.7
June,30,2020,Klickitat,WA,Truck,0,0,0,8102,8102,0
June,30,2020,Ferry,WA,Truck,0,0,0,3555,3555,0
June,30,2020,St. Louis,MO,Passenger,1,0,1,97,98,1.02
June,30,2020,Prince George's,MD,Passenger,1,1,2,163,165,1.21
June,30,2020,Wahkiakum,WA,Passenger,6,6,12,2991,3003,0.4
June,30,2020,Orange,CA,Passenger,7,2,9,492,501,1.8
June,30,2020,Douglas,WA,Passenger,71,40,111,28002,28113,0.39
June,30,2020,Grays Harbor,WA,Truck,0,0,0,20910,20910,0
June,30,2020,Polk,FL,Passenger,1,0,1,64,65,1.54
June,30,2020,Nassau,NY,Passenger,4,0,4,29,33,12.12
June,30,2020,Grant,WA,Passenger,59,71,130,65239,65369,0.2
June,30,2020,Lincoln,WA,Truck,0,0,0,4624,4624,0
June,30,2020,Kittitas,WA,Truck,0,0,0,14591,14591,0
June,30,2020,Clallam,WA,Truck,1,0,1,21760,21761,0
June,30,2020,Saginaw,MI,Passenger,1,0,1,10,11,9.09
June,30,2020,Clallam,WA,Passenger,228,168,396,50092,50488,0.78
June,30,2020,El Paso,TX,Passenger,3,0,3,421,424,0.71
June,30,2020,Jefferson,CO,Passenger,0,1,1,59,60,1.67
June,30,2020,Twin Falls,ID,Passenger,0,1,1,24,25,4
June,30,2020,Garfield,WA,Passenger,0,1,1,1351,1352,0.07
June,30,2020,Guadalupe,TX,Passenger,1,0,1,64,65,1.54
June,30,2020,DuPage,IL,Passenger,3,0,3,58,61,4.92
June,30,2020,Snohomish,WA,Truck,0,0,0,123942,123942,0
June,30,2020,Nassau,FL,Passenger,1,0,1,36,37,2.7
June,30,2020,Richmond,GA,Passenger,0,1,1,84,85,1.18
June,30,2020,Pima,AZ,Passenger,3,1,4,339,343,1.17
June,30,2020,Larimer,CO,Passenger,1,0,1,51,52,1.92
June,30,2020,Juneau,AK,Passenger,0,2,2,28,30,6.67
June,30,2020,Lee,FL,Passenger,1,0,1,50,51,1.96
June,30,2020,Salt Lake,UT,Passenger,0,1,1,194,195,0.51
June,30,2020,Putnam,TN,Passenger,0,1,1,3,4,25
June,30,2020,Nueces,TX,Passenger,1,0,1,82,83,1.2
June,30,2020,Columbia,WA,Truck,0,0,0,1532,1532,0
June,30,2020,Okaloosa,FL,Passenger,0,1,1,137,138,0.72
June,30,2020,Pinellas,FL,Passenger,1,1,2,109,111,1.8
June,30,2020,Virginia Beach,VA,Passenger,1,0,1,666,667,0.15
June,30,2020,Manassas,VA,Passenger,0,1,1,4,5,20
June,30,2020,Snohomish,WA,Passenger,4434,1765,6199,534548,540747,1.15
June,30,2020,Penobscot,ME,Passenger,0,1,1,13,14,7.14
June,30,2020,Douglas,WA,Truck,0,0,0,12308,12308,0
June,30,2020,Rogers,OK,Passenger,1,0,1,5,6,16.67
June,30,2020,Suffolk,VA,Passenger,1,0,1,127,128,0.78
June,30,2020,Skamania,WA,Passenger,31,18,49,8481,8530,0.57
June,30,2020,Walla Walla,WA,Passenger,73,62,135,35832,35967,0.38
June,30,2020,Spartanburg,SC,Passenger,0,1,1,46,47,2.13
June,30,2020,Harrison,MS,Passenger,1,0,1,53,54,1.85
June,30,2020,Washtenaw,MI,Passenger,1,0,1,36,37,2.7
June,30,2020,Chelan,WA,Truck,0,0,0,22520,22520,0
June,30,2020,Okanogan,WA,Passenger,36,33,69,25848,25917,0.27
June,30,2020,Wilson,TX,Passenger,0,1,1,5,6,16.67
June,30,2020,Clark,NV,Passenger,2,2,4,675,679,0.59
June,30,2020,Maui,HI,Passenger,1,0,1,31,32,3.12
June,30,2020,Hudson,NJ,Passenger,1,0,1,38,39,2.56
June,30,2020,Placer,CA,Passenger,2,0,2,89,91,2.2
June,30,2020,Carroll,NH,Passenger,0,1,1,4,5,20
March,31,2020,Travis,TX,Passenger,2,1,3,185,188,1.6
March,31,2020,El Paso,CO,Passenger,2,0,2,728,730,0.27
March,31,2020,Ada,ID,Passenger,0,1,1,286,287,0.35
March,31,2020,New London,CT,Passenger,1,2,3,245,248,1.21
March,31,2020,Douglas,WA,Truck,0,0,0,12333,12333,0
March,31,2020,Bexar,TX,Passenger,2,5,7,620,627,1.12
March,31,2020,Adams,WA,Passenger,7,7,14,12891,12905,0.11
March,31,2020,,,Passenger,10,6,16,867,883,1.81
March,31,2020,Walla Walla,WA,Passenger,68,63,131,36237,36368,0.36
March,31,2020,Erie,NY,Passenger,1,0,1,44,45,2.22
March,31,2020,San Mateo,CA,Passenger,0,1,1,114,115,0.87
March,31,2020,Walla Walla,WA,Truck,0,0,0,13647,13647,0
March,31,2020,Sacramento,CA,Passenger,1,0,1,271,272,0.37
March,31,2020,Larimer,CO,Passenger,1,0,1,55,56,1.79
March,31,2020,Yakima,WA,Truck,0,0,0,59596,59596,0
March,31,2020,Stevens,WA,Passenger,33,33,66,31263,31329,0.21
March,31,2020,Clackamas,OR,Passenger,2,1,3,209,212,1.42
March,31,2020,Santa Cruz,CA,Passenger,1,0,1,37,38,2.63
March,31,2020,Oklahoma,OK,Passenger,0,1,1,129,130,0.77
March,31,2020,Brevard,FL,Passenger,0,1,1,86,87,1.15
March,31,2020,Suffolk,VA,Passenger,1,0,1,124,125,0.8
March,31,2020,Cowlitz,WA,Truck,0,0,0,28852,28852,0
March,31,2020,Sedgwick,KS,Passenger,1,1,2,93,95,2.11
March,31,2020,Rockingham,NH,Passenger,1,0,1,27,28,3.57
March,31,2020,San Juan,WA,Truck,0,0,0,5932,5932,0
March,31,2020,Hudson,NJ,Passenger,1,0,1,39,40,2.5
March,31,2020,Owyhee,ID,Passenger,1,0,1,3,4,25
March,31,2020,Mason,WA,Truck,0,0,0,20576,20576,0
March,31,2020,Clark,NV,Passenger,3,2,5,682,687,0.73
March,31,2020,Riverside,CA,Passenger,3,1,4,639,643,0.62
March,31,2020,Lewis,WA,Passenger,105,108,213,59209,59422,0.36
March,31,2020,Vigo,IN,Passenger,1,0,1,5,6,16.67
March,31,2020,Skagit,WA,Truck,1,0,1,32552,32553,0
March,31,2020,Skagit,WA,Passenger,391,216,607,92155,92762,0.65
March,31,2020,Boone,MO,Passenger,0,1,1,12,13,7.69
March,31,2020,El Paso,TX,Passenger,3,0,3,440,443,0.68
March,31,2020,Osceola,FL,Passenger,1,0,1,41,42,2.38
March,31,2020,Virginia Beach,VA,Passenger,1,0,1,681,682,0.15
March,31,2020,Fairfax,VA,Passenger,4,3,7,747,754,0.93
March,31,2020,Pinal,AZ,Passenger,1,0,1,188,189,0.53
March,31,2020,Thurston,WA,Truck,0,0,0,55680,55680,0
March,31,2020,Multnomah,OR,Passenger,4,7,11,731,742,1.48
March,31,2020,Prince George's,MD,Passenger,1,1,2,168,170,1.18
March,31,2020,Whatcom,WA,Truck,3,0,3,43025,43028,0.01
March,31,2020,Placer,CA,Passenger,2,0,2,92,94,2.13
March,31,2020,Jones,GA,Passenger,1,0,1,1,2,50
March,31,2020,Polk,FL,Passenger,1,0,1,68,69,1.45
March,31,2020,Shasta,CA,Passenger,1,0,1,38,39,2.56
March,31,2020,Harnett,NC,Passenger,1,1,2,205,207,0.97
March,31,2020,Ferry,WA,Passenger,5,3,8,4365,4373,0.18
March,31,2020,Palm Beach,FL,Passenger,0,2,2,80,82,2.44
March,31,2020,Howard,MD,Passenger,0,1,1,70,71,1.41
March,31,2020,Island,WA,Passenger,406,269,675,63248,63923,1.06
March,31,2020,Jefferson,NY,Passenger,0,1,1,212,213,0.47
March,31,2020,Washtenaw,MI,Passenger,1,0,1,36,37,2.7
March,31,2020,Grant,WA,Passenger,58,71,129,65493,65622,0.2
March,31,2020,Powhatan,VA,Passenger,1,0,1,0,1,100
March,31,2020,Tulsa,OK,Passenger,1,1,2,45,47,4.26
March,31,2020,Sarasota,FL,Passenger,2,0,2,26,28,7.14
March,31,2020,Fresno,CA,Passenger,1,0,1,187,188,0.53
March,31,2020,Denver,CO,Passenger,1,0,1,121,122,0.82
March,31,2020,Lewis,WA,Truck,0,0,0,26030,26030,0
March,31,2020,Shelby,OH,Passenger,0,1,1,1,2,50
March,31,2020,Spokane,WA,Passenger,704,473,1177,317986,319163,0.37
March,31,2020,Kitsap,WA,Passenger,1297,674,1971,181797,183768,1.07
March,31,2020,Washoe,NV,Passenger,1,0,1,109,110,0.91
March,31,2020,Bucks,PA,Passenger,1,0,1,20,21,4.76
March,31,2020,Clallam,WA,Truck,1,0,1,21817,21818,0
March,31,2020,Alexandria,VA,Passenger,1,0,1,142,143,0.7
March,31,2020,Alameda,CA,Passenger,3,1,4,280,284,1.41
March,31,2020,Arlington,VA,Passenger,0,2,2,155,157,1.27
March,31,2020,Pierce,WA,Truck,0,0,0,141601,141601,0
March,31,2020,Goochland,VA,Passenger,2,1,3,260,263,1.14
March,31,2020,Washington,OR,Passenger,1,0,1,453,454,0.22
March,31,2020,Wahkiakum,WA,Passenger,6,5,11,3006,3017,0.36
March,31,2020,Santa Clara,CA,Passenger,7,2,9,324,333,2.7
March,31,2020,Mason,WA,Passenger,153,135,288,47512,47800,0.6
March,31,2020,Boulder,CO,Passenger,0,1,1,47,48,2.08
March,31,2020,San Joaquin,CA,Passenger,1,0,1,132,133,0.75
March,31,2020,Whatcom,WA,Passenger,1057,490,1547,151217,152764,1.01
March,31,2020,Snohomish,WA,Passenger,4370,1757,6127,537415,543542,1.13
March,31,2020,Cowlitz,WA,Passenger,134,114,248,73167,73415,0.34
March,31,2020,St. Clair,IL,Passenger,1,0,1,140,141,0.71
March,31,2020,Thurston,WA,Passenger,1131,728,1859,198621,200480,0.93
March,31,2020,Montgomery,AL,Passenger,0,1,1,38,39,2.56
March,31,2020,Prince William,VA,Passenger,2,3,5,228,233,2.15
March,31,2020,Lincoln,WA,Truck,0,0,0,4659,4659,0
March,31,2020,Williams,ND,Passenger,0,1,1,13,14,7.14
March,31,2020,Guadalupe,TX,Passenger,1,0,1,65,66,1.52
March,31,2020,Ulster,NY,Passenger,1,0,1,8,9,11.11
March,31,2020,Calvert,MD,Passenger,0,2,2,90,92,2.17
March,31,2020,Nassau,NY,Passenger,4,0,4,35,39,10.26
March,31,2020,Broward,FL,Passenger,3,1,4,116,120,3.33
March,31,2020,Lake,FL,Passenger,1,0,1,21,22,4.55
March,31,2020,Saginaw,MI,Passenger,1,0,1,11,12,8.33
March,31,2020,Orange,CA,Passenger,7,2,9,500,509,1.77
March,31,2020,Camden,NJ,Passenger,0,2,2,20,22,9.09
March,31,2020,Douglas,NE,Passenger,0,1,1,56,57,1.75
March,31,2020,Columbia,WA,Truck,0,0,0,1533,1533,0
March,31,2020,Jefferson,WA,Passenger,234,141,375,25071,25446,1.47
March,31,2020,Fairbanks North Star,AK,Passenger,0,1,1,98,99,1.01
March,31,2020,Charleston,SC,Passenger,1,0,1,107,108,0.93
March,31,2020,Pend Oreille,WA,Passenger,8,7,15,9369,9384,0.16
March,31,2020,Snohomish,WA,Truck,0,0,0,123723,123723,0
March,31,2020,Rogers,OK,Passenger,1,0,1,5,6,16.67
March,31,2020,Chesapeake,VA,Passenger,0,2,2,427,429,0.47
March,31,2020,Adams,WA,Truck,0,0,0,5219,5219,0
March,31,2020,Contra Costa,CA,Passenger,3,2,5,327,332,1.51
March,31,2020,King,WA,Passenger,23884,7720,31604,1397089,1428693,2.21
March,31,2020,Clark,WA,Truck,0,0,0,82047,82047,0
March,31,2020,Middlesex,MA,Passenger,1,1,2,102,104,1.92
March,31,2020,Franklin,WA,Passenger,58,77,135,61018,61153,0.22
March,31,2020,Franklin,WA,Truck,0,0,0,19901,19901,0
March,31,2020,Dakota,MN,Passenger,0,1,1,32,33,3.03
March,31,2020,Flathead,MT,Passenger,1,0,1,64,65,1.54
March,31,2020,Randolph,NC,Passenger,1,0,1,7,8,12.5
March,31,2020,Benton,WA,Truck,0,0,0,42519,42519,0
March,31,2020,Suffolk,MA,Passenger,0,2,2,37,39,5.13
March,31,2020,Moore,NC,Passenger,0,1,1,163,164,0.61
March,31,2020,Juneau,AK,Passenger,0,2,2,31,33,6.06
March,31,2020,Collin,TX,Passenger,1,1,2,126,128,1.56
March,31,2020,Lee,FL,Passenger,1,0,1,51,52,1.92
March,31,2020,Carroll,NH,Passenger,0,1,1,4,5,20
March,31,2020,Klamath,OR,Passenger,1,0,1,36,37,2.7
March,31,2020,Nueces,TX,Passenger,1,0,1,83,84,1.19
March,31,2020,Garfield,WA,Truck,0,0,0,976,976,0
March,31,2020,Solano,CA,Passenger,1,0,1,212,213,0.47
March,31,2020,Loudoun,VA,Passenger,1,0,1,89,90,1.11
March,31,2020,Norfolk,VA,Passenger,2,2,4,349,353,1.13
March,31,2020,Carson City,NV,Passenger,1,0,1,11,12,8.33
March,31,2020,Honolulu,HI,Passenger,4,2,6,465,471,1.27
March,31,2020,Kootenai,ID,Passenger,1,1,2,228,230,0.87
March,31,2020,Klickitat,WA,Truck,0,0,0,8273,8273,0
March,31,2020,Clay,FL,Passenger,0,1,1,83,84,1.19
March,31,2020,District of Columbia,DC,Passenger,1,1,2,206,208,0.96
March,31,2020,Pima,AZ,Passenger,3,1,4,358,362,1.1
March,31,2020,RÃ­o Grande,PR,Passenger,1,0,1,1,2,50
March,31,2020,Sumter,FL,Passenger,0,1,1,9,10,10
March,31,2020,Skamania,WA,Passenger,29,18,47,8716,8763,0.54
March,31,2020,Deschutes,OR,Passenger,3,0,3,143,146,2.05
March,31,2020,Shelby,TN,Passenger,0,1,1,89,90,1.11
March,31,2020,Grays Harbor,WA,Passenger,107,109,216,48321,48537,0.45
March,31,2020,Wilson,TX,Passenger,0,1,1,7,8,12.5
March,31,2020,Kittitas,WA,Truck,0,0,0,14621,14621,0
March,31,2020,Greene,MO,Passenger,0,1,1,31,32,3.12
March,31,2020,Williamson,TX,Passenger,0,2,2,142,144,1.39
March,31,2020,Montgomery,PA,Passenger,1,0,1,35,36,2.78
March,31,2020,Gwinnett,GA,Passenger,1,0,1,74,75,1.33
March,31,2020,Whitman,WA,Truck,0,0,0,8549,8549,0
March,31,2020,Fulton,GA,Passenger,1,2,3,106,109,2.75
March,31,2020,Penobscot,ME,Passenger,0,1,1,15,16,6.25
March,31,2020,Queens,NY,Passenger,1,0,1,53,54,1.85
March,31,2020,Houston,GA,Passenger,1,0,1,57,58,1.72
March,31,2020,Putnam,TN,Passenger,0,1,1,3,4,25
March,31,2020,Douglas,WA,Passenger,71,40,111,28174,28285,0.39
March,31,2020,Benton,WA,Passenger,344,319,663,135166,135829,0.49
March,31,2020,Asotin,WA,Passenger,16,12,28,12596,12624,0.22
March,31,2020,Pacific,WA,Passenger,29,34,63,16025,16088,0.39
March,31,2020,Hennepin,MN,Passenger,3,1,4,94,98,4.08
March,31,2020,Montgomery,OH,Passenger,0,1,1,46,47,2.13
March,31,2020,Jefferson,CO,Passenger,0,1,1,57,58,1.72
March,31,2020,Kitsap,WA,Truck,1,0,1,54213,54214,0
March,31,2020,Pierce,WA,Passenger,2310,1693,4003,551180,555183,0.72
March,31,2020,Hamilton,IN,Passenger,1,0,1,40,41,2.44
March,31,2020,Skamania,WA,Truck,0,0,0,4082,4082,0
March,31,2020,Cumberland,NC,Passenger,0,2,2,481,483,0.41
March,31,2020,Charles,MD,Passenger,0,1,1,74,75,1.33
March,31,2020,Dallas,TX,Passenger,1,0,1,200,201,0.5
March,31,2020,Hawaii,HI,Passenger,1,0,1,60,61,1.64
March,31,2020,Pend Oreille,WA,Truck,0,0,0,5757,5757,0
March,31,2020,San Juan,WA,Passenger,291,86,377,14281,14658,2.57
March,31,2020,Island,WA,Truck,1,0,1,21265,21266,0
March,31,2020,Okanogan,WA,Passenger,34,31,65,26068,26133,0.25
March,31,2020,Frederick,MD,Passenger,1,1,2,79,81,2.47
March,31,2020,Richland,SC,Passenger,0,1,1,155,156,0.64
March,31,2020,Kent,MI,Passenger,0,1,1,23,24,4.17
March,31,2020,San Francisco,CA,Passenger,2,1,3,99,102,2.94
March,31,2020,Tarrant,TX,Passenger,1,0,1,179,180,0.56
March,31,2020,Lincoln,WA,Passenger,2,12,14,7750,7764,0.18
March,31,2020,Garfield,WA,Passenger,0,1,1,1350,1351,0.07
March,31,2020,Cascade,MT,Passenger,0,1,1,55,56,1.79
March,31,2020,Grant,WA,Truck,0,0,0,27056,27056,0
March,31,2020,Maricopa,AZ,Passenger,7,6,13,1457,1470,0.88
March,31,2020,Fort Bend,TX,Passenger,1,0,1,47,48,2.08
March,31,2020,Montgomery,TX,Passenger,1,0,1,52,53,1.89
March,31,2020,San Diego,CA,Passenger,12,5,17,2781,2798,0.61
March,31,2020,Klickitat,WA,Passenger,51,41,92,15597,15689,0.59
March,31,2020,Maui,HI,Passenger,1,0,1,34,35,2.86
March,31,2020,Harris,TX,Passenger,1,0,1,236,237,0.42
March,31,2020,Asotin,WA,Truck,0,0,0,6667,6667,0
March,31,2020,Lake,IL,Passenger,1,0,1,166,167,0.6
March,31,2020,Duval,FL,Passenger,0,2,2,363,365,0.55
March,31,2020,Oldham,KY,Passenger,0,1,1,4,5,20
March,31,2020,Anne Arundel,MD,Passenger,1,1,2,424,426,0.47
March,31,2020,Chelan,WA,Truck,0,0,0,22551,22551,0
March,31,2020,St. Mary's,MD,Passenger,1,0,1,215,216,0.46
March,31,2020,Ferry,WA,Truck,0,0,0,3565,3565,0
March,31,2020,Twin Falls,ID,Passenger,0,1,1,28,29,3.45
March,31,2020,Tuolumne,CA,Passenger,0,1,1,10,11,9.09
March,31,2020,Chelan,WA,Passenger,220,79,299,54482,54781,0.55
March,31,2020,Columbia,WA,Passenger,3,3,6,2416,2422,0.25
March,31,2020,Portsmouth,VA,Passenger,0,1,1,79,80,1.25
March,31,2020,DeKalb,IN,Passenger,1,0,1,1,2,50
March,31,2020,Stevens,WA,Truck,0,0,0,18700,18700,0
March,31,2020,Pinellas,FL,Passenger,1,1,2,109,111,1.8
March,31,2020,Stafford,VA,Passenger,1,1,2,91,93,2.15
March,31,2020,Allegheny,PA,Passenger,1,0,1,74,75,1.33
March,31,2020,Spokane,WA,Truck,1,0,1,97458,97459,0
March,31,2020,Ramsey,MN,Passenger,1,0,1,40,41,2.44
March,31,2020,Whitman,WA,Passenger,42,46,88,22485,22573,0.39
March,31,2020,Spartanburg,SC,Passenger,0,1,1,47,48,2.08
March,31,2020,St. Louis,MO,Passenger,1,0,1,100,101,0.99
March,31,2020,Wahkiakum,WA,Truck,0,0,0,1760,1760,0
March,31,2020,Pacific,WA,Truck,0,0,0,7711,7711,0
March,31,2020,Albemarle,VA,Passenger,1,0,1,21,22,4.55
March,31,2020,Kittitas,WA,Passenger,98,49,147,29998,30145,0.49
March,31,2020,Kern,CA,Passenger,0,1,1,220,221,0.45
March,31,2020,Okanogan,WA,Truck,0,0,0,16458,16458,0
March,31,2020,Harrison,MS,Passenger,1,0,1,58,59,1.69
March,31,2020,Ventura,CA,Passenger,0,3,3,293,296,1.01
March,31,2020,Clallam,WA,Passenger,214,166,380,50661,51041,0.74
March,31,2020,Valencia,NM,Passenger,1,0,1,5,6,16.67
March,31,2020,Denton,TX,Passenger,1,0,1,92,93,1.08
March,31,2020,Clark,WA,Passenger,1983,1061,3044,320288,323332,0.94
March,31,2020,Cape May,NJ,Passenger,0,1,1,13,14,7.14
March,31,2020,Yakima,WA,Passenger,124,116,240,165838,166078,0.14
March,31,2020,Arapahoe,CO,Passenger,1,0,1,141,142,0.7
March,31,2020,Monroe,IL,Passenger,1,0,1,4,5,20
March,31,2020,Richmond,GA,Passenger,0,1,1,89,90,1.11
March,31,2020,Cochise,AZ,Passenger,0,1,1,102,103,0.97
March,31,2020,Grays Harbor,WA,Truck,0,0,0,20787,20787,0
March,31,2020,DuPage,IL,Passenger,3,0,3,61,64,4.69
March,31,2020,New Haven,CT,Passenger,0,2,2,41,43,4.65
March,31,2020,DeKalb,GA,Passenger,1,0,1,81,82,1.22
March,31,2020,Jefferson,WA,Truck,0,0,0,9594,9594,0
March,31,2020,King,WA,Truck,5,1,6,182420,182426,0
March,31,2020,Los Angeles,CA,Passenger,7,11,18,1027,1045,1.72
March,31,2020,Manassas,VA,Passenger,0,1,1,5,6,16.67
May,31,2020,Chelan,WA,Passenger,228,78,306,54111,54417,0.56
May,31,2020,Contra Costa,CA,Passenger,3,2,5,318,323,1.55
May,31,2020,Spokane,WA,Truck,1,0,1,97688,97689,0
May,31,2020,Erie,NY,Passenger,1,0,1,44,45,2.22
May,31,2020,Williams,ND,Passenger,0,1,1,11,12,8.33
May,31,2020,Pacific,WA,Truck,0,0,0,7625,7625,0
May,31,2020,Arlington,VA,Passenger,0,2,2,148,150,1.33
May,31,2020,Wahkiakum,WA,Passenger,6,6,12,2965,2977,0.4
May,31,2020,Washoe,NV,Passenger,1,0,1,105,106,0.94
May,31,2020,Columbia,WA,Passenger,4,3,7,2405,2412,0.29
May,31,2020,Calvert,MD,Passenger,0,2,2,88,90,2.22
May,31,2020,Hennepin,MN,Passenger,3,0,3,88,91,3.3
May,31,2020,San Diego,CA,Passenger,14,5,19,2741,2760,0.69
May,31,2020,Monroe,IL,Passenger,1,0,1,4,5,20
May,31,2020,Cascade,MT,Passenger,0,1,1,55,56,1.79
May,31,2020,Sedgwick,KS,Passenger,1,1,2,92,94,2.13
May,31,2020,Sarasota,FL,Passenger,2,0,2,24,26,7.69
May,31,2020,Ramsey,MN,Passenger,1,0,1,39,40,2.5
May,31,2020,Klamath,OR,Passenger,1,0,1,33,34,2.94
May,31,2020,Whatcom,WA,Passenger,1060,496,1556,149298,150854,1.03
May,31,2020,Yakima,WA,Truck,0,0,0,59572,59572,0
May,31,2020,Juneau,AK,Passenger,0,2,2,29,31,6.45
May,31,2020,Clark,NV,Passenger,3,2,5,674,679,0.74
May,31,2020,Hamilton,IN,Passenger,1,0,1,39,40,2.5
May,31,2020,Pierce,WA,Truck,0,0,0,141318,141318,0
May,31,2020,Kern,CA,Passenger,0,1,1,225,226,0.44
May,31,2020,Pinal,AZ,Passenger,1,0,1,184,185,0.54
May,31,2020,Powhatan,VA,Passenger,1,0,1,0,1,100
May,31,2020,Snohomish,WA,Truck,0,0,0,123364,123364,0
May,31,2020,Chelan,WA,Truck,0,0,0,22434,22434,0
May,31,2020,Grant,WA,Passenger,59,70,129,65207,65336,0.2
May,31,2020,Okanogan,WA,Truck,0,0,0,16391,16391,0
May,31,2020,Suffolk,MA,Passenger,0,2,2,35,37,5.41
May,31,2020,Grays Harbor,WA,Passenger,106,111,217,48015,48232,0.45
May,31,2020,Franklin,WA,Truck,0,0,0,19869,19869,0
May,31,2020,Camden,NJ,Passenger,0,1,1,22,23,4.35
May,31,2020,Saginaw,MI,Passenger,1,0,1,10,11,9.09
May,31,2020,Houston,GA,Passenger,1,0,1,55,56,1.79
May,31,2020,Lewis,WA,Truck,0,0,0,26001,26001,0
May,31,2020,Clark,WA,Passenger,2003,1055,3058,317495,320553,0.95
May,31,2020,Randolph,NC,Passenger,1,0,1,7,8,12.5
May,31,2020,Larimer,CO,Passenger,1,0,1,51,52,1.92
May,31,2020,Denton,TX,Passenger,1,0,1,89,90,1.11
May,31,2020,Prince George's,MD,Passenger,1,1,2,161,163,1.23
May,31,2020,Ada,ID,Passenger,0,1,1,273,274,0.36
May,31,2020,DeKalb,IN,Passenger,1,0,1,1,2,50
May,31,2020,Hudson,NJ,Passenger,1,0,1,38,39,2.56
May,31,2020,San Mateo,CA,Passenger,0,1,1,113,114,0.88
May,31,2020,Kittitas,WA,Passenger,102,48,150,29778,29928,0.5
May,31,2020,Franklin,WA,Passenger,58,75,133,60574,60707,0.22
May,31,2020,Skamania,WA,Truck,0,0,0,4029,4029,0
May,31,2020,Deschutes,OR,Passenger,3,0,3,134,137,2.19
May,31,2020,Frederick,MD,Passenger,1,1,2,75,77,2.6
May,31,2020,St. Louis,MO,Passenger,1,0,1,99,100,1
May,31,2020,Whatcom,WA,Truck,3,0,3,42847,42850,0.01
May,31,2020,Maui,HI,Passenger,1,0,1,32,33,3.03
May,31,2020,Gwinnett,GA,Passenger,1,0,1,73,74,1.35
May,31,2020,Howard,MD,Passenger,0,1,1,71,72,1.39
May,31,2020,Polk,FL,Passenger,1,0,1,65,66,1.52
May,31,2020,RÃ­o Grande,PR,Passenger,1,0,1,1,2,50
May,31,2020,Douglas,NE,Passenger,0,1,1,54,55,1.82
May,31,2020,Shelby,OH,Passenger,0,1,1,1,2,50
May,31,2020,San Juan,WA,Passenger,298,91,389,14062,14451,2.69
May,31,2020,Vigo,IN,Passenger,1,0,1,5,6,16.67
May,31,2020,Skagit,WA,Truck,1,0,1,32389,32390,0
May,31,2020,Bexar,TX,Passenger,2,5,7,605,612,1.14
May,31,2020,Travis,TX,Passenger,2,1,3,180,183,1.64
May,31,2020,Montgomery,TX,Passenger,1,0,1,52,53,1.89
May,31,2020,Utah,UT,Passenger,0,1,1,132,133,0.75
May,31,2020,Prince William,VA,Passenger,2,3,5,218,223,2.24
May,31,2020,Stevens,WA,Truck,0,0,0,18598,18598,0
May,31,2020,Douglas,WA,Truck,0,0,0,12279,12279,0
May,31,2020,,,Passenger,9,6,15,866,881,1.7
May,31,2020,Washtenaw,MI,Passenger,1,0,1,34,35,2.86
May,31,2020,DuPage,IL,Passenger,3,0,3,57,60,5
May,31,2020,Sacramento,CA,Passenger,1,0,1,267,268,0.37
May,31,2020,Lake,IL,Passenger,1,0,1,163,164,0.61
May,31,2020,Cape May,NJ,Passenger,0,1,1,13,14,7.14
May,31,2020,Broward,FL,Passenger,2,1,3,113,116,2.59
May,31,2020,Grays Harbor,WA,Truck,0,0,0,20770,20770,0
May,31,2020,Collin,TX,Passenger,1,1,2,119,121,1.65
May,31,2020,Pinellas,FL,Passenger,1,1,2,108,110,1.82
May,31,2020,Harnett,NC,Passenger,1,0,1,201,202,0.5
May,31,2020,Solano,CA,Passenger,1,0,1,206,207,0.48
May,31,2020,Spartanburg,SC,Passenger,0,1,1,47,48,2.08
May,31,2020,St. Clair,IL,Passenger,1,0,1,137,138,0.72
May,31,2020,Fairfax,VA,Passenger,4,3,7,737,744,0.94
May,31,2020,New London,CT,Passenger,1,2,3,244,247,1.21
May,31,2020,Yakima,WA,Passenger,131,117,248,165018,165266,0.15
May,31,2020,Tulsa,OK,Passenger,1,1,2,44,46,4.35
May,31,2020,Grant,WA,Truck,0,0,0,26982,26982,0
May,31,2020,Allegheny,PA,Passenger,1,0,1,72,73,1.37
May,31,2020,Dallas,TX,Passenger,1,0,1,197,198,0.51
May,31,2020,El Paso,TX,Passenger,3,0,3,431,434,0.69
May,31,2020,Wilson,TX,Passenger,0,1,1,6,7,14.29
May,31,2020,Oldham,KY,Passenger,0,1,1,4,5,20
May,31,2020,Jefferson,WA,Passenger,233,141,374,24824,25198,1.48
May,31,2020,Flathead,MT,Passenger,1,0,1,62,63,1.59
May,31,2020,Bartow,GA,Passenger,0,1,1,3,4,25
May,31,2020,Okanogan,WA,Passenger,34,33,67,25879,25946,0.26
May,31,2020,Mason,WA,Passenger,157,137,294,47178,47472,0.62
May,31,2020,Island,WA,Passenger,409,270,679,62803,63482,1.07
May,31,2020,Guadalupe,TX,Passenger,1,0,1,65,66,1.52
May,31,2020,Ulster,NY,Passenger,1,0,1,7,8,12.5
May,31,2020,New Haven,CT,Passenger,0,2,2,39,41,4.88
May,31,2020,Lake,FL,Passenger,1,0,1,20,21,4.76
May,31,2020,Clallam,WA,Truck,1,0,1,21671,21672,0
May,31,2020,Jefferson,NY,Passenger,0,1,1,210,211,0.47
May,31,2020,Shasta,CA,Passenger,1,0,1,36,37,2.7
May,31,2020,Harris,TX,Passenger,1,0,1,230,231,0.43
May,31,2020,Nueces,TX,Passenger,1,0,1,81,82,1.22
May,31,2020,Douglas,WA,Passenger,69,40,109,27964,28073,0.39
May,31,2020,Rockingham,NH,Passenger,1,0,1,26,27,3.7
May,31,2020,Denver,CO,Passenger,1,0,1,119,120,0.83
May,31,2020,Fort Bend,TX,Passenger,1,0,1,46,47,2.13
May,31,2020,Carson City,NV,Passenger,1,0,1,10,11,9.09
May,31,2020,Asotin,WA,Truck,0,0,0,6587,6587,0
May,31,2020,Stafford,VA,Passenger,1,1,2,92,94,2.13
May,31,2020,Alexandria,VA,Passenger,1,0,1,140,141,0.71
May,31,2020,Multnomah,OR,Passenger,4,7,11,717,728,1.51
May,31,2020,Manassas,VA,Passenger,0,1,1,5,6,16.67
May,31,2020,Fulton,GA,Passenger,1,2,3,103,106,2.83
May,31,2020,Montgomery,OH,Passenger,0,1,1,47,48,2.08
May,31,2020,Mason,WA,Truck,0,0,0,20508,20508,0
May,31,2020,Suffolk,VA,Passenger,1,0,1,122,123,0.81
May,31,2020,Ventura,CA,Passenger,1,2,3,283,286,1.05
May,31,2020,San Juan,WA,Truck,0,0,0,5860,5860,0
May,31,2020,Whitman,WA,Truck,0,0,0,8514,8514,0
May,31,2020,Garfield,WA,Passenger,0,1,1,1347,1348,0.07
May,31,2020,Kootenai,ID,Passenger,1,0,1,223,224,0.45
May,31,2020,Orange,CA,Passenger,7,2,9,490,499,1.8
May,31,2020,Clay,FL,Passenger,0,1,1,80,81,1.23
May,31,2020,Cowlitz,WA,Passenger,136,115,251,72360,72611,0.35
May,31,2020,Charleston,SC,Passenger,1,0,1,105,106,0.94
May,31,2020,Anne Arundel,MD,Passenger,0,1,1,411,412,0.24
May,31,2020,Klickitat,WA,Truck,0,0,0,8121,8121,0
May,31,2020,Columbia,WA,Truck,0,0,0,1523,1523,0
May,31,2020,Montgomery,PA,Passenger,1,0,1,30,31,3.23
May,31,2020,Hawaii,HI,Passenger,1,0,1,56,57,1.75
May,31,2020,Duval,FL,Passenger,0,2,2,356,358,0.56
May,31,2020,Dakota,MN,Passenger,0,1,1,32,33,3.03
May,31,2020,Jefferson,CO,Passenger,0,1,1,58,59,1.69
May,31,2020,Penobscot,ME,Passenger,0,1,1,15,16,6.25
May,31,2020,Santa Cruz,CA,Passenger,1,0,1,34,35,2.86
May,31,2020,Garfield,WA,Truck,0,0,0,967,967,0
May,31,2020,Queens,NY,Passenger,1,0,1,51,52,1.92
May,31,2020,Brevard,FL,Passenger,0,1,1,84,85,1.18
May,31,2020,Whitman,WA,Passenger,45,48,93,22175,22268,0.42
May,31,2020,Clark,WA,Truck,0,0,0,81892,81892,0
May,31,2020,Valencia,NM,Passenger,1,0,1,5,6,16.67
May,31,2020,DeKalb,GA,Passenger,1,0,1,79,80,1.25
May,31,2020,Moore,NC,Passenger,0,1,1,161,162,0.62
May,31,2020,Montgomery,AL,Passenger,0,1,1,39,40,2.5
May,31,2020,Clallam,WA,Passenger,222,165,387,50115,50502,0.77
May,31,2020,Virginia Beach,VA,Passenger,1,0,1,669,670,0.15
May,31,2020,Maricopa,AZ,Passenger,5,6,11,1418,1429,0.77
May,31,2020,Boone,MO,Passenger,0,1,1,10,11,9.09
May,31,2020,Spokane,WA,Passenger,721,479,1200,315019,316219,0.38
May,31,2020,Rogers,OK,Passenger,1,0,1,5,6,16.67
May,31,2020,Thurston,WA,Truck,0,0,0,55495,55495,0
May,31,2020,Kitsap,WA,Passenger,1312,678,1990,179656,181646,1.1
May,31,2020,Adams,WA,Passenger,8,7,15,12719,12734,0.12
May,31,2020,Snohomish,WA,Passenger,4402,1748,6150,533885,540035,1.14
May,31,2020,Carroll,NH,Passenger,0,1,1,4,5,20
May,31,2020,Riverside,CA,Passenger,3,1,4,625,629,0.64
May,31,2020,Skamania,WA,Passenger,30,17,47,8525,8572,0.55
May,31,2020,Lee,FL,Passenger,1,0,1,50,51,1.96
May,31,2020,Washington,OR,Passenger,1,0,1,442,443,0.23
May,31,2020,Nassau,NY,Passenger,4,0,4,33,37,10.81
May,31,2020,St. Mary's,MD,Passenger,1,0,1,216,217,0.46
May,31,2020,Owyhee,ID,Passenger,1,0,1,3,4,25
May,31,2020,Loudoun,VA,Passenger,1,0,1,88,89,1.12
May,31,2020,Cowlitz,WA,Truck,0,0,0,28759,28759,0
May,31,2020,Lewis,WA,Passenger,99,108,207,58242,58449,0.35
May,31,2020,Putnam,TN,Passenger,0,1,1,3,4,25
May,31,2020,Bucks,PA,Passenger,1,0,1,20,21,4.76
May,31,2020,Charles,MD,Passenger,1,1,2,73,75,2.67
May,31,2020,Jefferson,WA,Truck,0,0,0,9510,9510,0
May,31,2020,King,WA,Truck,5,1,6,181412,181418,0
May,31,2020,Richland,SC,Passenger,0,1,1,154,155,0.65
May,31,2020,Stevens,WA,Passenger,34,33,67,30736,30803,0.22
May,31,2020,Kitsap,WA,Truck,0,0,0,53864,53864,0
May,31,2020,District of Columbia,DC,Passenger,2,1,3,201,204,1.47
May,31,2020,Cumberland,NC,Passenger,0,3,3,466,469,0.64
May,31,2020,Clackamas,OR,Passenger,2,0,2,197,199,1.01
May,31,2020,Ferry,WA,Truck,0,0,0,3540,3540,0
May,31,2020,Placer,CA,Passenger,2,0,2,87,89,2.25
May,31,2020,Richmond,GA,Passenger,0,1,1,86,87,1.15
May,31,2020,Harrison,MS,Passenger,1,0,1,55,56,1.79
May,31,2020,Kent,MI,Passenger,0,1,1,23,24,4.17
May,31,2020,Adams,WA,Truck,0,0,0,5217,5217,0
May,31,2020,Jones,GA,Passenger,1,0,1,1,2,50
May,31,2020,Kittitas,WA,Truck,0,0,0,14554,14554,0
May,31,2020,San Francisco,CA,Passenger,1,1,2,96,98,2.04
May,31,2020,Island,WA,Truck,1,0,1,21136,21137,0
May,31,2020,Middlesex,MA,Passenger,1,1,2,96,98,2.04
May,31,2020,Lincoln,WA,Truck,0,0,0,4618,4618,0
May,31,2020,Fresno,CA,Passenger,1,0,1,183,184,0.54
May,31,2020,Pend Oreille,WA,Passenger,7,6,13,9217,9230,0.14
May,31,2020,Honolulu,HI,Passenger,4,2,6,448,454,1.32
May,31,2020,Pima,AZ,Passenger,3,1,4,343,347,1.15
May,31,2020,Albemarle,VA,Passenger,1,0,1,20,21,4.76
May,31,2020,Pierce,WA,Passenger,2351,1675,4026,547592,551618,0.73
May,31,2020,Portsmouth,VA,Passenger,0,1,1,76,77,1.3
May,31,2020,Thurston,WA,Passenger,1136,733,1869,196825,198694,0.94
May,31,2020,King,WA,Passenger,24017,7688,31705,1374959,1406664,2.25
May,31,2020,El Paso,CO,Passenger,2,0,2,717,719,0.28
May,31,2020,Benton,WA,Truck,0,0,0,42474,42474,0
May,31,2020,Twin Falls,ID,Passenger,0,1,1,26,27,3.7
May,31,2020,San Joaquin,CA,Passenger,1,0,1,127,128,0.78
May,31,2020,Fairbanks North Star,AK,Passenger,0,1,1,99,100,1
May,31,2020,Shelby,TN,Passenger,0,1,1,86,87,1.15
May,31,2020,Pend Oreille,WA,Truck,0,0,0,5741,5741,0
May,31,2020,Santa Clara,CA,Passenger,7,2,9,304,313,2.88
May,31,2020,Boulder,CO,Passenger,0,1,1,45,46,2.17
May,31,2020,Lincoln,WA,Passenger,4,12,16,7640,7656,0.21
May,31,2020,Greene,MO,Passenger,0,1,1,30,31,3.23
May,31,2020,Wahkiakum,WA,Truck,0,0,0,1759,1759,0
May,31,2020,Alameda,CA,Passenger,2,1,3,271,274,1.09
May,31,2020,Sumter,FL,Passenger,0,1,1,9,10,10
May,31,2020,Williamson,TX,Passenger,0,2,2,137,139,1.44
May,31,2020,Osceola,FL,Passenger,1,0,1,39,40,2.5
May,31,2020,Goochland,VA,Passenger,2,1,3,258,261,1.15
May,31,2020,Chesapeake,VA,Passenger,0,2,2,420,422,0.47
May,31,2020,Palm Beach,FL,Passenger,0,1,1,80,81,1.23
May,31,2020,Walla Walla,WA,Passenger,70,62,132,35820,35952,0.37
May,31,2020,Asotin,WA,Passenger,16,12,28,12338,12366,0.23
May,31,2020,Benton,WA,Passenger,354,321,675,134165,134840,0.5
May,31,2020,Skagit,WA,Passenger,400,216,616,91169,91785,0.67
May,31,2020,Norfolk,VA,Passenger,2,2,4,345,349,1.15
May,31,2020,Arapahoe,CO,Passenger,1,0,1,132,133,0.75
May,31,2020,Klickitat,WA,Passenger,53,40,93,15273,15366,0.61
May,31,2020,Pacific,WA,Passenger,31,33,64,15703,15767,0.41
May,31,2020,Walla Walla,WA,Truck,0,0,0,13670,13670,0
May,31,2020,Los Angeles,CA,Passenger,7,11,18,991,1009,1.78
May,31,2020,Ferry,WA,Passenger,5,3,8,4331,4339,0.18
November,30,2020,St. Mary's,MD,Passenger,1,0,1,215,216,0.46
November,30,2020,Palm Beach,FL,Passenger,0,1,1,73,74,1.35
November,30,2020,Prince William,VA,Passenger,2,2,4,220,224,1.79
November,30,2020,Adams,WA,Passenger,10,6,16,12942,12958,0.12
November,30,2020,Walla Walla,WA,Passenger,95,66,161,36066,36227,0.44
November,30,2020,Riverside,CA,Passenger,4,1,5,598,603,0.83
November,30,2020,Loudoun,VA,Passenger,1,0,1,77,78,1.28
November,30,2020,Pend Oreille,WA,Truck,0,0,0,5718,5718,0
November,30,2020,Santa Cruz,CA,Passenger,1,0,1,29,30,3.33
November,30,2020,Skamania,WA,Passenger,33,21,54,8305,8359,0.65
November,30,2020,San Juan,WA,Truck,0,0,0,5866,5866,0
November,30,2020,Cascade,MT,Passenger,0,1,1,52,53,1.89
November,30,2020,Clallam,WA,Passenger,262,176,438,49872,50310,0.87
November,30,2020,Williamson,TX,Passenger,0,2,2,122,124,1.61
November,30,2020,Cape May,NJ,Passenger,0,1,1,10,11,9.09
November,30,2020,Erie,NY,Passenger,1,0,1,44,45,2.22
November,30,2020,Goochland,VA,Passenger,4,2,6,243,249,2.41
November,30,2020,Fresno,CA,Passenger,1,0,1,169,170,0.59
November,30,2020,Ulster,NY,Passenger,1,0,1,8,9,11.11
November,30,2020,Frederick,MD,Passenger,1,1,2,73,75,2.67
November,30,2020,El Dorado,CA,Passenger,1,0,1,33,34,2.94
November,30,2020,Maricopa,AZ,Passenger,5,6,11,1316,1327,0.83
November,30,2020,Manassas,VA,Passenger,0,1,1,5,6,16.67
November,30,2020,Bradley,TN,Passenger,1,0,1,0,1,100
November,30,2020,DuPage,IL,Passenger,3,0,3,53,56,5.36
November,30,2020,Pierce,WA,Passenger,2759,1756,4515,554918,559433,0.81
November,30,2020,Whitman,WA,Passenger,51,44,95,21963,22058,0.43
November,30,2020,Lewis,WA,Truck,0,0,0,26547,26547,0
November,30,2020,Hawaii,HI,Passenger,1,0,1,52,53,1.89
November,30,2020,Saginaw,MI,Passenger,1,0,1,9,10,10
November,30,2020,Cowlitz,WA,Truck,0,0,0,28871,28871,0
November,30,2020,Yakima,WA,Passenger,166,122,288,167009,167297,0.17
November,30,2020,Adams,WA,Truck,0,0,0,5325,5325,0
November,30,2020,Mason,WA,Truck,0,0,0,20860,20860,0
November,30,2020,Missoula,MT,Passenger,1,0,1,63,64,1.56
November,30,2020,Mason,WA,Passenger,169,135,304,47500,47804,0.64
November,30,2020,Richland,SC,Passenger,0,1,1,139,140,0.71
November,30,2020,Skagit,WA,Truck,1,0,1,32715,32716,0
November,30,2020,Camden,NJ,Passenger,0,1,1,22,23,4.35
November,30,2020,Orange,FL,Passenger,1,0,1,115,116,0.86
November,30,2020,King,WA,Truck,6,1,7,184180,184187,0
November,30,2020,Asotin,WA,Truck,0,0,0,6665,6665,0
November,30,2020,Harris,TX,Passenger,1,0,1,215,216,0.46
November,30,2020,Pacific,WA,Passenger,36,34,70,15737,15807,0.44
November,30,2020,Anne Arundel,MD,Passenger,1,1,2,399,401,0.5
November,30,2020,Montgomery,TX,Passenger,1,0,1,47,48,2.08
November,30,2020,Kings,NY,Passenger,1,0,1,63,64,1.56
November,30,2020,Hudson,NJ,Passenger,1,0,1,38,39,2.56
November,30,2020,Spokane,WA,Passenger,859,542,1401,320275,321676,0.44
November,30,2020,Nassau,NY,Passenger,4,0,4,28,32,12.5
November,30,2020,Stevens,WA,Passenger,36,39,75,30275,30350,0.25
November,30,2020,Fulton,GA,Passenger,1,2,3,89,92,3.26
November,30,2020,Garfield,WA,Truck,0,0,0,997,997,0
November,30,2020,Suffolk,VA,Passenger,1,0,1,125,126,0.79
November,30,2020,Okaloosa,FL,Passenger,0,1,1,133,134,0.75
November,30,2020,Jones,GA,Passenger,1,0,1,1,2,50
November,30,2020,Thurston,WA,Passenger,1290,763,2053,197232,199285,1.03
November,30,2020,Moore,NC,Passenger,0,1,1,152,153,0.65
November,30,2020,Randolph,NC,Passenger,1,0,1,6,7,14.29
November,30,2020,Jefferson,WA,Passenger,276,153,429,24728,25157,1.71
November,30,2020,Williams,ND,Passenger,0,1,1,10,11,9.09
November,30,2020,Columbia,WA,Truck,0,0,0,1530,1530,0
November,30,2020,Kittitas,WA,Truck,0,0,0,14645,14645,0
November,30,2020,Carroll,MD,Passenger,0,1,1,21,22,4.55
November,30,2020,Suffolk,MA,Passenger,0,2,2,33,35,5.71
November,30,2020,Twin Falls,ID,Passenger,0,1,1,24,25,4
November,30,2020,Bexar,TX,Passenger,4,5,9,567,576,1.56
November,30,2020,Okanogan,WA,Passenger,51,37,88,25984,26072,0.34
November,30,2020,San Mateo,CA,Passenger,1,1,2,108,110,1.82
November,30,2020,St. Clair,IL,Passenger,1,0,1,138,139,0.72
November,30,2020,Platte,MO,Passenger,1,0,1,17,18,5.56
November,30,2020,Pinellas,FL,Passenger,1,1,2,98,100,2
November,30,2020,Asotin,WA,Passenger,17,14,31,12411,12442,0.25
November,30,2020,Jefferson,NY,Passenger,0,1,1,209,210,0.48
November,30,2020,Howard,MD,Passenger,0,1,1,62,63,1.59
November,30,2020,Lake,FL,Passenger,1,0,1,22,23,4.35
November,30,2020,Arapahoe,CO,Passenger,1,0,1,121,122,0.82
November,30,2020,Gwinnett,GA,Passenger,1,0,1,69,70,1.43
November,30,2020,Washtenaw,MI,Passenger,1,0,1,31,32,3.12
November,30,2020,Clark,WA,Passenger,2284,1140,3424,318828,322252,1.06
November,30,2020,Snohomish,WA,Passenger,4956,1823,6779,538061,544840,1.24
November,30,2020,Orange,CA,Passenger,4,3,7,451,458,1.53
November,30,2020,San Juan,WA,Passenger,355,106,461,14017,14478,3.18
November,30,2020,Prince George's,MD,Passenger,2,1,3,148,151,1.99
November,30,2020,Kern,CA,Passenger,0,1,1,216,217,0.46
November,30,2020,Spartanburg,SC,Passenger,0,1,1,48,49,2.04
November,30,2020,Benton,WA,Passenger,426,348,774,134791,135565,0.57
November,30,2020,El Paso,TX,Passenger,3,0,3,400,403,0.74
November,30,2020,Deschutes,OR,Passenger,1,0,1,122,123,0.81
November,30,2020,Rockingham,NH,Passenger,1,0,1,22,23,4.35
November,30,2020,Anchorage,AK,Passenger,1,0,1,143,144,0.69
November,30,2020,Placer,CA,Passenger,2,0,2,85,87,2.3
November,30,2020,Pima,AZ,Passenger,3,1,4,324,328,1.22
November,30,2020,San Diego,CA,Passenger,14,4,18,2711,2729,0.66
November,30,2020,Klickitat,WA,Truck,0,0,0,8086,8086,0
November,30,2020,Santa Clara,CA,Passenger,6,2,8,270,278,2.88
November,30,2020,Ventura,CA,Passenger,1,1,2,269,271,0.74
November,30,2020,San Joaquin,CA,Passenger,1,0,1,110,111,0.9
November,30,2020,Wichita,TX,Passenger,1,0,1,41,42,2.38
November,30,2020,Arlington,VA,Passenger,0,2,2,143,145,1.38
November,30,2020,Island,WA,Passenger,480,287,767,62942,63709,1.2
November,30,2020,Larimer,CO,Passenger,1,0,1,53,54,1.85
November,30,2020,Stevens,WA,Truck,0,0,0,18671,18671,0
November,30,2020,Albemarle,VA,Passenger,1,0,1,21,22,4.55
November,30,2020,Ada,ID,Passenger,0,1,1,245,246,0.41
November,30,2020,Oldham,KY,Passenger,0,1,1,4,5,20
November,30,2020,Harrison,MS,Passenger,1,0,1,53,54,1.85
November,30,2020,Norfolk,VA,Passenger,2,3,5,341,346,1.45
November,30,2020,Douglas,WA,Passenger,82,43,125,28127,28252,0.44
November,30,2020,Whatcom,WA,Truck,3,0,3,43487,43490,0.01
November,30,2020,Houston,GA,Passenger,1,0,1,52,53,1.89
November,30,2020,New Haven,CT,Passenger,0,2,2,35,37,5.41
November,30,2020,Plaquemines,LA,Passenger,0,1,1,13,14,7.14
November,30,2020,Bartow,GA,Passenger,0,1,1,4,5,20
November,30,2020,Klickitat,WA,Passenger,62,42,104,14976,15080,0.69
November,30,2020,Monroe,IL,Passenger,1,0,1,3,4,25
November,30,2020,Dakota,MN,Passenger,0,1,1,28,29,3.45
November,30,2020,Shelby,OH,Passenger,0,1,1,1,2,50
November,30,2020,Wahkiakum,WA,Truck,0,0,0,1766,1766,0
November,30,2020,Lee,FL,Passenger,1,0,1,45,46,2.17
November,30,2020,Skagit,WA,Passenger,481,235,716,91415,92131,0.78
November,30,2020,Queens,NY,Passenger,1,0,1,52,53,1.89
November,30,2020,San Francisco,CA,Passenger,1,1,2,89,91,2.2
November,30,2020,St. Louis,MO,Passenger,1,0,1,95,96,1.04
November,30,2020,Douglas,NE,Passenger,0,1,1,48,49,2.04
November,30,2020,DeKalb,IN,Passenger,1,0,1,0,1,100
November,30,2020,Snohomish,WA,Truck,0,0,0,125469,125469,0
November,30,2020,Grant,WA,Passenger,78,79,157,65766,65923,0.24
November,30,2020,New London,CT,Passenger,1,2,3,237,240,1.25
November,30,2020,Chelan,WA,Truck,0,0,0,22778,22778,0
November,30,2020,Clark,WA,Truck,0,0,0,83228,83228,0
November,30,2020,Hamilton,IN,Passenger,2,0,2,34,36,5.56
November,30,2020,Nassau,FL,Passenger,1,0,1,36,37,2.7
November,30,2020,Solano,CA,Passenger,1,0,1,206,207,0.48
November,30,2020,Owyhee,ID,Passenger,1,0,1,3,4,25
November,30,2020,Clallam,WA,Truck,1,0,1,21782,21783,0
November,30,2020,Harnett,NC,Passenger,1,0,1,187,188,0.53
November,30,2020,Whitman,WA,Truck,0,0,0,8487,8487,0
November,30,2020,Powhatan,VA,Passenger,1,0,1,0,1,100
November,30,2020,Kent,MI,Passenger,0,1,1,24,25,4
November,30,2020,Lewis,WA,Passenger,117,117,234,58633,58867,0.4
November,30,2020,Cowlitz,WA,Passenger,170,124,294,72016,72310,0.41
November,30,2020,Jefferson,WA,Truck,0,0,0,9582,9582,0
November,30,2020,District of Columbia,DC,Passenger,3,1,4,199,203,1.97
November,30,2020,Charleston,SC,Passenger,2,0,2,91,93,2.15
November,30,2020,Vigo,IN,Passenger,1,0,1,6,7,14.29
November,30,2020,Polk,FL,Passenger,1,0,1,58,59,1.69
November,30,2020,Maui,HI,Passenger,1,0,1,28,29,3.45
November,30,2020,Bucks,PA,Passenger,1,0,1,18,19,5.26
November,30,2020,Grays Harbor,WA,Passenger,122,117,239,48546,48785,0.49
November,30,2020,Boulder,CO,Passenger,0,1,1,44,45,2.22
November,30,2020,Franklin,WA,Truck,0,0,0,20378,20378,0
November,30,2020,Alexandria,VA,Passenger,2,0,2,134,136,1.47
November,30,2020,Broward,FL,Passenger,2,1,3,109,112,2.68
November,30,2020,Stafford,VA,Passenger,1,1,2,93,95,2.11
November,30,2020,Nueces,TX,Passenger,1,0,1,83,84,1.19
November,30,2020,Walla Walla,WA,Truck,0,0,0,13819,13819,0
November,30,2020,Kauai,HI,Passenger,1,0,1,15,16,6.25
November,30,2020,Dallas,TX,Passenger,1,0,1,174,175,0.57
November,30,2020,Collin,TX,Passenger,1,1,2,117,119,1.68
November,30,2020,Washington,OR,Passenger,1,0,1,416,417,0.24
November,30,2020,Ferry,WA,Passenger,8,3,11,4347,4358,0.25
November,30,2020,Calvert,MD,Passenger,0,2,2,85,87,2.3
November,30,2020,Tulsa,OK,Passenger,1,1,2,39,41,4.88
November,30,2020,Pierce,WA,Truck,0,0,0,144543,144543,0
November,30,2020,Richmond,GA,Passenger,0,1,1,79,80,1.25
November,30,2020,Alameda,CA,Passenger,3,0,3,259,262,1.15
November,30,2020,Montgomery,OH,Passenger,0,1,1,52,53,1.89
November,30,2020,Penobscot,ME,Passenger,0,1,1,10,11,9.09
November,30,2020,Leavenworth,KS,Passenger,0,1,1,125,126,0.79
November,30,2020,Pacific,WA,Truck,0,0,0,7762,7762,0
November,30,2020,Okanogan,WA,Truck,0,0,0,16579,16579,0
November,30,2020,Charles,MD,Passenger,1,1,2,73,75,2.67
November,30,2020,Whatcom,WA,Passenger,1203,534,1737,149736,151473,1.15
November,30,2020,Klamath,OR,Passenger,1,0,1,31,32,3.12
November,30,2020,Sumter,FL,Passenger,0,1,1,10,11,9.09
November,30,2020,Douglas,CO,Passenger,0,1,1,78,79,1.27
November,30,2020,Kittitas,WA,Passenger,125,52,177,29743,29920,0.59
November,30,2020,Benton,WA,Truck,0,0,0,43111,43111,0
November,30,2020,Honolulu,HI,Passenger,5,2,7,429,436,1.61
November,30,2020,Kitsap,WA,Passenger,1521,737,2258,179773,182031,1.24
November,30,2020,Denton,TX,Passenger,1,0,1,85,86,1.16
November,30,2020,Flathead,MT,Passenger,1,0,1,53,54,1.85
November,30,2020,Yakima,WA,Truck,0,0,0,60772,60772,0
November,30,2020,DeKalb,GA,Passenger,1,0,1,71,72,1.39
November,30,2020,Carson City,NV,Passenger,1,0,1,12,13,7.69
November,30,2020,Ramsey,MN,Passenger,1,0,1,34,35,2.86
November,30,2020,Middlesex,MA,Passenger,1,1,2,91,93,2.15
November,30,2020,Island,WA,Truck,0,0,0,21304,21304,0
November,30,2020,Putnam,TN,Passenger,0,1,1,2,3,33.33
November,30,2020,Sacramento,CA,Passenger,2,0,2,242,244,0.82
November,30,2020,Garfield,WA,Passenger,0,1,1,1363,1364,0.07
November,30,2020,Hampshire,MA,Passenger,1,0,1,6,7,14.29
November,30,2020,Chesapeake,VA,Passenger,0,3,3,405,408,0.74
November,30,2020,Lincoln,WA,Truck,0,0,0,4660,4660,0
November,30,2020,Spokane,WA,Truck,0,0,0,100377,100377,0
November,30,2020,Clark,NV,Passenger,3,2,5,653,658,0.76
November,30,2020,Skamania,WA,Truck,0,0,0,4008,4008,0
November,30,2020,Sarasota,FL,Passenger,2,0,2,26,28,7.14
November,30,2020,Pend Oreille,WA,Passenger,9,4,13,9146,9159,0.14
November,30,2020,Wilson,TX,Passenger,0,1,1,5,6,16.67
November,30,2020,Morris,NJ,Passenger,1,0,1,17,18,5.56
November,30,2020,Juneau,AK,Passenger,0,1,1,26,27,3.7
November,30,2020,Contra Costa,CA,Passenger,4,3,7,284,291,2.41
November,30,2020,Portsmouth,VA,Passenger,0,1,1,76,77,1.3
November,30,2020,Washoe,NV,Passenger,1,0,1,103,104,0.96
November,30,2020,Fairfax,VA,Passenger,4,3,7,710,717,0.98
November,30,2020,RÃ­o Grande,PR,Passenger,1,0,1,1,2,50
November,30,2020,Rogers,OK,Passenger,1,0,1,4,5,20
November,30,2020,Los Angeles,CA,Passenger,9,10,19,957,976,1.95
November,30,2020,Virginia Beach,VA,Passenger,1,0,1,643,644,0.16
November,30,2020,Lincoln,WA,Passenger,5,11,16,7617,7633,0.21
November,30,2020,Greene,MO,Passenger,0,1,1,32,33,3.03
November,30,2020,Grays Harbor,WA,Truck,0,0,0,21133,21133,0
November,30,2020,Columbia,WA,Passenger,4,3,7,2439,2446,0.29
November,30,2020,,,Passenger,8,7,15,965,980,1.53
November,30,2020,Sedgwick,KS,Passenger,1,1,2,89,91,2.2
November,30,2020,Cumberland,NC,Passenger,0,3,3,447,450,0.67
November,30,2020,Carroll,NH,Passenger,0,1,1,5,6,16.67
November,30,2020,Franklin,WA,Passenger,78,80,158,61166,61324,0.26
November,30,2020,Kitsap,WA,Truck,0,0,0,54292,54292,0
November,30,2020,Allegheny,PA,Passenger,1,1,2,66,68,2.94
November,30,2020,Miami-Dade,FL,Passenger,1,0,1,101,102,0.98
November,30,2020,Utah,UT,Passenger,0,1,1,128,129,0.78
November,30,2020,Grant,WA,Truck,0,0,0,27418,27418,0
November,30,2020,Travis,TX,Passenger,2,0,2,170,172,1.16
November,30,2020,Montgomery,AL,Passenger,0,1,1,40,41,2.44
November,30,2020,Monterey,CA,Passenger,0,1,1,155,156,0.64
November,30,2020,Fairbanks North Star,AK,Passenger,0,1,1,92,93,1.08
November,30,2020,Thurston,WA,Truck,0,0,0,56280,56280,0
November,30,2020,Montgomery,PA,Passenger,1,0,1,24,25,4
November,30,2020,Clackamas,OR,Passenger,2,0,2,179,181,1.1
November,30,2020,Salt Lake,UT,Passenger,0,1,1,172,173,0.58
November,30,2020,Fort Bend,TX,Passenger,1,0,1,42,43,2.33
November,30,2020,Ferry,WA,Truck,0,0,0,3598,3598,0
November,30,2020,El Paso,CO,Passenger,2,0,2,699,701,0.29
November,30,2020,Wahkiakum,WA,Passenger,6,6,12,3039,3051,0.39
November,30,2020,Multnomah,OR,Passenger,3,6,9,690,699,1.29
November,30,2020,New York,NY,Passenger,1,0,1,54,55,1.82
November,30,2020,Hennepin,MN,Passenger,2,0,2,83,85,2.35
November,30,2020,King,WA,Passenger,26599,8083,34682,1371168,1405850,2.47
November,30,2020,Howard,IN,Passenger,0,1,1,3,4,25
November,30,2020,Chelan,WA,Passenger,271,84,355,54377,54732,0.65
November,30,2020,Denver,CO,Passenger,1,0,1,114,115,0.87
November,30,2020,Douglas,WA,Truck,0,0,0,12451,12451,0
November,30,2020,Lake,IL,Passenger,2,0,2,158,160,1.25
November,30,2020,Boone,MO,Passenger,0,1,1,10,11,9.09
November,30,2020,Duval,FL,Passenger,0,2,2,354,356,0.56
October,31,2020,District of Columbia,DC,Passenger,2,1,3,199,202,1.49
October,31,2020,RÃ­o Grande,PR,Passenger,1,0,1,1,2,50
October,31,2020,,,Passenger,8,7,15,961,976,1.54
October,31,2020,Montgomery,PA,Passenger,1,0,1,25,26,3.85
October,31,2020,Randolph,NC,Passenger,1,0,1,7,8,12.5
October,31,2020,Whitman,WA,Passenger,50,46,96,21981,22077,0.43
October,31,2020,Collin,TX,Passenger,1,1,2,116,118,1.69
October,31,2020,Plaquemines,LA,Passenger,0,1,1,13,14,7.14
October,31,2020,Santa Clara,CA,Passenger,5,2,7,270,277,2.53
October,31,2020,Clark,NV,Passenger,3,2,5,660,665,0.75
October,31,2020,Orange,CA,Passenger,5,3,8,461,469,1.71
October,31,2020,Placer,CA,Passenger,2,0,2,85,87,2.3
October,31,2020,Clark,WA,Passenger,2212,1121,3333,318837,322170,1.03
October,31,2020,New Haven,CT,Passenger,0,2,2,33,35,5.71
October,31,2020,Stevens,WA,Truck,0,0,0,18696,18696,0
October,31,2020,Thurston,WA,Truck,0,0,0,56300,56300,0
October,31,2020,Whatcom,WA,Passenger,1169,531,1700,149671,151371,1.12
October,31,2020,Harnett,NC,Passenger,1,0,1,188,189,0.53
October,31,2020,Skagit,WA,Truck,1,0,1,32682,32683,0
October,31,2020,Moore,NC,Passenger,0,1,1,152,153,0.65
October,31,2020,Bexar,TX,Passenger,4,5,9,576,585,1.54
October,31,2020,Klickitat,WA,Truck,0,0,0,8088,8088,0
October,31,2020,Arapahoe,CO,Passenger,1,0,1,122,123,0.81
October,31,2020,Columbia,WA,Truck,0,0,0,1532,1532,0
October,31,2020,Duval,FL,Passenger,0,2,2,357,359,0.56
October,31,2020,Kent,MI,Passenger,0,1,1,23,24,4.17
October,31,2020,Cascade,MT,Passenger,0,1,1,51,52,1.92
October,31,2020,Ferry,WA,Truck,0,0,0,3596,3596,0
October,31,2020,Palm Beach,FL,Passenger,0,1,1,75,76,1.32
October,31,2020,Fresno,CA,Passenger,1,0,1,174,175,0.57
October,31,2020,Walla Walla,WA,Passenger,86,65,151,36014,36165,0.42
October,31,2020,San Juan,WA,Truck,0,0,0,5864,5864,0
October,31,2020,Clackamas,OR,Passenger,2,0,2,184,186,1.08
October,31,2020,Pierce,WA,Truck,0,0,0,144394,144394,0
October,31,2020,Lake,FL,Passenger,1,0,1,22,23,4.35
October,31,2020,Monterey,CA,Passenger,0,1,1,155,156,0.64
October,31,2020,Clark,WA,Truck,0,0,0,83170,83170,0
October,31,2020,Island,WA,Passenger,463,284,747,62908,63655,1.17
October,31,2020,Monroe,IL,Passenger,1,0,1,3,4,25
October,31,2020,Howard,MD,Passenger,0,1,1,62,63,1.59
October,31,2020,Williamson,TX,Passenger,0,2,2,127,129,1.55
October,31,2020,Whatcom,WA,Truck,3,0,3,43462,43465,0.01
October,31,2020,Kitsap,WA,Truck,0,0,0,54236,54236,0
October,31,2020,Cape May,NJ,Passenger,0,1,1,12,13,7.69
October,31,2020,Larimer,CO,Passenger,1,0,1,51,52,1.92
October,31,2020,San Juan,WA,Passenger,340,103,443,13969,14412,3.07
October,31,2020,Deschutes,OR,Passenger,1,0,1,123,124,0.81
October,31,2020,Bartow,GA,Passenger,0,1,1,4,5,20
October,31,2020,Contra Costa,CA,Passenger,4,3,7,286,293,2.39
October,31,2020,King,WA,Passenger,25876,8012,33888,1372970,1406858,2.41
October,31,2020,Fairfax,VA,Passenger,4,3,7,717,724,0.97
October,31,2020,Harris,TX,Passenger,1,0,1,220,221,0.45
October,31,2020,Ventura,CA,Passenger,1,1,2,271,273,0.73
October,31,2020,Richmond,GA,Passenger,0,1,1,79,80,1.25
October,31,2020,New London,CT,Passenger,1,2,3,237,240,1.25
October,31,2020,Frederick,MD,Passenger,1,1,2,72,74,2.7
October,31,2020,Rogers,OK,Passenger,1,0,1,4,5,20
October,31,2020,Platte,MO,Passenger,1,0,1,17,18,5.56
October,31,2020,Tulsa,OK,Passenger,1,1,2,40,42,4.76
October,31,2020,San Francisco,CA,Passenger,1,1,2,90,92,2.17
October,31,2020,Los Angeles,CA,Passenger,9,10,19,969,988,1.92
October,31,2020,Walla Walla,WA,Truck,0,0,0,13797,13797,0
October,31,2020,Garfield,WA,Passenger,0,1,1,1352,1353,0.07
October,31,2020,Spokane,WA,Passenger,828,525,1353,319743,321096,0.42
October,31,2020,Twin Falls,ID,Passenger,0,1,1,23,24,4.17
October,31,2020,Denton,TX,Passenger,1,0,1,85,86,1.16
October,31,2020,Douglas,WA,Truck,0,0,0,12416,12416,0
October,31,2020,Morris,NJ,Passenger,1,0,1,18,19,5.26
October,31,2020,DeKalb,IN,Passenger,1,0,1,1,2,50
October,31,2020,Douglas,WA,Passenger,80,43,123,28068,28191,0.44
October,31,2020,Allegheny,PA,Passenger,1,0,1,68,69,1.45
October,31,2020,Douglas,NE,Passenger,0,1,1,48,49,2.04
October,31,2020,Boone,MO,Passenger,0,1,1,10,11,9.09
October,31,2020,Charles,MD,Passenger,1,1,2,75,77,2.6
October,31,2020,Grant,WA,Truck,0,0,0,27386,27386,0
October,31,2020,Oldham,KY,Passenger,0,1,1,4,5,20
October,31,2020,Benton,WA,Truck,0,0,0,43068,43068,0
October,31,2020,Okanogan,WA,Passenger,47,36,83,25991,26074,0.32
October,31,2020,Clallam,WA,Truck,1,0,1,21767,21768,0
October,31,2020,Washtenaw,MI,Passenger,1,0,1,31,32,3.12
October,31,2020,Greene,MO,Passenger,0,1,1,33,34,2.94
October,31,2020,Klamath,OR,Passenger,1,0,1,31,32,3.12
October,31,2020,Skamania,WA,Passenger,32,20,52,8331,8383,0.62
October,31,2020,Howard,IN,Passenger,0,1,1,3,4,25
October,31,2020,Sumter,FL,Passenger,0,1,1,10,11,9.09
October,31,2020,Vigo,IN,Passenger,1,0,1,6,7,14.29
October,31,2020,Wilson,TX,Passenger,0,1,1,5,6,16.67
October,31,2020,Franklin,WA,Truck,0,0,0,20373,20373,0
October,31,2020,Spartanburg,SC,Passenger,0,1,1,49,50,2
October,31,2020,Montgomery,AL,Passenger,0,1,1,40,41,2.44
October,31,2020,Clallam,WA,Passenger,252,173,425,49893,50318,0.84
October,31,2020,Alexandria,VA,Passenger,2,0,2,135,137,1.46
October,31,2020,Calvert,MD,Passenger,0,2,2,84,86,2.33
October,31,2020,Santa Cruz,CA,Passenger,1,0,1,30,31,3.23
October,31,2020,Prince George's,MD,Passenger,2,1,3,150,153,1.96
October,31,2020,Douglas,CO,Passenger,0,1,1,77,78,1.28
October,31,2020,Salt Lake,UT,Passenger,0,1,1,176,177,0.56
October,31,2020,Juneau,AK,Passenger,0,1,1,27,28,3.57
October,31,2020,Owyhee,ID,Passenger,1,0,1,3,4,25
October,31,2020,Dallas,TX,Passenger,1,0,1,179,180,0.56
October,31,2020,Chelan,WA,Passenger,265,82,347,54374,54721,0.63
October,31,2020,Okaloosa,FL,Passenger,0,1,1,137,138,0.72
October,31,2020,Prince William,VA,Passenger,2,2,4,220,224,1.79
October,31,2020,Miami-Dade,FL,Passenger,1,0,1,103,104,0.96
October,31,2020,Suffolk,MA,Passenger,0,2,2,34,36,5.56
October,31,2020,Shelby,OH,Passenger,0,1,1,1,2,50
October,31,2020,Cowlitz,WA,Truck,0,0,0,28894,28894,0
October,31,2020,Kittitas,WA,Truck,0,0,0,14630,14630,0
October,31,2020,St. Louis,MO,Passenger,1,0,1,97,98,1.02
October,31,2020,Middlesex,MA,Passenger,1,1,2,94,96,2.08
October,31,2020,Adams,WA,Passenger,8,7,15,12936,12951,0.12
October,31,2020,Ferry,WA,Passenger,8,3,11,4351,4362,0.25
October,31,2020,Kittitas,WA,Passenger,121,49,170,29701,29871,0.57
October,31,2020,Washington,OR,Passenger,1,0,1,421,422,0.24
October,31,2020,Pacific,WA,Passenger,34,34,68,15725,15793,0.43
October,31,2020,Mason,WA,Passenger,165,134,299,47497,47796,0.63
October,31,2020,Wahkiakum,WA,Passenger,6,6,12,3035,3047,0.39
October,31,2020,Hawaii,HI,Passenger,1,0,1,52,53,1.89
October,31,2020,Skamania,WA,Truck,0,0,0,3995,3995,0
October,31,2020,Manassas,VA,Passenger,0,1,1,5,6,16.67
October,31,2020,Asotin,WA,Truck,0,0,0,6685,6685,0
October,31,2020,Lee,FL,Passenger,1,0,1,47,48,2.08
October,31,2020,Stafford,VA,Passenger,1,1,2,94,96,2.08
October,31,2020,Lewis,WA,Truck,0,0,0,26496,26496,0
October,31,2020,Kern,CA,Passenger,0,1,1,219,220,0.45
October,31,2020,Pima,AZ,Passenger,3,1,4,325,329,1.22
October,31,2020,Anne Arundel,MD,Passenger,1,1,2,404,406,0.49
October,31,2020,Polk,FL,Passenger,1,0,1,59,60,1.67
October,31,2020,Williams,ND,Passenger,0,1,1,11,12,8.33
October,31,2020,Pacific,WA,Truck,0,0,0,7752,7752,0
October,31,2020,Putnam,TN,Passenger,0,1,1,2,3,33.33
October,31,2020,Thurston,WA,Passenger,1254,761,2015,197304,199319,1.01
October,31,2020,Portsmouth,VA,Passenger,0,1,1,74,75,1.33
October,31,2020,Nassau,FL,Passenger,1,0,1,36,37,2.7
October,31,2020,Fort Bend,TX,Passenger,1,0,1,43,44,2.27
October,31,2020,Yakima,WA,Truck,0,0,0,60694,60694,0
October,31,2020,Broward,FL,Passenger,1,1,2,110,112,1.79
October,31,2020,Leavenworth,KS,Passenger,0,1,1,124,125,0.8
October,31,2020,Sacramento,CA,Passenger,1,0,1,243,244,0.41
October,31,2020,Solano,CA,Passenger,1,0,1,205,206,0.49
October,31,2020,Hudson,NJ,Passenger,1,0,1,39,40,2.5
October,31,2020,Cumberland,NC,Passenger,0,3,3,450,453,0.66
October,31,2020,Goochland,VA,Passenger,3,2,5,246,251,1.99
October,31,2020,Penobscot,ME,Passenger,0,1,1,12,13,7.69
October,31,2020,Nueces,TX,Passenger,1,0,1,85,86,1.16
October,31,2020,Chelan,WA,Truck,0,0,0,22770,22770,0
October,31,2020,Lincoln,WA,Truck,0,0,0,4661,4661,0
October,31,2020,Ramsey,MN,Passenger,1,0,1,34,35,2.86
October,31,2020,Jefferson,NY,Passenger,0,1,1,209,210,0.48
October,31,2020,Kitsap,WA,Passenger,1465,730,2195,179705,181900,1.21
October,31,2020,Kings,NY,Passenger,1,0,1,63,64,1.56
October,31,2020,Loudoun,VA,Passenger,1,0,1,80,81,1.23
October,31,2020,DeKalb,GA,Passenger,1,0,1,74,75,1.33
October,31,2020,Chesapeake,VA,Passenger,0,3,3,405,408,0.74
October,31,2020,San Joaquin,CA,Passenger,1,0,1,113,114,0.88
October,31,2020,Sarasota,FL,Passenger,2,0,2,24,26,7.69
October,31,2020,Montgomery,OH,Passenger,0,1,1,48,49,2.04
October,31,2020,Honolulu,HI,Passenger,5,2,7,428,435,1.61
October,31,2020,Klickitat,WA,Passenger,59,44,103,15003,15106,0.68
October,31,2020,Spokane,WA,Truck,0,0,0,100211,100211,0
October,31,2020,Wahkiakum,WA,Truck,0,0,0,1764,1764,0
October,31,2020,Gwinnett,GA,Passenger,1,0,1,68,69,1.45
October,31,2020,El Paso,TX,Passenger,3,0,3,411,414,0.72
October,31,2020,Multnomah,OR,Passenger,3,6,9,700,709,1.27
October,31,2020,Fulton,GA,Passenger,1,2,3,89,92,3.26
October,31,2020,Queens,NY,Passenger,1,0,1,52,53,1.89
October,31,2020,El Dorado,CA,Passenger,1,0,1,32,33,3.03
October,31,2020,Dakota,MN,Passenger,0,1,1,28,29,3.45
October,31,2020,Kauai,HI,Passenger,1,0,1,14,15,6.67
October,31,2020,Boulder,CO,Passenger,0,1,1,42,43,2.33
October,31,2020,Lincoln,WA,Passenger,5,10,15,7609,7624,0.2
October,31,2020,Washoe,NV,Passenger,1,0,1,100,101,0.99
October,31,2020,Franklin,WA,Passenger,73,78,151,61101,61252,0.25
October,31,2020,Yakima,WA,Passenger,157,122,279,166886,167165,0.17
October,31,2020,Montgomery,TX,Passenger,1,0,1,47,48,2.08
October,31,2020,Erie,NY,Passenger,1,0,1,45,46,2.17
October,31,2020,Arlington,VA,Passenger,0,2,2,144,146,1.37
October,31,2020,Pinellas,FL,Passenger,1,1,2,99,101,1.98
October,31,2020,Cowlitz,WA,Passenger,160,122,282,72100,72382,0.39
October,31,2020,Harrison,MS,Passenger,1,0,1,51,52,1.92
October,31,2020,Stevens,WA,Passenger,36,39,75,30368,30443,0.25
October,31,2020,Skagit,WA,Passenger,466,231,697,91532,92229,0.76
October,31,2020,Okanogan,WA,Truck,0,0,0,16573,16573,0
October,31,2020,El Paso,CO,Passenger,2,0,2,699,701,0.29
October,31,2020,Hamilton,IN,Passenger,2,0,2,37,39,5.13
October,31,2020,Riverside,CA,Passenger,4,1,5,600,605,0.83
October,31,2020,St. Clair,IL,Passenger,1,0,1,136,137,0.73
October,31,2020,New York,NY,Passenger,1,0,1,56,57,1.75
October,31,2020,Hennepin,MN,Passenger,2,0,2,83,85,2.35
October,31,2020,Richland,SC,Passenger,0,1,1,143,144,0.69
October,31,2020,DuPage,IL,Passenger,3,0,3,54,57,5.26
October,31,2020,Grant,WA,Passenger,71,81,152,65747,65899,0.23
October,31,2020,Houston,GA,Passenger,1,0,1,52,53,1.89
October,31,2020,Jefferson,WA,Truck,0,0,0,9575,9575,0
October,31,2020,Pend Oreille,WA,Truck,0,0,0,5717,5717,0
October,31,2020,Fairbanks North Star,AK,Passenger,0,1,1,94,95,1.05
October,31,2020,Jones,GA,Passenger,1,0,1,1,2,50
October,31,2020,Rockingham,NH,Passenger,1,0,1,22,23,4.35
October,31,2020,King,WA,Truck,5,1,6,184061,184067,0
October,31,2020,Pend Oreille,WA,Passenger,8,4,12,9158,9170,0.13
October,31,2020,Snohomish,WA,Truck,0,0,0,125318,125318,0
October,31,2020,Ada,ID,Passenger,0,1,1,250,251,0.4
October,31,2020,Benton,WA,Passenger,403,339,742,134682,135424,0.55
October,31,2020,Jefferson,WA,Passenger,260,151,411,24723,25134,1.64
October,31,2020,Ulster,NY,Passenger,1,0,1,8,9,11.11
October,31,2020,Mason,WA,Truck,0,0,0,20836,20836,0
October,31,2020,Carroll,MD,Passenger,0,1,1,21,22,4.55
October,31,2020,San Diego,CA,Passenger,14,4,18,2724,2742,0.66
October,31,2020,Suffolk,VA,Passenger,1,0,1,126,127,0.79
October,31,2020,Flathead,MT,Passenger,1,0,1,54,55,1.82
October,31,2020,Garfield,WA,Truck,0,0,0,991,991,0
October,31,2020,Utah,UT,Passenger,0,1,1,128,129,0.78
October,31,2020,Sedgwick,KS,Passenger,1,1,2,91,93,2.15
October,31,2020,Nassau,NY,Passenger,4,0,4,28,32,12.5
October,31,2020,Bucks,PA,Passenger,1,0,1,18,19,5.26
October,31,2020,Maricopa,AZ,Passenger,5,6,11,1330,1341,0.82
October,31,2020,Grays Harbor,WA,Passenger,118,117,235,48521,48756,0.48
October,31,2020,San Mateo,CA,Passenger,1,1,2,105,107,1.87
October,31,2020,St. Mary's,MD,Passenger,1,0,1,215,216,0.46
October,31,2020,Alameda,CA,Passenger,2,0,2,255,257,0.78
October,31,2020,Saginaw,MI,Passenger,1,0,1,9,10,10
October,31,2020,Virginia Beach,VA,Passenger,1,0,1,646,647,0.15
October,31,2020,Albemarle,VA,Passenger,1,0,1,21,22,4.55
October,31,2020,Carson City,NV,Passenger,1,0,1,11,12,8.33
October,31,2020,Grays Harbor,WA,Truck,0,0,0,21123,21123,0
October,31,2020,Maui,HI,Passenger,1,0,1,28,29,3.45
October,31,2020,Travis,TX,Passenger,2,1,3,168,171,1.75
October,31,2020,Columbia,WA,Passenger,4,3,7,2439,2446,0.29
October,31,2020,Powhatan,VA,Passenger,1,0,1,0,1,100
October,31,2020,Norfolk,VA,Passenger,2,3,5,345,350,1.43
October,31,2020,Charleston,SC,Passenger,2,0,2,91,93,2.15
October,31,2020,Carroll,NH,Passenger,0,1,1,5,6,16.67
October,31,2020,Denver,CO,Passenger,1,0,1,113,114,0.88
October,31,2020,Lewis,WA,Passenger,114,115,229,58451,58680,0.39
October,31,2020,Camden,NJ,Passenger,0,1,1,22,23,4.35
October,31,2020,Bradley,TN,Passenger,1,0,1,0,1,100
October,31,2020,Pierce,WA,Passenger,2660,1740,4400,554816,559216,0.79
October,31,2020,Asotin,WA,Passenger,17,14,31,12401,12432,0.25
October,31,2020,Whitman,WA,Truck,0,0,0,8487,8487,0
October,31,2020,Snohomish,WA,Passenger,4831,1816,6647,537854,544501,1.22
October,31,2020,Adams,WA,Truck,0,0,0,5335,5335,0
October,31,2020,Island,WA,Truck,1,0,1,21311,21312,0
October,31,2020,Lake,IL,Passenger,2,0,2,160,162,1.23
October,31,2020,Hampshire,MA,Passenger,1,0,1,6,7,14.29
September,30,2020,Washoe,NV,Passenger,1,0,1,99,100,1
September,30,2020,Cowlitz,WA,Passenger,157,120,277,72161,72438,0.38
September,30,2020,Duval,FL,Passenger,0,2,2,357,359,0.56
September,30,2020,Mason,WA,Truck,0,0,0,20804,20804,0
September,30,2020,Adams,WA,Truck,0,0,0,5309,5309,0
September,30,2020,Hamilton,IN,Passenger,1,0,1,37,38,2.63
September,30,2020,Skamania,WA,Truck,0,0,0,4005,4005,0
September,30,2020,New London,CT,Passenger,1,2,3,237,240,1.25
September,30,2020,DeKalb,IN,Passenger,1,0,1,1,2,50
September,30,2020,Bexar,TX,Passenger,4,5,9,582,591,1.52
September,30,2020,Prince William,VA,Passenger,2,2,4,219,223,1.79
September,30,2020,Cascade,MT,Passenger,0,1,1,53,54,1.85
September,30,2020,Grant,WA,Truck,0,0,0,27301,27301,0
September,30,2020,Walla Walla,WA,Truck,0,0,0,13789,13789,0
September,30,2020,Pacific,WA,Passenger,32,34,66,15716,15782,0.42
September,30,2020,Portsmouth,VA,Passenger,0,1,1,74,75,1.33
September,30,2020,Kauai,HI,Passenger,1,0,1,14,15,6.67
September,30,2020,Greene,MO,Passenger,0,1,1,32,33,3.03
September,30,2020,Maricopa,AZ,Passenger,5,7,12,1347,1359,0.88
September,30,2020,DeKalb,GA,Passenger,1,0,1,77,78,1.28
September,30,2020,Spartanburg,SC,Passenger,0,1,1,49,50,2
September,30,2020,Oldham,KY,Passenger,0,1,1,4,5,20
September,30,2020,Garfield,WA,Passenger,0,1,1,1348,1349,0.07
September,30,2020,San Francisco,CA,Passenger,2,1,3,89,92,3.26
September,30,2020,Howard,MD,Passenger,0,1,1,63,64,1.56
September,30,2020,Wahkiakum,WA,Passenger,6,6,12,3016,3028,0.4
September,30,2020,Prince George's,MD,Passenger,2,1,3,149,152,1.97
September,30,2020,Clackamas,OR,Passenger,2,0,2,183,185,1.08
September,30,2020,Santa Clara,CA,Passenger,6,2,8,276,284,2.82
September,30,2020,Travis,TX,Passenger,2,1,3,169,172,1.74
September,30,2020,Montgomery,TX,Passenger,1,0,1,47,48,2.08
September,30,2020,Sacramento,CA,Passenger,1,0,1,251,252,0.4
September,30,2020,Harnett,NC,Passenger,1,0,1,191,192,0.52
September,30,2020,Clark,WA,Passenger,2174,1098,3272,318408,321680,1.02
September,30,2020,Erie,NY,Passenger,1,0,1,46,47,2.13
September,30,2020,Fresno,CA,Passenger,1,0,1,173,174,0.57
September,30,2020,Stafford,VA,Passenger,1,1,2,93,95,2.11
September,30,2020,Placer,CA,Passenger,2,0,2,85,87,2.3
September,30,2020,San Juan,WA,Passenger,331,100,431,13907,14338,3.01
September,30,2020,El Dorado,CA,Passenger,1,0,1,33,34,2.94
September,30,2020,Frederick,MD,Passenger,1,1,2,72,74,2.7
September,30,2020,Manassas,VA,Passenger,0,1,1,5,6,16.67
September,30,2020,El Paso,CO,Passenger,2,0,2,707,709,0.28
September,30,2020,Asotin,WA,Passenger,17,14,31,12398,12429,0.25
September,30,2020,Miami-Dade,FL,Passenger,1,0,1,104,105,0.95
September,30,2020,Rockingham,NH,Passenger,1,0,1,22,23,4.35
September,30,2020,Walla Walla,WA,Passenger,86,62,148,35944,36092,0.41
September,30,2020,Leavenworth,KS,Passenger,0,1,1,120,121,0.83
September,30,2020,Grant,WA,Passenger,67,80,147,65582,65729,0.22
September,30,2020,Whatcom,WA,Passenger,1140,525,1665,149401,151066,1.1
September,30,2020,Cumberland,NC,Passenger,0,3,3,452,455,0.66
September,30,2020,Kittitas,WA,Passenger,113,48,161,29701,29862,0.54
September,30,2020,Kings,NY,Passenger,1,0,1,65,66,1.52
September,30,2020,San Joaquin,CA,Passenger,1,0,1,115,116,0.86
September,30,2020,Lake,IL,Passenger,1,0,1,163,164,0.61
September,30,2020,Sedgwick,KS,Passenger,1,1,2,92,94,2.13
September,30,2020,Williamson,TX,Passenger,0,2,2,128,130,1.54
September,30,2020,Douglas,WA,Passenger,79,45,124,28040,28164,0.44
September,30,2020,New York,NY,Passenger,1,0,1,55,56,1.79
September,30,2020,Loudoun,VA,Passenger,1,0,1,82,83,1.2
September,30,2020,Virginia Beach,VA,Passenger,1,0,1,655,656,0.15
September,30,2020,Houston,GA,Passenger,1,0,1,53,54,1.85
September,30,2020,Snohomish,WA,Truck,0,0,0,124936,124936,0
September,30,2020,Ferry,WA,Truck,0,0,0,3582,3582,0
September,30,2020,Spokane,WA,Passenger,797,513,1310,318772,320082,0.41
September,30,2020,St. Mary's,MD,Passenger,1,0,1,217,218,0.46
September,30,2020,Richmond,GA,Passenger,0,1,1,81,82,1.22
September,30,2020,Douglas,NE,Passenger,0,1,1,48,49,2.04
September,30,2020,Bartow,GA,Passenger,0,1,1,4,5,20
September,30,2020,Lee,FL,Passenger,1,0,1,47,48,2.08
September,30,2020,Kern,CA,Passenger,0,1,1,223,224,0.45
September,30,2020,St. Clair,IL,Passenger,1,0,1,137,138,0.72
September,30,2020,Gwinnett,GA,Passenger,1,0,1,69,70,1.43
September,30,2020,Boulder,CO,Passenger,0,1,1,43,44,2.27
September,30,2020,Okanogan,WA,Passenger,45,36,81,25965,26046,0.31
September,30,2020,Monroe,IL,Passenger,1,0,1,3,4,25
September,30,2020,San Diego,CA,Passenger,15,5,20,2735,2755,0.73
September,30,2020,Calvert,MD,Passenger,0,2,2,85,87,2.3
September,30,2020,Tulsa,OK,Passenger,1,1,2,40,42,4.76
September,30,2020,Saginaw,MI,Passenger,1,0,1,9,10,10
September,30,2020,San Juan,WA,Truck,0,0,0,5848,5848,0
September,30,2020,Pacific,WA,Truck,0,0,0,7742,7742,0
September,30,2020,Shelby,OH,Passenger,0,1,1,1,2,50
September,30,2020,Harrison,MS,Passenger,1,0,1,51,52,1.92
September,30,2020,Nueces,TX,Passenger,1,0,1,86,87,1.15
September,30,2020,Alexandria,VA,Passenger,2,0,2,135,137,1.46
September,30,2020,Penobscot,ME,Passenger,0,1,1,12,13,7.69
September,30,2020,Benton,WA,Passenger,394,329,723,134382,135105,0.54
September,30,2020,Fulton,GA,Passenger,1,2,3,94,97,3.09
September,30,2020,Collin,TX,Passenger,1,1,2,119,121,1.65
September,30,2020,Allegheny,PA,Passenger,1,0,1,68,69,1.45
September,30,2020,Dallas,TX,Passenger,1,0,1,179,180,0.56
September,30,2020,Yakima,WA,Passenger,154,124,278,166493,166771,0.17
September,30,2020,Washington,OR,Passenger,1,0,1,423,424,0.24
September,30,2020,Wilson,TX,Passenger,0,1,1,5,6,16.67
September,30,2020,Suffolk,VA,Passenger,1,0,1,125,126,0.79
September,30,2020,Pierce,WA,Truck,0,0,0,143993,143993,0
September,30,2020,Douglas,CO,Passenger,0,1,1,77,78,1.28
September,30,2020,Snohomish,WA,Passenger,4694,1808,6502,537221,543723,1.2
September,30,2020,Polk,FL,Passenger,1,0,1,60,61,1.64
September,30,2020,Utah,UT,Passenger,0,1,1,129,130,0.77
September,30,2020,Ferry,WA,Passenger,8,3,11,4305,4316,0.25
September,30,2020,Clallam,WA,Passenger,245,173,418,49886,50304,0.83
September,30,2020,Alameda,CA,Passenger,2,0,2,263,265,0.75
September,30,2020,Skagit,WA,Truck,1,0,1,32643,32644,0
September,30,2020,Garfield,WA,Truck,0,0,0,987,987,0
September,30,2020,Ada,ID,Passenger,0,1,1,249,250,0.4
September,30,2020,Harris,TX,Passenger,1,0,1,223,224,0.45
September,30,2020,Lewis,WA,Truck,0,0,0,26446,26446,0
September,30,2020,Boone,MO,Passenger,0,1,1,10,11,9.09
September,30,2020,Arlington,VA,Passenger,0,2,2,146,148,1.35
September,30,2020,El Paso,TX,Passenger,3,0,3,415,418,0.72
September,30,2020,Fort Bend,TX,Passenger,1,0,1,44,45,2.22
September,30,2020,New Haven,CT,Passenger,0,2,2,34,36,5.56
September,30,2020,Montgomery,AL,Passenger,0,1,1,39,40,2.5
September,30,2020,Klamath,OR,Passenger,1,0,1,31,32,3.12
September,30,2020,Columbia,WA,Passenger,4,3,7,2421,2428,0.29
September,30,2020,Albemarle,VA,Passenger,1,0,1,20,21,4.76
September,30,2020,Salt Lake,UT,Passenger,0,1,1,176,177,0.56
September,30,2020,Camden,NJ,Passenger,0,1,1,23,24,4.17
September,30,2020,Flathead,MT,Passenger,1,0,1,56,57,1.75
September,30,2020,Klickitat,WA,Passenger,58,42,100,15023,15123,0.66
September,30,2020,King,WA,Passenger,25389,7895,33284,1371586,1404870,2.37
September,30,2020,Benton,WA,Truck,0,0,0,43090,43090,0
September,30,2020,Morris,NJ,Passenger,1,0,1,18,19,5.26
September,30,2020,Chelan,WA,Passenger,260,80,340,54306,54646,0.62
September,30,2020,,,Passenger,9,7,16,949,965,1.66
September,30,2020,Jefferson,CO,Passenger,0,1,1,55,56,1.79
September,30,2020,District of Columbia,DC,Passenger,2,1,3,197,200,1.5
September,30,2020,Putnam,TN,Passenger,0,1,1,2,3,33.33
September,30,2020,Honolulu,HI,Passenger,5,2,7,428,435,1.61
September,30,2020,Nassau,FL,Passenger,1,0,1,36,37,2.7
September,30,2020,St. Louis,MO,Passenger,1,0,1,96,97,1.03
September,30,2020,Juneau,AK,Passenger,0,1,1,28,29,3.45
September,30,2020,Montgomery,OH,Passenger,0,1,1,47,48,2.08
September,30,2020,Maui,HI,Passenger,1,0,1,29,30,3.33
September,30,2020,Thurston,WA,Passenger,1211,753,1964,197219,199183,0.99
September,30,2020,Hennepin,MN,Passenger,2,0,2,83,85,2.35
September,30,2020,Stevens,WA,Passenger,35,38,73,30417,30490,0.24
September,30,2020,Ramsey,MN,Passenger,1,0,1,36,37,2.7
September,30,2020,Twin Falls,ID,Passenger,0,1,1,23,24,4.17
September,30,2020,Williams,ND,Passenger,0,1,1,11,12,8.33
September,30,2020,Jefferson,WA,Truck,0,0,0,9541,9541,0
September,30,2020,Suffolk,MA,Passenger,0,2,2,34,36,5.56
September,30,2020,Spokane,WA,Truck,1,0,1,99865,99866,0
September,30,2020,Kootenai,ID,Passenger,1,0,1,220,221,0.45
September,30,2020,Owyhee,ID,Passenger,1,0,1,3,4,25
September,30,2020,San Mateo,CA,Passenger,0,1,1,105,106,0.94
September,30,2020,Chelan,WA,Truck,0,0,0,22729,22729,0
September,30,2020,Denver,CO,Passenger,1,0,1,113,114,0.88
September,30,2020,Goochland,VA,Passenger,3,2,5,247,252,1.98
September,30,2020,Arapahoe,CO,Passenger,1,0,1,127,128,0.78
September,30,2020,Anne Arundel,MD,Passenger,1,1,2,400,402,0.5
September,30,2020,Fairbanks North Star,AK,Passenger,0,1,1,94,95,1.05
September,30,2020,Riverside,CA,Passenger,3,0,3,607,610,0.49
September,30,2020,Douglas,WA,Truck,0,0,0,12380,12380,0
September,30,2020,Pierce,WA,Passenger,2575,1710,4285,553881,558166,0.77
September,30,2020,Fairfax,VA,Passenger,4,3,7,730,737,0.95
September,30,2020,Cowlitz,WA,Truck,0,0,0,28936,28936,0
September,30,2020,Asotin,WA,Truck,0,0,0,6693,6693,0
September,30,2020,Powhatan,VA,Passenger,1,0,1,0,1,100
September,30,2020,Palm Beach,FL,Passenger,0,1,1,78,79,1.27
September,30,2020,Skagit,WA,Passenger,447,228,675,91505,92180,0.73
September,30,2020,Middlesex,MA,Passenger,1,1,2,91,93,2.15
September,30,2020,Nassau,NY,Passenger,4,0,4,28,32,12.5
September,30,2020,Multnomah,OR,Passenger,4,6,10,696,706,1.42
September,30,2020,Sumter,FL,Passenger,0,1,1,11,12,8.33
September,30,2020,Monterey,CA,Passenger,0,1,1,157,158,0.63
September,30,2020,Montgomery,PA,Passenger,1,0,1,27,28,3.57
September,30,2020,Thurston,WA,Truck,0,0,0,56132,56132,0
September,30,2020,Santa Cruz,CA,Passenger,1,0,1,31,32,3.12
September,30,2020,Lincoln,WA,Passenger,5,10,15,7595,7610,0.2
September,30,2020,Clallam,WA,Truck,1,0,1,21773,21774,0
September,30,2020,Charles,MD,Passenger,1,1,2,74,76,2.63
September,30,2020,Bucks,PA,Passenger,1,0,1,19,20,5
September,30,2020,Lincoln,WA,Truck,0,0,0,4640,4640,0
September,30,2020,Island,WA,Passenger,444,280,724,62886,63610,1.14
September,30,2020,Queens,NY,Passenger,1,0,1,53,54,1.85
September,30,2020,Adams,WA,Passenger,8,7,15,12918,12933,0.12
September,30,2020,Hawaii,HI,Passenger,1,0,1,51,52,1.92
September,30,2020,Island,WA,Truck,1,0,1,21261,21262,0
September,30,2020,Plaquemines,LA,Passenger,0,1,1,14,15,6.67
September,30,2020,Kent,MI,Passenger,0,1,1,23,24,4.17
September,30,2020,Kittitas,WA,Truck,0,0,0,14601,14601,0
September,30,2020,King,WA,Truck,5,1,6,183674,183680,0
September,30,2020,Dakota,MN,Passenger,0,1,1,31,32,3.12
September,30,2020,Pend Oreille,WA,Truck,0,0,0,5727,5727,0
September,30,2020,Lake,FL,Passenger,1,0,1,23,24,4.17
September,30,2020,Vigo,IN,Passenger,1,0,1,6,7,14.29
September,30,2020,Chesapeake,VA,Passenger,0,3,3,412,415,0.72
September,30,2020,DuPage,IL,Passenger,3,0,3,55,58,5.17
September,30,2020,Whitman,WA,Truck,0,0,0,8497,8497,0
September,30,2020,Ventura,CA,Passenger,1,2,3,272,275,1.09
September,30,2020,Grays Harbor,WA,Truck,0,0,0,21093,21093,0
September,30,2020,Bradley,TN,Passenger,1,0,1,1,2,50
September,30,2020,Solano,CA,Passenger,1,0,1,205,206,0.49
September,30,2020,RÃ­o Grande,PR,Passenger,1,0,1,1,2,50
September,30,2020,Randolph,NC,Passenger,1,0,1,7,8,12.5
September,30,2020,Wahkiakum,WA,Truck,0,0,0,1759,1759,0
September,30,2020,Cape May,NJ,Passenger,0,1,1,11,12,8.33
September,30,2020,Skamania,WA,Passenger,32,22,54,8373,8427,0.64
September,30,2020,Mason,WA,Passenger,162,131,293,47460,47753,0.61
September,30,2020,Carson City,NV,Passenger,1,0,1,10,11,9.09
September,30,2020,Denton,TX,Passenger,1,0,1,87,88,1.14
September,30,2020,Moore,NC,Passenger,0,1,1,156,157,0.64
September,30,2020,Ulster,NY,Passenger,1,0,1,8,9,11.11
September,30,2020,Lewis,WA,Passenger,111,117,228,58309,58537,0.39
September,30,2020,Larimer,CO,Passenger,1,0,1,52,53,1.89
September,30,2020,Contra Costa,CA,Passenger,4,3,7,296,303,2.31
September,30,2020,Jefferson,NY,Passenger,0,1,1,210,211,0.47
September,30,2020,Carroll,MD,Passenger,0,1,1,21,22,4.55
September,30,2020,Whatcom,WA,Truck,3,0,3,43388,43391,0.01
September,30,2020,Deschutes,OR,Passenger,1,0,1,125,126,0.79
September,30,2020,Richland,SC,Passenger,0,1,1,143,144,0.69
September,30,2020,Charleston,SC,Passenger,2,0,2,93,95,2.11
September,30,2020,Carroll,NH,Passenger,0,1,1,5,6,16.67
September,30,2020,Shelby,TN,Passenger,0,1,1,79,80,1.25
September,30,2020,Orange,CA,Passenger,5,3,8,464,472,1.69
September,30,2020,Sarasota,FL,Passenger,2,0,2,23,25,8
September,30,2020,Grays Harbor,WA,Passenger,115,116,231,48482,48713,0.47
September,30,2020,Whitman,WA,Passenger,47,47,94,21996,22090,0.43
September,30,2020,Washtenaw,MI,Passenger,1,0,1,34,35,2.86
September,30,2020,Pinellas,FL,Passenger,1,1,2,103,105,1.9
September,30,2020,Jones,GA,Passenger,1,0,1,1,2,50
September,30,2020,Klickitat,WA,Truck,0,0,0,8105,8105,0
September,30,2020,Clark,NV,Passenger,2,2,4,663,667,0.6
September,30,2020,Rogers,OK,Passenger,1,0,1,4,5,20
September,30,2020,Jefferson,WA,Passenger,257,148,405,24734,25139,1.61
September,30,2020,Clark,WA,Truck,0,0,0,82868,82868,0
September,30,2020,Los Angeles,CA,Passenger,9,11,20,976,996,2.01
September,30,2020,Kitsap,WA,Truck,0,0,0,54186,54186,0
September,30,2020,Yakima,WA,Truck,0,0,0,60573,60573,0
September,30,2020,Pend Oreille,WA,Passenger,8,4,12,9189,9201,0.13
September,30,2020,Brevard,FL,Passenger,0,1,1,81,82,1.22
September,30,2020,Franklin,WA,Truck,0,0,0,20289,20289,0
September,30,2020,Broward,FL,Passenger,1,1,2,108,110,1.82
September,30,2020,Norfolk,VA,Passenger,2,2,4,347,351,1.14
September,30,2020,Howard,IN,Passenger,0,1,1,3,4,25
September,30,2020,Franklin,WA,Passenger,68,76,144,60928,61072,0.24
September,30,2020,Stevens,WA,Truck,0,0,0,18704,18704,0
September,30,2020,Okaloosa,FL,Passenger,0,1,1,140,141,0.71
September,30,2020,Pima,AZ,Passenger,3,1,4,326,330,1.21
September,30,2020,Hudson,NJ,Passenger,1,0,1,39,40,2.5
September,30,2020,Okanogan,WA,Truck,0,0,0,16547,16547,0
September,30,2020,Columbia,WA,Truck,0,0,0,1532,1532,0
September,30,2020,Kitsap,WA,Passenger,1426,713,2139,179647,181786,1.18
April,30,2021,Thurston,WA,Truck,0,0,0,56710,56710,0
April,30,2021,Snohomish,WA,Truck,1,0,1,126400,126401,0
April,30,2021,Skagit,WA,Truck,1,0,1,33024,33025,0
April,30,2021,Carroll,MD,Passenger,0,1,1,18,19,5.26
April,30,2021,Jones,GA,Passenger,1,0,1,1,2,50
April,30,2021,Dakota,MN,Passenger,0,1,1,25,26,3.85
April,30,2021,Douglas,CO,Passenger,0,1,1,76,77,1.3
April,30,2021,Utah,UT,Passenger,0,1,1,119,120,0.83
April,30,2021,Clackamas,OR,Passenger,2,0,2,176,178,1.12
April,30,2021,Saginaw,MI,Passenger,2,0,2,10,12,16.67
April,30,2021,Boone,MO,Passenger,0,1,1,9,10,10
April,30,2021,Charleston,SC,Passenger,2,0,2,85,87,2.3
April,30,2021,Douglas,WA,Passenger,88,46,134,28472,28606,0.47
April,30,2021,Columbia,WA,Truck,0,0,0,1560,1560,0
April,30,2021,Sumter,FL,Passenger,0,1,1,10,11,9.09
April,30,2021,Walla Walla,WA,Passenger,108,71,179,36527,36706,0.49
April,30,2021,District of Columbia,DC,Passenger,4,1,5,194,199,2.51
April,30,2021,Salt Lake,UT,Passenger,0,1,1,171,172,0.58
April,30,2021,Harrison,MS,Passenger,2,0,2,50,52,3.85
April,30,2021,Pend Oreille,WA,Passenger,14,5,19,9302,9321,0.2
April,30,2021,Bexar,TX,Passenger,4,5,9,538,547,1.65
April,30,2021,Ventura,CA,Passenger,1,1,2,265,267,0.75
April,30,2021,Santa Clara,CA,Passenger,8,2,10,260,270,3.7
April,30,2021,Spartanburg,SC,Passenger,0,1,1,51,52,1.92
April,30,2021,Montgomery,MD,Passenger,1,0,1,228,229,0.44
April,30,2021,Grays Harbor,WA,Truck,0,0,0,21415,21415,0
April,30,2021,Louisa,VA,Passenger,0,1,1,1,2,50
April,30,2021,Boulder,CO,Passenger,0,1,1,46,47,2.13
April,30,2021,Jefferson,NY,Passenger,0,1,1,211,212,0.47
April,30,2021,Chelan,WA,Truck,0,0,0,23068,23068,0
April,30,2021,New York,NY,Passenger,1,0,1,47,48,2.08
April,30,2021,Nassau,FL,Passenger,1,0,1,32,33,3.03
April,30,2021,Island,WA,Truck,0,0,0,21561,21561,0
April,30,2021,Prince William,VA,Passenger,1,1,2,213,215,0.93
April,30,2021,Norfolk,VA,Passenger,2,3,5,324,329,1.52
April,30,2021,Asotin,WA,Passenger,19,14,33,12659,12692,0.26
April,30,2021,Arapahoe,CO,Passenger,1,0,1,116,117,0.85
April,30,2021,Whatcom,WA,Truck,4,0,4,43870,43874,0.01
April,30,2021,Stevens,WA,Truck,0,0,0,18874,18874,0
April,30,2021,Manassas,VA,Passenger,0,1,1,6,7,14.29
April,30,2021,Okaloosa,FL,Passenger,0,1,1,124,125,0.8
April,30,2021,Lewis,WA,Truck,0,0,0,26910,26910,0
April,30,2021,Prince George's,MD,Passenger,2,1,3,142,145,2.07
April,30,2021,Sarasota,FL,Passenger,2,0,2,27,29,6.9
April,30,2021,Philadelphia,PA,Passenger,1,0,1,51,52,1.92
April,30,2021,RÃ­o Grande,PR,Passenger,1,0,1,1,2,50
April,30,2021,Kittitas,WA,Passenger,153,58,211,29983,30194,0.7
April,30,2021,Whatcom,WA,Passenger,1355,582,1937,151158,153095,1.27
April,30,2021,Camden,NJ,Passenger,0,1,1,15,16,6.25
April,30,2021,Pima,AZ,Passenger,2,1,3,290,293,1.02
April,30,2021,Asotin,WA,Truck,0,0,0,6769,6769,0
April,30,2021,Anchorage,AK,Passenger,1,0,1,141,142,0.7
April,30,2021,Polk,FL,Passenger,1,0,1,54,55,1.82
April,30,2021,Wilson,TX,Passenger,0,1,1,3,4,25
April,30,2021,Harris,TX,Passenger,1,1,2,200,202,0.99
April,30,2021,Thurston,WA,Passenger,1494,834,2328,198087,200415,1.16
April,30,2021,Anne Arundel,MD,Passenger,4,2,6,393,399,1.5
April,30,2021,Hudson,NJ,Passenger,1,0,1,43,44,2.27
April,30,2021,El Paso,CO,Passenger,3,0,3,683,686,0.44
April,30,2021,Suffolk,MA,Passenger,0,2,2,33,35,5.71
April,30,2021,Sedgwick,KS,Passenger,1,1,2,86,88,2.27
April,30,2021,Rockingham,NH,Passenger,1,0,1,23,24,4.17
April,30,2021,Howard,MD,Passenger,0,1,1,63,64,1.56
April,30,2021,Owyhee,ID,Passenger,1,0,1,3,4,25
April,30,2021,Douglas,NE,Passenger,1,1,2,50,52,3.85
April,30,2021,San Mateo,CA,Passenger,1,1,2,102,104,1.92
April,30,2021,Richland,SC,Passenger,0,1,1,139,140,0.71
April,30,2021,Portsmouth,VA,Passenger,0,1,1,78,79,1.27
April,30,2021,Hampshire,MA,Passenger,1,0,1,6,7,14.29
April,30,2021,Danville,VA,Passenger,1,0,1,0,1,100
April,30,2021,Allegheny,PA,Passenger,1,1,2,64,66,3.03
April,30,2021,Carroll,NH,Passenger,0,1,1,5,6,16.67
April,30,2021,Carson City,NV,Passenger,1,0,1,11,12,8.33
April,30,2021,Pierce,WA,Passenger,3272,1903,5175,559851,565026,0.92
April,30,2021,Bartow,GA,Passenger,0,1,1,4,5,20
April,30,2021,Klamath,OR,Passenger,1,0,1,31,32,3.12
April,30,2021,Richmond,NY,Passenger,1,0,1,8,9,11.11
April,30,2021,Nassau,NY,Passenger,4,0,4,26,30,13.33
April,30,2021,Franklin,WA,Passenger,109,95,204,61946,62150,0.33
April,30,2021,Los Angeles,CA,Passenger,10,11,21,903,924,2.27
April,30,2021,Klickitat,WA,Truck,0,0,0,8248,8248,0
April,30,2021,Jefferson,WA,Truck,0,0,0,9623,9623,0
April,30,2021,Skagit,WA,Passenger,562,268,830,91975,92805,0.89
April,30,2021,Larimer,CO,Passenger,1,0,1,52,53,1.89
April,30,2021,,,Passenger,8,7,15,997,1012,1.48
April,30,2021,Yamhill,OR,Passenger,1,0,1,37,38,2.63
April,30,2021,Leavenworth,KS,Passenger,0,1,1,119,120,0.83
April,30,2021,Houston,GA,Passenger,1,0,1,50,51,1.96
April,30,2021,Greene,MO,Passenger,0,1,1,31,32,3.12
April,30,2021,Placer,CA,Passenger,2,0,2,79,81,2.47
April,30,2021,Hamilton,IN,Passenger,2,0,2,34,36,5.56
April,30,2021,Pend Oreille,WA,Truck,0,0,0,5738,5738,0
April,30,2021,Collin,TX,Passenger,1,1,2,115,117,1.71
April,30,2021,Stafford,VA,Passenger,2,1,3,99,102,2.94
April,30,2021,Riverside,CA,Passenger,5,1,6,567,573,1.05
April,30,2021,Hennepin,MN,Passenger,2,0,2,78,80,2.5
April,30,2021,Grays Harbor,WA,Passenger,156,134,290,49368,49658,0.58
April,30,2021,Okanogan,WA,Truck,0,0,0,16751,16751,0
April,30,2021,Sacramento,CA,Passenger,2,0,2,227,229,0.87
April,30,2021,Bucks,PA,Passenger,1,0,1,17,18,5.56
April,30,2021,Kings,NY,Passenger,1,0,1,67,68,1.47
April,30,2021,San Diego,CA,Passenger,16,6,22,2633,2655,0.83
April,30,2021,Pennington,SD,Passenger,1,0,1,32,33,3.03
April,30,2021,Milwaukee,WI,Passenger,1,0,1,38,39,2.56
April,30,2021,DeKalb,GA,Passenger,1,0,1,62,63,1.59
April,30,2021,Garfield,WA,Passenger,0,2,2,1376,1378,0.15
April,30,2021,Montgomery,TX,Passenger,1,1,2,43,45,4.44
April,30,2021,Alameda,CA,Passenger,3,0,3,243,246,1.22
April,30,2021,Montgomery,OH,Passenger,0,1,1,57,58,1.72
April,30,2021,Walla Walla,WA,Truck,0,0,0,14047,14047,0
April,30,2021,Fort Bend,TX,Passenger,1,0,1,39,40,2.5
April,30,2021,Gwinnett,GA,Passenger,1,0,1,66,67,1.49
April,30,2021,Vigo,IN,Passenger,1,0,1,5,6,16.67
April,30,2021,Missoula,MT,Passenger,1,0,1,61,62,1.61
April,30,2021,Contra Costa,CA,Passenger,3,4,7,278,285,2.46
April,30,2021,Cape May,NJ,Passenger,0,1,1,8,9,11.11
April,30,2021,Yakima,WA,Truck,0,0,0,61656,61656,0
April,30,2021,Lee,FL,Passenger,1,0,1,38,39,2.56
April,30,2021,King,WA,Truck,6,1,7,184931,184938,0
April,30,2021,Orange,CA,Passenger,4,3,7,434,441,1.59
April,30,2021,DuPage,IL,Passenger,2,0,2,55,57,3.51
April,30,2021,St. Louis,MO,Passenger,1,0,1,88,89,1.12
April,30,2021,King,WA,Passenger,29460,8753,38213,1369496,1407709,2.71
April,30,2021,Benton,WA,Passenger,496,377,873,136100,136973,0.64
April,30,2021,Benton,WA,Truck,0,0,0,43685,43685,0
April,30,2021,Denver,CO,Passenger,1,0,1,113,114,0.88
April,30,2021,Adams,WA,Truck,0,0,0,5406,5406,0
April,30,2021,Middlesex,MA,Passenger,1,1,2,92,94,2.13
April,30,2021,Franklin,WA,Truck,0,0,0,20683,20683,0
April,30,2021,Yakima,WA,Passenger,206,139,345,169220,169565,0.2
April,30,2021,Jefferson,WA,Passenger,310,178,488,24904,25392,1.92
April,30,2021,San Francisco,CA,Passenger,1,1,2,89,91,2.2
April,30,2021,San Juan,WA,Passenger,406,125,531,14147,14678,3.62
April,30,2021,Fulton,GA,Passenger,0,1,1,80,81,1.23
April,30,2021,Howard,IN,Passenger,0,1,1,3,4,25
April,30,2021,Adams,WA,Passenger,11,9,20,13054,13074,0.15
April,30,2021,Rogers,OK,Passenger,1,0,1,3,4,25
April,30,2021,Powhatan,VA,Passenger,1,0,1,1,2,50
April,30,2021,Cumberland,NC,Passenger,0,2,2,432,434,0.46
April,30,2021,Ferry,WA,Passenger,10,3,13,4406,4419,0.29
April,30,2021,New Haven,CT,Passenger,0,2,2,31,33,6.06
April,30,2021,St. Mary's,MD,Passenger,1,0,1,211,212,0.47
April,30,2021,Miami-Dade,FL,Passenger,1,0,1,97,98,1.02
April,30,2021,Kauai,HI,Passenger,1,0,1,16,17,5.88
April,30,2021,San Joaquin,CA,Passenger,1,0,1,105,106,0.94
April,30,2021,Island,WA,Passenger,582,308,890,63254,64144,1.39
April,30,2021,Shelby,OH,Passenger,0,1,1,1,2,50
April,30,2021,Monterey,CA,Passenger,0,1,1,147,148,0.68
April,30,2021,New London,CT,Passenger,1,2,3,223,226,1.33
April,30,2021,Plaquemines,LA,Passenger,0,1,1,16,17,5.88
April,30,2021,Cowlitz,WA,Passenger,211,134,345,72518,72863,0.47
April,30,2021,Tulsa,OK,Passenger,1,0,1,41,42,2.38
April,30,2021,Lake,IL,Passenger,2,0,2,153,155,1.29
April,30,2021,Clallam,WA,Passenger,309,206,515,50403,50918,1.01
April,30,2021,Mason,WA,Passenger,191,134,325,48096,48421,0.67
April,30,2021,Calvert,MD,Passenger,0,2,2,87,89,2.25
April,30,2021,Frederick,MD,Passenger,1,1,2,70,72,2.78
April,30,2021,Klickitat,WA,Passenger,67,47,114,15186,15300,0.75
April,30,2021,Ramsey,MN,Passenger,1,0,1,30,31,3.23
April,30,2021,Travis,TX,Passenger,2,3,5,160,165,3.03
April,30,2021,Columbia,WA,Passenger,5,4,9,2478,2487,0.36
April,30,2021,Williamson,TX,Passenger,0,2,2,111,113,1.77
April,30,2021,Whitman,WA,Passenger,59,44,103,21991,22094,0.47
April,30,2021,Multnomah,OR,Passenger,2,5,7,656,663,1.06
April,30,2021,Sevier,AR,Passenger,0,1,1,0,1,100
April,30,2021,Wahkiakum,WA,Truck,0,0,0,1806,1806,0
April,30,2021,Putnam,TN,Passenger,0,1,1,0,1,100
April,30,2021,Wichita,TX,Passenger,1,0,1,41,42,2.38
April,30,2021,Loudoun,VA,Passenger,1,0,1,72,73,1.37
April,30,2021,Montgomery,PA,Passenger,1,0,1,24,25,4
April,30,2021,Moore,NC,Passenger,0,1,1,135,136,0.74
April,30,2021,Skamania,WA,Passenger,40,30,70,8366,8436,0.83
April,30,2021,Deschutes,OR,Passenger,1,0,1,116,117,0.85
April,30,2021,Douglas,WA,Truck,0,0,0,12625,12625,0
April,30,2021,Erie,NY,Passenger,1,0,1,39,40,2.5
April,30,2021,Cowlitz,WA,Truck,0,0,0,29173,29173,0
April,30,2021,Kitsap,WA,Passenger,1733,814,2547,180539,183086,1.39
April,30,2021,Penobscot,ME,Passenger,0,1,1,9,10,10
April,30,2021,Grant,WA,Passenger,102,86,188,66806,66994,0.28
April,30,2021,Burlington,NJ,Passenger,0,1,1,133,134,0.75
April,30,2021,Lincoln,WA,Truck,0,0,0,4751,4751,0
April,30,2021,Clallam,WA,Truck,1,0,1,21992,21993,0
April,30,2021,Garfield,WA,Truck,0,0,0,1007,1007,0
April,30,2021,Fairbanks North Star,AK,Passenger,0,1,1,82,83,1.2
April,30,2021,Lane,OR,Passenger,0,1,1,127,128,0.78
April,30,2021,Alexandria,VA,Passenger,2,0,2,134,136,1.47
April,30,2021,Stevens,WA,Passenger,40,43,83,30581,30664,0.27
April,30,2021,Richmond,GA,Passenger,0,1,1,75,76,1.32
April,30,2021,Pinellas,FL,Passenger,1,1,2,93,95,2.11
April,30,2021,Pacific,WA,Truck,0,0,0,7919,7919,0
April,30,2021,Goochland,VA,Passenger,4,2,6,232,238,2.52
April,30,2021,Oldham,KY,Passenger,0,1,1,4,5,20
April,30,2021,Pierce,WA,Truck,0,0,0,145966,145966,0
April,30,2021,Spokane,WA,Truck,0,0,0,101932,101932,0
April,30,2021,Platte,MO,Passenger,1,0,1,18,19,5.26
April,30,2021,Fresno,CA,Passenger,1,0,1,170,171,0.58
April,30,2021,San Juan,WA,Truck,0,0,0,5911,5911,0
April,30,2021,Lewis,WA,Passenger,146,135,281,59779,60060,0.47
April,30,2021,Duval,FL,Passenger,0,2,2,341,343,0.58
April,30,2021,Maui,HI,Passenger,1,0,1,27,28,3.57
April,30,2021,Chelan,WA,Passenger,314,93,407,54673,55080,0.74
April,30,2021,Kittitas,WA,Truck,0,0,0,14775,14775,0
April,30,2021,Dallas,TX,Passenger,1,0,1,163,164,0.61
April,30,2021,Wahkiakum,WA,Passenger,11,6,17,3113,3130,0.54
April,30,2021,El Paso,TX,Passenger,3,0,3,377,380,0.79
April,30,2021,Albemarle,VA,Passenger,1,0,1,20,21,4.76
April,30,2021,Suffolk,VA,Passenger,1,0,1,127,128,0.78
April,30,2021,Chesapeake,VA,Passenger,0,3,3,391,394,0.76
April,30,2021,Hawaii,HI,Passenger,1,0,1,48,49,2.04
April,30,2021,Mason,WA,Truck,0,0,0,21291,21291,0
April,30,2021,Skamania,WA,Truck,0,0,0,4022,4022,0
April,30,2021,Flathead,MT,Passenger,1,0,1,43,44,2.27
April,30,2021,Clark,NV,Passenger,4,2,6,632,638,0.94
April,30,2021,Randolph,NC,Passenger,1,0,1,7,8,12.5
April,30,2021,Pacific,WA,Passenger,41,41,82,16071,16153,0.51
April,30,2021,Williams,ND,Passenger,0,1,1,9,10,10
April,30,2021,Kern,CA,Passenger,0,1,1,213,214,0.47
April,30,2021,El Dorado,CA,Passenger,1,0,1,31,32,3.12
April,30,2021,Lincoln,WA,Passenger,5,13,18,7751,7769,0.23
April,30,2021,Whitman,WA,Truck,0,0,0,8564,8564,0
April,30,2021,Broward,FL,Passenger,1,0,1,105,106,0.94
April,30,2021,Clark,WA,Passenger,2681,1330,4011,321630,325641,1.23
April,30,2021,Orange,FL,Passenger,1,0,1,112,113,0.88
April,30,2021,Harnett,NC,Passenger,1,1,2,174,176,1.14
April,30,2021,Okanogan,WA,Passenger,60,36,96,26414,26510,0.36
April,30,2021,St. Clair,IL,Passenger,1,0,1,135,136,0.74
April,30,2021,Juneau,AK,Passenger,0,1,1,26,27,3.7
April,30,2021,Lake,FL,Passenger,1,0,1,22,23,4.35
April,30,2021,Virginia Beach,VA,Passenger,3,0,3,621,624,0.48
April,30,2021,Bradley,TN,Passenger,1,0,1,0,1,100
April,30,2021,Queens,NY,Passenger,2,0,2,49,51,3.92
April,30,2021,Maricopa,AZ,Passenger,5,4,9,1211,1220,0.74
April,30,2021,Fairfax,VA,Passenger,4,4,8,693,701,1.14
April,30,2021,Sumter,SC,Passenger,0,1,1,39,40,2.5
April,30,2021,Santa Cruz,CA,Passenger,1,0,1,26,27,3.7
April,30,2021,Clark,WA,Truck,0,0,0,84198,84198,0
April,30,2021,Grant,WA,Truck,0,0,0,27879,27879,0
April,30,2021,Spokane,WA,Passenger,1000,611,1611,324879,326490,0.49
April,30,2021,Ray,MO,Passenger,0,1,1,1,2,50
April,30,2021,Kitsap,WA,Truck,0,0,0,54575,54575,0
April,30,2021,Nueces,TX,Passenger,1,0,1,78,79,1.27
April,30,2021,Washington,MD,Passenger,1,0,1,12,13,7.69
April,30,2021,Honolulu,HI,Passenger,5,2,7,402,409,1.71
April,30,2021,Ferry,WA,Truck,0,0,0,3649,3649,0
April,30,2021,Morris,NJ,Passenger,1,0,1,16,17,5.88
April,30,2021,Arlington,VA,Passenger,0,1,1,138,139,0.72
April,30,2021,Washington,OR,Passenger,1,0,1,394,395,0.25
April,30,2021,Snohomish,WA,Passenger,5588,1967,7555,540438,547993,1.38
April,30,2021,Allen,IN,Passenger,1,0,1,15,16,6.25
April,30,2021,Ulster,NY,Passenger,1,0,1,7,8,12.5
April,30,2021,Charles,MD,Passenger,1,1,2,69,71,2.82
August,31,2021,Richmond,NY,Passenger,1,0,1,8,9,11.11
August,31,2021,Fort Bend,TX,Passenger,1,0,1,35,36,2.78
August,31,2021,Lake,IL,Passenger,2,0,2,156,158,1.27
August,31,2021,San Diego,CA,Passenger,17,7,24,2518,2542,0.94
August,31,2021,Owyhee,ID,Passenger,1,0,1,2,3,33.33
August,31,2021,Island,WA,Truck,0,0,0,21590,21590,0
August,31,2021,Columbia,WA,Truck,0,0,0,1539,1539,0
August,31,2021,Pennington,SD,Passenger,1,0,1,31,32,3.12
August,31,2021,Norfolk,VA,Passenger,3,3,6,310,316,1.9
August,31,2021,Geary,KS,Passenger,1,0,1,95,96,1.04
August,31,2021,San Francisco,CA,Passenger,0,1,1,84,85,1.18
August,31,2021,Snohomish,WA,Passenger,6310,2137,8447,539419,547866,1.54
August,31,2021,Hidalgo,TX,Passenger,0,1,1,52,53,1.89
August,31,2021,Kings,NY,Passenger,1,0,1,67,68,1.47
August,31,2021,Hampshire,MA,Passenger,1,0,1,6,7,14.29
August,31,2021,Portsmouth,VA,Passenger,0,1,1,76,77,1.3
August,31,2021,Miami-Dade,FL,Passenger,1,0,1,95,96,1.04
August,31,2021,Chelan,WA,Passenger,364,102,466,54718,55184,0.84
August,31,2021,Houston,GA,Passenger,1,0,1,46,47,2.13
August,31,2021,Lewis,WA,Passenger,181,151,332,59647,59979,0.55
August,31,2021,Sonoma,CA,Passenger,0,1,1,82,83,1.2
August,31,2021,Suffolk,MA,Passenger,0,2,2,28,30,6.67
August,31,2021,Santa Clara,CA,Passenger,8,2,10,243,253,3.95
August,31,2021,Sevier,AR,Passenger,0,1,1,0,1,100
August,31,2021,Thurston,WA,Truck,0,0,0,56421,56421,0
August,31,2021,Queens,NY,Passenger,2,0,2,48,50,4
August,31,2021,Carroll,NH,Passenger,0,1,1,5,6,16.67
August,31,2021,New Haven,CT,Passenger,0,2,2,28,30,6.67
August,31,2021,Skamania,WA,Passenger,52,38,90,8389,8479,1.06
August,31,2021,Albemarle,VA,Passenger,1,0,1,20,21,4.76
August,31,2021,Wichita,TX,Passenger,1,0,1,41,42,2.38
August,31,2021,Sacramento,CA,Passenger,2,0,2,212,214,0.93
August,31,2021,Moore,NC,Passenger,0,1,1,123,124,0.81
August,31,2021,Greene,MO,Passenger,0,1,1,28,29,3.45
August,31,2021,Boulder,CO,Passenger,0,1,1,39,40,2.5
August,31,2021,Wahkiakum,WA,Passenger,16,8,24,3079,3103,0.77
August,31,2021,Garfield,WA,Truck,0,0,0,1003,1003,0
August,31,2021,Kern,CA,Passenger,0,1,1,203,204,0.49
August,31,2021,Pierce,WA,Truck,0,0,0,145668,145668,0
August,31,2021,Walla Walla,WA,Truck,0,0,0,14079,14079,0
August,31,2021,Philadelphia,PA,Passenger,1,0,1,44,45,2.22
August,31,2021,Arlington,VA,Passenger,0,1,1,133,134,0.75
August,31,2021,Calvert,MD,Passenger,0,2,2,86,88,2.27
August,31,2021,Prince William,VA,Passenger,1,1,2,203,205,0.98
August,31,2021,Anne Arundel,MD,Passenger,4,3,7,374,381,1.84
August,31,2021,Grant,WA,Truck,0,0,0,27997,27997,0
August,31,2021,Wilson,NC,Passenger,1,0,1,0,1,100
August,31,2021,Missoula,MT,Passenger,1,0,1,52,53,1.89
August,31,2021,Wahkiakum,WA,Truck,0,0,0,1801,1801,0
August,31,2021,Baltimore,MD,Passenger,1,0,1,93,94,1.06
August,31,2021,Cowlitz,WA,Passenger,237,152,389,72118,72507,0.54
August,31,2021,Klickitat,WA,Truck,0,0,0,8331,8331,0
August,31,2021,Montgomery,PA,Passenger,2,0,2,22,24,8.33
August,31,2021,Randolph,NC,Passenger,1,0,1,5,6,16.67
August,31,2021,Stafford,VA,Passenger,2,1,3,98,101,2.97
August,31,2021,Whatcom,WA,Truck,4,0,4,43867,43871,0.01
August,31,2021,King,WA,Truck,5,1,6,184053,184059,0
August,31,2021,Juneau,AK,Passenger,0,1,1,26,27,3.7
August,31,2021,Whitman,WA,Passenger,63,52,115,21930,22045,0.52
August,31,2021,Santa Cruz,CA,Passenger,1,0,1,25,26,3.85
August,31,2021,Hudson,NJ,Passenger,1,0,1,41,42,2.38
August,31,2021,Wilson,TX,Passenger,0,1,1,3,4,25
August,31,2021,San Juan,WA,Truck,0,0,0,5976,5976,0
August,31,2021,Polk,FL,Passenger,1,0,1,56,57,1.75
August,31,2021,Virginia Beach,VA,Passenger,2,0,2,602,604,0.33
August,31,2021,Garfield,WA,Passenger,0,3,3,1369,1372,0.22
August,31,2021,Snohomish,WA,Truck,1,0,1,126015,126016,0
August,31,2021,Clackamas,OR,Passenger,2,0,2,167,169,1.18
August,31,2021,Onslow,NC,Passenger,0,1,1,178,179,0.56
August,31,2021,Erie,NY,Passenger,1,0,1,36,37,2.7
August,31,2021,New London,CT,Passenger,1,3,4,214,218,1.83
August,31,2021,Champaign,IL,Passenger,1,0,1,10,11,9.09
August,31,2021,Clallam,WA,Truck,1,0,1,22024,22025,0
August,31,2021,Flathead,MT,Passenger,1,0,1,42,43,2.33
August,31,2021,Whatcom,WA,Passenger,1520,628,2148,150496,152644,1.41
August,31,2021,Carroll,MD,Passenger,0,1,1,17,18,5.56
August,31,2021,Burlington,NJ,Passenger,0,1,1,124,125,0.8
August,31,2021,Spokane,WA,Truck,0,0,0,102463,102463,0
August,31,2021,Montgomery,OH,Passenger,0,1,1,55,56,1.79
August,31,2021,Skagit,WA,Passenger,620,287,907,91723,92630,0.98
August,31,2021,Howard,IN,Passenger,0,1,1,5,6,16.67
August,31,2021,Howard,MD,Passenger,0,1,1,58,59,1.69
August,31,2021,Collin,TX,Passenger,1,1,2,105,107,1.87
August,31,2021,Spokane,WA,Passenger,1158,684,1842,326045,327887,0.56
August,31,2021,Franklin,WA,Truck,0,0,0,20720,20720,0
August,31,2021,Larimer,CO,Passenger,1,0,1,48,49,2.04
August,31,2021,Pacific,WA,Truck,0,0,0,7973,7973,0
August,31,2021,Yakima,WA,Truck,0,0,0,61772,61772,0
August,31,2021,Jefferson,NY,Passenger,0,1,1,210,211,0.47
August,31,2021,Montgomery,MD,Passenger,3,1,4,207,211,1.9
August,31,2021,Fairbanks North Star,AK,Passenger,0,1,1,79,80,1.25
August,31,2021,El Paso,TX,Passenger,3,0,3,358,361,0.83
August,31,2021,Kittitas,WA,Truck,0,0,0,14782,14782,0
August,31,2021,Walla Walla,WA,Passenger,121,82,203,36479,36682,0.55
August,31,2021,San Luis Obispo,CA,Passenger,1,0,1,58,59,1.69
August,31,2021,Mason,WA,Passenger,227,147,374,48071,48445,0.77
August,31,2021,Dallas,TX,Passenger,1,0,1,144,145,0.69
August,31,2021,Sarasota,FL,Passenger,2,0,2,28,30,6.67
August,31,2021,Clallam,WA,Passenger,350,220,570,50504,51074,1.12
August,31,2021,Anchorage,AK,Passenger,1,0,1,132,133,0.75
August,31,2021,Fresno,CA,Passenger,1,0,1,161,162,0.62
August,31,2021,New York,NY,Passenger,1,0,1,39,40,2.5
August,31,2021,Okaloosa,FL,Passenger,0,1,1,111,112,0.89
August,31,2021,Hennepin,MN,Passenger,3,0,3,72,75,4
August,31,2021,Okanogan,WA,Passenger,66,45,111,26473,26584,0.42
August,31,2021,Travis,TX,Passenger,3,3,6,141,147,4.08
August,31,2021,Maricopa,AZ,Passenger,6,2,8,1098,1106,0.72
August,31,2021,Riverside,CA,Passenger,5,1,6,530,536,1.12
August,31,2021,Gwinnett,GA,Passenger,1,0,1,58,59,1.69
August,31,2021,Louisa,VA,Passenger,0,1,1,1,2,50
August,31,2021,,,Passenger,11,7,18,1090,1108,1.62
August,31,2021,Los Angeles,CA,Passenger,10,9,19,849,868,2.19
August,31,2021,Rogers,OK,Passenger,1,0,1,3,4,25
August,31,2021,Klamath,OR,Passenger,1,0,1,28,29,3.45
August,31,2021,Salt Lake,UT,Passenger,0,1,1,158,159,0.63
August,31,2021,Las Animas,CO,Passenger,1,0,1,0,1,100
August,31,2021,DuPage,IL,Passenger,1,0,1,51,52,1.92
August,31,2021,Kitsap,WA,Passenger,1952,888,2840,180672,183512,1.55
August,31,2021,Adams,WA,Passenger,16,14,30,13041,13071,0.23
August,31,2021,Skamania,WA,Truck,0,0,0,4036,4036,0
August,31,2021,Alexandria,VA,Passenger,2,0,2,122,124,1.61
August,31,2021,Grays Harbor,WA,Passenger,177,147,324,49506,49830,0.65
August,31,2021,Stevens,WA,Passenger,48,44,92,30285,30377,0.3
August,31,2021,San Mateo,CA,Passenger,1,0,1,93,94,1.06
August,31,2021,Rockdale,GA,Passenger,1,0,1,8,9,11.11
August,31,2021,Williamson,TX,Passenger,0,2,2,100,102,1.96
August,31,2021,Pend Oreille,WA,Truck,0,0,0,5726,5726,0
August,31,2021,Honolulu,HI,Passenger,5,3,8,365,373,2.14
August,31,2021,Klickitat,WA,Passenger,82,51,133,15361,15494,0.86
August,31,2021,Multnomah,OR,Passenger,2,7,9,626,635,1.42
August,31,2021,Chelan,WA,Truck,0,0,0,23088,23088,0
August,31,2021,Denver,CO,Passenger,1,0,1,116,117,0.85
August,31,2021,Leavenworth,KS,Passenger,0,1,1,114,115,0.87
August,31,2021,Broward,FL,Passenger,2,0,2,104,106,1.89
August,31,2021,Plaquemines,LA,Passenger,0,1,1,16,17,5.88
August,31,2021,DeKalb,GA,Passenger,1,0,1,59,60,1.67
August,31,2021,Penobscot,ME,Passenger,0,1,1,8,9,11.11
August,31,2021,Camden,NJ,Passenger,0,1,1,14,15,6.67
August,31,2021,Milwaukee,WI,Passenger,1,0,1,38,39,2.56
August,31,2021,King,WA,Passenger,32289,9551,41840,1365924,1407764,2.97
August,31,2021,Yakima,WA,Passenger,248,163,411,168910,169321,0.24
August,31,2021,Frederick,MD,Passenger,1,1,2,68,70,2.86
August,31,2021,Powhatan,VA,Passenger,1,0,1,1,2,50
August,31,2021,Williams,ND,Passenger,0,1,1,7,8,12.5
August,31,2021,Skagit,WA,Truck,1,0,1,32973,32974,0
August,31,2021,San Joaquin,CA,Passenger,1,0,1,100,101,0.99
August,31,2021,Lake,FL,Passenger,1,0,1,22,23,4.35
August,31,2021,Harnett,NC,Passenger,1,1,2,162,164,1.22
August,31,2021,Monterey,CA,Passenger,0,1,1,144,145,0.69
August,31,2021,Goochland,VA,Passenger,4,2,6,210,216,2.78
August,31,2021,Ferry,WA,Passenger,9,3,12,4389,4401,0.27
August,31,2021,Thurston,WA,Passenger,1715,906,2621,197780,200401,1.31
August,31,2021,Yamhill,OR,Passenger,1,0,1,33,34,2.94
August,31,2021,Grant,WA,Passenger,123,96,219,66857,67076,0.33
August,31,2021,San Juan,WA,Passenger,452,141,593,14207,14800,4.01
August,31,2021,Alameda,CA,Passenger,4,0,4,227,231,1.73
August,31,2021,Sumter,SC,Passenger,0,1,1,36,37,2.7
August,31,2021,Clark,WA,Truck,0,0,0,84180,84180,0
August,31,2021,Hamilton,IN,Passenger,2,0,2,29,31,6.45
August,31,2021,Clark,NV,Passenger,4,2,6,593,599,1
August,31,2021,Lewis,WA,Truck,0,0,0,26748,26748,0
August,31,2021,El Paso,CO,Passenger,3,0,3,660,663,0.45
August,31,2021,Suffolk,VA,Passenger,1,0,1,124,125,0.8
August,31,2021,Island,WA,Passenger,645,318,963,63236,64199,1.5
August,31,2021,Pierce,WA,Passenger,3774,2031,5805,559092,564897,1.03
August,31,2021,Harris,TX,Passenger,1,1,2,179,181,1.1
August,31,2021,Ulster,NY,Passenger,1,0,1,8,9,11.11
August,31,2021,Placer,CA,Passenger,2,0,2,70,72,2.78
August,31,2021,Rockingham,NH,Passenger,1,0,1,19,20,5
August,31,2021,Denton,TX,Passenger,1,0,1,77,78,1.28
August,31,2021,Saratoga,NY,Passenger,1,0,1,42,43,2.33
August,31,2021,Orange,CA,Passenger,5,2,7,402,409,1.71
August,31,2021,Charles,MD,Passenger,1,1,2,69,71,2.82
August,31,2021,Columbia,WA,Passenger,7,2,9,2458,2467,0.36
August,31,2021,St. Louis,MO,Passenger,1,0,1,78,79,1.27
August,31,2021,Cumberland,NC,Passenger,0,2,2,414,416,0.48
August,31,2021,Stevens,WA,Truck,0,0,0,18913,18913,0
August,31,2021,Jefferson,WA,Truck,0,0,0,9611,9611,0
August,31,2021,Nassau,NY,Passenger,2,0,2,26,28,7.14
August,31,2021,Clark,WA,Passenger,3072,1473,4545,322091,326636,1.39
August,31,2021,District of Columbia,DC,Passenger,5,1,6,198,204,2.94
August,31,2021,Whitman,WA,Truck,0,0,0,8572,8572,0
August,31,2021,Asotin,WA,Passenger,21,17,38,12728,12766,0.3
August,31,2021,Douglas,WA,Truck,0,0,0,12682,12682,0
August,31,2021,Kittitas,WA,Passenger,173,72,245,29872,30117,0.81
August,31,2021,Carson City,NV,Passenger,1,0,1,10,11,9.09
August,31,2021,Cook,IL,Passenger,1,0,1,201,202,0.5
August,31,2021,Danville,VA,Passenger,1,0,1,0,1,100
August,31,2021,Washington,MD,Passenger,2,0,2,13,15,13.33
August,31,2021,Essex,NJ,Passenger,2,0,2,10,12,16.67
August,31,2021,Harrison,MS,Passenger,2,0,2,51,53,3.77
August,31,2021,Loudoun,VA,Passenger,1,0,1,72,73,1.37
August,31,2021,Richmond,GA,Passenger,0,1,1,73,74,1.35
August,31,2021,Lincoln,WA,Truck,0,0,0,4773,4773,0
August,31,2021,Shelby,OH,Passenger,0,1,1,2,3,33.33
August,31,2021,Richland,SC,Passenger,0,1,1,132,133,0.75
August,31,2021,Cowlitz,WA,Truck,0,1,1,29085,29086,0
August,31,2021,Lincoln,WA,Passenger,7,15,22,7695,7717,0.29
August,31,2021,Spartanburg,SC,Passenger,0,1,1,49,50,2
August,31,2021,Chesapeake,VA,Passenger,0,4,4,384,388,1.03
August,31,2021,Nueces,TX,Passenger,1,0,1,67,68,1.47
August,31,2021,Ferry,WA,Truck,0,0,0,3632,3632,0
August,31,2021,Sedgwick,KS,Passenger,1,1,2,79,81,2.47
August,31,2021,Washington,OR,Passenger,1,0,1,368,369,0.27
August,31,2021,Fairfax,VA,Passenger,5,4,9,676,685,1.31
August,31,2021,Contra Costa,CA,Passenger,2,4,6,260,266,2.26
August,31,2021,Middlesex,MA,Passenger,1,1,2,91,93,2.15
August,31,2021,Bartow,GA,Passenger,0,1,1,3,4,25
August,31,2021,Pend Oreille,WA,Passenger,16,7,23,9243,9266,0.25
August,31,2021,Oldham,KY,Passenger,0,1,1,4,5,20
August,31,2021,Hillsborough,FL,Passenger,0,1,1,143,144,0.69
August,31,2021,Kings,CA,Passenger,1,0,1,321,322,0.31
August,31,2021,Douglas,NE,Passenger,1,1,2,50,52,3.85
August,31,2021,Vigo,IN,Passenger,1,0,1,5,6,16.67
August,31,2021,Orange,FL,Passenger,1,0,1,109,110,0.91
August,31,2021,St. Clair,IL,Passenger,2,0,2,131,133,1.5
August,31,2021,Hawaii,HI,Passenger,1,0,1,44,45,2.22
August,31,2021,Lee,FL,Passenger,1,0,1,34,35,2.86
August,31,2021,Boone,MO,Passenger,0,1,1,10,11,9.09
August,31,2021,Kauai,HI,Passenger,1,0,1,18,19,5.26
August,31,2021,Ray,MO,Passenger,0,1,1,1,2,50
August,31,2021,Cape May,NJ,Passenger,0,1,1,8,9,11.11
August,31,2021,Manassas,VA,Passenger,0,1,1,7,8,12.5
August,31,2021,Platte,MO,Passenger,1,0,1,16,17,5.88
August,31,2021,Franklin,WA,Passenger,139,99,238,61954,62192,0.38
August,31,2021,Adams,WA,Truck,0,0,0,5413,5413,0
August,31,2021,Pima,AZ,Passenger,1,1,2,259,261,0.77
August,31,2021,Saginaw,MI,Passenger,1,0,1,6,7,14.29
August,31,2021,Allen,IN,Passenger,1,0,1,15,16,6.25
August,31,2021,Asotin,WA,Truck,0,0,0,6755,6755,0
August,31,2021,Charleston,SC,Passenger,1,1,2,80,82,2.44
August,31,2021,Kitsap,WA,Truck,0,0,0,54394,54394,0
August,31,2021,Duval,FL,Passenger,0,2,2,329,331,0.6
August,31,2021,Ventura,CA,Passenger,1,2,3,251,254,1.18
August,31,2021,Escambia,FL,Passenger,0,1,1,143,144,0.69
August,31,2021,Douglas,WA,Passenger,103,51,154,28575,28729,0.54
August,31,2021,Grays Harbor,WA,Truck,0,0,0,21395,21395,0
August,31,2021,Bucks,PA,Passenger,1,0,1,14,15,6.67
August,31,2021,Arapahoe,CO,Passenger,1,0,1,104,105,0.95
August,31,2021,RÃ­o Grande,PR,Passenger,1,0,1,0,1,100
August,31,2021,Jefferson,WA,Passenger,350,183,533,24858,25391,2.1
August,31,2021,Allegheny,PA,Passenger,1,1,2,61,63,3.17
August,31,2021,Wake,NC,Passenger,1,0,1,119,120,0.83
August,31,2021,Montgomery,TX,Passenger,1,1,2,38,40,5
August,31,2021,Mason,WA,Truck,0,0,0,21324,21324,0
August,31,2021,Lane,OR,Passenger,0,1,1,119,120,0.83
August,31,2021,Benton,WA,Passenger,567,409,976,136208,137184,0.71
August,31,2021,Okanogan,WA,Truck,0,0,0,16752,16752,0
August,31,2021,St. Mary's,MD,Passenger,1,0,1,203,204,0.49
August,31,2021,Prince George's,MD,Passenger,2,1,3,137,140,2.14
August,31,2021,Pacific,WA,Passenger,48,54,102,16069,16171,0.63
August,31,2021,Douglas,CO,Passenger,0,1,1,75,76,1.32
August,31,2021,Pinellas,FL,Passenger,0,1,1,90,91,1.1
August,31,2021,Benton,WA,Truck,0,0,0,43605,43605,0
August,31,2021,Bexar,TX,Passenger,3,4,7,506,513,1.36
December,31,2021,Benton,WA,Truck,0,0,0,43707,43707,0
December,31,2021,Bartow,GA,Passenger,0,1,1,3,4,25
December,31,2021,Lewis,WA,Passenger,206,164,370,59615,59985,0.62
December,31,2021,Geary,KS,Passenger,1,0,1,94,95,1.05
December,31,2021,Pend Oreille,WA,Truck,0,0,0,5703,5703,0
December,31,2021,Denton,TX,Passenger,1,0,1,74,75,1.33
December,31,2021,Wilson,NC,Passenger,1,0,1,0,1,100
December,31,2021,Hamilton,OH,Passenger,1,0,1,32,33,3.03
December,31,2021,El Paso,TX,Passenger,2,0,2,344,346,0.58
December,31,2021,Moore,NC,Passenger,0,1,1,120,121,0.83
December,31,2021,Elmore,ID,Passenger,1,0,1,16,17,5.88
December,31,2021,Williamson,TX,Passenger,1,2,3,90,93,3.23
December,31,2021,Lincoln,WA,Truck,0,0,0,4823,4823,0
December,31,2021,Williams,ND,Passenger,0,1,1,8,9,11.11
December,31,2021,Benton,WA,Passenger,639,445,1084,136113,137197,0.79
December,31,2021,Grant,WA,Truck,0,0,0,27999,27999,0
December,31,2021,Alexandria,VA,Passenger,2,0,2,115,117,1.71
December,31,2021,Erie,NY,Passenger,1,0,1,31,32,3.12
December,31,2021,Coryell,TX,Passenger,1,0,1,106,107,0.93
December,31,2021,Fresno,CA,Passenger,1,0,1,155,156,0.64
December,31,2021,Clallam,WA,Truck,1,0,1,22124,22125,0
December,31,2021,Wahkiakum,WA,Passenger,17,10,27,3082,3109,0.87
December,31,2021,Spokane,WA,Truck,0,0,0,102792,102792,0
December,31,2021,Asotin,WA,Truck,0,0,0,6755,6755,0
December,31,2021,Penobscot,ME,Passenger,0,1,1,8,9,11.11
December,31,2021,Grant,WA,Passenger,137,98,235,66973,67208,0.35
December,31,2021,Greene,MO,Passenger,0,1,1,24,25,4
December,31,2021,Adams,WA,Truck,0,0,0,5419,5419,0
December,31,2021,Fairfax,VA,Passenger,3,4,7,645,652,1.07
December,31,2021,Howard,IN,Passenger,0,1,1,6,7,14.29
December,31,2021,Larimer,CO,Passenger,1,0,1,50,51,1.96
December,31,2021,Monterey,CA,Passenger,0,1,1,136,137,0.73
December,31,2021,Stevens,WA,Truck,0,0,0,18940,18940,0
December,31,2021,Asotin,WA,Passenger,22,17,39,12718,12757,0.31
December,31,2021,Boulder,CO,Passenger,1,1,2,38,40,5
December,31,2021,Island,WA,Passenger,714,340,1054,62768,63822,1.65
December,31,2021,,,Passenger,14,7,21,1101,1122,1.87
December,31,2021,Charleston,SC,Passenger,2,1,3,75,78,3.85
December,31,2021,Santa Cruz,CA,Passenger,1,0,1,23,24,4.17
December,31,2021,Adams,WA,Passenger,17,14,31,13083,13114,0.24
December,31,2021,Whatcom,WA,Truck,4,0,4,43696,43700,0.01
December,31,2021,St. Clair,IL,Passenger,2,0,2,120,122,1.64
December,31,2021,Solano,CA,Passenger,1,0,1,173,174,0.57
December,31,2021,Pend Oreille,WA,Passenger,18,9,27,9129,9156,0.29
December,31,2021,Jefferson,WA,Truck,0,0,0,9599,9599,0
December,31,2021,Santa Clara,CA,Passenger,7,1,8,227,235,3.4
December,31,2021,Rogers,OK,Passenger,1,0,1,3,4,25
December,31,2021,Jefferson,WA,Passenger,382,194,576,24756,25332,2.27
December,31,2021,Ferry,WA,Passenger,14,3,17,4442,4459,0.38
December,31,2021,Thurston,WA,Truck,0,0,0,56065,56065,0
December,31,2021,Powhatan,VA,Passenger,1,0,1,1,2,50
December,31,2021,Honolulu,HI,Passenger,4,4,8,346,354,2.26
December,31,2021,Alameda,CA,Passenger,4,0,4,210,214,1.87
December,31,2021,Kittitas,WA,Truck,0,0,0,14794,14794,0
December,31,2021,Ulster,NY,Passenger,1,0,1,9,10,10
December,31,2021,Whitman,WA,Passenger,67,59,126,21978,22104,0.57
December,31,2021,Suffolk,VA,Passenger,1,0,1,124,125,0.8
December,31,2021,Juneau,AK,Passenger,0,1,1,27,28,3.57
December,31,2021,Houston,GA,Passenger,1,0,1,43,44,2.27
December,31,2021,Clallam,WA,Passenger,383,239,622,50384,51006,1.22
December,31,2021,Klickitat,WA,Passenger,89,53,142,15347,15489,0.92
December,31,2021,Sarpy,NE,Passenger,1,0,1,58,59,1.69
December,31,2021,Wahkiakum,WA,Truck,0,0,0,1824,1824,0
December,31,2021,Carroll,MD,Passenger,0,1,1,16,17,5.88
December,31,2021,Franklin,WA,Passenger,162,104,266,62306,62572,0.43
December,31,2021,Pacific,WA,Passenger,51,64,115,16068,16183,0.71
December,31,2021,Clark,WA,Truck,1,0,1,83996,83997,0
December,31,2021,Plaquemines,LA,Passenger,0,1,1,17,18,5.56
December,31,2021,Flathead,MT,Passenger,1,0,1,38,39,2.56
December,31,2021,Okaloosa,FL,Passenger,0,1,1,108,109,0.92
December,31,2021,Carroll,NH,Passenger,0,1,1,5,6,16.67
December,31,2021,Manassas,VA,Passenger,0,1,1,7,8,12.5
December,31,2021,King,WA,Passenger,35480,10222,45702,1359266,1404968,3.25
December,31,2021,Grays Harbor,WA,Truck,0,0,0,21388,21388,0
December,31,2021,Collin,TX,Passenger,1,0,1,102,103,0.97
December,31,2021,Richmond,NY,Passenger,1,0,1,6,7,14.29
December,31,2021,Nueces,TX,Passenger,1,1,2,64,66,3.03
December,31,2021,Yakima,WA,Truck,0,0,0,61785,61785,0
December,31,2021,Salt Lake,UT,Passenger,1,1,2,150,152,1.32
December,31,2021,Platte,MO,Passenger,1,0,1,17,18,5.56
December,31,2021,Boone,MO,Passenger,0,1,1,9,10,10
December,31,2021,Lincoln,WA,Passenger,7,16,23,7719,7742,0.3
December,31,2021,Klickitat,WA,Truck,0,0,0,8333,8333,0
December,31,2021,Island,WA,Truck,0,0,0,21524,21524,0
December,31,2021,DeKalb,GA,Passenger,1,0,1,56,57,1.75
December,31,2021,Shelby,OH,Passenger,0,1,1,2,3,33.33
December,31,2021,Allegheny,PA,Passenger,1,1,2,55,57,3.51
December,31,2021,Ventura,CA,Passenger,2,1,3,242,245,1.22
December,31,2021,San Juan,WA,Passenger,478,149,627,14189,14816,4.23
December,31,2021,Essex,NJ,Passenger,2,0,2,10,12,16.67
December,31,2021,Gwinnett,GA,Passenger,1,0,1,57,58,1.72
December,31,2021,Kings,NY,Passenger,1,0,1,66,67,1.49
December,31,2021,Baltimore,MD,Passenger,1,0,1,80,81,1.23
December,31,2021,Snohomish,WA,Passenger,7024,2235,9259,537474,546733,1.69
December,31,2021,Cowlitz,WA,Truck,0,1,1,28998,28999,0
December,31,2021,Placer,CA,Passenger,2,0,2,71,73,2.74
December,31,2021,Douglas,WA,Truck,0,0,0,12700,12700,0
December,31,2021,Bexar,TX,Passenger,3,4,7,481,488,1.43
December,31,2021,Onslow,NC,Passenger,0,1,1,167,168,0.6
December,31,2021,Carson City,NV,Passenger,1,0,1,8,9,11.11
December,31,2021,Queens,NY,Passenger,1,0,1,49,50,2
December,31,2021,Montgomery,MD,Passenger,3,2,5,203,208,2.4
December,31,2021,Mason,WA,Passenger,266,158,424,47764,48188,0.88
December,31,2021,Wichita,TX,Passenger,1,0,1,42,43,2.33
December,31,2021,Charles,MD,Passenger,1,1,2,67,69,2.9
December,31,2021,Owyhee,ID,Passenger,1,0,1,2,3,33.33
December,31,2021,Orange,FL,Passenger,1,0,1,103,104,0.96
December,31,2021,Ray,MO,Passenger,0,1,1,1,2,50
December,31,2021,Burlington,NJ,Passenger,0,1,1,118,119,0.84
December,31,2021,Lewis,WA,Truck,0,0,0,26677,26677,0
December,31,2021,Riverside,CA,Passenger,5,1,6,494,500,1.2
December,31,2021,Multnomah,OR,Passenger,2,5,7,599,606,1.16
December,31,2021,Columbia,WA,Passenger,6,2,8,2452,2460,0.33
December,31,2021,Oldham,KY,Passenger,0,1,1,4,5,20
December,31,2021,Lake,IL,Passenger,3,0,3,149,152,1.97
December,31,2021,Virginia Beach,VA,Passenger,2,0,2,558,560,0.36
December,31,2021,Kern,CA,Passenger,0,1,1,198,199,0.5
December,31,2021,Clark,WA,Passenger,3474,1562,5036,320347,325383,1.55
December,31,2021,Harris,TX,Passenger,1,0,1,160,161,0.62
December,31,2021,Calvert,MD,Passenger,0,2,2,80,82,2.44
December,31,2021,St. Mary's,MD,Passenger,1,0,1,202,203,0.49
December,31,2021,Travis,TX,Passenger,2,0,2,130,132,1.52
December,31,2021,Clackamas,OR,Passenger,2,0,2,159,161,1.24
December,31,2021,Nassau,NY,Passenger,2,0,2,25,27,7.41
December,31,2021,Jefferson,NY,Passenger,0,1,1,205,206,0.49
December,31,2021,Yamhill,OR,Passenger,1,0,1,31,32,3.12
December,31,2021,Frederick,MD,Passenger,1,1,2,68,70,2.86
December,31,2021,Rockdale,GA,Passenger,1,0,1,7,8,12.5
December,31,2021,Okanogan,WA,Truck,0,0,0,16688,16688,0
December,31,2021,Whitman,WA,Truck,0,0,0,8559,8559,0
December,31,2021,San Bernardino,CA,Passenger,0,1,1,357,358,0.28
December,31,2021,Escambia,FL,Passenger,0,1,1,136,137,0.73
December,31,2021,Cowlitz,WA,Passenger,274,163,437,71563,72000,0.61
December,31,2021,Rockingham,NH,Passenger,1,0,1,17,18,5.56
December,31,2021,Pinellas,FL,Passenger,0,1,1,85,86,1.16
December,31,2021,Randolph,NC,Passenger,1,0,1,5,6,16.67
December,31,2021,Whatcom,WA,Passenger,1643,673,2316,149995,152311,1.52
December,31,2021,Loudoun,VA,Passenger,1,0,1,66,67,1.49
December,31,2021,Yakima,WA,Passenger,286,173,459,168770,169229,0.27
December,31,2021,Los Angeles,CA,Passenger,8,7,15,825,840,1.79
December,31,2021,Sonoma,CA,Passenger,0,1,1,80,81,1.23
December,31,2021,Lee,FL,Passenger,1,0,1,29,30,3.33
December,31,2021,Prince William,VA,Passenger,1,1,2,199,201,1
December,31,2021,Hillsborough,FL,Passenger,0,1,1,134,135,0.74
December,31,2021,Columbia,WA,Truck,0,0,0,1555,1555,0
December,31,2021,Wake,NC,Passenger,1,0,1,106,107,0.93
December,31,2021,Montgomery,PA,Passenger,2,0,2,21,23,8.7
December,31,2021,Cumberland,NC,Passenger,1,2,3,393,396,0.76
December,31,2021,El Paso,CO,Passenger,3,0,3,644,647,0.46
December,31,2021,Skamania,WA,Passenger,60,42,102,8323,8425,1.21
December,31,2021,Kauai,HI,Passenger,1,0,1,17,18,5.56
December,31,2021,Fairbanks North Star,AK,Passenger,0,1,1,77,78,1.28
December,31,2021,Stafford,VA,Passenger,2,1,3,92,95,3.16
December,31,2021,Contra Costa,CA,Passenger,1,4,5,260,265,1.89
December,31,2021,Kitsap,WA,Truck,0,0,0,54199,54199,0
December,31,2021,Wood,OH,Passenger,0,1,1,5,6,16.67
December,31,2021,Arlington,VA,Passenger,1,0,1,127,128,0.78
December,31,2021,Cook,IL,Passenger,2,0,2,191,193,1.04
December,31,2021,Hennepin,MN,Passenger,3,0,3,63,66,4.55
December,31,2021,San Joaquin,CA,Passenger,1,1,2,94,96,2.08
December,31,2021,Albemarle,VA,Passenger,1,0,1,18,19,5.26
December,31,2021,Cape May,NJ,Passenger,0,1,1,8,9,11.11
December,31,2021,Grays Harbor,WA,Passenger,192,157,349,49447,49796,0.7
December,31,2021,Lake,FL,Passenger,1,0,1,22,23,4.35
December,31,2021,Garfield,WA,Truck,0,0,0,1001,1001,0
December,31,2021,Harnett,NC,Passenger,1,1,2,150,152,1.32
December,31,2021,Tarrant,TX,Passenger,1,0,1,127,128,0.78
December,31,2021,Danville,VA,Passenger,1,0,1,0,1,100
December,31,2021,Prince George's,MD,Passenger,2,1,3,140,143,2.1
December,31,2021,Miami-Dade,FL,Passenger,1,0,1,90,91,1.1
December,31,2021,Snohomish,WA,Truck,2,0,2,125446,125448,0
December,31,2021,Middlesex,MA,Passenger,0,1,1,85,86,1.16
December,31,2021,Sedgwick,KS,Passenger,1,1,2,81,83,2.41
December,31,2021,San Juan,WA,Truck,0,0,0,6002,6002,0
December,31,2021,Fort Bend,TX,Passenger,1,0,1,31,32,3.12
December,31,2021,Douglas,NE,Passenger,1,2,3,46,49,6.12
December,31,2021,Norfolk,VA,Passenger,3,3,6,304,310,1.94
December,31,2021,Hudson,NJ,Passenger,2,0,2,38,40,5
December,31,2021,Chesapeake,VA,Passenger,2,3,5,372,377,1.33
December,31,2021,DuPage,IL,Passenger,1,0,1,48,49,2.04
December,31,2021,Garfield,WA,Passenger,0,3,3,1350,1353,0.22
December,31,2021,Sacramento,CA,Passenger,2,0,2,207,209,0.96
December,31,2021,Maricopa,AZ,Passenger,8,2,10,1035,1045,0.96
December,31,2021,Walla Walla,WA,Truck,0,0,0,14090,14090,0
December,31,2021,Dallas,TX,Passenger,1,0,1,136,137,0.73
December,31,2021,Mason,WA,Truck,0,0,0,21219,21219,0
December,31,2021,San Luis Obispo,CA,Passenger,1,0,1,56,57,1.75
December,31,2021,Saratoga,NY,Passenger,1,0,1,39,40,2.5
December,31,2021,Broward,FL,Passenger,2,0,2,93,95,2.11
December,31,2021,Douglas,CO,Passenger,0,1,1,75,76,1.32
December,31,2021,Camden,NJ,Passenger,0,1,1,14,15,6.67
December,31,2021,Hawaii,HI,Passenger,1,0,1,40,41,2.44
December,31,2021,Pierce,WA,Passenger,4236,2127,6363,555764,562127,1.13
December,31,2021,Goochland,VA,Passenger,3,2,5,179,184,2.72
December,31,2021,Marin,CA,Passenger,0,1,1,32,33,3.03
December,31,2021,Duval,FL,Passenger,0,2,2,314,316,0.63
December,31,2021,Clark,NV,Passenger,4,2,6,557,563,1.07
December,31,2021,Chelan,WA,Truck,0,0,0,23108,23108,0
December,31,2021,Douglas,WA,Passenger,116,56,172,28610,28782,0.6
December,31,2021,Walla Walla,WA,Passenger,143,87,230,36378,36608,0.63
December,31,2021,Richmond,GA,Passenger,0,1,1,70,71,1.41
December,31,2021,Washington,MD,Passenger,2,0,2,14,16,12.5
December,31,2021,Hamilton,IN,Passenger,2,0,2,24,26,7.69
December,31,2021,Okanogan,WA,Passenger,69,45,114,26600,26714,0.43
December,31,2021,Skagit,WA,Passenger,695,302,997,91135,92132,1.08
December,31,2021,Wilson,TX,Passenger,0,1,1,2,3,33.33
December,31,2021,Orange,CA,Passenger,5,2,7,376,383,1.83
December,31,2021,Ferry,WA,Truck,0,0,0,3596,3596,0
December,31,2021,Skamania,WA,Truck,0,0,0,4002,4002,0
December,31,2021,San Francisco,CA,Passenger,0,1,1,81,82,1.22
December,31,2021,Stevens,WA,Passenger,55,44,99,30290,30389,0.33
December,31,2021,Pennington,SD,Passenger,1,0,1,31,32,3.12
December,31,2021,New London,CT,Passenger,1,4,5,210,215,2.33
December,31,2021,Pacific,WA,Truck,0,0,0,8019,8019,0
December,31,2021,District of Columbia,DC,Passenger,5,0,5,188,193,2.59
December,31,2021,Anchorage,AK,Passenger,1,0,1,122,123,0.81
December,31,2021,Lane,OR,Passenger,0,1,1,108,109,0.92
December,31,2021,Kittitas,WA,Passenger,207,75,282,29844,30126,0.94
December,31,2021,Sevier,AR,Passenger,0,1,1,0,1,100
December,31,2021,Champaign,IL,Passenger,1,0,1,9,10,10
December,31,2021,Louisa,VA,Passenger,0,1,1,1,2,50
December,31,2021,King,WA,Truck,6,1,7,183027,183034,0
December,31,2021,Harrison,MS,Passenger,2,0,2,44,46,4.35
December,31,2021,Sumter,SC,Passenger,0,1,1,34,35,2.86
December,31,2021,Suffolk,MA,Passenger,0,2,2,25,27,7.41
December,31,2021,Hidalgo,TX,Passenger,0,1,1,53,54,1.85
December,31,2021,Lincoln,OR,Passenger,0,1,1,32,33,3.03
December,31,2021,Franklin,WA,Truck,0,0,0,20851,20851,0
December,31,2021,Philadelphia,PA,Passenger,1,0,1,36,37,2.7
December,31,2021,San Mateo,CA,Passenger,2,0,2,78,80,2.5
December,31,2021,Sarasota,FL,Passenger,2,0,2,30,32,6.25
December,31,2021,Thurston,WA,Passenger,1867,964,2831,196824,199655,1.42
December,31,2021,Kings,CA,Passenger,2,1,3,321,324,0.93
December,31,2021,San Diego,CA,Passenger,15,8,23,2410,2433,0.95
December,31,2021,Dorchester,SC,Passenger,1,0,1,62,63,1.59
December,31,2021,Klamath,OR,Passenger,1,0,1,28,29,3.45
December,31,2021,Howard,MD,Passenger,0,1,1,54,55,1.82
December,31,2021,Spokane,WA,Passenger,1310,758,2068,327386,329454,0.63
December,31,2021,Pierce,WA,Truck,0,0,0,144818,144818,0
December,31,2021,Pima,AZ,Passenger,1,1,2,247,249,0.8
December,31,2021,Kitsap,WA,Passenger,2129,958,3087,180142,183229,1.68
December,31,2021,Leavenworth,KS,Passenger,0,1,1,107,108,0.93
December,31,2021,Las Animas,CO,Passenger,1,0,1,0,1,100
December,31,2021,Allen,IN,Passenger,1,0,1,14,15,6.67
December,31,2021,Anne Arundel,MD,Passenger,4,3,7,354,361,1.94
December,31,2021,Spartanburg,SC,Passenger,0,1,1,47,48,2.08
December,31,2021,New York,NY,Passenger,1,0,1,36,37,2.7
December,31,2021,Portsmouth,VA,Passenger,0,1,1,76,77,1.3
December,31,2021,New Haven,CT,Passenger,0,2,2,27,29,6.9
December,31,2021,RÃ­o Grande,PR,Passenger,1,0,1,0,1,100
December,31,2021,Montgomery,TX,Passenger,1,1,2,35,37,5.41
December,31,2021,Vigo,IN,Passenger,1,0,1,5,6,16.67
December,31,2021,Richland,SC,Passenger,0,1,1,130,131,0.76
December,31,2021,St. Louis,MO,Passenger,1,0,1,73,74,1.35
December,31,2021,Chelan,WA,Passenger,408,114,522,54685,55207,0.95
December,31,2021,Skagit,WA,Truck,1,0,1,32702,32703,0
February,28,2021,Sedgwick,KS,Passenger,1,1,2,89,91,2.2
February,28,2021,Portsmouth,VA,Passenger,0,1,1,76,77,1.3
February,28,2021,Miami-Dade,FL,Passenger,1,0,1,97,98,1.02
February,28,2021,Hennepin,MN,Passenger,2,0,2,78,80,2.5
February,28,2021,Spartanburg,SC,Passenger,0,1,1,49,50,2
February,28,2021,Washtenaw,MI,Passenger,1,0,1,30,31,3.23
February,28,2021,Sumter,FL,Passenger,0,1,1,10,11,9.09
February,28,2021,San Joaquin,CA,Passenger,1,0,1,108,109,0.92
February,28,2021,Saginaw,MI,Passenger,2,0,2,9,11,18.18
February,28,2021,Island,WA,Passenger,546,296,842,62878,63720,1.32
February,28,2021,Jefferson,NY,Passenger,0,1,1,212,213,0.47
February,28,2021,Prince George's,MD,Passenger,2,1,3,139,142,2.11
February,28,2021,Spokane,WA,Passenger,923,560,1483,321417,322900,0.46
February,28,2021,Juneau,AK,Passenger,0,1,1,25,26,3.85
February,28,2021,Missoula,MT,Passenger,1,0,1,65,66,1.52
February,28,2021,Washoe,NV,Passenger,1,0,1,97,98,1.02
February,28,2021,Williamson,TX,Passenger,0,2,2,115,117,1.71
February,28,2021,Wahkiakum,WA,Passenger,8,6,14,3045,3059,0.46
February,28,2021,Kings,NY,Passenger,1,0,1,64,65,1.54
February,28,2021,Montgomery,OH,Passenger,0,1,1,54,55,1.82
February,28,2021,Wichita,TX,Passenger,1,0,1,41,42,2.38
February,28,2021,Wahkiakum,WA,Truck,0,0,0,1782,1782,0
February,28,2021,Hudson,NJ,Passenger,1,0,1,39,40,2.5
February,28,2021,Manassas,VA,Passenger,0,1,1,6,7,14.29
February,28,2021,Rogers,OK,Passenger,1,0,1,4,5,20
February,28,2021,District of Columbia,DC,Passenger,3,1,4,201,205,1.95
February,28,2021,Hampshire,MA,Passenger,1,0,1,6,7,14.29
February,28,2021,El Paso,TX,Passenger,3,0,3,384,387,0.78
February,28,2021,Ramsey,MN,Passenger,1,0,1,34,35,2.86
February,28,2021,Thurston,WA,Truck,0,0,0,56448,56448,0
February,28,2021,Norfolk,VA,Passenger,2,3,5,330,335,1.49
February,28,2021,Franklin,WA,Truck,0,0,0,20510,20510,0
February,28,2021,King,WA,Truck,6,1,7,184321,184328,0
February,28,2021,Erie,NY,Passenger,1,0,1,43,44,2.27
February,28,2021,Dakota,MN,Passenger,0,1,1,25,26,3.85
February,28,2021,Grant,WA,Passenger,90,86,176,66076,66252,0.27
February,28,2021,Hamilton,IN,Passenger,2,0,2,34,36,5.56
February,28,2021,San Francisco,CA,Passenger,1,1,2,91,93,2.15
February,28,2021,Palm Beach,FL,Passenger,0,1,1,72,73,1.37
February,28,2021,Moore,NC,Passenger,0,1,1,138,139,0.72
February,28,2021,Carroll,NH,Passenger,0,1,1,5,6,16.67
February,28,2021,Columbia,WA,Truck,0,0,0,1543,1543,0
February,28,2021,Boulder,CO,Passenger,0,1,1,44,45,2.22
February,28,2021,Kittitas,WA,Passenger,142,53,195,29825,30020,0.65
February,28,2021,Charles,MD,Passenger,1,1,2,72,74,2.7
February,28,2021,Suffolk,MA,Passenger,0,2,2,32,34,5.88
February,28,2021,Tulsa,OK,Passenger,1,1,2,40,42,4.76
February,28,2021,Lewis,WA,Truck,0,0,0,26704,26704,0
February,28,2021,Bradley,TN,Passenger,1,0,1,0,1,100
February,28,2021,Pacific,WA,Passenger,37,38,75,15822,15897,0.47
February,28,2021,Shelby,OH,Passenger,0,1,1,1,2,50
February,28,2021,Okanogan,WA,Passenger,56,35,91,26131,26222,0.35
February,28,2021,Okaloosa,FL,Passenger,0,1,1,130,131,0.76
February,28,2021,Duval,FL,Passenger,0,2,2,346,348,0.57
February,28,2021,Walla Walla,WA,Truck,0,0,0,13907,13907,0
February,28,2021,Grays Harbor,WA,Passenger,142,130,272,48797,49069,0.55
February,28,2021,DeKalb,IN,Passenger,1,0,1,0,1,100
February,28,2021,Suffolk,VA,Passenger,1,0,1,124,125,0.8
February,28,2021,Gwinnett,GA,Passenger,1,0,1,68,69,1.45
February,28,2021,Howard,MD,Passenger,0,1,1,62,63,1.59
February,28,2021,Douglas,WA,Passenger,86,46,132,28249,28381,0.47
February,28,2021,Riverside,CA,Passenger,4,1,5,581,586,0.85
February,28,2021,Sacramento,CA,Passenger,2,0,2,232,234,0.85
February,28,2021,Okanogan,WA,Truck,0,0,0,16631,16631,0
February,28,2021,Stevens,WA,Truck,0,0,0,18720,18720,0
February,28,2021,El Dorado,CA,Passenger,1,0,1,32,33,3.03
February,28,2021,Harris,TX,Passenger,1,1,2,204,206,0.97
February,28,2021,Plaquemines,LA,Passenger,0,1,1,14,15,6.67
February,28,2021,Flathead,MT,Passenger,1,0,1,46,47,2.13
February,28,2021,Nueces,TX,Passenger,1,0,1,79,80,1.25
February,28,2021,Kitsap,WA,Passenger,1642,777,2419,179346,181765,1.33
February,28,2021,Howard,IN,Passenger,0,1,1,3,4,25
February,28,2021,Fort Bend,TX,Passenger,1,0,1,40,41,2.44
February,28,2021,Powhatan,VA,Passenger,1,0,1,1,2,50
February,28,2021,Bexar,TX,Passenger,4,5,9,554,563,1.6
February,28,2021,Orange,CA,Passenger,4,3,7,436,443,1.58
February,28,2021,Whatcom,WA,Passenger,1277,572,1849,150039,151888,1.22
February,28,2021,Houston,GA,Passenger,1,0,1,50,51,1.96
February,28,2021,Fairfax,VA,Passenger,4,4,8,694,702,1.14
February,28,2021,Ventura,CA,Passenger,1,1,2,266,268,0.75
February,28,2021,Island,WA,Truck,0,0,0,21432,21432,0
February,28,2021,Nassau,NY,Passenger,4,0,4,27,31,12.9
February,28,2021,Morris,NJ,Passenger,1,0,1,16,17,5.88
February,28,2021,Klickitat,WA,Passenger,65,45,110,14999,15109,0.73
February,28,2021,Yakima,WA,Truck,0,0,0,61147,61147,0
February,28,2021,Jefferson,WA,Truck,0,0,0,9576,9576,0
February,28,2021,San Mateo,CA,Passenger,1,1,2,103,105,1.9
February,28,2021,San Juan,WA,Passenger,383,118,501,14058,14559,3.44
February,28,2021,Travis,TX,Passenger,2,3,5,160,165,3.03
February,28,2021,Multnomah,OR,Passenger,3,5,8,665,673,1.19
February,28,2021,Skamania,WA,Passenger,37,24,61,8292,8353,0.73
February,28,2021,Queens,NY,Passenger,2,0,2,49,51,3.92
February,28,2021,Chelan,WA,Truck,0,0,0,22878,22878,0
February,28,2021,,,Passenger,7,7,14,974,988,1.42
February,28,2021,Honolulu,HI,Passenger,5,2,7,409,416,1.68
February,28,2021,Walla Walla,WA,Passenger,105,69,174,36134,36308,0.48
February,28,2021,Whitman,WA,Passenger,53,46,99,21854,21953,0.45
February,28,2021,Washington,OR,Passenger,1,0,1,399,400,0.25
February,28,2021,Bartow,GA,Passenger,0,1,1,4,5,20
February,28,2021,Thurston,WA,Passenger,1383,811,2194,197237,199431,1.1
February,28,2021,Rockingham,NH,Passenger,1,0,1,22,23,4.35
February,28,2021,Anchorage,AK,Passenger,1,0,1,140,141,0.71
February,28,2021,Owyhee,ID,Passenger,1,0,1,3,4,25
February,28,2021,Anne Arundel,MD,Passenger,3,1,4,395,399,1
February,28,2021,Denver,CO,Passenger,1,0,1,114,115,0.87
February,28,2021,Larimer,CO,Passenger,1,0,1,53,54,1.85
February,28,2021,Charleston,SC,Passenger,2,0,2,83,85,2.35
February,28,2021,St. Clair,IL,Passenger,1,0,1,137,138,0.72
February,28,2021,Placer,CA,Passenger,2,0,2,79,81,2.47
February,28,2021,Randolph,NC,Passenger,1,0,1,6,7,14.29
February,28,2021,Vigo,IN,Passenger,1,0,1,5,6,16.67
February,28,2021,Jones,GA,Passenger,1,0,1,1,2,50
February,28,2021,Nassau,FL,Passenger,1,0,1,33,34,2.94
February,28,2021,Fairbanks North Star,AK,Passenger,0,1,1,86,87,1.15
February,28,2021,Prince William,VA,Passenger,1,1,2,212,214,0.93
February,28,2021,Clallam,WA,Truck,1,0,1,21901,21902,0
February,28,2021,Skagit,WA,Passenger,535,247,782,91350,92132,0.85
February,28,2021,Klamath,OR,Passenger,1,0,1,29,30,3.33
February,28,2021,Maui,HI,Passenger,1,0,1,27,28,3.57
February,28,2021,Kauai,HI,Passenger,1,0,1,15,16,6.25
February,28,2021,Yakima,WA,Passenger,184,135,319,167503,167822,0.19
February,28,2021,Ulster,NY,Passenger,1,0,1,7,8,12.5
February,28,2021,Goochland,VA,Passenger,4,3,7,237,244,2.87
February,28,2021,Santa Clara,CA,Passenger,7,2,9,263,272,3.31
February,28,2021,Sarasota,FL,Passenger,2,0,2,25,27,7.41
February,28,2021,Whatcom,WA,Truck,3,0,3,43636,43639,0.01
February,28,2021,Alexandria,VA,Passenger,2,0,2,133,135,1.48
February,28,2021,Whitman,WA,Truck,0,0,0,8514,8514,0
February,28,2021,Fresno,CA,Passenger,1,0,1,169,170,0.59
February,28,2021,Lake,IL,Passenger,2,0,2,152,154,1.3
February,28,2021,Clark,NV,Passenger,4,2,6,646,652,0.92
February,28,2021,Los Angeles,CA,Passenger,10,10,20,917,937,2.13
February,28,2021,Philadelphia,PA,Passenger,1,0,1,56,57,1.75
February,28,2021,Salt Lake,UT,Passenger,0,1,1,171,172,0.58
February,28,2021,Snohomish,WA,Truck,1,0,1,125733,125734,0
February,28,2021,Kern,CA,Passenger,0,1,1,217,218,0.46
February,28,2021,Adams,WA,Truck,0,0,0,5344,5344,0
February,28,2021,Kitsap,WA,Truck,0,0,0,54278,54278,0
February,28,2021,Fulton,GA,Passenger,0,2,2,85,87,2.3
February,28,2021,Douglas,CO,Passenger,0,1,1,76,77,1.3
February,28,2021,Arlington,VA,Passenger,0,1,1,138,139,0.72
February,28,2021,Dallas,TX,Passenger,1,0,1,166,167,0.6
February,28,2021,Kittitas,WA,Truck,0,0,0,14694,14694,0
February,28,2021,Stevens,WA,Passenger,38,42,80,30228,30308,0.26
February,28,2021,New London,CT,Passenger,1,2,3,225,228,1.32
February,28,2021,Pacific,WA,Truck,0,0,0,7828,7828,0
February,28,2021,Skagit,WA,Truck,1,0,1,32853,32854,0
February,28,2021,Deschutes,OR,Passenger,1,0,1,119,120,0.83
February,28,2021,Richland,SC,Passenger,0,1,1,139,140,0.71
February,28,2021,Stafford,VA,Passenger,2,1,3,95,98,3.06
February,28,2021,Cumberland,NC,Passenger,0,2,2,440,442,0.45
February,28,2021,Collin,TX,Passenger,1,1,2,115,117,1.71
February,28,2021,New Haven,CT,Passenger,0,2,2,33,35,5.71
February,28,2021,Bucks,PA,Passenger,1,0,1,18,19,5.26
February,28,2021,Clallam,WA,Passenger,282,195,477,49992,50469,0.95
February,28,2021,Oldham,KY,Passenger,0,1,1,4,5,20
February,28,2021,Frederick,MD,Passenger,1,1,2,68,70,2.86
February,28,2021,St. Mary's,MD,Passenger,1,0,1,212,213,0.47
February,28,2021,Spokane,WA,Truck,0,0,0,101004,101004,0
February,28,2021,Asotin,WA,Passenger,17,14,31,12486,12517,0.25
February,28,2021,Ray,MO,Passenger,0,1,1,1,2,50
February,28,2021,Lincoln,WA,Passenger,6,13,19,7648,7667,0.25
February,28,2021,Virginia Beach,VA,Passenger,3,0,3,624,627,0.48
February,28,2021,St. Louis,MO,Passenger,1,0,1,91,92,1.09
February,28,2021,Pend Oreille,WA,Truck,0,0,0,5722,5722,0
February,28,2021,Contra Costa,CA,Passenger,3,3,6,279,285,2.11
February,28,2021,El Paso,CO,Passenger,2,0,2,686,688,0.29
February,28,2021,Clackamas,OR,Passenger,3,0,3,175,178,1.69
February,28,2021,Orange,FL,Passenger,1,0,1,111,112,0.89
February,28,2021,Columbia,WA,Passenger,5,4,9,2453,2462,0.37
February,28,2021,Santa Cruz,CA,Passenger,1,0,1,30,31,3.23
February,28,2021,Putnam,TN,Passenger,0,1,1,2,3,33.33
February,28,2021,Carroll,MD,Passenger,0,1,1,20,21,4.76
February,28,2021,Boone,MO,Passenger,0,1,1,10,11,9.09
February,28,2021,Clark,WA,Truck,0,0,0,83537,83537,0
February,28,2021,Chelan,WA,Passenger,301,88,389,54492,54881,0.71
February,28,2021,Adams,WA,Passenger,10,6,16,12975,12991,0.12
February,28,2021,Pima,AZ,Passenger,2,1,3,306,309,0.97
February,28,2021,Kent,MI,Passenger,0,1,1,25,26,3.85
February,28,2021,Klickitat,WA,Truck,0,0,0,8118,8118,0
February,28,2021,Montgomery,PA,Passenger,1,0,1,25,26,3.85
February,28,2021,Asotin,WA,Truck,0,0,0,6696,6696,0
February,28,2021,RÃ­o Grande,PR,Passenger,1,0,1,1,2,50
February,28,2021,Williams,ND,Passenger,0,1,1,10,11,9.09
February,28,2021,Skamania,WA,Truck,0,0,0,4030,4030,0
February,28,2021,Hawaii,HI,Passenger,1,0,1,49,50,2
February,28,2021,Snohomish,WA,Passenger,5270,1894,7164,538252,545416,1.31
February,28,2021,Carson City,NV,Passenger,1,0,1,12,13,7.69
February,28,2021,Alameda,CA,Passenger,3,0,3,253,256,1.17
February,28,2021,Mason,WA,Passenger,177,135,312,47649,47961,0.65
February,28,2021,Pend Oreille,WA,Passenger,12,4,16,9194,9210,0.17
February,28,2021,Greene,MO,Passenger,0,1,1,31,32,3.12
February,28,2021,Twin Falls,ID,Passenger,0,1,1,22,23,4.35
February,28,2021,Ferry,WA,Truck,0,0,0,3625,3625,0
February,28,2021,Cowlitz,WA,Passenger,194,130,324,71935,72259,0.45
February,28,2021,Albemarle,VA,Passenger,1,0,1,21,22,4.55
February,28,2021,Milwaukee,WI,Passenger,1,0,1,40,41,2.44
February,28,2021,Sevier,AR,Passenger,0,1,1,0,1,100
February,28,2021,Grays Harbor,WA,Truck,0,0,0,21251,21251,0
February,28,2021,Leavenworth,KS,Passenger,0,1,1,120,121,0.83
February,28,2021,San Juan,WA,Truck,0,0,0,5867,5867,0
February,28,2021,Pierce,WA,Truck,0,0,0,145031,145031,0
February,28,2021,Middlesex,MA,Passenger,1,1,2,94,96,2.08
February,28,2021,DeKalb,GA,Passenger,1,0,1,65,66,1.52
February,28,2021,San Diego,CA,Passenger,13,5,18,2662,2680,0.67
February,28,2021,Douglas,NE,Passenger,1,1,2,50,52,3.85
February,28,2021,Pennington,SD,Passenger,1,0,1,34,35,2.86
February,28,2021,Washington,MD,Passenger,1,0,1,11,12,8.33
February,28,2021,Allegheny,PA,Passenger,1,1,2,65,67,2.99
February,28,2021,Cape May,NJ,Passenger,0,1,1,9,10,10
February,28,2021,Broward,FL,Passenger,2,0,2,107,109,1.83
February,28,2021,Penobscot,ME,Passenger,0,1,1,10,11,9.09
February,28,2021,Cowlitz,WA,Truck,0,0,0,28976,28976,0
February,28,2021,Harnett,NC,Passenger,1,0,1,180,181,0.55
February,28,2021,DuPage,IL,Passenger,2,0,2,54,56,3.57
February,28,2021,Douglas,WA,Truck,0,0,0,12517,12517,0
February,28,2021,Lee,FL,Passenger,1,0,1,39,40,2.5
February,28,2021,Garfield,WA,Passenger,0,2,2,1356,1358,0.15
February,28,2021,Maricopa,AZ,Passenger,5,5,10,1265,1275,0.78
February,28,2021,Monterey,CA,Passenger,0,1,1,149,150,0.67
February,28,2021,Mason,WA,Truck,0,0,0,21053,21053,0
February,28,2021,Solano,CA,Passenger,1,0,1,195,196,0.51
February,28,2021,Loudoun,VA,Passenger,1,0,1,72,73,1.37
February,28,2021,Harrison,MS,Passenger,2,0,2,54,56,3.57
February,28,2021,Montgomery,TX,Passenger,1,0,1,45,46,2.17
February,28,2021,Garfield,WA,Truck,0,0,0,1006,1006,0
February,28,2021,New York,NY,Passenger,1,0,1,51,52,1.92
February,28,2021,Pierce,WA,Passenger,3029,1810,4839,555482,560321,0.86
February,28,2021,Benton,WA,Passenger,460,362,822,135084,135906,0.6
February,28,2021,Pinellas,FL,Passenger,1,1,2,97,99,2.02
February,28,2021,Franklin,WA,Passenger,92,87,179,61606,61785,0.29
February,28,2021,Richmond,GA,Passenger,0,1,1,78,79,1.27
February,28,2021,Utah,UT,Passenger,0,1,1,123,124,0.81
February,28,2021,Camden,NJ,Passenger,0,1,1,16,17,5.88
February,28,2021,Lincoln,WA,Truck,0,0,0,4689,4689,0
February,28,2021,Arapahoe,CO,Passenger,1,0,1,118,119,0.84
February,28,2021,Platte,MO,Passenger,1,0,1,18,19,5.26
February,28,2021,Calvert,MD,Passenger,0,2,2,85,87,2.3
February,28,2021,Clark,WA,Passenger,2505,1245,3750,318957,322707,1.16
February,28,2021,Monroe,IL,Passenger,1,0,1,3,4,25
February,28,2021,Polk,FL,Passenger,1,0,1,53,54,1.85
February,28,2021,Benton,WA,Truck,0,0,0,43381,43381,0
February,28,2021,Jefferson,WA,Passenger,295,168,463,24790,25253,1.83
February,28,2021,Lake,FL,Passenger,1,0,1,21,22,4.55
February,28,2021,King,WA,Passenger,28230,8448,36678,1364916,1401594,2.62
February,28,2021,Wilson,TX,Passenger,0,1,1,5,6,16.67
February,28,2021,Montgomery,MD,Passenger,1,0,1,228,229,0.44
February,28,2021,Chesapeake,VA,Passenger,0,3,3,399,402,0.75
February,28,2021,Lewis,WA,Passenger,127,132,259,58860,59119,0.44
February,28,2021,Grant,WA,Truck,0,0,0,27662,27662,0
February,28,2021,Ferry,WA,Passenger,10,3,13,4332,4345,0.3
January,31,2021,Asotin,WA,Truck,0,0,0,6690,6690,0
January,31,2021,Mason,WA,Passenger,179,137,316,47690,48006,0.66
January,31,2021,Whitman,WA,Truck,0,0,0,8512,8512,0
January,31,2021,Adams,WA,Truck,0,0,0,5347,5347,0
January,31,2021,Fairbanks North Star,AK,Passenger,0,1,1,87,88,1.14
January,31,2021,Virginia Beach,VA,Passenger,3,0,3,628,631,0.48
January,31,2021,Allegheny,PA,Passenger,1,1,2,65,67,2.99
January,31,2021,San Juan,WA,Passenger,377,113,490,14023,14513,3.38
January,31,2021,El Paso,TX,Passenger,3,0,3,388,391,0.77
January,31,2021,Norfolk,VA,Passenger,2,3,5,335,340,1.47
January,31,2021,Missoula,MT,Passenger,1,0,1,64,65,1.54
January,31,2021,Lee,FL,Passenger,1,0,1,42,43,2.33
January,31,2021,Skamania,WA,Passenger,34,23,57,8339,8396,0.68
January,31,2021,Los Angeles,CA,Passenger,10,11,21,927,948,2.22
January,31,2021,Grays Harbor,WA,Passenger,133,126,259,48779,49038,0.53
January,31,2021,Albemarle,VA,Passenger,1,0,1,21,22,4.55
January,31,2021,Harrison,MS,Passenger,2,0,2,52,54,3.7
January,31,2021,Pierce,WA,Passenger,2963,1790,4753,555715,560468,0.85
January,31,2021,St. Clair,IL,Passenger,1,0,1,135,136,0.74
January,31,2021,Wilson,TX,Passenger,0,1,1,5,6,16.67
January,31,2021,Yakima,WA,Passenger,178,129,307,167569,167876,0.18
January,31,2021,Anchorage,AK,Passenger,1,0,1,143,144,0.69
January,31,2021,Bexar,TX,Passenger,3,5,8,562,570,1.4
January,31,2021,Sedgwick,KS,Passenger,1,1,2,89,91,2.2
January,31,2021,Jefferson,NY,Passenger,0,1,1,211,212,0.47
January,31,2021,Contra Costa,CA,Passenger,3,3,6,278,284,2.11
January,31,2021,Moore,NC,Passenger,0,1,1,141,142,0.7
January,31,2021,Wahkiakum,WA,Truck,0,0,0,1769,1769,0
January,31,2021,Grant,WA,Truck,0,0,0,27594,27594,0
January,31,2021,Deschutes,OR,Passenger,1,0,1,119,120,0.83
January,31,2021,Hamilton,IN,Passenger,2,0,2,34,36,5.56
January,31,2021,Randolph,NC,Passenger,1,0,1,6,7,14.29
January,31,2021,Snohomish,WA,Passenger,5177,1876,7053,538376,545429,1.29
January,31,2021,Santa Clara,CA,Passenger,7,2,9,263,272,3.31
January,31,2021,Adams,WA,Passenger,10,6,16,12971,12987,0.12
January,31,2021,Harris,TX,Passenger,1,1,2,209,211,0.95
January,31,2021,Orange,FL,Passenger,1,0,1,112,113,0.88
January,31,2021,Nassau,NY,Passenger,4,0,4,27,31,12.9
January,31,2021,Boulder,CO,Passenger,0,1,1,43,44,2.27
January,31,2021,Grays Harbor,WA,Truck,0,0,0,21244,21244,0
January,31,2021,DeKalb,GA,Passenger,1,0,1,64,65,1.54
January,31,2021,Cowlitz,WA,Truck,0,0,0,28973,28973,0
January,31,2021,Montgomery,OH,Passenger,0,1,1,53,54,1.85
January,31,2021,Pinellas,FL,Passenger,1,1,2,96,98,2.04
January,31,2021,Riverside,CA,Passenger,4,1,5,582,587,0.85
January,31,2021,Wichita,TX,Passenger,1,0,1,42,43,2.33
January,31,2021,Frederick,MD,Passenger,1,1,2,69,71,2.82
January,31,2021,Charles,MD,Passenger,1,1,2,72,74,2.7
January,31,2021,Loudoun,VA,Passenger,1,0,1,73,74,1.35
January,31,2021,Cowlitz,WA,Passenger,188,129,317,72162,72479,0.44
January,31,2021,Anne Arundel,MD,Passenger,3,1,4,400,404,0.99
January,31,2021,Garfield,WA,Truck,0,0,0,1003,1003,0
January,31,2021,Manassas,VA,Passenger,0,1,1,5,6,16.67
January,31,2021,Hennepin,MN,Passenger,2,0,2,79,81,2.47
January,31,2021,Montgomery,MD,Passenger,1,0,1,226,227,0.44
January,31,2021,Okanogan,WA,Truck,0,0,0,16594,16594,0
January,31,2021,Jefferson,WA,Truck,0,0,0,9597,9597,0
January,31,2021,Williams,ND,Passenger,0,1,1,10,11,9.09
January,31,2021,Placer,CA,Passenger,2,0,2,81,83,2.41
January,31,2021,El Paso,CO,Passenger,2,0,2,689,691,0.29
January,31,2021,Dallas,TX,Passenger,1,0,1,166,167,0.6
January,31,2021,Oldham,KY,Passenger,0,1,1,4,5,20
January,31,2021,Houston,GA,Passenger,1,0,1,52,53,1.89
January,31,2021,Klamath,OR,Passenger,1,0,1,30,31,3.23
January,31,2021,Juneau,AK,Passenger,0,1,1,25,26,3.85
January,31,2021,Flathead,MT,Passenger,1,0,1,48,49,2.04
January,31,2021,Stevens,WA,Truck,0,0,0,18751,18751,0
January,31,2021,Sevier,AR,Passenger,0,1,1,0,1,100
January,31,2021,King,WA,Truck,6,1,7,184346,184353,0
January,31,2021,Lewis,WA,Truck,0,0,0,26714,26714,0
January,31,2021,Suffolk,MA,Passenger,0,2,2,30,32,6.25
January,31,2021,Palm Beach,FL,Passenger,0,1,1,72,73,1.37
January,31,2021,,,Passenger,8,7,15,973,988,1.52
January,31,2021,Klickitat,WA,Passenger,63,43,106,14989,15095,0.7
January,31,2021,Nueces,TX,Passenger,1,0,1,81,82,1.22
January,31,2021,Greene,MO,Passenger,0,1,1,32,33,3.03
January,31,2021,Washoe,NV,Passenger,1,0,1,99,100,1
January,31,2021,Travis,TX,Passenger,2,3,5,162,167,2.99
January,31,2021,Clallam,WA,Passenger,281,190,471,49972,50443,0.93
January,31,2021,Thurston,WA,Truck,0,0,0,56449,56449,0
January,31,2021,St. Mary's,MD,Passenger,1,0,1,213,214,0.47
January,31,2021,Shelby,OH,Passenger,0,1,1,1,2,50
January,31,2021,Alexandria,VA,Passenger,2,0,2,133,135,1.48
January,31,2021,Bradley,TN,Passenger,1,0,1,0,1,100
January,31,2021,Pima,AZ,Passenger,2,1,3,309,312,0.96
January,31,2021,Walla Walla,WA,Truck,0,0,0,13897,13897,0
January,31,2021,Arapahoe,CO,Passenger,1,0,1,120,121,0.83
January,31,2021,Miami-Dade,FL,Passenger,1,0,1,97,98,1.02
January,31,2021,Clallam,WA,Truck,1,0,1,21869,21870,0
January,31,2021,Pacific,WA,Truck,0,0,0,7802,7802,0
January,31,2021,Carroll,MD,Passenger,0,1,1,20,21,4.76
January,31,2021,Morris,NJ,Passenger,1,0,1,16,17,5.88
January,31,2021,Mason,WA,Truck,0,0,0,21024,21024,0
January,31,2021,Camden,NJ,Passenger,0,1,1,18,19,5.26
January,31,2021,Lewis,WA,Passenger,126,131,257,58904,59161,0.43
January,31,2021,Hampshire,MA,Passenger,1,0,1,6,7,14.29
January,31,2021,Prince William,VA,Passenger,1,1,2,216,218,0.92
January,31,2021,Whatcom,WA,Truck,3,0,3,43603,43606,0.01
January,31,2021,Whitman,WA,Passenger,51,46,97,21847,21944,0.44
January,31,2021,Stafford,VA,Passenger,2,1,3,94,97,3.09
January,31,2021,Ferry,WA,Truck,0,0,0,3606,3606,0
January,31,2021,Ventura,CA,Passenger,1,1,2,268,270,0.74
January,31,2021,Island,WA,Passenger,527,294,821,62983,63804,1.29
January,31,2021,Platte,MO,Passenger,1,0,1,18,19,5.26
January,31,2021,Pend Oreille,WA,Passenger,12,3,15,9181,9196,0.16
January,31,2021,Powhatan,VA,Passenger,1,0,1,1,2,50
January,31,2021,Asotin,WA,Passenger,16,13,29,12441,12470,0.23
January,31,2021,Collin,TX,Passenger,1,1,2,115,117,1.71
January,31,2021,Okanogan,WA,Passenger,56,36,92,26138,26230,0.35
January,31,2021,Salt Lake,UT,Passenger,0,1,1,172,173,0.58
January,31,2021,Okaloosa,FL,Passenger,0,1,1,133,134,0.75
January,31,2021,Larimer,CO,Passenger,1,0,1,52,53,1.89
January,31,2021,Washtenaw,MI,Passenger,1,0,1,31,32,3.12
January,31,2021,Leavenworth,KS,Passenger,0,1,1,121,122,0.82
January,31,2021,Richmond,GA,Passenger,0,1,1,77,78,1.28
January,31,2021,Columbia,WA,Passenger,5,3,8,2452,2460,0.33
January,31,2021,Vigo,IN,Passenger,1,0,1,6,7,14.29
January,31,2021,San Francisco,CA,Passenger,1,1,2,89,91,2.2
January,31,2021,Spokane,WA,Passenger,910,551,1461,320997,322458,0.45
January,31,2021,Philadelphia,PA,Passenger,1,0,1,58,59,1.69
January,31,2021,Lincoln,WA,Truck,0,0,0,4693,4693,0
January,31,2021,Clark,NV,Passenger,4,2,6,644,650,0.92
January,31,2021,Rogers,OK,Passenger,1,0,1,4,5,20
January,31,2021,Monterey,CA,Passenger,0,1,1,150,151,0.66
January,31,2021,DuPage,IL,Passenger,2,0,2,54,56,3.57
January,31,2021,Jones,GA,Passenger,1,0,1,1,2,50
January,31,2021,Garfield,WA,Passenger,0,2,2,1362,1364,0.15
January,31,2021,Douglas,WA,Truck,0,0,0,12505,12505,0
January,31,2021,Alameda,CA,Passenger,3,0,3,259,262,1.15
January,31,2021,Fort Bend,TX,Passenger,1,0,1,42,43,2.33
January,31,2021,Stevens,WA,Passenger,37,40,77,30273,30350,0.25
January,31,2021,Lake,IL,Passenger,2,0,2,158,160,1.25
January,31,2021,Grant,WA,Passenger,87,84,171,66105,66276,0.26
January,31,2021,San Juan,WA,Truck,0,0,0,5867,5867,0
January,31,2021,Skagit,WA,Passenger,517,243,760,91439,92199,0.82
January,31,2021,Dakota,MN,Passenger,0,1,1,26,27,3.7
January,31,2021,Utah,UT,Passenger,0,1,1,124,125,0.8
January,31,2021,Polk,FL,Passenger,1,0,1,55,56,1.79
January,31,2021,Clark,WA,Passenger,2459,1211,3670,319410,323080,1.14
January,31,2021,Tulsa,OK,Passenger,1,1,2,39,41,4.88
January,31,2021,Pend Oreille,WA,Truck,0,0,0,5717,5717,0
January,31,2021,Benton,WA,Passenger,453,358,811,135157,135968,0.6
January,31,2021,Kittitas,WA,Truck,0,0,0,14675,14675,0
January,31,2021,Charleston,SC,Passenger,2,0,2,85,87,2.3
January,31,2021,Saginaw,MI,Passenger,2,0,2,9,11,18.18
January,31,2021,Thurston,WA,Passenger,1350,796,2146,197459,199605,1.08
January,31,2021,New York,NY,Passenger,1,0,1,52,53,1.89
January,31,2021,San Mateo,CA,Passenger,1,1,2,106,108,1.85
January,31,2021,Yakima,WA,Truck,0,0,0,61081,61081,0
January,31,2021,Pierce,WA,Truck,0,0,0,144891,144891,0
January,31,2021,Hudson,NJ,Passenger,1,0,1,40,41,2.44
January,31,2021,Kings,NY,Passenger,1,0,1,62,63,1.59
January,31,2021,Howard,MD,Passenger,0,1,1,63,64,1.56
January,31,2021,Fulton,GA,Passenger,0,2,2,86,88,2.27
January,31,2021,Kent,MI,Passenger,0,1,1,23,24,4.17
January,31,2021,Suffolk,VA,Passenger,1,0,1,124,125,0.8
January,31,2021,St. Louis,MO,Passenger,1,0,1,95,96,1.04
January,31,2021,Benton,WA,Truck,0,0,0,43331,43331,0
January,31,2021,Middlesex,MA,Passenger,1,1,2,91,93,2.15
January,31,2021,Richland,SC,Passenger,0,1,1,140,141,0.71
January,31,2021,Franklin,WA,Truck,0,0,0,20491,20491,0
January,31,2021,Fairfax,VA,Passenger,4,3,7,696,703,1
January,31,2021,Twin Falls,ID,Passenger,0,1,1,25,26,3.85
January,31,2021,Owyhee,ID,Passenger,1,0,1,3,4,25
January,31,2021,Goochland,VA,Passenger,4,3,7,240,247,2.83
January,31,2021,Milwaukee,WI,Passenger,1,0,1,39,40,2.5
January,31,2021,Kitsap,WA,Passenger,1607,765,2372,179318,181690,1.31
January,31,2021,Lincoln,WA,Passenger,6,12,18,7632,7650,0.24
January,31,2021,Denver,CO,Passenger,1,0,1,116,117,0.85
January,31,2021,Whatcom,WA,Passenger,1253,564,1817,150089,151906,1.2
January,31,2021,Klickitat,WA,Truck,0,0,0,8117,8117,0
January,31,2021,Kern,CA,Passenger,0,1,1,214,215,0.47
January,31,2021,Lake,FL,Passenger,1,0,1,21,22,4.55
January,31,2021,Boone,MO,Passenger,0,1,1,10,11,9.09
January,31,2021,Chelan,WA,Truck,0,0,0,22844,22844,0
January,31,2021,Sacramento,CA,Passenger,2,0,2,232,234,0.85
January,31,2021,Sarasota,FL,Passenger,2,0,2,25,27,7.41
January,31,2021,Orange,CA,Passenger,4,3,7,440,447,1.57
January,31,2021,Hawaii,HI,Passenger,1,0,1,51,52,1.92
January,31,2021,Putnam,TN,Passenger,0,1,1,2,3,33.33
January,31,2021,Cascade,MT,Passenger,0,1,1,54,55,1.82
January,31,2021,Skamania,WA,Truck,0,0,0,4017,4017,0
January,31,2021,Fresno,CA,Passenger,1,0,1,170,171,0.58
January,31,2021,Franklin,WA,Passenger,89,85,174,61500,61674,0.28
January,31,2021,Walla Walla,WA,Passenger,103,68,171,36164,36335,0.47
January,31,2021,New Haven,CT,Passenger,0,2,2,35,37,5.41
January,31,2021,Calvert,MD,Passenger,0,2,2,85,87,2.3
January,31,2021,Clark,WA,Truck,0,0,0,83564,83564,0
January,31,2021,Douglas,NE,Passenger,1,1,2,51,53,3.77
January,31,2021,Bucks,PA,Passenger,1,0,1,18,19,5.26
January,31,2021,Skagit,WA,Truck,1,0,1,32861,32862,0
January,31,2021,Gwinnett,GA,Passenger,1,0,1,66,67,1.49
January,31,2021,Plaquemines,LA,Passenger,0,1,1,14,15,6.67
January,31,2021,Snohomish,WA,Truck,1,0,1,125692,125693,0
January,31,2021,Montgomery,TX,Passenger,1,0,1,46,47,2.13
January,31,2021,Rockingham,NH,Passenger,1,0,1,22,23,4.35
January,31,2021,Maricopa,AZ,Passenger,5,5,10,1286,1296,0.77
January,31,2021,Ray,MO,Passenger,0,1,1,1,2,50
January,31,2021,Honolulu,HI,Passenger,5,2,7,416,423,1.65
January,31,2021,San Diego,CA,Passenger,13,5,18,2686,2704,0.67
January,31,2021,Chelan,WA,Passenger,294,87,381,54481,54862,0.69
January,31,2021,Jefferson,WA,Passenger,290,166,456,24802,25258,1.81
January,31,2021,Howard,IN,Passenger,0,1,1,3,4,25
January,31,2021,New London,CT,Passenger,1,2,3,229,232,1.29
January,31,2021,El Dorado,CA,Passenger,1,0,1,32,33,3.03
January,31,2021,Duval,FL,Passenger,0,2,2,352,354,0.56
January,31,2021,Clackamas,OR,Passenger,3,0,3,177,180,1.67
January,31,2021,DeKalb,IN,Passenger,1,0,1,0,1,100
January,31,2021,Pacific,WA,Passenger,35,37,72,15798,15870,0.45
January,31,2021,Montgomery,PA,Passenger,1,0,1,26,27,3.7
January,31,2021,Douglas,WA,Passenger,84,46,130,28199,28329,0.46
January,31,2021,Arlington,VA,Passenger,0,1,1,137,138,0.72
January,31,2021,District of Columbia,DC,Passenger,3,1,4,201,205,1.95
January,31,2021,Spartanburg,SC,Passenger,0,1,1,50,51,1.96
January,31,2021,RÃ­o Grande,PR,Passenger,1,0,1,1,2,50
January,31,2021,Kitsap,WA,Truck,0,0,0,54300,54300,0
January,31,2021,Kittitas,WA,Passenger,134,52,186,29834,30020,0.62
January,31,2021,Monroe,IL,Passenger,1,0,1,3,4,25
January,31,2021,Harnett,NC,Passenger,1,0,1,182,183,0.55
January,31,2021,Carroll,NH,Passenger,0,1,1,5,6,16.67
January,31,2021,Portsmouth,VA,Passenger,0,1,1,76,77,1.3
January,31,2021,Penobscot,ME,Passenger,0,1,1,9,10,10
January,31,2021,Cape May,NJ,Passenger,0,1,1,9,10,10
January,31,2021,Williamson,TX,Passenger,0,2,2,120,122,1.64
January,31,2021,Erie,NY,Passenger,1,0,1,43,44,2.27
January,31,2021,Sumter,FL,Passenger,0,1,1,10,11,9.09
January,31,2021,Multnomah,OR,Passenger,3,5,8,671,679,1.18
January,31,2021,Queens,NY,Passenger,1,0,1,50,51,1.96
January,31,2021,Ferry,WA,Passenger,9,3,12,4341,4353,0.28
January,31,2021,Wahkiakum,WA,Passenger,7,6,13,3040,3053,0.43
January,31,2021,Pennington,SD,Passenger,1,0,1,34,35,2.86
January,31,2021,Prince George's,MD,Passenger,2,1,3,144,147,2.04
January,31,2021,Broward,FL,Passenger,2,1,3,106,109,2.75
January,31,2021,San Joaquin,CA,Passenger,1,0,1,107,108,0.93
January,31,2021,Maui,HI,Passenger,1,0,1,26,27,3.7
January,31,2021,Nassau,FL,Passenger,1,0,1,34,35,2.86
January,31,2021,Washington,OR,Passenger,1,0,1,401,402,0.25
January,31,2021,Ramsey,MN,Passenger,1,0,1,34,35,2.86
January,31,2021,Santa Cruz,CA,Passenger,1,0,1,27,28,3.57
January,31,2021,Solano,CA,Passenger,1,0,1,198,199,0.5
January,31,2021,Island,WA,Truck,0,0,0,21409,21409,0
January,31,2021,Carson City,NV,Passenger,1,0,1,12,13,7.69
January,31,2021,Columbia,WA,Truck,0,0,0,1547,1547,0
January,31,2021,Spokane,WA,Truck,0,0,0,100880,100880,0
January,31,2021,Ulster,NY,Passenger,1,0,1,7,8,12.5
January,31,2021,Chesapeake,VA,Passenger,0,3,3,401,404,0.74
January,31,2021,Kauai,HI,Passenger,1,0,1,14,15,6.67
January,31,2021,Douglas,CO,Passenger,0,1,1,78,79,1.27
January,31,2021,Cumberland,NC,Passenger,0,2,2,440,442,0.45
January,31,2021,King,WA,Passenger,27793,8324,36117,1367229,1403346,2.57
January,31,2021,Bartow,GA,Passenger,0,1,1,4,5,20
July,31,2021,Howard,IN,Passenger,0,1,1,5,6,16.67
July,31,2021,Honolulu,HI,Passenger,5,2,7,382,389,1.8
July,31,2021,San Juan,WA,Passenger,443,139,582,14241,14823,3.93
July,31,2021,Louisa,VA,Passenger,0,1,1,1,2,50
July,31,2021,Okanogan,WA,Truck,0,0,0,16751,16751,0
July,31,2021,Montgomery,TX,Passenger,1,1,2,38,40,5
July,31,2021,Benton,WA,Truck,0,0,0,43648,43648,0
July,31,2021,San Diego,CA,Passenger,17,7,24,2530,2554,0.94
July,31,2021,Larimer,CO,Passenger,1,0,1,50,51,1.96
July,31,2021,Jefferson,WA,Truck,0,0,0,9618,9618,0
July,31,2021,Snohomish,WA,Passenger,6126,2100,8226,539757,547983,1.5
July,31,2021,Mason,WA,Passenger,216,139,355,48095,48450,0.73
July,31,2021,Hampshire,MA,Passenger,1,0,1,6,7,14.29
July,31,2021,Queens,NY,Passenger,2,0,2,47,49,4.08
July,31,2021,Charles,MD,Passenger,1,1,2,69,71,2.82
July,31,2021,Harrison,MS,Passenger,2,0,2,52,54,3.7
July,31,2021,Platte,MO,Passenger,1,0,1,17,18,5.56
July,31,2021,Clallam,WA,Passenger,341,220,561,50460,51021,1.1
July,31,2021,Lincoln,WA,Truck,0,0,0,4759,4759,0
July,31,2021,Harris,TX,Passenger,1,1,2,185,187,1.07
July,31,2021,Powhatan,VA,Passenger,1,0,1,1,2,50
July,31,2021,Onslow,NC,Passenger,0,1,1,178,179,0.56
July,31,2021,Salt Lake,UT,Passenger,0,1,1,162,163,0.61
July,31,2021,Douglas,WA,Passenger,100,51,151,28504,28655,0.53
July,31,2021,Fresno,CA,Passenger,1,0,1,165,166,0.6
July,31,2021,Oldham,KY,Passenger,0,1,1,4,5,20
July,31,2021,San Mateo,CA,Passenger,1,0,1,95,96,1.04
July,31,2021,Denver,CO,Passenger,1,0,1,116,117,0.85
July,31,2021,San Juan,WA,Truck,0,0,0,5955,5955,0
July,31,2021,Fairbanks North Star,AK,Passenger,0,1,1,83,84,1.19
July,31,2021,Multnomah,OR,Passenger,2,6,8,634,642,1.25
July,31,2021,Sarasota,FL,Passenger,2,0,2,27,29,6.9
July,31,2021,Adams,WA,Truck,0,0,0,5392,5392,0
July,31,2021,Wahkiakum,WA,Passenger,15,8,23,3091,3114,0.74
July,31,2021,Yakima,WA,Passenger,236,161,397,169309,169706,0.23
July,31,2021,New London,CT,Passenger,1,2,3,216,219,1.37
July,31,2021,Lee,FL,Passenger,1,0,1,33,34,2.94
July,31,2021,El Paso,CO,Passenger,3,0,3,666,669,0.45
July,31,2021,Carroll,MD,Passenger,0,1,1,19,20,5
July,31,2021,Chelan,WA,Passenger,350,101,451,54716,55167,0.82
July,31,2021,Howard,MD,Passenger,0,1,1,59,60,1.67
July,31,2021,Stevens,WA,Truck,0,0,0,18921,18921,0
July,31,2021,Washington,MD,Passenger,2,0,2,13,15,13.33
July,31,2021,Albemarle,VA,Passenger,1,0,1,19,20,5
July,31,2021,Manassas,VA,Passenger,0,1,1,7,8,12.5
July,31,2021,RÃ­o Grande,PR,Passenger,1,0,1,0,1,100
July,31,2021,Whitman,WA,Truck,0,0,0,8590,8590,0
July,31,2021,Portsmouth,VA,Passenger,0,1,1,78,79,1.27
July,31,2021,Kings,CA,Passenger,1,0,1,319,320,0.31
July,31,2021,Stevens,WA,Passenger,49,46,95,30404,30499,0.31
July,31,2021,Rockdale,GA,Passenger,1,0,1,9,10,10
July,31,2021,Montgomery,OH,Passenger,0,1,1,55,56,1.79
July,31,2021,Maricopa,AZ,Passenger,6,3,9,1118,1127,0.8
July,31,2021,Clackamas,OR,Passenger,2,0,2,173,175,1.14
July,31,2021,Charleston,SC,Passenger,1,1,2,82,84,2.38
July,31,2021,Mason,WA,Truck,0,0,0,21344,21344,0
July,31,2021,Grant,WA,Passenger,120,90,210,66913,67123,0.31
July,31,2021,Hidalgo,TX,Passenger,0,1,1,54,55,1.82
July,31,2021,Lewis,WA,Passenger,165,144,309,59658,59967,0.52
July,31,2021,Ray,MO,Passenger,0,1,1,1,2,50
July,31,2021,Clark,WA,Truck,0,0,0,84269,84269,0
July,31,2021,Baltimore,MD,Passenger,1,0,1,97,98,1.02
July,31,2021,Santa Cruz,CA,Passenger,1,0,1,24,25,4
July,31,2021,Los Angeles,CA,Passenger,10,11,21,871,892,2.35
July,31,2021,Yamhill,OR,Passenger,1,0,1,34,35,2.86
July,31,2021,Rockingham,NH,Passenger,1,0,1,21,22,4.55
July,31,2021,Alameda,CA,Passenger,4,0,4,231,235,1.7
July,31,2021,Okanogan,WA,Passenger,65,43,108,26539,26647,0.41
July,31,2021,Orange,FL,Passenger,1,0,1,107,108,0.93
July,31,2021,Wahkiakum,WA,Truck,0,0,0,1793,1793,0
July,31,2021,Loudoun,VA,Passenger,1,0,1,72,73,1.37
July,31,2021,Broward,FL,Passenger,2,0,2,107,109,1.83
July,31,2021,Williamson,TX,Passenger,0,2,2,103,105,1.9
July,31,2021,Juneau,AK,Passenger,0,1,1,26,27,3.7
July,31,2021,Boulder,CO,Passenger,0,1,1,39,40,2.5
July,31,2021,Dallas,TX,Passenger,1,0,1,148,149,0.67
July,31,2021,Harnett,NC,Passenger,1,1,2,167,169,1.18
July,31,2021,Sedgwick,KS,Passenger,1,1,2,81,83,2.41
July,31,2021,Prince William,VA,Passenger,1,1,2,201,203,0.99
July,31,2021,Pacific,WA,Passenger,46,53,99,16030,16129,0.61
July,31,2021,Klickitat,WA,Truck,0,0,0,8313,8313,0
July,31,2021,Lewis,WA,Truck,0,0,0,26765,26765,0
July,31,2021,Kitsap,WA,Truck,0,0,0,54423,54423,0
July,31,2021,Kings,NY,Passenger,1,0,1,65,66,1.52
July,31,2021,Leavenworth,KS,Passenger,0,1,1,116,117,0.85
July,31,2021,Thurston,WA,Truck,0,0,0,56500,56500,0
July,31,2021,Lincoln,WA,Passenger,6,15,21,7722,7743,0.27
July,31,2021,Owyhee,ID,Passenger,1,0,1,2,3,33.33
July,31,2021,Rogers,OK,Passenger,1,0,1,3,4,25
July,31,2021,Adams,WA,Passenger,16,12,28,13038,13066,0.21
July,31,2021,Grays Harbor,WA,Truck,0,0,0,21418,21418,0
July,31,2021,New York,NY,Passenger,1,0,1,42,43,2.33
July,31,2021,Kern,CA,Passenger,0,1,1,210,211,0.47
July,31,2021,Ferry,WA,Passenger,9,3,12,4379,4391,0.27
July,31,2021,Anchorage,AK,Passenger,1,0,1,131,132,0.76
July,31,2021,Placer,CA,Passenger,2,0,2,75,77,2.6
July,31,2021,Jefferson,NY,Passenger,0,1,1,213,214,0.47
July,31,2021,Fort Bend,TX,Passenger,1,0,1,36,37,2.7
July,31,2021,Frederick,MD,Passenger,1,1,2,68,70,2.86
July,31,2021,Sumter,SC,Passenger,0,1,1,37,38,2.63
July,31,2021,Danville,VA,Passenger,1,0,1,0,1,100
July,31,2021,Asotin,WA,Passenger,21,17,38,12708,12746,0.3
July,31,2021,Skamania,WA,Truck,0,0,0,4027,4027,0
July,31,2021,Thurston,WA,Passenger,1660,892,2552,197867,200419,1.27
July,31,2021,Kitsap,WA,Passenger,1911,871,2782,180648,183430,1.52
July,31,2021,Cowlitz,WA,Truck,0,0,0,29116,29116,0
July,31,2021,Grant,WA,Truck,0,0,0,27936,27936,0
July,31,2021,San Francisco,CA,Passenger,0,1,1,84,85,1.18
July,31,2021,Skagit,WA,Passenger,608,281,889,91879,92768,0.96
July,31,2021,Sacramento,CA,Passenger,2,0,2,213,215,0.93
July,31,2021,Lane,OR,Passenger,0,1,1,120,121,0.83
July,31,2021,Las Animas,CO,Passenger,1,0,1,0,1,100
July,31,2021,Douglas,WA,Truck,0,0,0,12696,12696,0
July,31,2021,Pierce,WA,Passenger,3637,2018,5655,559608,565263,1
July,31,2021,Island,WA,Passenger,625,316,941,63232,64173,1.47
July,31,2021,Flathead,MT,Passenger,1,0,1,42,43,2.33
July,31,2021,Lake,FL,Passenger,1,0,1,22,23,4.35
July,31,2021,Arapahoe,CO,Passenger,1,0,1,106,107,0.93
July,31,2021,Denton,TX,Passenger,1,0,1,80,81,1.23
July,31,2021,Anne Arundel,MD,Passenger,4,3,7,384,391,1.79
July,31,2021,Williams,ND,Passenger,0,1,1,7,8,12.5
July,31,2021,Franklin,WA,Truck,0,0,0,20725,20725,0
July,31,2021,Chelan,WA,Truck,0,0,0,23102,23102,0
July,31,2021,Benton,WA,Passenger,540,397,937,136282,137219,0.68
July,31,2021,Snohomish,WA,Truck,1,0,1,126198,126199,0
July,31,2021,Cumberland,NC,Passenger,0,2,2,416,418,0.48
July,31,2021,Pima,AZ,Passenger,2,1,3,267,270,1.11
July,31,2021,Bexar,TX,Passenger,3,4,7,514,521,1.34
July,31,2021,Pierce,WA,Truck,0,0,0,145859,145859,0
July,31,2021,Camden,NJ,Passenger,0,1,1,14,15,6.67
July,31,2021,Whatcom,WA,Truck,4,0,4,43871,43875,0.01
July,31,2021,Goochland,VA,Passenger,4,2,6,214,220,2.73
July,31,2021,Wichita,TX,Passenger,1,0,1,40,41,2.44
July,31,2021,Columbia,WA,Truck,0,0,0,1555,1555,0
July,31,2021,Kauai,HI,Passenger,1,0,1,17,18,5.56
July,31,2021,Montgomery,MD,Passenger,3,1,4,212,216,1.85
July,31,2021,Suffolk,MA,Passenger,0,2,2,31,33,6.06
July,31,2021,Collin,TX,Passenger,1,1,2,105,107,1.87
July,31,2021,Lake,IL,Passenger,2,0,2,156,158,1.27
July,31,2021,Skamania,WA,Passenger,51,36,87,8410,8497,1.02
July,31,2021,DeKalb,GA,Passenger,1,0,1,58,59,1.69
July,31,2021,Sevier,AR,Passenger,0,1,1,0,1,100
July,31,2021,Penobscot,ME,Passenger,0,1,1,8,9,11.11
July,31,2021,Norfolk,VA,Passenger,3,3,6,313,319,1.88
July,31,2021,Hennepin,MN,Passenger,3,0,3,72,75,4
July,31,2021,Plaquemines,LA,Passenger,0,1,1,16,17,5.88
July,31,2021,Douglas,NE,Passenger,1,1,2,51,53,3.77
July,31,2021,St. Louis,MO,Passenger,1,0,1,80,81,1.23
July,31,2021,Allegheny,PA,Passenger,1,1,2,62,64,3.12
July,31,2021,King,WA,Truck,5,1,6,184354,184360,0
July,31,2021,Alexandria,VA,Passenger,2,0,2,122,124,1.61
July,31,2021,Riverside,CA,Passenger,5,1,6,537,543,1.1
July,31,2021,Garfield,WA,Passenger,0,3,3,1375,1378,0.22
July,31,2021,Pennington,SD,Passenger,1,0,1,31,32,3.12
July,31,2021,Saginaw,MI,Passenger,1,0,1,6,7,14.29
July,31,2021,Clallam,WA,Truck,1,0,1,22036,22037,0
July,31,2021,Kittitas,WA,Passenger,166,68,234,29980,30214,0.77
July,31,2021,Calvert,MD,Passenger,0,2,2,88,90,2.22
July,31,2021,Richmond,NY,Passenger,1,0,1,9,10,10
July,31,2021,St. Mary's,MD,Passenger,1,0,1,205,206,0.49
July,31,2021,Middlesex,MA,Passenger,1,1,2,93,95,2.11
July,31,2021,Nueces,TX,Passenger,1,0,1,69,70,1.43
July,31,2021,Missoula,MT,Passenger,1,0,1,54,55,1.82
July,31,2021,Stafford,VA,Passenger,2,1,3,98,101,2.97
July,31,2021,Saratoga,NY,Passenger,1,0,1,42,43,2.33
July,31,2021,Miami-Dade,FL,Passenger,1,0,1,97,98,1.02
July,31,2021,Asotin,WA,Truck,0,0,0,6768,6768,0
July,31,2021,Yakima,WA,Truck,0,0,0,61720,61720,0
July,31,2021,Greene,MO,Passenger,0,1,1,29,30,3.33
July,31,2021,Wilson,TX,Passenger,0,1,1,3,4,25
July,31,2021,Okaloosa,FL,Passenger,0,1,1,114,115,0.87
July,31,2021,King,WA,Passenger,31555,9349,40904,1366948,1407852,2.91
July,31,2021,Columbia,WA,Passenger,6,2,8,2472,2480,0.32
July,31,2021,Philadelphia,PA,Passenger,1,0,1,44,45,2.22
July,31,2021,Pacific,WA,Truck,0,0,0,7961,7961,0
July,31,2021,Hudson,NJ,Passenger,1,0,1,42,43,2.33
July,31,2021,Contra Costa,CA,Passenger,2,3,5,262,267,1.87
July,31,2021,New Haven,CT,Passenger,0,2,2,28,30,6.67
July,31,2021,Clark,NV,Passenger,4,2,6,602,608,0.99
July,31,2021,Hawaii,HI,Passenger,1,0,1,44,45,2.22
July,31,2021,Hillsborough,FL,Passenger,0,1,1,145,146,0.68
July,31,2021,Moore,NC,Passenger,0,1,1,130,131,0.76
July,31,2021,Bucks,PA,Passenger,1,0,1,15,16,6.25
July,31,2021,Suffolk,VA,Passenger,1,0,1,125,126,0.79
July,31,2021,Gwinnett,GA,Passenger,1,0,1,61,62,1.61
July,31,2021,Orange,CA,Passenger,5,3,8,407,415,1.93
July,31,2021,Polk,FL,Passenger,1,0,1,55,56,1.79
July,31,2021,Clark,WA,Passenger,2977,1459,4436,322390,326826,1.36
July,31,2021,Pend Oreille,WA,Truck,0,0,0,5747,5747,0
July,31,2021,Prince George's,MD,Passenger,2,1,3,139,142,2.11
July,31,2021,Wilson,NC,Passenger,1,0,1,0,1,100
July,31,2021,Richmond,GA,Passenger,0,1,1,74,75,1.33
July,31,2021,Shelby,OH,Passenger,0,1,1,1,2,50
July,31,2021,Washington,OR,Passenger,1,0,1,377,378,0.26
July,31,2021,Spartanburg,SC,Passenger,0,1,1,51,52,1.92
July,31,2021,Whatcom,WA,Passenger,1475,618,2093,150663,152756,1.37
July,31,2021,Sonoma,CA,Passenger,0,1,1,79,80,1.25
July,31,2021,Klamath,OR,Passenger,1,0,1,28,29,3.45
July,31,2021,Grays Harbor,WA,Passenger,176,146,322,49519,49841,0.65
July,31,2021,Ferry,WA,Truck,0,0,0,3646,3646,0
July,31,2021,Houston,GA,Passenger,1,0,1,46,47,2.13
July,31,2021,Milwaukee,WI,Passenger,1,0,1,38,39,2.56
July,31,2021,Duval,FL,Passenger,0,2,2,330,332,0.6
July,31,2021,Champaign,IL,Passenger,1,0,1,11,12,8.33
July,31,2021,Carroll,NH,Passenger,0,1,1,5,6,16.67
July,31,2021,Douglas,CO,Passenger,0,1,1,77,78,1.28
July,31,2021,Randolph,NC,Passenger,1,0,1,5,6,16.67
July,31,2021,District of Columbia,DC,Passenger,5,1,6,199,205,2.93
July,31,2021,San Joaquin,CA,Passenger,1,0,1,101,102,0.98
July,31,2021,Carson City,NV,Passenger,1,0,1,10,11,9.09
July,31,2021,,,Passenger,10,7,17,1046,1063,1.6
July,31,2021,Travis,TX,Passenger,3,3,6,153,159,3.77
July,31,2021,El Dorado,CA,Passenger,1,0,1,30,31,3.23
July,31,2021,Fairfax,VA,Passenger,4,4,8,679,687,1.16
July,31,2021,Whitman,WA,Passenger,61,49,110,21944,22054,0.5
July,31,2021,Allen,IN,Passenger,1,0,1,15,16,6.25
July,31,2021,Klickitat,WA,Passenger,77,50,127,15342,15469,0.82
July,31,2021,Cowlitz,WA,Passenger,229,146,375,72247,72622,0.52
July,31,2021,Erie,NY,Passenger,1,0,1,37,38,2.63
July,31,2021,Walla Walla,WA,Truck,0,0,0,14055,14055,0
July,31,2021,Santa Clara,CA,Passenger,8,2,10,247,257,3.89
July,31,2021,Island,WA,Truck,0,0,0,21573,21573,0
July,31,2021,Monterey,CA,Passenger,0,1,1,143,144,0.69
July,31,2021,Nassau,NY,Passenger,2,0,2,26,28,7.14
July,31,2021,Garfield,WA,Truck,0,0,0,1004,1004,0
July,31,2021,Boone,MO,Passenger,0,1,1,9,10,10
July,31,2021,DuPage,IL,Passenger,1,0,1,51,52,1.92
July,31,2021,Arlington,VA,Passenger,0,1,1,135,136,0.74
July,31,2021,Cape May,NJ,Passenger,0,1,1,8,9,11.11
July,31,2021,Pinellas,FL,Passenger,0,1,1,93,94,1.06
July,31,2021,Montgomery,PA,Passenger,1,0,1,24,25,4
July,31,2021,Ventura,CA,Passenger,1,2,3,250,253,1.19
July,31,2021,Spokane,WA,Truck,0,0,0,102316,102316,0
July,31,2021,Vigo,IN,Passenger,1,0,1,5,6,16.67
July,31,2021,Hamilton,IN,Passenger,2,0,2,31,33,6.06
July,31,2021,Bartow,GA,Passenger,0,1,1,3,4,25
July,31,2021,Chesapeake,VA,Passenger,0,4,4,387,391,1.02
July,31,2021,Skagit,WA,Truck,1,0,1,33023,33024,0
July,31,2021,Essex,NJ,Passenger,1,0,1,10,11,9.09
July,31,2021,Kittitas,WA,Truck,0,0,0,14792,14792,0
July,31,2021,Ulster,NY,Passenger,1,0,1,8,9,11.11
July,31,2021,Spokane,WA,Passenger,1119,653,1772,326073,327845,0.54
July,31,2021,Pend Oreille,WA,Passenger,15,7,22,9264,9286,0.24
July,31,2021,St. Clair,IL,Passenger,2,0,2,134,136,1.47
July,31,2021,El Paso,TX,Passenger,3,0,3,365,368,0.82
July,31,2021,Franklin,WA,Passenger,134,97,231,62058,62289,0.37
July,31,2021,Walla Walla,WA,Passenger,115,76,191,36567,36758,0.52
July,31,2021,Burlington,NJ,Passenger,0,1,1,126,127,0.79
July,31,2021,Jones,GA,Passenger,1,0,1,1,2,50
July,31,2021,Cook,IL,Passenger,1,0,1,196,197,0.51
July,31,2021,Richland,SC,Passenger,0,1,1,134,135,0.74
July,31,2021,Virginia Beach,VA,Passenger,2,0,2,611,613,0.33
July,31,2021,Jefferson,WA,Passenger,339,183,522,24889,25411,2.05
June,30,2021,Gwinnett,GA,Passenger,1,0,1,62,63,1.59
June,30,2021,Duval,FL,Passenger,0,2,2,335,337,0.59
June,30,2021,Jefferson,WA,Passenger,331,184,515,24891,25406,2.03
June,30,2021,Ventura,CA,Passenger,1,2,3,255,258,1.16
June,30,2021,Douglas,NE,Passenger,1,1,2,50,52,3.85
June,30,2021,Snohomish,WA,Passenger,5886,2048,7934,540300,548234,1.45
June,30,2021,Stevens,WA,Passenger,45,45,90,30479,30569,0.29
June,30,2021,Carroll,MD,Passenger,0,1,1,18,19,5.26
June,30,2021,Mason,WA,Truck,0,0,0,21335,21335,0
June,30,2021,Chelan,WA,Passenger,336,99,435,54745,55180,0.79
June,30,2021,Snohomish,WA,Truck,1,0,1,126272,126273,0
June,30,2021,Bucks,PA,Passenger,1,0,1,15,16,6.25
June,30,2021,Spokane,WA,Truck,0,0,0,102350,102350,0
June,30,2021,Pima,AZ,Passenger,2,1,3,273,276,1.09
June,30,2021,Williams,ND,Passenger,0,1,1,7,8,12.5
June,30,2021,Whatcom,WA,Passenger,1419,602,2021,150844,152865,1.32
June,30,2021,San Mateo,CA,Passenger,1,0,1,99,100,1
June,30,2021,Pacific,WA,Passenger,45,53,98,16057,16155,0.61
June,30,2021,King,WA,Passenger,30495,9167,39662,1368513,1408175,2.82
June,30,2021,Chelan,WA,Truck,0,0,0,23127,23127,0
June,30,2021,Miami-Dade,FL,Passenger,1,0,1,97,98,1.02
June,30,2021,,,Passenger,8,7,15,1015,1030,1.46
June,30,2021,Charleston,SC,Passenger,1,1,2,83,85,2.35
June,30,2021,Thurston,WA,Truck,0,0,0,56575,56575,0
June,30,2021,Montgomery,PA,Passenger,1,0,1,24,25,4
June,30,2021,Grays Harbor,WA,Truck,0,0,0,21450,21450,0
June,30,2021,Charles,MD,Passenger,1,1,2,69,71,2.82
June,30,2021,Cook,IL,Passenger,1,0,1,202,203,0.49
June,30,2021,Asotin,WA,Passenger,20,17,37,12728,12765,0.29
June,30,2021,Arlington,VA,Passenger,0,1,1,137,138,0.72
June,30,2021,Cape May,NJ,Passenger,0,1,1,8,9,11.11
June,30,2021,Okanogan,WA,Truck,0,0,0,16757,16757,0
June,30,2021,Whatcom,WA,Truck,4,0,4,43913,43917,0.01
June,30,2021,District of Columbia,DC,Passenger,5,1,6,199,205,2.93
June,30,2021,Sacramento,CA,Passenger,2,0,2,214,216,0.93
June,30,2021,Fairbanks North Star,AK,Passenger,0,1,1,85,86,1.16
June,30,2021,Pacific,WA,Truck,0,0,0,7965,7965,0
June,30,2021,Philadelphia,PA,Passenger,1,0,1,47,48,2.08
June,30,2021,Carson City,NV,Passenger,1,0,1,10,11,9.09
June,30,2021,Wahkiakum,WA,Passenger,15,8,23,3109,3132,0.73
June,30,2021,San Francisco,CA,Passenger,0,1,1,85,86,1.16
June,30,2021,Albemarle,VA,Passenger,1,0,1,19,20,5
June,30,2021,Skamania,WA,Truck,0,0,0,4029,4029,0
June,30,2021,Howard,MD,Passenger,0,1,1,59,60,1.67
June,30,2021,Boone,MO,Passenger,0,1,1,9,10,10
June,30,2021,Hidalgo,TX,Passenger,0,1,1,56,57,1.75
June,30,2021,Santa Clara,CA,Passenger,8,2,10,245,255,3.92
June,30,2021,Grant,WA,Truck,0,0,0,27912,27912,0
June,30,2021,Benton,WA,Passenger,518,394,912,136405,137317,0.66
June,30,2021,Prince George's,MD,Passenger,2,1,3,139,142,2.11
June,30,2021,Clark,WA,Truck,0,0,0,84343,84343,0
June,30,2021,Orange,FL,Passenger,1,0,1,111,112,0.89
June,30,2021,Asotin,WA,Truck,0,0,0,6792,6792,0
June,30,2021,Anchorage,AK,Passenger,1,0,1,133,134,0.75
June,30,2021,Montgomery,OH,Passenger,0,1,1,56,57,1.75
June,30,2021,Kern,CA,Passenger,0,1,1,211,212,0.47
June,30,2021,Ferry,WA,Passenger,9,3,12,4373,4385,0.27
June,30,2021,Wilson,NC,Passenger,1,0,1,0,1,100
June,30,2021,Franklin,WA,Passenger,123,97,220,62016,62236,0.35
June,30,2021,Dakota,MN,Passenger,0,1,1,25,26,3.85
June,30,2021,Cumberland,NC,Passenger,0,2,2,420,422,0.47
June,30,2021,Salt Lake,UT,Passenger,0,1,1,167,168,0.6
June,30,2021,Bartow,GA,Passenger,0,1,1,3,4,25
June,30,2021,Riverside,CA,Passenger,5,1,6,544,550,1.09
June,30,2021,Shelby,OH,Passenger,0,1,1,1,2,50
June,30,2021,Cowlitz,WA,Passenger,224,142,366,72350,72716,0.5
June,30,2021,Ray,MO,Passenger,0,1,1,1,2,50
June,30,2021,Island,WA,Passenger,617,317,934,63262,64196,1.45
June,30,2021,Missoula,MT,Passenger,1,0,1,60,61,1.64
June,30,2021,Danville,VA,Passenger,1,0,1,0,1,100
June,30,2021,Boulder,CO,Passenger,0,1,1,44,45,2.22
June,30,2021,Flathead,MT,Passenger,1,0,1,43,44,2.27
June,30,2021,RÃ­o Grande,PR,Passenger,1,0,1,0,1,100
June,30,2021,Kitsap,WA,Truck,0,0,0,54475,54475,0
June,30,2021,Randolph,NC,Passenger,1,0,1,7,8,12.5
June,30,2021,Ulster,NY,Passenger,1,0,1,8,9,11.11
June,30,2021,Harris,TX,Passenger,1,1,2,194,196,1.02
June,30,2021,Richmond,GA,Passenger,0,1,1,77,78,1.28
June,30,2021,Loudoun,VA,Passenger,1,0,1,74,75,1.33
June,30,2021,Milwaukee,WI,Passenger,1,0,1,38,39,2.56
June,30,2021,Nueces,TX,Passenger,1,0,1,73,74,1.35
June,30,2021,El Paso,TX,Passenger,3,0,3,374,377,0.8
June,30,2021,Ferry,WA,Truck,0,0,0,3641,3641,0
June,30,2021,Wilson,TX,Passenger,0,1,1,3,4,25
June,30,2021,Garfield,WA,Truck,0,0,0,998,998,0
June,30,2021,Whitman,WA,Truck,0,0,0,8585,8585,0
June,30,2021,Contra Costa,CA,Passenger,2,3,5,261,266,1.88
June,30,2021,Queens,NY,Passenger,2,0,2,49,51,3.92
June,30,2021,Pierce,WA,Truck,0,0,0,146075,146075,0
June,30,2021,Okanogan,WA,Passenger,63,38,101,26512,26613,0.38
June,30,2021,Hamilton,IN,Passenger,2,0,2,32,34,5.88
June,30,2021,Harrison,MS,Passenger,2,0,2,51,53,3.77
June,30,2021,Jefferson,WA,Truck,0,0,0,9625,9625,0
June,30,2021,Jones,GA,Passenger,1,0,1,1,2,50
June,30,2021,Pend Oreille,WA,Passenger,14,7,21,9267,9288,0.23
June,30,2021,Kittitas,WA,Truck,0,0,0,14785,14785,0
June,30,2021,DuPage,IL,Passenger,1,0,1,50,51,1.96
June,30,2021,Skagit,WA,Truck,1,0,1,33029,33030,0
June,30,2021,Honolulu,HI,Passenger,5,2,7,392,399,1.75
June,30,2021,Klickitat,WA,Truck,0,0,0,8301,8301,0
June,30,2021,Douglas,WA,Passenger,93,48,141,28517,28658,0.49
June,30,2021,Placer,CA,Passenger,2,0,2,77,79,2.53
June,30,2021,Los Angeles,CA,Passenger,10,11,21,878,899,2.34
June,30,2021,Montgomery,MD,Passenger,3,1,4,218,222,1.8
June,30,2021,Grant,WA,Passenger,107,89,196,66973,67169,0.29
June,30,2021,Richmond,NY,Passenger,1,0,1,9,10,10
June,30,2021,Yakima,WA,Truck,0,0,0,61725,61725,0
June,30,2021,Denver,CO,Passenger,1,0,1,118,119,0.84
June,30,2021,Chesapeake,VA,Passenger,0,4,4,389,393,1.02
June,30,2021,Dallas,TX,Passenger,1,0,1,158,159,0.63
June,30,2021,Wahkiakum,WA,Truck,0,0,0,1797,1797,0
June,30,2021,El Paso,CO,Passenger,3,0,3,669,672,0.45
June,30,2021,Middlesex,MA,Passenger,1,1,2,93,95,2.11
June,30,2021,Manassas,VA,Passenger,0,1,1,7,8,12.5
June,30,2021,Greene,MO,Passenger,0,1,1,29,30,3.33
June,30,2021,Kings,CA,Passenger,1,0,1,319,320,0.31
June,30,2021,Kings,NY,Passenger,1,0,1,67,68,1.47
June,30,2021,Sedgwick,KS,Passenger,1,1,2,83,85,2.35
June,30,2021,Grays Harbor,WA,Passenger,168,144,312,49450,49762,0.63
June,30,2021,Yakima,WA,Passenger,225,155,380,169332,169712,0.22
June,30,2021,New York,NY,Passenger,1,0,1,44,45,2.22
June,30,2021,Franklin,WA,Truck,0,0,0,20697,20697,0
June,30,2021,San Juan,WA,Passenger,431,135,566,14255,14821,3.82
June,30,2021,Columbia,WA,Passenger,6,2,8,2468,2476,0.32
June,30,2021,Suffolk,MA,Passenger,0,2,2,30,32,6.25
June,30,2021,Calvert,MD,Passenger,0,2,2,90,92,2.17
June,30,2021,Kittitas,WA,Passenger,160,67,227,29984,30211,0.75
June,30,2021,Clallam,WA,Passenger,329,217,546,50489,51035,1.07
June,30,2021,Broward,FL,Passenger,2,0,2,107,109,1.83
June,30,2021,Lewis,WA,Passenger,163,139,302,59680,59982,0.5
June,30,2021,Clackamas,OR,Passenger,2,0,2,170,172,1.16
June,30,2021,St. Mary's,MD,Passenger,1,0,1,205,206,0.49
June,30,2021,Washington,OR,Passenger,1,0,1,383,384,0.26
June,30,2021,Clark,WA,Passenger,2841,1423,4264,322560,326824,1.3
June,30,2021,Douglas,CO,Passenger,0,1,1,75,76,1.32
June,30,2021,Houston,GA,Passenger,1,0,1,47,48,2.08
June,30,2021,Fort Bend,TX,Passenger,1,0,1,36,37,2.7
June,30,2021,Monterey,CA,Passenger,0,1,1,147,148,0.68
June,30,2021,Nassau,NY,Passenger,2,0,2,26,28,7.14
June,30,2021,Whitman,WA,Passenger,58,47,105,21996,22101,0.48
June,30,2021,Cowlitz,WA,Truck,0,0,0,29122,29122,0
June,30,2021,Alameda,CA,Passenger,3,0,3,236,239,1.26
June,30,2021,Platte,MO,Passenger,1,0,1,17,18,5.56
June,30,2021,Adams,WA,Truck,0,0,0,5386,5386,0
June,30,2021,Hillsborough,FL,Passenger,0,1,1,146,147,0.68
June,30,2021,Jefferson,NY,Passenger,0,1,1,214,215,0.47
June,30,2021,Norfolk,VA,Passenger,2,3,5,316,321,1.56
June,30,2021,Hudson,NJ,Passenger,1,0,1,42,43,2.33
June,30,2021,San Juan,WA,Truck,0,0,0,5942,5942,0
June,30,2021,Kauai,HI,Passenger,1,0,1,17,18,5.56
June,30,2021,Lee,FL,Passenger,1,0,1,35,36,2.78
June,30,2021,Erie,NY,Passenger,1,0,1,37,38,2.63
June,30,2021,Vigo,IN,Passenger,1,0,1,5,6,16.67
June,30,2021,Adams,WA,Passenger,16,11,27,13035,13062,0.21
June,30,2021,Richland,SC,Passenger,0,1,1,134,135,0.74
June,30,2021,Oldham,KY,Passenger,0,1,1,4,5,20
June,30,2021,Larimer,CO,Passenger,1,0,1,50,51,1.96
June,30,2021,Pierce,WA,Passenger,3470,1997,5467,560461,565928,0.97
June,30,2021,Penobscot,ME,Passenger,0,1,1,8,9,11.11
June,30,2021,Lewis,WA,Truck,0,0,0,26859,26859,0
June,30,2021,Pinellas,FL,Passenger,0,1,1,93,94,1.06
June,30,2021,Harnett,NC,Passenger,1,1,2,167,169,1.18
June,30,2021,Goochland,VA,Passenger,4,2,6,217,223,2.69
June,30,2021,Champaign,IL,Passenger,1,0,1,11,12,8.33
June,30,2021,Collin,TX,Passenger,1,1,2,109,111,1.8
June,30,2021,Prince William,VA,Passenger,1,1,2,210,212,0.94
June,30,2021,Mason,WA,Passenger,215,140,355,48176,48531,0.73
June,30,2021,Howard,IN,Passenger,0,1,1,5,6,16.67
June,30,2021,Rogers,OK,Passenger,1,0,1,3,4,25
June,30,2021,Stafford,VA,Passenger,2,1,3,99,102,2.94
June,30,2021,Walla Walla,WA,Passenger,113,74,187,36614,36801,0.51
June,30,2021,Lincoln,WA,Truck,0,0,0,4754,4754,0
June,30,2021,Wichita,TX,Passenger,1,0,1,40,41,2.44
June,30,2021,Sarasota,FL,Passenger,2,0,2,28,30,6.67
June,30,2021,Maui,HI,Passenger,1,0,1,26,27,3.7
June,30,2021,Rockingham,NH,Passenger,1,0,1,21,22,4.55
June,30,2021,Klickitat,WA,Passenger,70,51,121,15279,15400,0.79
June,30,2021,Lane,OR,Passenger,0,1,1,125,126,0.79
June,30,2021,Williamson,TX,Passenger,0,2,2,105,107,1.87
June,30,2021,Fresno,CA,Passenger,1,0,1,168,169,0.59
June,30,2021,Owyhee,ID,Passenger,1,0,1,3,4,25
June,30,2021,Powhatan,VA,Passenger,1,0,1,1,2,50
June,30,2021,Columbia,WA,Truck,0,0,0,1546,1546,0
June,30,2021,Sumter,SC,Passenger,0,1,1,39,40,2.5
June,30,2021,Saginaw,MI,Passenger,1,0,1,6,7,14.29
June,30,2021,Yamhill,OR,Passenger,1,0,1,35,36,2.78
June,30,2021,Spokane,WA,Passenger,1069,646,1715,326466,328181,0.52
June,30,2021,Travis,TX,Passenger,3,3,6,156,162,3.7
June,30,2021,Clark,NV,Passenger,4,2,6,614,620,0.97
June,30,2021,Juneau,AK,Passenger,0,1,1,26,27,3.7
June,30,2021,Lake,IL,Passenger,2,0,2,157,159,1.26
June,30,2021,Moore,NC,Passenger,0,1,1,129,130,0.77
June,30,2021,Pend Oreille,WA,Truck,0,0,0,5748,5748,0
June,30,2021,Frederick,MD,Passenger,1,1,2,67,69,2.9
June,30,2021,Okaloosa,FL,Passenger,0,1,1,115,116,0.86
June,30,2021,Walla Walla,WA,Truck,0,0,0,14076,14076,0
June,30,2021,Spartanburg,SC,Passenger,0,1,1,50,51,1.96
June,30,2021,Montgomery,TX,Passenger,1,1,2,39,41,4.88
June,30,2021,Allegheny,PA,Passenger,1,1,2,62,64,3.12
June,30,2021,Orange,CA,Passenger,4,3,7,416,423,1.65
June,30,2021,San Joaquin,CA,Passenger,1,0,1,106,107,0.93
June,30,2021,Bexar,TX,Passenger,3,4,7,524,531,1.32
June,30,2021,New London,CT,Passenger,1,2,3,221,224,1.34
June,30,2021,Skagit,WA,Passenger,589,274,863,91973,92836,0.93
June,30,2021,King,WA,Truck,6,1,7,184630,184637,0
June,30,2021,Carroll,NH,Passenger,0,1,1,5,6,16.67
June,30,2021,Alexandria,VA,Passenger,2,0,2,123,125,1.6
June,30,2021,Benton,WA,Truck,0,0,0,43627,43627,0
June,30,2021,Camden,NJ,Passenger,0,1,1,15,16,6.25
June,30,2021,Sumter,FL,Passenger,0,1,1,8,9,11.11
June,30,2021,New Haven,CT,Passenger,0,2,2,28,30,6.67
June,30,2021,Polk,FL,Passenger,1,0,1,54,55,1.82
June,30,2021,Lake,FL,Passenger,1,0,1,22,23,4.35
June,30,2021,El Dorado,CA,Passenger,1,0,1,31,32,3.12
June,30,2021,Skamania,WA,Passenger,44,34,78,8407,8485,0.92
June,30,2021,Thurston,WA,Passenger,1585,872,2457,198143,200600,1.22
June,30,2021,Hennepin,MN,Passenger,3,0,3,75,78,3.85
June,30,2021,Pennington,SD,Passenger,1,0,1,30,31,3.23
June,30,2021,Douglas,WA,Truck,0,0,0,12685,12685,0
June,30,2021,Stevens,WA,Truck,0,0,0,18947,18947,0
June,30,2021,Kitsap,WA,Passenger,1851,859,2710,180524,183234,1.48
June,30,2021,Washington,MD,Passenger,1,0,1,13,14,7.14
June,30,2021,Burlington,NJ,Passenger,0,1,1,129,130,0.77
June,30,2021,Plaquemines,LA,Passenger,0,1,1,16,17,5.88
June,30,2021,Suffolk,VA,Passenger,1,0,1,125,126,0.79
June,30,2021,San Diego,CA,Passenger,16,6,22,2559,2581,0.85
June,30,2021,Leavenworth,KS,Passenger,0,1,1,116,117,0.85
June,30,2021,Sevier,AR,Passenger,0,1,1,0,1,100
June,30,2021,Multnomah,OR,Passenger,2,5,7,639,646,1.08
June,30,2021,St. Louis,MO,Passenger,1,0,1,81,82,1.22
June,30,2021,DeKalb,GA,Passenger,1,0,1,58,59,1.69
June,30,2021,Louisa,VA,Passenger,0,1,1,1,2,50
June,30,2021,Maricopa,AZ,Passenger,6,3,9,1153,1162,0.77
June,30,2021,Lincoln,WA,Passenger,5,13,18,7738,7756,0.23
June,30,2021,Allen,IN,Passenger,1,0,1,15,16,6.25
June,30,2021,Hampshire,MA,Passenger,1,0,1,5,6,16.67
June,30,2021,Hawaii,HI,Passenger,1,0,1,46,47,2.13
June,30,2021,Clallam,WA,Truck,1,0,1,22026,22027,0
June,30,2021,Arapahoe,CO,Passenger,1,0,1,110,111,0.9
June,30,2021,Portsmouth,VA,Passenger,0,1,1,76,77,1.3
June,30,2021,Garfield,WA,Passenger,0,3,3,1375,1378,0.22
June,30,2021,Virginia Beach,VA,Passenger,3,0,3,614,617,0.49
June,30,2021,Santa Cruz,CA,Passenger,1,0,1,25,26,3.85
June,30,2021,Fairfax,VA,Passenger,4,4,8,684,692,1.16
June,30,2021,Morris,NJ,Passenger,1,0,1,15,16,6.25
June,30,2021,Island,WA,Truck,0,0,0,21624,21624,0
June,30,2021,Anne Arundel,MD,Passenger,4,2,6,388,394,1.52
June,30,2021,St. Clair,IL,Passenger,2,0,2,135,137,1.46
June,30,2021,Klamath,OR,Passenger,1,0,1,29,30,3.33
March,31,2021,Richmond,GA,Passenger,0,1,1,75,76,1.32
March,31,2021,Sacramento,CA,Passenger,2,0,2,232,234,0.85
March,31,2021,San Francisco,CA,Passenger,1,1,2,90,92,2.17
March,31,2021,El Paso,CO,Passenger,3,0,3,681,684,0.44
March,31,2021,Greene,MO,Passenger,0,1,1,31,32,3.12
March,31,2021,Houston,GA,Passenger,1,0,1,49,50,2
March,31,2021,Clallam,WA,Truck,1,0,1,21955,21956,0
March,31,2021,Skagit,WA,Truck,1,0,1,32932,32933,0
March,31,2021,Kent,MI,Passenger,0,1,1,26,27,3.7
March,31,2021,Ray,MO,Passenger,0,1,1,1,2,50
March,31,2021,District of Columbia,DC,Passenger,3,1,4,200,204,1.96
March,31,2021,Williams,ND,Passenger,0,1,1,10,11,9.09
March,31,2021,Carroll,MD,Passenger,0,1,1,19,20,5
March,31,2021,Queens,NY,Passenger,2,0,2,49,51,3.92
March,31,2021,Yakima,WA,Passenger,188,135,323,168230,168553,0.19
March,31,2021,Pacific,WA,Passenger,39,40,79,15920,15999,0.49
March,31,2021,Pacific,WA,Truck,0,0,0,7879,7879,0
March,31,2021,Charleston,SC,Passenger,2,0,2,84,86,2.33
March,31,2021,Anchorage,AK,Passenger,1,0,1,140,141,0.71
March,31,2021,San Juan,WA,Passenger,394,123,517,14117,14634,3.53
March,31,2021,Okaloosa,FL,Passenger,0,1,1,127,128,0.78
March,31,2021,Tulsa,OK,Passenger,1,0,1,41,42,2.38
March,31,2021,Sevier,AR,Passenger,0,1,1,0,1,100
March,31,2021,Leavenworth,KS,Passenger,0,1,1,118,119,0.84
March,31,2021,Moore,NC,Passenger,0,1,1,134,135,0.74
March,31,2021,Whatcom,WA,Truck,4,0,4,43783,43787,0.01
March,31,2021,Multnomah,OR,Passenger,3,5,8,660,668,1.2
March,31,2021,Bartow,GA,Passenger,0,1,1,4,5,20
March,31,2021,Yamhill,OR,Passenger,1,0,1,37,38,2.63
March,31,2021,Fairfax,VA,Passenger,4,4,8,695,703,1.14
March,31,2021,Jones,GA,Passenger,1,0,1,1,2,50
March,31,2021,Alameda,CA,Passenger,3,0,3,251,254,1.18
March,31,2021,Lewis,WA,Passenger,130,134,264,59293,59557,0.44
March,31,2021,Sedgwick,KS,Passenger,1,1,2,86,88,2.27
March,31,2021,Ferry,WA,Truck,0,0,0,3623,3623,0
March,31,2021,Prince George's,MD,Passenger,2,1,3,140,143,2.1
March,31,2021,Pennington,SD,Passenger,1,0,1,32,33,3.03
March,31,2021,Thurston,WA,Passenger,1432,824,2256,197465,199721,1.13
March,31,2021,Dakota,MN,Passenger,0,1,1,25,26,3.85
March,31,2021,San Mateo,CA,Passenger,1,1,2,102,104,1.92
March,31,2021,Goochland,VA,Passenger,4,3,7,237,244,2.87
March,31,2021,Chelan,WA,Passenger,304,94,398,54537,54935,0.72
March,31,2021,Kittitas,WA,Passenger,146,55,201,29891,30092,0.67
March,31,2021,Kings,NY,Passenger,1,0,1,67,68,1.47
March,31,2021,Polk,FL,Passenger,1,0,1,53,54,1.85
March,31,2021,Klickitat,WA,Truck,0,0,0,8173,8173,0
March,31,2021,Manassas,VA,Passenger,0,1,1,6,7,14.29
March,31,2021,Shelby,OH,Passenger,0,1,1,1,2,50
March,31,2021,Bucks,PA,Passenger,1,0,1,18,19,5.26
March,31,2021,Middlesex,MA,Passenger,1,1,2,93,95,2.11
March,31,2021,Island,WA,Truck,0,0,0,21460,21460,0
March,31,2021,Douglas,NE,Passenger,1,1,2,49,51,3.92
March,31,2021,Montgomery,TX,Passenger,1,1,2,43,45,4.44
March,31,2021,Cape May,NJ,Passenger,0,1,1,8,9,11.11
March,31,2021,Grant,WA,Truck,0,0,0,27760,27760,0
March,31,2021,Kitsap,WA,Truck,0,0,0,54392,54392,0
March,31,2021,Jefferson,WA,Truck,0,0,0,9591,9591,0
March,31,2021,Santa Cruz,CA,Passenger,1,0,1,29,30,3.33
March,31,2021,King,WA,Passenger,28522,8567,37089,1365152,1402241,2.64
March,31,2021,Allegheny,PA,Passenger,1,1,2,65,67,2.99
March,31,2021,Snohomish,WA,Passenger,5384,1931,7315,538886,546201,1.34
March,31,2021,Philadelphia,PA,Passenger,1,0,1,55,56,1.79
March,31,2021,Frederick,MD,Passenger,1,1,2,71,73,2.74
March,31,2021,Bexar,TX,Passenger,4,5,9,546,555,1.62
March,31,2021,Spartanburg,SC,Passenger,0,1,1,50,51,1.96
March,31,2021,Walla Walla,WA,Truck,0,0,0,13966,13966,0
March,31,2021,Skamania,WA,Truck,0,0,0,4027,4027,0
March,31,2021,Lane,OR,Passenger,0,1,1,125,126,0.79
March,31,2021,St. Mary's,MD,Passenger,1,0,1,213,214,0.47
March,31,2021,Nassau,NY,Passenger,4,0,4,27,31,12.9
March,31,2021,Honolulu,HI,Passenger,5,2,7,407,414,1.69
March,31,2021,Washoe,NV,Passenger,1,0,1,96,97,1.03
March,31,2021,Ferry,WA,Passenger,10,3,13,4349,4362,0.3
March,31,2021,Grays Harbor,WA,Passenger,150,131,281,49026,49307,0.57
March,31,2021,Riverside,CA,Passenger,5,1,6,574,580,1.03
March,31,2021,DuPage,IL,Passenger,2,0,2,54,56,3.57
March,31,2021,Kauai,HI,Passenger,1,0,1,15,16,6.25
March,31,2021,Nueces,TX,Passenger,1,0,1,79,80,1.25
March,31,2021,St. Clair,IL,Passenger,1,0,1,138,139,0.72
March,31,2021,Walla Walla,WA,Passenger,107,72,179,36286,36465,0.49
March,31,2021,Lee,FL,Passenger,1,0,1,38,39,2.56
March,31,2021,San Diego,CA,Passenger,14,5,19,2637,2656,0.72
March,31,2021,Mason,WA,Truck,0,0,0,21168,21168,0
March,31,2021,Yakima,WA,Truck,0,0,0,61384,61384,0
March,31,2021,Kittitas,WA,Truck,0,0,0,14757,14757,0
March,31,2021,Prince William,VA,Passenger,1,1,2,212,214,0.93
March,31,2021,Douglas,WA,Truck,0,0,0,12557,12557,0
March,31,2021,Pima,AZ,Passenger,2,1,3,302,305,0.98
March,31,2021,Kitsap,WA,Passenger,1675,800,2475,179749,182224,1.36
March,31,2021,Adams,WA,Truck,0,0,0,5375,5375,0
March,31,2021,Fulton,GA,Passenger,0,2,2,81,83,2.41
March,31,2021,Maui,HI,Passenger,1,0,1,26,27,3.7
March,31,2021,DeKalb,GA,Passenger,1,0,1,63,64,1.56
March,31,2021,Cumberland,NC,Passenger,0,2,2,436,438,0.46
March,31,2021,Monroe,IL,Passenger,1,0,1,3,4,25
March,31,2021,Howard,MD,Passenger,0,1,1,63,64,1.56
March,31,2021,Platte,MO,Passenger,1,0,1,19,20,5
March,31,2021,Franklin,WA,Truck,0,0,0,20608,20608,0
March,31,2021,Hawaii,HI,Passenger,1,0,1,48,49,2.04
March,31,2021,Spokane,WA,Truck,0,0,0,101439,101439,0
March,31,2021,Okanogan,WA,Truck,0,0,0,16672,16672,0
March,31,2021,Garfield,WA,Truck,0,0,0,1012,1012,0
March,31,2021,Maricopa,AZ,Passenger,5,4,9,1234,1243,0.72
March,31,2021,Larimer,CO,Passenger,1,0,1,53,54,1.85
March,31,2021,Orange,FL,Passenger,1,0,1,112,113,0.88
March,31,2021,Salt Lake,UT,Passenger,0,1,1,171,172,0.58
March,31,2021,Harrison,MS,Passenger,2,0,2,51,53,3.77
March,31,2021,Snohomish,WA,Truck,1,0,1,125936,125937,0
March,31,2021,Washington,OR,Passenger,1,0,1,394,395,0.25
March,31,2021,El Dorado,CA,Passenger,1,0,1,30,31,3.23
March,31,2021,Arlington,VA,Passenger,0,1,1,136,137,0.73
March,31,2021,Orange,CA,Passenger,4,3,7,440,447,1.57
March,31,2021,Wichita,TX,Passenger,1,0,1,40,41,2.44
March,31,2021,Boone,MO,Passenger,0,1,1,10,11,9.09
March,31,2021,Clark,WA,Truck,0,0,0,83850,83850,0
March,31,2021,Lincoln,WA,Passenger,5,13,18,7691,7709,0.23
March,31,2021,Cowlitz,WA,Truck,0,0,0,29052,29052,0
March,31,2021,Douglas,CO,Passenger,0,1,1,77,78,1.28
March,31,2021,Montgomery,OH,Passenger,0,1,1,55,56,1.79
March,31,2021,Skagit,WA,Passenger,539,260,799,91602,92401,0.86
March,31,2021,Clallam,WA,Passenger,299,199,498,50123,50621,0.98
March,31,2021,Portsmouth,VA,Passenger,0,1,1,76,77,1.3
March,31,2021,Hampshire,MA,Passenger,1,0,1,6,7,14.29
March,31,2021,Clackamas,OR,Passenger,3,0,3,175,178,1.69
March,31,2021,Clark,NV,Passenger,4,2,6,639,645,0.93
March,31,2021,Island,WA,Passenger,556,299,855,63006,63861,1.34
March,31,2021,St. Louis,MO,Passenger,1,0,1,91,92,1.09
March,31,2021,Whitman,WA,Truck,0,0,0,8553,8553,0
March,31,2021,Lewis,WA,Truck,0,0,0,26811,26811,0
March,31,2021,Suffolk,VA,Passenger,1,0,1,124,125,0.8
March,31,2021,Stafford,VA,Passenger,2,1,3,97,100,3
March,31,2021,Fairbanks North Star,AK,Passenger,0,1,1,85,86,1.16
March,31,2021,Carroll,NH,Passenger,0,1,1,5,6,16.67
March,31,2021,Owyhee,ID,Passenger,1,0,1,3,4,25
March,31,2021,Montgomery,MD,Passenger,1,0,1,228,229,0.44
March,31,2021,Montgomery,PA,Passenger,1,0,1,24,25,4
March,31,2021,Jefferson,WA,Passenger,302,174,476,24829,25305,1.88
March,31,2021,Ramsey,MN,Passenger,1,0,1,32,33,3.03
March,31,2021,Hamilton,IN,Passenger,2,0,2,35,37,5.41
March,31,2021,Hudson,NJ,Passenger,1,0,1,41,42,2.38
March,31,2021,Placer,CA,Passenger,2,0,2,79,81,2.47
March,31,2021,Wahkiakum,WA,Truck,0,0,0,1788,1788,0
March,31,2021,Nassau,FL,Passenger,1,0,1,32,33,3.03
March,31,2021,Franklin,WA,Passenger,100,88,188,61668,61856,0.3
March,31,2021,Boulder,CO,Passenger,0,1,1,46,47,2.13
March,31,2021,Douglas,WA,Passenger,86,47,133,28378,28511,0.47
March,31,2021,Morris,NJ,Passenger,1,0,1,16,17,5.88
March,31,2021,San Joaquin,CA,Passenger,1,0,1,104,105,0.95
March,31,2021,RÃ­o Grande,PR,Passenger,1,0,1,1,2,50
March,31,2021,Pinellas,FL,Passenger,1,1,2,95,97,2.06
March,31,2021,Putnam,TN,Passenger,0,1,1,0,1,100
March,31,2021,Norfolk,VA,Passenger,2,3,5,327,332,1.51
March,31,2021,Sumter,FL,Passenger,0,1,1,10,11,9.09
March,31,2021,Denver,CO,Passenger,1,0,1,112,113,0.88
March,31,2021,San Juan,WA,Truck,0,0,0,5885,5885,0
March,31,2021,New Haven,CT,Passenger,0,2,2,32,34,5.88
March,31,2021,Stevens,WA,Truck,0,0,0,18796,18796,0
March,31,2021,King,WA,Truck,6,1,7,184559,184566,0
March,31,2021,Duval,FL,Passenger,0,2,2,346,348,0.57
March,31,2021,Sarasota,FL,Passenger,2,0,2,26,28,7.14
March,31,2021,Contra Costa,CA,Passenger,3,4,7,273,280,2.5
March,31,2021,Santa Clara,CA,Passenger,8,2,10,261,271,3.69
March,31,2021,Whatcom,WA,Passenger,1298,576,1874,150446,152320,1.23
March,31,2021,Flathead,MT,Passenger,1,0,1,45,46,2.17
March,31,2021,Grant,WA,Passenger,93,87,180,66441,66621,0.27
March,31,2021,Camden,NJ,Passenger,0,1,1,14,15,6.67
March,31,2021,Fresno,CA,Passenger,1,0,1,167,168,0.6
March,31,2021,Howard,IN,Passenger,0,1,1,3,4,25
March,31,2021,Thurston,WA,Truck,0,0,0,56530,56530,0
March,31,2021,Wahkiakum,WA,Passenger,9,7,16,3083,3099,0.52
March,31,2021,Pierce,WA,Passenger,3126,1845,4971,556748,561719,0.88
March,31,2021,Mason,WA,Passenger,185,137,322,47894,48216,0.67
March,31,2021,Okanogan,WA,Passenger,57,35,92,26225,26317,0.35
March,31,2021,Chesapeake,VA,Passenger,0,3,3,397,400,0.75
March,31,2021,New York,NY,Passenger,1,0,1,49,50,2
March,31,2021,Harnett,NC,Passenger,1,1,2,176,178,1.12
March,31,2021,Pierce,WA,Truck,0,0,0,145348,145348,0
March,31,2021,Fort Bend,TX,Passenger,1,0,1,39,40,2.5
March,31,2021,Oldham,KY,Passenger,0,1,1,4,5,20
March,31,2021,Spokane,WA,Passenger,952,584,1536,322674,324210,0.47
March,31,2021,Clark,WA,Passenger,2578,1276,3854,320028,323882,1.19
March,31,2021,Chelan,WA,Truck,0,0,0,22987,22987,0
March,31,2021,Loudoun,VA,Passenger,1,0,1,72,73,1.37
March,31,2021,Arapahoe,CO,Passenger,1,0,1,115,116,0.86
March,31,2021,Miami-Dade,FL,Passenger,1,0,1,97,98,1.02
March,31,2021,Vigo,IN,Passenger,1,0,1,5,6,16.67
March,31,2021,Columbia,WA,Passenger,5,4,9,2466,2475,0.36
March,31,2021,Los Angeles,CA,Passenger,10,10,20,910,930,2.15
March,31,2021,Missoula,MT,Passenger,1,0,1,64,65,1.54
March,31,2021,Saginaw,MI,Passenger,2,0,2,10,12,16.67
March,31,2021,Utah,UT,Passenger,0,1,1,119,120,0.83
March,31,2021,Rockingham,NH,Passenger,1,0,1,23,24,4.17
March,31,2021,Benton,WA,Passenger,466,369,835,135501,136336,0.61
March,31,2021,Harris,TX,Passenger,1,1,2,202,204,0.98
March,31,2021,Monterey,CA,Passenger,0,1,1,147,148,0.68
March,31,2021,Collin,TX,Passenger,1,1,2,114,116,1.72
March,31,2021,Klamath,OR,Passenger,1,0,1,29,30,3.33
March,31,2021,Powhatan,VA,Passenger,1,0,1,1,2,50
March,31,2021,Pend Oreille,WA,Truck,0,0,0,5724,5724,0
March,31,2021,Washington,MD,Passenger,1,0,1,12,13,7.69
March,31,2021,Charles,MD,Passenger,1,1,2,70,72,2.78
March,31,2021,Cowlitz,WA,Passenger,197,133,330,72161,72491,0.46
March,31,2021,Alexandria,VA,Passenger,2,0,2,131,133,1.5
March,31,2021,Penobscot,ME,Passenger,0,1,1,9,10,10
March,31,2021,Randolph,NC,Passenger,1,0,1,7,8,12.5
March,31,2021,Suffolk,MA,Passenger,0,2,2,33,35,5.71
March,31,2021,Williamson,TX,Passenger,0,2,2,113,115,1.74
March,31,2021,Travis,TX,Passenger,2,3,5,163,168,2.98
March,31,2021,Skamania,WA,Passenger,38,25,63,8308,8371,0.75
March,31,2021,Deschutes,OR,Passenger,1,0,1,119,120,0.83
March,31,2021,Asotin,WA,Truck,0,0,0,6725,6725,0
March,31,2021,Anne Arundel,MD,Passenger,4,1,5,395,400,1.25
March,31,2021,Jefferson,NY,Passenger,0,1,1,211,212,0.47
March,31,2021,Bradley,TN,Passenger,1,0,1,0,1,100
March,31,2021,Solano,CA,Passenger,1,0,1,195,196,0.51
March,31,2021,Juneau,AK,Passenger,0,1,1,26,27,3.7
March,31,2021,Lincoln,WA,Truck,0,0,0,4733,4733,0
March,31,2021,Columbia,WA,Truck,0,0,0,1549,1549,0
March,31,2021,Ulster,NY,Passenger,1,0,1,7,8,12.5
March,31,2021,Lake,FL,Passenger,1,0,1,21,22,4.55
March,31,2021,Benton,WA,Truck,0,0,0,43534,43534,0
March,31,2021,Gwinnett,GA,Passenger,1,0,1,66,67,1.49
March,31,2021,Stevens,WA,Passenger,38,43,81,30317,30398,0.27
March,31,2021,Pend Oreille,WA,Passenger,12,6,18,9281,9299,0.19
March,31,2021,Hennepin,MN,Passenger,2,0,2,79,81,2.47
March,31,2021,Kern,CA,Passenger,0,1,1,213,214,0.47
March,31,2021,Rogers,OK,Passenger,1,0,1,4,5,20
March,31,2021,Ventura,CA,Passenger,1,1,2,265,267,0.75
March,31,2021,Milwaukee,WI,Passenger,1,0,1,38,39,2.56
March,31,2021,Twin Falls,ID,Passenger,0,1,1,21,22,4.55
March,31,2021,Dallas,TX,Passenger,1,0,1,163,164,0.61
March,31,2021,Carson City,NV,Passenger,1,0,1,12,13,7.69
March,31,2021,Wilson,TX,Passenger,0,1,1,4,5,20
March,31,2021,Whitman,WA,Passenger,54,44,98,21932,22030,0.44
March,31,2021,Garfield,WA,Passenger,0,2,2,1365,1367,0.15
March,31,2021,Richland,SC,Passenger,0,1,1,137,138,0.72
March,31,2021,Adams,WA,Passenger,10,7,17,12997,13014,0.13
March,31,2021,Broward,FL,Passenger,1,0,1,109,110,0.91
March,31,2021,El Paso,TX,Passenger,3,0,3,382,385,0.78
March,31,2021,Erie,NY,Passenger,1,0,1,41,42,2.38
March,31,2021,Klickitat,WA,Passenger,65,46,111,15028,15139,0.73
March,31,2021,Asotin,WA,Passenger,17,14,31,12569,12600,0.25
March,31,2021,Lake,IL,Passenger,2,0,2,151,153,1.31
March,31,2021,Virginia Beach,VA,Passenger,3,0,3,625,628,0.48
March,31,2021,Grays Harbor,WA,Truck,0,0,0,21269,21269,0
March,31,2021,Calvert,MD,Passenger,0,2,2,85,87,2.3
March,31,2021,Plaquemines,LA,Passenger,0,1,1,15,16,6.25
March,31,2021,Albemarle,VA,Passenger,1,0,1,21,22,4.55
March,31,2021,New London,CT,Passenger,1,2,3,223,226,1.33
March,31,2021,,,Passenger,7,7,14,980,994,1.41
May,31,2021,Erie,NY,Passenger,1,0,1,39,40,2.5
May,31,2021,Adams,WA,Truck,0,0,0,5374,5374,0
May,31,2021,Ferry,WA,Passenger,9,3,12,4373,4385,0.27
May,31,2021,Adams,WA,Passenger,11,9,20,13043,13063,0.15
May,31,2021,Lincoln,WA,Passenger,5,13,18,7733,7751,0.23
May,31,2021,Whatcom,WA,Passenger,1386,596,1982,150988,152970,1.3
May,31,2021,San Joaquin,CA,Passenger,1,0,1,105,106,0.94
May,31,2021,Howard,IN,Passenger,0,1,1,3,4,25
May,31,2021,El Paso,TX,Passenger,3,0,3,375,378,0.79
May,31,2021,Pend Oreille,WA,Truck,0,0,0,5748,5748,0
May,31,2021,Kitsap,WA,Truck,0,0,0,54547,54547,0
May,31,2021,Hamilton,IN,Passenger,2,0,2,33,35,5.71
May,31,2021,Richland,SC,Passenger,0,1,1,139,140,0.71
May,31,2021,Sarasota,FL,Passenger,2,0,2,27,29,6.9
May,31,2021,Clallam,WA,Truck,1,0,1,22005,22006,0
May,31,2021,Platte,MO,Passenger,1,0,1,18,19,5.26
May,31,2021,Missoula,MT,Passenger,1,0,1,61,62,1.61
May,31,2021,Howard,MD,Passenger,0,1,1,61,62,1.61
May,31,2021,Multnomah,OR,Passenger,2,5,7,649,656,1.07
May,31,2021,Asotin,WA,Truck,0,0,0,6783,6783,0
May,31,2021,Hampshire,MA,Passenger,1,0,1,6,7,14.29
May,31,2021,Jefferson,NY,Passenger,0,1,1,210,211,0.47
May,31,2021,Klamath,OR,Passenger,1,0,1,31,32,3.12
May,31,2021,Pennington,SD,Passenger,1,0,1,31,32,3.12
May,31,2021,Benton,WA,Passenger,504,385,889,136106,136995,0.65
May,31,2021,Montgomery,MD,Passenger,2,1,3,226,229,1.31
May,31,2021,Ray,MO,Passenger,0,1,1,1,2,50
May,31,2021,Portsmouth,VA,Passenger,0,1,1,77,78,1.28
May,31,2021,Owyhee,ID,Passenger,1,0,1,3,4,25
May,31,2021,Columbia,WA,Passenger,6,3,9,2476,2485,0.36
May,31,2021,Kittitas,WA,Truck,0,0,0,14768,14768,0
May,31,2021,Lewis,WA,Passenger,157,135,292,59809,60101,0.49
May,31,2021,Pierce,WA,Passenger,3382,1941,5323,559989,565312,0.94
May,31,2021,San Juan,WA,Passenger,423,131,554,14216,14770,3.75
May,31,2021,Flathead,MT,Passenger,1,0,1,44,45,2.22
May,31,2021,Sumter,FL,Passenger,0,1,1,10,11,9.09
May,31,2021,Arapahoe,CO,Passenger,1,0,1,112,113,0.88
May,31,2021,Klickitat,WA,Truck,0,0,0,8263,8263,0
May,31,2021,Sumter,SC,Passenger,0,1,1,39,40,2.5
May,31,2021,Skamania,WA,Truck,0,0,0,4030,4030,0
May,31,2021,Lake,FL,Passenger,1,0,1,22,23,4.35
May,31,2021,Bexar,TX,Passenger,3,4,7,530,537,1.3
May,31,2021,New York,NY,Passenger,1,0,1,47,48,2.08
May,31,2021,Carroll,MD,Passenger,0,1,1,18,19,5.26
May,31,2021,Clackamas,OR,Passenger,2,0,2,172,174,1.15
May,31,2021,Milwaukee,WI,Passenger,1,0,1,38,39,2.56
May,31,2021,Pinellas,FL,Passenger,0,1,1,94,95,1.05
May,31,2021,Denver,CO,Passenger,1,0,1,110,111,0.9
May,31,2021,Harnett,NC,Passenger,1,1,2,172,174,1.15
May,31,2021,El Dorado,CA,Passenger,1,0,1,29,30,3.33
May,31,2021,Nassau,NY,Passenger,3,0,3,25,28,10.71
May,31,2021,San Francisco,CA,Passenger,1,1,2,87,89,2.25
May,31,2021,Montgomery,PA,Passenger,1,0,1,24,25,4
May,31,2021,Chelan,WA,Passenger,322,98,420,54729,55149,0.76
May,31,2021,Montgomery,OH,Passenger,0,1,1,57,58,1.72
May,31,2021,Wilson,NC,Passenger,1,0,1,0,1,100
May,31,2021,Asotin,WA,Passenger,19,14,33,12700,12733,0.26
May,31,2021,St. Clair,IL,Passenger,1,0,1,135,136,0.74
May,31,2021,Cowlitz,WA,Passenger,218,136,354,72447,72801,0.49
May,31,2021,Klickitat,WA,Passenger,66,47,113,15237,15350,0.74
May,31,2021,Skagit,WA,Passenger,577,265,842,91964,92806,0.91
May,31,2021,Walla Walla,WA,Passenger,110,72,182,36556,36738,0.5
May,31,2021,Jones,GA,Passenger,1,0,1,1,2,50
May,31,2021,Nueces,TX,Passenger,1,0,1,77,78,1.28
May,31,2021,Allen,IN,Passenger,1,0,1,16,17,5.88
May,31,2021,Clark,WA,Truck,0,0,0,84190,84190,0
May,31,2021,Duval,FL,Passenger,0,2,2,334,336,0.6
May,31,2021,Williamson,TX,Passenger,0,2,2,106,108,1.85
May,31,2021,Rogers,OK,Passenger,1,0,1,3,4,25
May,31,2021,Powhatan,VA,Passenger,1,0,1,1,2,50
May,31,2021,Goochland,VA,Passenger,4,2,6,226,232,2.59
May,31,2021,Contra Costa,CA,Passenger,3,3,6,267,273,2.2
May,31,2021,Fresno,CA,Passenger,1,0,1,168,169,0.59
May,31,2021,Morris,NJ,Passenger,1,0,1,14,15,6.67
May,31,2021,Lincoln,WA,Truck,0,0,0,4754,4754,0
May,31,2021,Columbia,WA,Truck,0,0,0,1552,1552,0
May,31,2021,Arlington,VA,Passenger,0,1,1,137,138,0.72
May,31,2021,Thurston,WA,Truck,0,0,0,56635,56635,0
May,31,2021,Yakima,WA,Passenger,211,145,356,169299,169655,0.21
May,31,2021,Benton,WA,Truck,0,0,0,43665,43665,0
May,31,2021,Ventura,CA,Passenger,1,1,2,262,264,0.76
May,31,2021,Hennepin,MN,Passenger,2,0,2,75,77,2.6
May,31,2021,Stevens,WA,Passenger,42,45,87,30559,30646,0.28
May,31,2021,Juneau,AK,Passenger,0,1,1,25,26,3.85
May,31,2021,Wahkiakum,WA,Passenger,13,7,20,3113,3133,0.64
May,31,2021,Fairfax,VA,Passenger,4,4,8,687,695,1.15
May,31,2021,Garfield,WA,Passenger,0,2,2,1370,1372,0.15
May,31,2021,Oldham,KY,Passenger,0,1,1,4,5,20
May,31,2021,Thurston,WA,Passenger,1543,852,2395,198108,200503,1.19
May,31,2021,Philadelphia,PA,Passenger,1,0,1,48,49,2.04
May,31,2021,Kittitas,WA,Passenger,155,62,217,29978,30195,0.72
May,31,2021,Santa Cruz,CA,Passenger,1,0,1,26,27,3.7
May,31,2021,Vigo,IN,Passenger,1,0,1,5,6,16.67
May,31,2021,Moore,NC,Passenger,0,1,1,132,133,0.75
May,31,2021,Riverside,CA,Passenger,5,1,6,551,557,1.08
May,31,2021,Lake,IL,Passenger,2,0,2,154,156,1.28
May,31,2021,Harris,TX,Passenger,1,1,2,195,197,1.02
May,31,2021,Skagit,WA,Truck,1,0,1,33056,33057,0
May,31,2021,Middlesex,MA,Passenger,1,1,2,93,95,2.11
May,31,2021,Harrison,MS,Passenger,2,0,2,49,51,3.92
May,31,2021,Charles,MD,Passenger,1,1,2,68,70,2.86
May,31,2021,New Haven,CT,Passenger,0,2,2,29,31,6.45
May,31,2021,Honolulu,HI,Passenger,5,2,7,397,404,1.73
May,31,2021,District of Columbia,DC,Passenger,5,1,6,196,202,2.97
May,31,2021,Maui,HI,Passenger,1,0,1,26,27,3.7
May,31,2021,Dallas,TX,Passenger,1,0,1,158,159,0.63
May,31,2021,Deschutes,OR,Passenger,1,0,1,112,113,0.88
May,31,2021,Williams,ND,Passenger,0,1,1,7,8,12.5
May,31,2021,Anchorage,AK,Passenger,1,0,1,137,138,0.72
May,31,2021,Allegheny,PA,Passenger,1,1,2,64,66,3.03
May,31,2021,Mason,WA,Passenger,207,136,343,48113,48456,0.71
May,31,2021,San Diego,CA,Passenger,16,6,22,2601,2623,0.84
May,31,2021,Lee,FL,Passenger,1,0,1,36,37,2.7
May,31,2021,Prince George's,MD,Passenger,2,1,3,139,142,2.11
May,31,2021,Carson City,NV,Passenger,1,0,1,10,11,9.09
May,31,2021,Lane,OR,Passenger,0,1,1,126,127,0.79
May,31,2021,Pierce,WA,Truck,0,0,0,145896,145896,0
May,31,2021,Okanogan,WA,Truck,0,0,0,16755,16755,0
May,31,2021,Kings,NY,Passenger,1,0,1,66,67,1.49
May,31,2021,Kern,CA,Passenger,0,1,1,211,212,0.47
May,31,2021,Monterey,CA,Passenger,0,1,1,148,149,0.67
May,31,2021,Yakima,WA,Truck,0,0,0,61680,61680,0
May,31,2021,Spokane,WA,Passenger,1030,624,1654,325579,327233,0.51
May,31,2021,Placer,CA,Passenger,2,0,2,80,82,2.44
May,31,2021,Queens,NY,Passenger,2,0,2,48,50,4
May,31,2021,Suffolk,VA,Passenger,1,0,1,126,127,0.79
May,31,2021,Cumberland,NC,Passenger,0,2,2,427,429,0.47
May,31,2021,Boone,MO,Passenger,0,1,1,8,9,11.11
May,31,2021,Virginia Beach,VA,Passenger,3,0,3,619,622,0.48
May,31,2021,Sacramento,CA,Passenger,2,0,2,221,223,0.9
May,31,2021,Franklin,WA,Passenger,117,95,212,61959,62171,0.34
May,31,2021,Santa Clara,CA,Passenger,8,3,11,255,266,4.14
May,31,2021,Miami-Dade,FL,Passenger,1,0,1,96,97,1.03
May,31,2021,Bartow,GA,Passenger,0,1,1,4,5,20
May,31,2021,Calvert,MD,Passenger,0,2,2,89,91,2.2
May,31,2021,Jefferson,WA,Truck,0,0,0,9616,9616,0
May,31,2021,Albemarle,VA,Passenger,1,0,1,19,20,5
May,31,2021,Burlington,NJ,Passenger,0,1,1,129,130,0.77
May,31,2021,Grays Harbor,WA,Truck,0,0,0,21430,21430,0
May,31,2021,Cowlitz,WA,Truck,0,0,0,29142,29142,0
May,31,2021,San Mateo,CA,Passenger,1,0,1,102,103,0.97
May,31,2021,Pend Oreille,WA,Passenger,14,6,20,9275,9295,0.22
May,31,2021,Douglas,NE,Passenger,1,1,2,49,51,3.92
May,31,2021,Clark,NV,Passenger,4,2,6,618,624,0.96
May,31,2021,Washington,MD,Passenger,1,0,1,13,14,7.14
May,31,2021,Fort Bend,TX,Passenger,1,0,1,36,37,2.7
May,31,2021,Charleston,SC,Passenger,2,0,2,83,85,2.35
May,31,2021,Broward,FL,Passenger,1,0,1,103,104,0.96
May,31,2021,Ferry,WA,Truck,0,0,0,3661,3661,0
May,31,2021,RÃ­o Grande,PR,Passenger,1,0,1,1,2,50
May,31,2021,Los Angeles,CA,Passenger,10,11,21,891,912,2.3
May,31,2021,Greene,MO,Passenger,0,1,1,30,31,3.23
May,31,2021,Camden,NJ,Passenger,0,1,1,15,16,6.25
May,31,2021,Garfield,WA,Truck,0,0,0,999,999,0
May,31,2021,Cape May,NJ,Passenger,0,1,1,8,9,11.11
May,31,2021,Champaign,IL,Passenger,1,0,1,12,13,7.69
May,31,2021,Nassau,FL,Passenger,1,0,1,30,31,3.23
May,31,2021,El Paso,CO,Passenger,3,0,3,675,678,0.44
May,31,2021,Penobscot,ME,Passenger,0,1,1,9,10,10
May,31,2021,DeKalb,GA,Passenger,1,0,1,57,58,1.72
May,31,2021,Franklin,WA,Truck,0,0,0,20653,20653,0
May,31,2021,Lewis,WA,Truck,0,0,0,26895,26895,0
May,31,2021,Wichita,TX,Passenger,1,0,1,39,40,2.5
May,31,2021,Salt Lake,UT,Passenger,0,1,1,173,174,0.57
May,31,2021,Douglas,WA,Truck,0,0,0,12664,12664,0
May,31,2021,Wahkiakum,WA,Truck,0,0,0,1799,1799,0
May,31,2021,DuPage,IL,Passenger,1,0,1,52,53,1.89
May,31,2021,Plaquemines,LA,Passenger,0,1,1,16,17,5.88
May,31,2021,Orange,CA,Passenger,4,3,7,425,432,1.62
May,31,2021,Prince William,VA,Passenger,1,1,2,212,214,0.93
May,31,2021,Norfolk,VA,Passenger,2,3,5,324,329,1.52
May,31,2021,Mason,WA,Truck,0,0,0,21339,21339,0
May,31,2021,Polk,FL,Passenger,1,0,1,54,55,1.82
May,31,2021,Randolph,NC,Passenger,1,0,1,7,8,12.5
May,31,2021,Whitman,WA,Truck,0,0,0,8571,8571,0
May,31,2021,New London,CT,Passenger,1,2,3,223,226,1.33
May,31,2021,King,WA,Truck,6,1,7,184688,184695,0
May,31,2021,Stafford,VA,Passenger,2,1,3,98,101,2.97
May,31,2021,Island,WA,Passenger,599,310,909,63247,64156,1.42
May,31,2021,Danville,VA,Passenger,1,0,1,0,1,100
May,31,2021,Houston,GA,Passenger,1,0,1,49,50,2
May,31,2021,Island,WA,Truck,0,0,0,21611,21611,0
May,31,2021,Manassas,VA,Passenger,0,1,1,7,8,12.5
May,31,2021,Snohomish,WA,Passenger,5729,2002,7731,540294,548025,1.41
May,31,2021,Alameda,CA,Passenger,3,0,3,237,240,1.25
May,31,2021,Bucks,PA,Passenger,1,0,1,16,17,5.88
May,31,2021,St. Mary's,MD,Passenger,1,0,1,208,209,0.48
May,31,2021,Louisa,VA,Passenger,0,1,1,1,2,50
May,31,2021,Maricopa,AZ,Passenger,5,4,9,1182,1191,0.76
May,31,2021,,,Passenger,8,7,15,995,1010,1.49
May,31,2021,Saginaw,MI,Passenger,1,0,1,8,9,11.11
May,31,2021,Loudoun,VA,Passenger,1,0,1,74,75,1.33
May,31,2021,Douglas,WA,Passenger,92,47,139,28516,28655,0.49
May,31,2021,Travis,TX,Passenger,3,3,6,160,166,3.61
May,31,2021,Kitsap,WA,Passenger,1796,833,2629,180423,183052,1.44
May,31,2021,Richmond,GA,Passenger,0,1,1,77,78,1.28
May,31,2021,Dakota,MN,Passenger,0,1,1,25,26,3.85
May,31,2021,Rockingham,NH,Passenger,1,0,1,23,24,4.17
May,31,2021,Walla Walla,WA,Truck,0,0,0,14041,14041,0
May,31,2021,Grant,WA,Truck,0,0,0,27874,27874,0
May,31,2021,Washington,OR,Passenger,1,0,1,387,388,0.26
May,31,2021,Clallam,WA,Passenger,321,208,529,50426,50955,1.04
May,31,2021,Boulder,CO,Passenger,0,1,1,45,46,2.17
May,31,2021,Okaloosa,FL,Passenger,0,1,1,119,120,0.83
May,31,2021,Okanogan,WA,Passenger,61,37,98,26414,26512,0.37
May,31,2021,San Juan,WA,Truck,0,0,0,5926,5926,0
May,31,2021,Jefferson,WA,Passenger,322,181,503,24893,25396,1.98
May,31,2021,Sevier,AR,Passenger,0,1,1,0,1,100
May,31,2021,Leavenworth,KS,Passenger,0,1,1,118,119,0.84
May,31,2021,Snohomish,WA,Truck,1,0,1,126365,126366,0
May,31,2021,Grant,WA,Passenger,102,87,189,66863,67052,0.28
May,31,2021,Ulster,NY,Passenger,1,0,1,8,9,11.11
May,31,2021,Spokane,WA,Truck,0,0,0,102090,102090,0
May,31,2021,Shelby,OH,Passenger,0,1,1,1,2,50
May,31,2021,Tulsa,OK,Passenger,1,0,1,39,40,2.5
May,31,2021,Larimer,CO,Passenger,1,0,1,51,52,1.92
May,31,2021,Chesapeake,VA,Passenger,0,4,4,387,391,1.02
May,31,2021,Bradley,TN,Passenger,1,0,1,0,1,100
May,31,2021,King,WA,Passenger,30043,8922,38965,1368667,1407632,2.77
May,31,2021,Skamania,WA,Passenger,43,32,75,8395,8470,0.89
May,31,2021,Wilson,TX,Passenger,0,1,1,3,4,25
May,31,2021,Yamhill,OR,Passenger,1,0,1,36,37,2.7
May,31,2021,Pacific,WA,Passenger,43,47,90,16070,16160,0.56
May,31,2021,Douglas,CO,Passenger,0,1,1,74,75,1.33
May,31,2021,Hillsborough,FL,Passenger,0,1,1,152,153,0.65
May,31,2021,Sedgwick,KS,Passenger,0,1,1,86,87,1.15
May,31,2021,Whitman,WA,Passenger,60,44,104,22016,22120,0.47
May,31,2021,Kauai,HI,Passenger,1,0,1,16,17,5.88
May,31,2021,Suffolk,MA,Passenger,0,2,2,33,35,5.71
May,31,2021,Orange,FL,Passenger,1,0,1,108,109,0.92
May,31,2021,Fairbanks North Star,AK,Passenger,0,1,1,84,85,1.18
May,31,2021,Hudson,NJ,Passenger,1,0,1,41,42,2.38
May,31,2021,Hawaii,HI,Passenger,1,0,1,47,48,2.08
May,31,2021,Gwinnett,GA,Passenger,1,0,1,63,64,1.56
May,31,2021,Carroll,NH,Passenger,0,1,1,5,6,16.67
May,31,2021,Pacific,WA,Truck,0,0,0,7939,7939,0
May,31,2021,Anne Arundel,MD,Passenger,4,2,6,393,399,1.5
May,31,2021,Spartanburg,SC,Passenger,0,1,1,52,53,1.89
May,31,2021,St. Louis,MO,Passenger,1,0,1,81,82,1.22
May,31,2021,Clark,WA,Passenger,2757,1368,4125,321959,326084,1.27
May,31,2021,Richmond,NY,Passenger,1,0,1,9,10,10
May,31,2021,Collin,TX,Passenger,1,1,2,113,115,1.74
May,31,2021,Pima,AZ,Passenger,2,1,3,281,284,1.06
May,31,2021,Chelan,WA,Truck,0,0,0,23102,23102,0
May,31,2021,Grays Harbor,WA,Passenger,161,139,300,49369,49669,0.6
May,31,2021,Alexandria,VA,Passenger,2,0,2,130,132,1.52
May,31,2021,Whatcom,WA,Truck,4,0,4,43874,43878,0.01
May,31,2021,Frederick,MD,Passenger,1,1,2,67,69,2.9
May,31,2021,Stevens,WA,Truck,0,0,0,18957,18957,0
May,31,2021,Montgomery,TX,Passenger,1,1,2,43,45,4.44
November,30,2021,Whitman,WA,Passenger,66,58,124,21959,22083,0.56
November,30,2021,Klamath,OR,Passenger,1,0,1,28,29,3.45
November,30,2021,Nassau,NY,Passenger,2,0,2,24,26,7.69
November,30,2021,Penobscot,ME,Passenger,0,1,1,8,9,11.11
November,30,2021,Douglas,CO,Passenger,0,1,1,76,77,1.3
November,30,2021,Orange,CA,Passenger,5,2,7,384,391,1.79
November,30,2021,Platte,MO,Passenger,1,0,1,17,18,5.56
November,30,2021,Kauai,HI,Passenger,1,0,1,17,18,5.56
November,30,2021,Spokane,WA,Passenger,1262,748,2010,327064,329074,0.61
November,30,2021,Middlesex,MA,Passenger,1,1,2,84,86,2.33
November,30,2021,Suffolk,MA,Passenger,0,2,2,26,28,7.14
November,30,2021,Sevier,AR,Passenger,0,1,1,0,1,100
November,30,2021,Douglas,WA,Passenger,106,53,159,28610,28769,0.55
November,30,2021,Harrison,MS,Passenger,2,0,2,46,48,4.17
November,30,2021,Geary,KS,Passenger,1,0,1,96,97,1.03
November,30,2021,Orange,FL,Passenger,1,0,1,104,105,0.95
November,30,2021,Lake,IL,Passenger,3,0,3,152,155,1.94
November,30,2021,Benton,WA,Truck,0,0,0,43650,43650,0
November,30,2021,Riverside,CA,Passenger,5,1,6,502,508,1.18
November,30,2021,Hudson,NJ,Passenger,1,0,1,40,41,2.44
November,30,2021,Stafford,VA,Passenger,2,1,3,95,98,3.06
November,30,2021,Mason,WA,Passenger,255,158,413,47799,48212,0.86
November,30,2021,Lane,OR,Passenger,0,1,1,109,110,0.91
November,30,2021,Wilson,NC,Passenger,1,0,1,0,1,100
November,30,2021,Benton,WA,Passenger,625,435,1060,136011,137071,0.77
November,30,2021,Honolulu,HI,Passenger,4,3,7,356,363,1.93
November,30,2021,Salt Lake,UT,Passenger,0,1,1,155,156,0.64
November,30,2021,Vigo,IN,Passenger,1,0,1,5,6,16.67
November,30,2021,Santa Cruz,CA,Passenger,1,0,1,22,23,4.35
November,30,2021,Baltimore,MD,Passenger,1,0,1,83,84,1.19
November,30,2021,Travis,TX,Passenger,3,3,6,129,135,4.44
November,30,2021,Powhatan,VA,Passenger,1,0,1,1,2,50
November,30,2021,El Paso,CO,Passenger,3,0,3,653,656,0.46
November,30,2021,Sonoma,CA,Passenger,0,1,1,82,83,1.2
November,30,2021,Pennington,SD,Passenger,1,0,1,31,32,3.12
November,30,2021,Champaign,IL,Passenger,1,0,1,9,10,10
November,30,2021,Snohomish,WA,Truck,2,0,2,125685,125687,0
November,30,2021,Fort Bend,TX,Passenger,1,0,1,35,36,2.78
November,30,2021,Cook,IL,Passenger,2,0,2,192,194,1.03
November,30,2021,Pend Oreille,WA,Truck,0,0,0,5696,5696,0
November,30,2021,Sarpy,NE,Passenger,1,0,1,58,59,1.69
November,30,2021,Coryell,TX,Passenger,1,0,1,106,107,0.93
November,30,2021,Wahkiakum,WA,Truck,0,0,0,1817,1817,0
November,30,2021,Alexandria,VA,Passenger,2,0,2,118,120,1.67
November,30,2021,Stevens,WA,Passenger,54,43,97,30313,30410,0.32
November,30,2021,New Haven,CT,Passenger,0,2,2,27,29,6.9
November,30,2021,Suffolk,VA,Passenger,1,0,1,122,123,0.81
November,30,2021,Skamania,WA,Passenger,57,40,97,8344,8441,1.15
November,30,2021,San Juan,WA,Passenger,473,147,620,14195,14815,4.18
November,30,2021,Klickitat,WA,Truck,0,0,0,8335,8335,0
November,30,2021,Larimer,CO,Passenger,1,0,1,50,51,1.96
November,30,2021,Yakima,WA,Truck,0,0,0,61715,61715,0
November,30,2021,Yakima,WA,Passenger,272,167,439,168647,169086,0.26
November,30,2021,Island,WA,Passenger,701,342,1043,62971,64014,1.63
November,30,2021,Virginia Beach,VA,Passenger,2,0,2,569,571,0.35
November,30,2021,Harris,TX,Passenger,1,1,2,168,170,1.18
November,30,2021,San Mateo,CA,Passenger,2,0,2,79,81,2.47
November,30,2021,Kings,NY,Passenger,1,0,1,66,67,1.49
November,30,2021,Grant,WA,Passenger,131,97,228,66942,67170,0.34
November,30,2021,Miami-Dade,FL,Passenger,1,0,1,89,90,1.11
November,30,2021,Harnett,NC,Passenger,1,1,2,151,153,1.31
November,30,2021,Washington,MD,Passenger,2,0,2,14,16,12.5
November,30,2021,Columbia,WA,Passenger,6,2,8,2459,2467,0.32
November,30,2021,Collin,TX,Passenger,1,0,1,101,102,0.98
November,30,2021,Skagit,WA,Truck,1,0,1,32804,32805,0
November,30,2021,Kitsap,WA,Passenger,2083,941,3024,180487,183511,1.65
November,30,2021,Philadelphia,PA,Passenger,1,0,1,38,39,2.56
November,30,2021,Columbia,WA,Truck,0,0,0,1552,1552,0
November,30,2021,Kings,CA,Passenger,2,0,2,322,324,0.62
November,30,2021,St. Clair,IL,Passenger,2,0,2,120,122,1.64
November,30,2021,Jefferson,WA,Passenger,372,195,567,24790,25357,2.24
November,30,2021,Louisa,VA,Passenger,0,1,1,1,2,50
November,30,2021,Ferry,WA,Truck,0,0,0,3600,3600,0
November,30,2021,San Joaquin,CA,Passenger,1,1,2,95,97,2.06
November,30,2021,Flathead,MT,Passenger,1,0,1,40,41,2.44
November,30,2021,Rogers,OK,Passenger,1,0,1,3,4,25
November,30,2021,Jefferson,NY,Passenger,0,1,1,202,203,0.49
November,30,2021,San Francisco,CA,Passenger,0,1,1,80,81,1.23
November,30,2021,Lee,FL,Passenger,1,0,1,29,30,3.33
November,30,2021,DuPage,IL,Passenger,1,0,1,49,50,2
November,30,2021,Portsmouth,VA,Passenger,0,1,1,77,78,1.28
November,30,2021,Skamania,WA,Truck,0,0,0,4003,4003,0
November,30,2021,Dallas,TX,Passenger,1,0,1,143,144,0.69
November,30,2021,King,WA,Passenger,34716,10089,44805,1362899,1407704,3.18
November,30,2021,New London,CT,Passenger,1,4,5,212,217,2.3
November,30,2021,Goochland,VA,Passenger,3,2,5,187,192,2.6
November,30,2021,Fairbanks North Star,AK,Passenger,0,1,1,76,77,1.3
November,30,2021,Thurston,WA,Passenger,1845,949,2794,197125,199919,1.4
November,30,2021,Douglas,NE,Passenger,1,1,2,46,48,4.17
November,30,2021,Okanogan,WA,Truck,0,0,0,16689,16689,0
November,30,2021,San Diego,CA,Passenger,16,8,24,2436,2460,0.98
November,30,2021,Contra Costa,CA,Passenger,1,4,5,262,267,1.87
November,30,2021,Las Animas,CO,Passenger,1,0,1,0,1,100
November,30,2021,Whatcom,WA,Passenger,1611,660,2271,150227,152498,1.49
November,30,2021,Cumberland,NC,Passenger,1,2,3,395,398,0.75
November,30,2021,Boone,MO,Passenger,0,1,1,9,10,10
November,30,2021,San Juan,WA,Truck,0,0,0,5996,5996,0
November,30,2021,,,Passenger,13,7,20,1104,1124,1.78
November,30,2021,Milwaukee,WI,Passenger,1,0,1,36,37,2.7
November,30,2021,Pacific,WA,Truck,0,0,0,8004,8004,0
November,30,2021,Hillsborough,FL,Passenger,0,1,1,138,139,0.72
November,30,2021,Plaquemines,LA,Passenger,0,1,1,17,18,5.56
November,30,2021,Bexar,TX,Passenger,3,4,7,484,491,1.43
November,30,2021,Loudoun,VA,Passenger,1,0,1,66,67,1.49
November,30,2021,Erie,NY,Passenger,1,0,1,31,32,3.12
November,30,2021,Pinellas,FL,Passenger,0,1,1,87,88,1.14
November,30,2021,Kern,CA,Passenger,0,1,1,199,200,0.5
November,30,2021,Pierce,WA,Passenger,4130,2111,6241,557334,563575,1.11
November,30,2021,Williams,ND,Passenger,0,1,1,8,9,11.11
November,30,2021,Sedgwick,KS,Passenger,1,1,2,81,83,2.41
November,30,2021,Walla Walla,WA,Passenger,137,85,222,36395,36617,0.61
November,30,2021,St. Mary's,MD,Passenger,1,0,1,202,203,0.49
November,30,2021,Kittitas,WA,Truck,0,0,0,14805,14805,0
November,30,2021,Charleston,SC,Passenger,2,1,3,77,80,3.75
November,30,2021,Klickitat,WA,Passenger,88,52,140,15349,15489,0.9
November,30,2021,Cowlitz,WA,Truck,0,1,1,29027,29028,0
November,30,2021,El Paso,TX,Passenger,3,0,3,348,351,0.85
November,30,2021,Oldham,KY,Passenger,0,1,1,4,5,20
November,30,2021,Carroll,MD,Passenger,0,1,1,16,17,5.88
November,30,2021,Denton,TX,Passenger,1,0,1,75,76,1.32
November,30,2021,Broward,FL,Passenger,2,0,2,96,98,2.04
November,30,2021,Asotin,WA,Truck,0,0,0,6760,6760,0
November,30,2021,Houston,GA,Passenger,1,0,1,43,44,2.27
November,30,2021,Jefferson,WA,Truck,0,0,0,9601,9601,0
November,30,2021,Anne Arundel,MD,Passenger,4,3,7,357,364,1.92
November,30,2021,Hawaii,HI,Passenger,1,0,1,41,42,2.38
November,30,2021,Richmond,NY,Passenger,1,0,1,6,7,14.29
November,30,2021,Spartanburg,SC,Passenger,0,1,1,48,49,2.04
November,30,2021,Owyhee,ID,Passenger,1,0,1,2,3,33.33
November,30,2021,Lincoln,WA,Passenger,7,16,23,7693,7716,0.3
November,30,2021,Asotin,WA,Passenger,21,17,38,12753,12791,0.3
November,30,2021,Ulster,NY,Passenger,1,0,1,9,10,10
November,30,2021,Duval,FL,Passenger,0,2,2,322,324,0.62
November,30,2021,Fresno,CA,Passenger,1,0,1,156,157,0.64
November,30,2021,Sarasota,FL,Passenger,2,0,2,29,31,6.45
November,30,2021,Pima,AZ,Passenger,1,1,2,249,251,0.8
November,30,2021,Prince William,VA,Passenger,1,1,2,200,202,0.99
November,30,2021,Clackamas,OR,Passenger,2,0,2,162,164,1.22
November,30,2021,Maricopa,AZ,Passenger,8,2,10,1060,1070,0.93
November,30,2021,Saratoga,NY,Passenger,1,0,1,39,40,2.5
November,30,2021,RÃ­o Grande,PR,Passenger,1,0,1,0,1,100
November,30,2021,Montgomery,TX,Passenger,1,1,2,36,38,5.26
November,30,2021,Douglas,WA,Truck,0,0,0,12693,12693,0
November,30,2021,Monterey,CA,Passenger,0,1,1,137,138,0.72
November,30,2021,Nueces,TX,Passenger,1,0,1,64,65,1.54
November,30,2021,Franklin,WA,Truck,0,0,0,20782,20782,0
November,30,2021,Solano,CA,Passenger,1,0,1,175,176,0.57
November,30,2021,Norfolk,VA,Passenger,3,3,6,307,313,1.92
November,30,2021,Lake,FL,Passenger,1,0,1,22,23,4.35
November,30,2021,Wilson,TX,Passenger,0,1,1,2,3,33.33
November,30,2021,Sumter,SC,Passenger,0,1,1,34,35,2.86
November,30,2021,Garfield,WA,Truck,0,0,0,995,995,0
November,30,2021,Dorchester,SC,Passenger,1,0,1,63,64,1.56
November,30,2021,Ventura,CA,Passenger,2,1,3,246,249,1.2
November,30,2021,Pend Oreille,WA,Passenger,18,7,25,9167,9192,0.27
November,30,2021,Lewis,WA,Passenger,199,163,362,59631,59993,0.6
November,30,2021,Multnomah,OR,Passenger,2,6,8,612,620,1.29
November,30,2021,St. Louis,MO,Passenger,1,0,1,71,72,1.39
November,30,2021,Lewis,WA,Truck,0,0,0,26719,26719,0
November,30,2021,Carson City,NV,Passenger,1,0,1,8,9,11.11
November,30,2021,Placer,CA,Passenger,2,0,2,70,72,2.78
November,30,2021,Burlington,NJ,Passenger,0,1,1,120,121,0.83
November,30,2021,Clark,WA,Truck,0,0,0,84070,84070,0
November,30,2021,Leavenworth,KS,Passenger,0,1,1,107,108,0.93
November,30,2021,Hidalgo,TX,Passenger,0,1,1,53,54,1.85
November,30,2021,Hamilton,IN,Passenger,2,0,2,28,30,6.67
November,30,2021,Albemarle,VA,Passenger,1,0,1,19,20,5
November,30,2021,Wahkiakum,WA,Passenger,17,10,27,3091,3118,0.87
November,30,2021,Stevens,WA,Truck,0,0,0,18924,18924,0
November,30,2021,Juneau,AK,Passenger,0,1,1,27,28,3.57
November,30,2021,Alameda,CA,Passenger,4,0,4,211,215,1.86
November,30,2021,Randolph,NC,Passenger,1,0,1,5,6,16.67
November,30,2021,Snohomish,WA,Passenger,6837,2229,9066,538413,547479,1.66
November,30,2021,Cowlitz,WA,Passenger,265,159,424,71773,72197,0.59
November,30,2021,Kitsap,WA,Truck,0,0,0,54275,54275,0
November,30,2021,Calvert,MD,Passenger,0,2,2,82,84,2.38
November,30,2021,Walla Walla,WA,Truck,0,0,0,14078,14078,0
November,30,2021,Rockdale,GA,Passenger,1,0,1,7,8,12.5
November,30,2021,San Luis Obispo,CA,Passenger,1,0,1,57,58,1.72
November,30,2021,Grays Harbor,WA,Truck,0,0,0,21428,21428,0
November,30,2021,Montgomery,PA,Passenger,2,0,2,21,23,8.7
November,30,2021,Adams,WA,Truck,0,0,0,5421,5421,0
November,30,2021,Hamilton,OH,Passenger,1,0,1,32,33,3.03
November,30,2021,Santa Clara,CA,Passenger,7,1,8,230,238,3.36
November,30,2021,Escambia,FL,Passenger,0,1,1,138,139,0.72
November,30,2021,Manassas,VA,Passenger,0,1,1,7,8,12.5
November,30,2021,Anchorage,AK,Passenger,1,0,1,124,125,0.8
November,30,2021,Whatcom,WA,Truck,4,0,4,43702,43706,0.01
November,30,2021,Shelby,OH,Passenger,0,1,1,2,3,33.33
November,30,2021,District of Columbia,DC,Passenger,5,0,5,191,196,2.55
November,30,2021,Gwinnett,GA,Passenger,1,0,1,58,59,1.69
November,30,2021,Marin,CA,Passenger,0,1,1,33,34,2.94
November,30,2021,Thurston,WA,Truck,0,0,0,56178,56178,0
November,30,2021,Clark,WA,Passenger,3363,1536,4899,320835,325734,1.5
November,30,2021,Los Angeles,CA,Passenger,10,7,17,832,849,2
November,30,2021,Lincoln,WA,Truck,0,0,0,4811,4811,0
November,30,2021,Clark,NV,Passenger,4,2,6,558,564,1.06
November,30,2021,Carroll,NH,Passenger,0,1,1,5,6,16.67
November,30,2021,DeKalb,GA,Passenger,1,0,1,56,57,1.75
November,30,2021,Camden,NJ,Passenger,0,1,1,14,15,6.67
November,30,2021,Okanogan,WA,Passenger,67,43,110,26601,26711,0.41
November,30,2021,Clallam,WA,Passenger,372,238,610,50508,51118,1.19
November,30,2021,Sacramento,CA,Passenger,2,0,2,216,218,0.92
November,30,2021,Spokane,WA,Truck,0,0,0,102699,102699,0
November,30,2021,Washington,OR,Passenger,1,0,1,348,349,0.29
November,30,2021,Whitman,WA,Truck,0,0,0,8556,8556,0
November,30,2021,Chelan,WA,Passenger,400,113,513,54703,55216,0.93
November,30,2021,Saginaw,MI,Passenger,1,0,1,5,6,16.67
November,30,2021,King,WA,Truck,6,1,7,183330,183337,0
November,30,2021,Polk,FL,Passenger,1,0,1,55,56,1.79
November,30,2021,Essex,NJ,Passenger,2,0,2,10,12,16.67
November,30,2021,Wood,OH,Passenger,0,1,1,5,6,16.67
November,30,2021,Onslow,NC,Passenger,0,1,1,169,170,0.59
November,30,2021,Frederick,MD,Passenger,1,1,2,69,71,2.82
November,30,2021,Rockingham,NH,Passenger,1,0,1,19,20,5
November,30,2021,Ray,MO,Passenger,0,1,1,1,2,50
November,30,2021,Island,WA,Truck,0,0,0,21547,21547,0
November,30,2021,Richmond,GA,Passenger,0,1,1,71,72,1.39
November,30,2021,Adams,WA,Passenger,16,14,30,13044,13074,0.23
November,30,2021,Franklin,WA,Passenger,154,103,257,62279,62536,0.41
November,30,2021,Skagit,WA,Passenger,667,299,966,91301,92267,1.05
November,30,2021,Ferry,WA,Passenger,13,3,16,4457,4473,0.36
November,30,2021,Yamhill,OR,Passenger,1,0,1,32,33,3.03
November,30,2021,Bartow,GA,Passenger,0,1,1,3,4,25
November,30,2021,Grays Harbor,WA,Passenger,191,155,346,49503,49849,0.69
November,30,2021,San Bernardino,CA,Passenger,0,1,1,363,364,0.27
November,30,2021,Moore,NC,Passenger,0,1,1,121,122,0.82
November,30,2021,Williamson,TX,Passenger,1,2,3,93,96,3.12
November,30,2021,Howard,IN,Passenger,0,1,1,6,7,14.29
November,30,2021,Fairfax,VA,Passenger,3,4,7,656,663,1.06
November,30,2021,Allegheny,PA,Passenger,1,1,2,59,61,3.28
November,30,2021,Allen,IN,Passenger,1,0,1,14,15,6.67
November,30,2021,Tarrant,TX,Passenger,1,0,1,129,130,0.77
November,30,2021,Danville,VA,Passenger,1,0,1,0,1,100
November,30,2021,Pierce,WA,Truck,0,0,0,145138,145138,0
November,30,2021,Hennepin,MN,Passenger,3,0,3,65,68,4.41
November,30,2021,Kittitas,WA,Passenger,196,75,271,29843,30114,0.9
November,30,2021,Pacific,WA,Passenger,51,64,115,16071,16186,0.71
November,30,2021,Bernalillo,NM,Passenger,1,0,1,109,110,0.91
November,30,2021,Prince George's,MD,Passenger,2,1,3,141,144,2.08
November,30,2021,Clallam,WA,Truck,1,0,1,22115,22116,0
November,30,2021,Mason,WA,Truck,0,0,0,21254,21254,0
November,30,2021,Grant,WA,Truck,0,0,0,28045,28045,0
November,30,2021,Chesapeake,VA,Passenger,2,3,5,373,378,1.32
November,30,2021,Arlington,VA,Passenger,1,1,2,127,129,1.55
November,30,2021,Charles,MD,Passenger,1,1,2,67,69,2.9
November,30,2021,Okaloosa,FL,Passenger,0,1,1,109,110,0.91
November,30,2021,New York,NY,Passenger,1,0,1,37,38,2.63
November,30,2021,Chelan,WA,Truck,0,0,0,23094,23094,0
November,30,2021,Garfield,WA,Passenger,0,3,3,1350,1353,0.22
November,30,2021,Montgomery,MD,Passenger,3,2,5,203,208,2.4
November,30,2021,Queens,NY,Passenger,1,0,1,46,47,2.13
November,30,2021,Howard,MD,Passenger,0,1,1,54,55,1.82
November,30,2021,Cape May,NJ,Passenger,0,1,1,8,9,11.11
November,30,2021,Wichita,TX,Passenger,1,0,1,42,43,2.33
November,30,2021,Greene,MO,Passenger,0,1,1,25,26,3.85
November,30,2021,Richland,SC,Passenger,0,1,1,130,131,0.76
November,30,2021,Boulder,CO,Passenger,1,1,2,37,39,5.13
November,30,2021,Wake,NC,Passenger,1,0,1,108,109,0.92
October,31,2021,Clark,NV,Passenger,4,2,6,573,579,1.04
October,31,2021,St. Mary's,MD,Passenger,1,0,1,203,204,0.49
October,31,2021,,,Passenger,11,7,18,1103,1121,1.61
October,31,2021,Kitsap,WA,Passenger,2042,916,2958,180643,183601,1.61
October,31,2021,Ferry,WA,Passenger,11,3,14,4446,4460,0.31
October,31,2021,Milwaukee,WI,Passenger,1,0,1,36,37,2.7
October,31,2021,Richmond,GA,Passenger,0,1,1,71,72,1.39
October,31,2021,Stafford,VA,Passenger,2,1,3,96,99,3.03
October,31,2021,Monterey,CA,Passenger,0,1,1,142,143,0.7
October,31,2021,Carroll,NH,Passenger,0,1,1,5,6,16.67
October,31,2021,Snohomish,WA,Truck,2,0,2,125795,125797,0
October,31,2021,Stevens,WA,Truck,0,0,0,18891,18891,0
October,31,2021,Juneau,AK,Passenger,0,1,1,27,28,3.57
October,31,2021,Island,WA,Truck,0,0,0,21569,21569,0
October,31,2021,Fairbanks North Star,AK,Passenger,0,1,1,77,78,1.28
October,31,2021,Rockdale,GA,Passenger,1,0,1,7,8,12.5
October,31,2021,Chelan,WA,Truck,0,0,0,23075,23075,0
October,31,2021,Walla Walla,WA,Passenger,132,82,214,36363,36577,0.59
October,31,2021,Las Animas,CO,Passenger,1,0,1,0,1,100
October,31,2021,Grays Harbor,WA,Truck,0,0,0,21396,21396,0
October,31,2021,Klickitat,WA,Passenger,87,51,138,15357,15495,0.89
October,31,2021,Ventura,CA,Passenger,2,1,3,248,251,1.2
October,31,2021,Cowlitz,WA,Truck,0,1,1,29069,29070,0
October,31,2021,Grant,WA,Passenger,133,95,228,66824,67052,0.34
October,31,2021,Whatcom,WA,Truck,4,0,4,43778,43782,0.01
October,31,2021,Champaign,IL,Passenger,1,0,1,10,11,9.09
October,31,2021,Fresno,CA,Passenger,1,0,1,160,161,0.62
October,31,2021,Montgomery,PA,Passenger,2,0,2,23,25,8
October,31,2021,Harrison,MS,Passenger,2,0,2,48,50,4
October,31,2021,Hudson,NJ,Passenger,1,0,1,41,42,2.38
October,31,2021,Hawaii,HI,Passenger,1,0,1,41,42,2.38
October,31,2021,Montgomery,TX,Passenger,1,1,2,37,39,5.13
October,31,2021,Suffolk,VA,Passenger,1,0,1,122,123,0.81
October,31,2021,Yamhill,OR,Passenger,1,0,1,32,33,3.03
October,31,2021,DeKalb,GA,Passenger,1,0,1,56,57,1.75
October,31,2021,Asotin,WA,Passenger,21,17,38,12770,12808,0.3
October,31,2021,Grant,WA,Truck,0,0,0,28018,28018,0
October,31,2021,Wahkiakum,WA,Passenger,17,8,25,3065,3090,0.81
October,31,2021,Fairfax,VA,Passenger,4,4,8,664,672,1.19
October,31,2021,Portsmouth,VA,Passenger,0,1,1,77,78,1.28
October,31,2021,Harnett,NC,Passenger,1,1,2,153,155,1.29
October,31,2021,Hillsborough,FL,Passenger,0,1,1,142,143,0.7
October,31,2021,Arlington,VA,Passenger,1,1,2,128,130,1.54
October,31,2021,Lewis,WA,Passenger,194,158,352,59631,59983,0.59
October,31,2021,Adams,WA,Truck,0,0,0,5409,5409,0
October,31,2021,Lake,IL,Passenger,3,0,3,154,157,1.91
October,31,2021,Honolulu,HI,Passenger,5,3,8,363,371,2.16
October,31,2021,Whatcom,WA,Passenger,1581,646,2227,150431,152658,1.46
October,31,2021,Orange,FL,Passenger,1,0,1,107,108,0.93
October,31,2021,Rogers,OK,Passenger,1,0,1,3,4,25
October,31,2021,Penobscot,ME,Passenger,0,1,1,8,9,11.11
October,31,2021,Pacific,WA,Truck,0,0,0,7990,7990,0
October,31,2021,Washington,MD,Passenger,2,0,2,13,15,13.33
October,31,2021,Sarpy,NE,Passenger,1,0,1,58,59,1.69
October,31,2021,Yakima,WA,Passenger,270,165,435,168835,169270,0.26
October,31,2021,Goochland,VA,Passenger,3,2,5,197,202,2.48
October,31,2021,Pierce,WA,Passenger,4001,2085,6086,557924,564010,1.08
October,31,2021,Columbia,WA,Passenger,7,2,9,2439,2448,0.37
October,31,2021,Clark,WA,Truck,0,0,0,84034,84034,0
October,31,2021,Harris,TX,Passenger,1,1,2,170,172,1.16
October,31,2021,Pend Oreille,WA,Passenger,18,7,25,9206,9231,0.27
October,31,2021,Wichita,TX,Passenger,1,0,1,43,44,2.27
October,31,2021,Snohomish,WA,Passenger,6655,2197,8852,538791,547643,1.62
October,31,2021,Montgomery,OH,Passenger,0,1,1,53,54,1.85
October,31,2021,Carson City,NV,Passenger,1,0,1,10,11,9.09
October,31,2021,Middlesex,MA,Passenger,1,1,2,86,88,2.27
October,31,2021,King,WA,Passenger,33841,9915,43756,1363940,1407696,3.11
October,31,2021,Jefferson,WA,Passenger,362,191,553,24778,25331,2.18
October,31,2021,Placer,CA,Passenger,2,0,2,71,73,2.74
October,31,2021,Klickitat,WA,Truck,0,0,0,8316,8316,0
October,31,2021,Charles,MD,Passenger,1,1,2,68,70,2.86
October,31,2021,Boone,MO,Passenger,0,1,1,9,10,10
October,31,2021,Sedgwick,KS,Passenger,1,1,2,79,81,2.47
October,31,2021,Shelby,OH,Passenger,0,1,1,2,3,33.33
October,31,2021,Riverside,CA,Passenger,5,1,6,514,520,1.15
October,31,2021,Larimer,CO,Passenger,1,0,1,49,50,2
October,31,2021,Charleston,SC,Passenger,2,1,3,79,82,3.66
October,31,2021,Douglas,CO,Passenger,0,1,1,75,76,1.32
October,31,2021,Garfield,WA,Passenger,0,3,3,1355,1358,0.22
October,31,2021,Cook,IL,Passenger,2,0,2,195,197,1.02
October,31,2021,Ulster,NY,Passenger,1,0,1,9,10,10
October,31,2021,Lewis,WA,Truck,0,0,0,26738,26738,0
October,31,2021,Island,WA,Passenger,679,333,1012,63091,64103,1.58
October,31,2021,Saratoga,NY,Passenger,1,0,1,41,42,2.38
October,31,2021,Sacramento,CA,Passenger,2,0,2,215,217,0.92
October,31,2021,Clark,WA,Passenger,3253,1514,4767,321077,325844,1.46
October,31,2021,Wilson,TX,Passenger,0,1,1,2,3,33.33
October,31,2021,Hamilton,IN,Passenger,2,0,2,28,30,6.67
October,31,2021,Lincoln,WA,Passenger,7,16,23,7707,7730,0.3
October,31,2021,Salt Lake,UT,Passenger,0,1,1,158,159,0.63
October,31,2021,Richland,SC,Passenger,0,1,1,129,130,0.77
October,31,2021,Douglas,WA,Passenger,103,51,154,28576,28730,0.54
October,31,2021,Powhatan,VA,Passenger,1,0,1,1,2,50
October,31,2021,Broward,FL,Passenger,2,0,2,97,99,2.02
October,31,2021,Greene,MO,Passenger,0,1,1,26,27,3.7
October,31,2021,Houston,GA,Passenger,1,0,1,44,45,2.22
October,31,2021,Hidalgo,TX,Passenger,0,1,1,54,55,1.82
October,31,2021,Burlington,NJ,Passenger,0,1,1,120,121,0.83
October,31,2021,Chesapeake,VA,Passenger,1,3,4,376,380,1.05
October,31,2021,St. Clair,IL,Passenger,2,0,2,123,125,1.6
October,31,2021,Whitman,WA,Truck,0,0,0,8556,8556,0
October,31,2021,Geary,KS,Passenger,1,0,1,96,97,1.03
October,31,2021,Sumter,SC,Passenger,0,1,1,36,37,2.7
October,31,2021,Tarrant,TX,Passenger,1,0,1,136,137,0.73
October,31,2021,Escambia,FL,Passenger,0,1,1,139,140,0.71
October,31,2021,Spartanburg,SC,Passenger,0,1,1,48,49,2.04
October,31,2021,Kittitas,WA,Passenger,193,72,265,29844,30109,0.88
October,31,2021,Manassas,VA,Passenger,0,1,1,7,8,12.5
October,31,2021,Spokane,WA,Truck,0,0,0,102587,102587,0
October,31,2021,Williamson,TX,Passenger,1,2,3,97,100,3
October,31,2021,Cape May,NJ,Passenger,0,1,1,8,9,11.11
October,31,2021,New York,NY,Passenger,1,0,1,37,38,2.63
October,31,2021,Duval,FL,Passenger,0,2,2,321,323,0.62
October,31,2021,Mason,WA,Passenger,246,156,402,47894,48296,0.83
October,31,2021,Howard,IN,Passenger,0,1,1,6,7,14.29
October,31,2021,Rockingham,NH,Passenger,1,0,1,19,20,5
October,31,2021,Cumberland,NC,Passenger,0,2,2,399,401,0.5
October,31,2021,Pima,AZ,Passenger,1,1,2,251,253,0.79
October,31,2021,Nueces,TX,Passenger,1,0,1,64,65,1.54
October,31,2021,Cowlitz,WA,Passenger,258,154,412,71857,72269,0.57
October,31,2021,New London,CT,Passenger,1,4,5,212,217,2.3
October,31,2021,Fort Bend,TX,Passenger,1,0,1,35,36,2.78
October,31,2021,Missoula,MT,Passenger,1,0,1,52,53,1.89
October,31,2021,Wake,NC,Passenger,1,0,1,112,113,0.88
October,31,2021,Sonoma,CA,Passenger,0,1,1,82,83,1.2
October,31,2021,Denton,TX,Passenger,1,0,1,76,77,1.3
October,31,2021,Lee,FL,Passenger,1,0,1,33,34,2.94
October,31,2021,Richmond,NY,Passenger,1,0,1,6,7,14.29
October,31,2021,Franklin,WA,Passenger,144,102,246,62082,62328,0.39
October,31,2021,Baltimore,MD,Passenger,1,0,1,86,87,1.15
October,31,2021,RÃ­o Grande,PR,Passenger,1,0,1,0,1,100
October,31,2021,Multnomah,OR,Passenger,2,6,8,622,630,1.27
October,31,2021,Skamania,WA,Truck,0,0,0,4019,4019,0
October,31,2021,Solano,CA,Passenger,1,0,1,177,178,0.56
October,31,2021,Calvert,MD,Passenger,0,2,2,83,85,2.35
October,31,2021,Onslow,NC,Passenger,0,1,1,170,171,0.58
October,31,2021,Douglas,NE,Passenger,1,1,2,49,51,3.92
October,31,2021,Williams,ND,Passenger,0,1,1,8,9,11.11
October,31,2021,Thurston,WA,Passenger,1803,921,2724,197240,199964,1.36
October,31,2021,Clallam,WA,Truck,1,0,1,22063,22064,0
October,31,2021,Clackamas,OR,Passenger,2,0,2,165,167,1.2
October,31,2021,Kings,CA,Passenger,2,0,2,322,324,0.62
October,31,2021,Saginaw,MI,Passenger,1,0,1,5,6,16.67
October,31,2021,Pacific,WA,Passenger,49,59,108,16114,16222,0.67
October,31,2021,Platte,MO,Passenger,1,0,1,17,18,5.56
October,31,2021,Clallam,WA,Passenger,365,235,600,50522,51122,1.17
October,31,2021,Whitman,WA,Passenger,63,58,121,21932,22053,0.55
October,31,2021,Garfield,WA,Truck,0,0,0,999,999,0
October,31,2021,Sevier,AR,Passenger,0,1,1,0,1,100
October,31,2021,Moore,NC,Passenger,0,1,1,123,124,0.81
October,31,2021,Columbia,WA,Truck,0,0,0,1537,1537,0
October,31,2021,San Joaquin,CA,Passenger,1,1,2,96,98,2.04
October,31,2021,Kern,CA,Passenger,0,1,1,196,197,0.51
October,31,2021,San Luis Obispo,CA,Passenger,1,0,1,58,59,1.69
October,31,2021,Suffolk,MA,Passenger,0,2,2,27,29,6.9
October,31,2021,Anne Arundel,MD,Passenger,4,3,7,363,370,1.89
October,31,2021,Alexandria,VA,Passenger,2,0,2,122,124,1.61
October,31,2021,Wahkiakum,WA,Truck,0,0,0,1827,1827,0
October,31,2021,San Juan,WA,Truck,0,0,0,5976,5976,0
October,31,2021,Montgomery,MD,Passenger,3,2,5,206,211,2.37
October,31,2021,Pierce,WA,Truck,0,0,0,145249,145249,0
October,31,2021,Bexar,TX,Passenger,3,5,8,489,497,1.61
October,31,2021,Erie,NY,Passenger,1,0,1,31,32,3.12
October,31,2021,Allegheny,PA,Passenger,1,1,2,60,62,3.23
October,31,2021,Loudoun,VA,Passenger,1,0,1,67,68,1.47
October,31,2021,Frederick,MD,Passenger,1,1,2,69,71,2.82
October,31,2021,Pend Oreille,WA,Truck,0,0,0,5687,5687,0
October,31,2021,Jefferson,WA,Truck,0,0,0,9592,9592,0
October,31,2021,Kitsap,WA,Truck,0,0,0,54245,54245,0
October,31,2021,Asotin,WA,Truck,0,0,0,6748,6748,0
October,31,2021,New Haven,CT,Passenger,0,2,2,28,30,6.67
October,31,2021,Mason,WA,Truck,0,0,0,21283,21283,0
October,31,2021,Coryell,TX,Passenger,1,0,1,108,109,0.92
October,31,2021,Randolph,NC,Passenger,1,0,1,5,6,16.67
October,31,2021,Hamilton,OH,Passenger,1,0,1,33,34,2.94
October,31,2021,Los Angeles,CA,Passenger,7,9,16,833,849,1.88
October,31,2021,Okanogan,WA,Passenger,66,44,110,26572,26682,0.41
October,31,2021,Kings,NY,Passenger,1,0,1,70,71,1.41
October,31,2021,Douglas,WA,Truck,0,0,0,12679,12679,0
October,31,2021,Collin,TX,Passenger,1,0,1,100,101,0.99
October,31,2021,Benton,WA,Truck,0,0,0,43707,43707,0
October,31,2021,Flathead,MT,Passenger,1,0,1,43,44,2.27
October,31,2021,Pinellas,FL,Passenger,0,1,1,89,90,1.11
October,31,2021,Okaloosa,FL,Passenger,0,1,1,112,113,0.88
October,31,2021,Benton,WA,Passenger,595,426,1021,136009,137030,0.75
October,31,2021,Skamania,WA,Passenger,58,39,97,8335,8432,1.15
October,31,2021,Franklin,WA,Truck,0,0,0,20773,20773,0
October,31,2021,Vigo,IN,Passenger,1,0,1,5,6,16.67
October,31,2021,San Juan,WA,Passenger,469,146,615,14189,14804,4.15
October,31,2021,Grays Harbor,WA,Passenger,187,151,338,49486,49824,0.68
October,31,2021,Dorchester,SC,Passenger,1,0,1,65,66,1.52
October,31,2021,San Francisco,CA,Passenger,0,1,1,81,82,1.22
October,31,2021,Nassau,NY,Passenger,2,0,2,25,27,7.41
October,31,2021,Ferry,WA,Truck,0,0,0,3592,3592,0
October,31,2021,El Paso,TX,Passenger,3,0,3,349,352,0.85
October,31,2021,Thurston,WA,Truck,0,0,0,56195,56195,0
October,31,2021,Albemarle,VA,Passenger,1,0,1,19,20,5
October,31,2021,Owyhee,ID,Passenger,1,0,1,2,3,33.33
October,31,2021,Contra Costa,CA,Passenger,1,4,5,264,269,1.86
October,31,2021,Santa Clara,CA,Passenger,7,2,9,237,246,3.66
October,31,2021,Carroll,MD,Passenger,0,1,1,16,17,5.88
October,31,2021,Washington,OR,Passenger,1,0,1,355,356,0.28
October,31,2021,Allen,IN,Passenger,1,0,1,15,16,6.25
October,31,2021,Walla Walla,WA,Truck,0,0,0,14050,14050,0
October,31,2021,Alameda,CA,Passenger,4,0,4,212,216,1.85
October,31,2021,Klamath,OR,Passenger,1,0,1,28,29,3.45
October,31,2021,Queens,NY,Passenger,1,0,1,44,45,2.22
October,31,2021,Philadelphia,PA,Passenger,1,0,1,40,41,2.44
October,31,2021,Skagit,WA,Truck,1,0,1,32836,32837,0
October,31,2021,Yakima,WA,Truck,0,0,0,61670,61670,0
October,31,2021,Adams,WA,Passenger,16,14,30,13034,13064,0.23
October,31,2021,Hennepin,MN,Passenger,3,0,3,69,72,4.17
October,31,2021,Miami-Dade,FL,Passenger,1,0,1,94,95,1.05
October,31,2021,Louisa,VA,Passenger,0,1,1,1,2,50
October,31,2021,Anchorage,AK,Passenger,1,0,1,130,131,0.76
October,31,2021,Prince William,VA,Passenger,1,1,2,201,203,0.99
October,31,2021,Boulder,CO,Passenger,1,1,2,37,39,5.13
October,31,2021,Polk,FL,Passenger,1,0,1,53,54,1.85
October,31,2021,Sarasota,FL,Passenger,2,0,2,30,32,6.25
October,31,2021,Essex,NJ,Passenger,2,0,2,10,12,16.67
October,31,2021,District of Columbia,DC,Passenger,5,0,5,193,198,2.53
October,31,2021,Orange,CA,Passenger,5,2,7,389,396,1.77
October,31,2021,King,WA,Truck,4,1,5,183489,183494,0
October,31,2021,Stevens,WA,Passenger,52,43,95,30243,30338,0.31
October,31,2021,Howard,MD,Passenger,0,1,1,54,55,1.82
October,31,2021,Camden,NJ,Passenger,0,1,1,14,15,6.67
October,31,2021,Pennington,SD,Passenger,1,0,1,30,31,3.23
October,31,2021,Bartow,GA,Passenger,0,1,1,3,4,25
October,31,2021,Skagit,WA,Passenger,649,295,944,91478,92422,1.02
October,31,2021,Spokane,WA,Passenger,1218,727,1945,326533,328478,0.59
October,31,2021,Bernalillo,NM,Passenger,1,0,1,111,112,0.89
October,31,2021,Kittitas,WA,Truck,0,0,0,14773,14773,0
October,31,2021,Leavenworth,KS,Passenger,0,1,1,108,109,0.92
October,31,2021,Chelan,WA,Passenger,385,110,495,54679,55174,0.9
October,31,2021,Lane,OR,Passenger,0,1,1,114,115,0.87
October,31,2021,Gwinnett,GA,Passenger,1,0,1,58,59,1.69
October,31,2021,Wilson,NC,Passenger,1,0,1,0,1,100
October,31,2021,Kauai,HI,Passenger,1,0,1,17,18,5.56
October,31,2021,Travis,TX,Passenger,3,3,6,132,138,4.35
October,31,2021,Oldham,KY,Passenger,0,1,1,4,5,20
October,31,2021,Jefferson,NY,Passenger,0,1,1,206,207,0.48
October,31,2021,Santa Cruz,CA,Passenger,1,0,1,25,26,3.85
October,31,2021,Lincoln,WA,Truck,0,0,0,4804,4804,0
October,31,2021,San Diego,CA,Passenger,16,8,24,2467,2491,0.96
October,31,2021,Virginia Beach,VA,Passenger,2,0,2,576,578,0.35
October,31,2021,DuPage,IL,Passenger,1,0,1,50,51,1.96
October,31,2021,Norfolk,VA,Passenger,3,3,6,312,318,1.89
October,31,2021,Ray,MO,Passenger,0,1,1,1,2,50
October,31,2021,Okanogan,WA,Truck,0,0,0,16678,16678,0
October,31,2021,El Paso,CO,Passenger,3,0,3,655,658,0.46
October,31,2021,San Mateo,CA,Passenger,2,0,2,83,85,2.35
October,31,2021,Danville,VA,Passenger,1,0,1,0,1,100
October,31,2021,Maricopa,AZ,Passenger,8,2,10,1080,1090,0.92
October,31,2021,St. Louis,MO,Passenger,1,0,1,72,73,1.37
October,31,2021,Lake,FL,Passenger,1,0,1,22,23,4.35
October,31,2021,Prince George's,MD,Passenger,2,1,3,138,141,2.13
October,31,2021,Plaquemines,LA,Passenger,0,1,1,17,18,5.56
October,31,2021,Dallas,TX,Passenger,1,0,1,144,145,0.69
September,30,2021,Rogers,OK,Passenger,1,0,1,3,4,25
September,30,2021,Walla Walla,WA,Truck,0,0,0,14076,14076,0
September,30,2021,Hennepin,MN,Passenger,3,0,3,71,74,4.05
September,30,2021,Nueces,TX,Passenger,1,0,1,65,66,1.52
September,30,2021,Baltimore,MD,Passenger,1,0,1,90,91,1.1
September,30,2021,Fort Bend,TX,Passenger,1,0,1,37,38,2.63
September,30,2021,Montgomery,OH,Passenger,0,1,1,56,57,1.75
September,30,2021,Lewis,WA,Truck,0,0,0,26704,26704,0
September,30,2021,Grant,WA,Passenger,125,97,222,66876,67098,0.33
September,30,2021,Houston,GA,Passenger,1,0,1,44,45,2.22
September,30,2021,Saratoga,NY,Passenger,1,0,1,42,43,2.33
September,30,2021,Calvert,MD,Passenger,0,2,2,85,87,2.3
September,30,2021,Arlington,VA,Passenger,1,1,2,132,134,1.49
September,30,2021,Orange,CA,Passenger,5,2,7,397,404,1.73
September,30,2021,Okaloosa,FL,Passenger,0,1,1,110,111,0.9
September,30,2021,,,Passenger,11,7,18,1102,1120,1.61
September,30,2021,Philadelphia,PA,Passenger,1,0,1,43,44,2.27
September,30,2021,St. Louis,MO,Passenger,1,0,1,78,79,1.27
September,30,2021,Sedgwick,KS,Passenger,1,1,2,81,83,2.41
September,30,2021,Loudoun,VA,Passenger,1,0,1,70,71,1.41
September,30,2021,Suffolk,MA,Passenger,0,2,2,27,29,6.9
September,30,2021,Oldham,KY,Passenger,0,1,1,4,5,20
September,30,2021,Skagit,WA,Truck,1,0,1,32933,32934,0
September,30,2021,Cowlitz,WA,Truck,0,1,1,29037,29038,0
September,30,2021,Multnomah,OR,Passenger,2,6,8,623,631,1.27
September,30,2021,Flathead,MT,Passenger,1,0,1,43,44,2.27
September,30,2021,San Diego,CA,Passenger,16,8,24,2494,2518,0.95
September,30,2021,Shelby,OH,Passenger,0,1,1,2,3,33.33
September,30,2021,Hillsborough,FL,Passenger,0,1,1,144,145,0.69
September,30,2021,Vigo,IN,Passenger,1,0,1,5,6,16.67
September,30,2021,Walla Walla,WA,Passenger,128,82,210,36440,36650,0.57
September,30,2021,Leavenworth,KS,Passenger,0,1,1,112,113,0.88
September,30,2021,Duval,FL,Passenger,0,2,2,325,327,0.61
September,30,2021,Frederick,MD,Passenger,1,1,2,68,70,2.86
September,30,2021,Sacramento,CA,Passenger,2,0,2,218,220,0.91
September,30,2021,El Paso,TX,Passenger,3,0,3,355,358,0.84
September,30,2021,Kittitas,WA,Truck,0,0,0,14782,14782,0
September,30,2021,Sonoma,CA,Passenger,0,1,1,82,83,1.2
September,30,2021,Mason,WA,Passenger,239,151,390,47982,48372,0.81
September,30,2021,Columbia,WA,Passenger,7,2,9,2451,2460,0.37
September,30,2021,Travis,TX,Passenger,3,3,6,134,140,4.29
September,30,2021,Erie,NY,Passenger,1,0,1,32,33,3.03
September,30,2021,Franklin,WA,Passenger,138,100,238,62127,62365,0.38
September,30,2021,Clackamas,OR,Passenger,2,0,2,163,165,1.21
September,30,2021,Yakima,WA,Passenger,257,164,421,168958,169379,0.25
September,30,2021,Broward,FL,Passenger,2,0,2,99,101,1.98
September,30,2021,Goochland,VA,Passenger,3,2,5,202,207,2.42
September,30,2021,Clark,NV,Passenger,4,2,6,584,590,1.02
September,30,2021,Saginaw,MI,Passenger,1,0,1,5,6,16.67
September,30,2021,Skagit,WA,Passenger,641,291,932,91682,92614,1.01
September,30,2021,Clark,WA,Passenger,3150,1486,4636,321804,326440,1.42
September,30,2021,Ferry,WA,Passenger,10,3,13,4403,4416,0.29
September,30,2021,Essex,NJ,Passenger,2,0,2,10,12,16.67
September,30,2021,Owyhee,ID,Passenger,1,0,1,2,3,33.33
September,30,2021,Douglas,WA,Passenger,103,51,154,28572,28726,0.54
September,30,2021,Chelan,WA,Truck,0,0,0,23103,23103,0
September,30,2021,Suffolk,VA,Passenger,1,0,1,126,127,0.79
September,30,2021,Geary,KS,Passenger,1,0,1,97,98,1.02
September,30,2021,Louisa,VA,Passenger,0,1,1,1,2,50
September,30,2021,Wahkiakum,WA,Passenger,16,8,24,3071,3095,0.78
September,30,2021,Pierce,WA,Truck,0,0,0,145459,145459,0
September,30,2021,RÃ­o Grande,PR,Passenger,1,0,1,0,1,100
September,30,2021,Anchorage,AK,Passenger,1,0,1,134,135,0.74
September,30,2021,Wichita,TX,Passenger,1,0,1,41,42,2.38
September,30,2021,Thurston,WA,Passenger,1751,908,2659,197543,200202,1.33
September,30,2021,Hamilton,IN,Passenger,2,0,2,28,30,6.67
September,30,2021,San Luis Obispo,CA,Passenger,1,0,1,59,60,1.67
September,30,2021,Rockdale,GA,Passenger,1,0,1,7,8,12.5
September,30,2021,Manassas,VA,Passenger,0,1,1,7,8,12.5
September,30,2021,San Joaquin,CA,Passenger,1,1,2,97,99,2.02
September,30,2021,Hidalgo,TX,Passenger,0,1,1,53,54,1.85
September,30,2021,Kitsap,WA,Truck,0,0,0,54327,54327,0
September,30,2021,Columbia,WA,Truck,0,0,0,1537,1537,0
September,30,2021,Thurston,WA,Truck,0,0,0,56349,56349,0
September,30,2021,Hudson,NJ,Passenger,1,0,1,40,41,2.44
September,30,2021,Danville,VA,Passenger,1,0,1,0,1,100
September,30,2021,Snohomish,WA,Truck,1,0,1,125958,125959,0
September,30,2021,Douglas,NE,Passenger,1,1,2,48,50,4
September,30,2021,Pennington,SD,Passenger,1,0,1,31,32,3.12
September,30,2021,Lee,FL,Passenger,1,0,1,34,35,2.86
September,30,2021,Allegheny,PA,Passenger,1,1,2,63,65,3.08
September,30,2021,Okanogan,WA,Truck,0,0,0,16701,16701,0
September,30,2021,Burlington,NJ,Passenger,0,1,1,119,120,0.83
September,30,2021,Ferry,WA,Truck,0,0,0,3592,3592,0
September,30,2021,Sarasota,FL,Passenger,2,0,2,28,30,6.67
September,30,2021,Juneau,AK,Passenger,0,1,1,26,27,3.7
September,30,2021,Howard,IN,Passenger,0,1,1,6,7,14.29
September,30,2021,DuPage,IL,Passenger,1,0,1,52,53,1.89
September,30,2021,Randolph,NC,Passenger,1,0,1,5,6,16.67
September,30,2021,St. Mary's,MD,Passenger,1,0,1,203,204,0.49
September,30,2021,Adams,WA,Truck,0,0,0,5403,5403,0
September,30,2021,Los Angeles,CA,Passenger,7,9,16,847,863,1.85
September,30,2021,Honolulu,HI,Passenger,5,3,8,364,372,2.15
September,30,2021,Carroll,NH,Passenger,0,1,1,5,6,16.67
September,30,2021,Whatcom,WA,Truck,4,0,4,43814,43818,0.01
September,30,2021,Gwinnett,GA,Passenger,1,0,1,57,58,1.72
September,30,2021,Norfolk,VA,Passenger,3,3,6,309,315,1.9
September,30,2021,Washington,MD,Passenger,2,0,2,13,15,13.33
September,30,2021,Ventura,CA,Passenger,1,2,3,253,256,1.17
September,30,2021,Jefferson,NY,Passenger,0,1,1,208,209,0.48
September,30,2021,Kittitas,WA,Passenger,180,72,252,29865,30117,0.84
September,30,2021,El Paso,CO,Passenger,3,0,3,656,659,0.46
September,30,2021,Kauai,HI,Passenger,1,0,1,17,18,5.56
September,30,2021,Montgomery,PA,Passenger,2,0,2,22,24,8.33
September,30,2021,Santa Cruz,CA,Passenger,1,0,1,25,26,3.85
September,30,2021,Missoula,MT,Passenger,1,0,1,52,53,1.89
September,30,2021,Spokane,WA,Passenger,1187,703,1890,326207,328097,0.58
September,30,2021,Bexar,TX,Passenger,3,4,7,499,506,1.38
September,30,2021,New London,CT,Passenger,1,4,5,210,215,2.33
September,30,2021,Moore,NC,Passenger,0,1,1,123,124,0.81
September,30,2021,Lake,FL,Passenger,1,0,1,22,23,4.35
September,30,2021,Richland,SC,Passenger,0,1,1,132,133,0.75
September,30,2021,Whitman,WA,Truck,0,0,0,8558,8558,0
September,30,2021,Harrison,MS,Passenger,2,0,2,50,52,3.85
September,30,2021,San Francisco,CA,Passenger,0,1,1,82,83,1.2
September,30,2021,King,WA,Truck,5,1,6,183901,183907,0
September,30,2021,Penobscot,ME,Passenger,0,1,1,8,9,11.11
September,30,2021,Mason,WA,Truck,0,0,0,21291,21291,0
September,30,2021,Lincoln,WA,Passenger,7,16,23,7682,7705,0.3
September,30,2021,Williamson,TX,Passenger,1,2,3,98,101,2.97
September,30,2021,Polk,FL,Passenger,1,0,1,55,56,1.79
September,30,2021,Yakima,WA,Truck,0,0,0,61737,61737,0
September,30,2021,Cape May,NJ,Passenger,0,1,1,8,9,11.11
September,30,2021,Dallas,TX,Passenger,1,0,1,146,147,0.68
September,30,2021,Sumter,SC,Passenger,0,1,1,36,37,2.7
September,30,2021,Portsmouth,VA,Passenger,0,1,1,77,78,1.28
September,30,2021,Montgomery,TX,Passenger,1,1,2,36,38,5.26
September,30,2021,Howard,MD,Passenger,0,1,1,56,57,1.75
September,30,2021,San Mateo,CA,Passenger,1,0,1,88,89,1.12
September,30,2021,Chesapeake,VA,Passenger,1,3,4,381,385,1.04
September,30,2021,Salt Lake,UT,Passenger,0,1,1,156,157,0.64
September,30,2021,Greene,MO,Passenger,0,1,1,27,28,3.57
September,30,2021,Queens,NY,Passenger,2,0,2,44,46,4.35
September,30,2021,Harris,TX,Passenger,1,1,2,174,176,1.14
September,30,2021,Skamania,WA,Passenger,53,39,92,8385,8477,1.09
September,30,2021,Miami-Dade,FL,Passenger,1,0,1,95,96,1.04
September,30,2021,Garfield,WA,Truck,0,0,0,998,998,0
September,30,2021,Fresno,CA,Passenger,1,0,1,161,162,0.62
September,30,2021,Kings,CA,Passenger,1,0,1,320,321,0.31
September,30,2021,Jefferson,WA,Passenger,358,186,544,24810,25354,2.15
September,30,2021,Pend Oreille,WA,Passenger,17,7,24,9240,9264,0.26
September,30,2021,Island,WA,Truck,0,0,0,21574,21574,0
September,30,2021,Chelan,WA,Passenger,375,104,479,54762,55241,0.87
September,30,2021,Lane,OR,Passenger,0,1,1,115,116,0.86
September,30,2021,Richmond,GA,Passenger,0,1,1,72,73,1.37
September,30,2021,Albemarle,VA,Passenger,1,0,1,19,20,5
September,30,2021,Pierce,WA,Passenger,3877,2069,5946,559042,564988,1.05
September,30,2021,Skamania,WA,Truck,0,0,0,4043,4043,0
September,30,2021,Garfield,WA,Passenger,0,3,3,1366,1369,0.22
September,30,2021,Camden,NJ,Passenger,0,1,1,14,15,6.67
September,30,2021,Larimer,CO,Passenger,1,0,1,47,48,2.08
September,30,2021,Champaign,IL,Passenger,1,0,1,10,11,9.09
September,30,2021,Pima,AZ,Passenger,1,1,2,255,257,0.78
September,30,2021,Stafford,VA,Passenger,2,1,3,95,98,3.06
September,30,2021,Franklin,WA,Truck,0,0,0,20718,20718,0
September,30,2021,Grant,WA,Truck,0,0,0,28010,28010,0
September,30,2021,Douglas,WA,Truck,0,0,0,12713,12713,0
September,30,2021,Lincoln,WA,Truck,0,0,0,4784,4784,0
September,30,2021,Clark,WA,Truck,0,0,0,84157,84157,0
September,30,2021,Benton,WA,Truck,0,0,0,43672,43672,0
September,30,2021,Ulster,NY,Passenger,1,0,1,8,9,11.11
September,30,2021,Carroll,MD,Passenger,0,1,1,16,17,5.88
September,30,2021,Stevens,WA,Truck,0,0,0,18892,18892,0
September,30,2021,New Haven,CT,Passenger,0,2,2,28,30,6.67
September,30,2021,Grays Harbor,WA,Truck,0,0,0,21400,21400,0
September,30,2021,Kitsap,WA,Passenger,1993,907,2900,180805,183705,1.58
September,30,2021,Cook,IL,Passenger,2,0,2,201,203,0.99
September,30,2021,Alameda,CA,Passenger,4,0,4,221,225,1.78
September,30,2021,Rockingham,NH,Passenger,1,0,1,19,20,5
September,30,2021,Spokane,WA,Truck,0,0,0,102568,102568,0
September,30,2021,Richmond,NY,Passenger,1,0,1,8,9,11.11
September,30,2021,Contra Costa,CA,Passenger,2,4,6,263,269,2.23
September,30,2021,Prince William,VA,Passenger,1,1,2,205,207,0.97
September,30,2021,Asotin,WA,Passenger,20,17,37,12736,12773,0.29
September,30,2021,Wake,NC,Passenger,1,0,1,113,114,0.88
September,30,2021,Cowlitz,WA,Passenger,246,154,400,72035,72435,0.55
September,30,2021,Lewis,WA,Passenger,185,149,334,59589,59923,0.56
September,30,2021,Spartanburg,SC,Passenger,0,1,1,48,49,2.04
September,30,2021,Wilson,TX,Passenger,0,1,1,2,3,33.33
September,30,2021,Yamhill,OR,Passenger,1,0,1,31,32,3.12
September,30,2021,Lake,IL,Passenger,2,0,2,155,157,1.27
September,30,2021,Williams,ND,Passenger,0,1,1,8,9,11.11
September,30,2021,Maricopa,AZ,Passenger,7,3,10,1092,1102,0.91
September,30,2021,Kings,NY,Passenger,1,0,1,67,68,1.47
September,30,2021,Adams,WA,Passenger,16,14,30,13045,13075,0.23
September,30,2021,Orange,FL,Passenger,1,0,1,108,109,0.92
September,30,2021,San Juan,WA,Truck,0,0,0,5983,5983,0
September,30,2021,Snohomish,WA,Passenger,6456,2164,8620,539501,548121,1.57
September,30,2021,Plaquemines,LA,Passenger,0,1,1,17,18,5.56
September,30,2021,Carson City,NV,Passenger,1,0,1,10,11,9.09
September,30,2021,Harnett,NC,Passenger,1,1,2,156,158,1.27
September,30,2021,Fairfax,VA,Passenger,5,4,9,673,682,1.32
September,30,2021,Pend Oreille,WA,Truck,0,0,0,5690,5690,0
September,30,2021,Nassau,NY,Passenger,2,0,2,25,27,7.41
September,30,2021,Douglas,CO,Passenger,0,1,1,76,77,1.3
September,30,2021,Ray,MO,Passenger,0,1,1,1,2,50
September,30,2021,Milwaukee,WI,Passenger,1,0,1,38,39,2.56
September,30,2021,Prince George's,MD,Passenger,2,1,3,137,140,2.14
September,30,2021,Wahkiakum,WA,Truck,0,0,0,1815,1815,0
September,30,2021,Jefferson,WA,Truck,0,0,0,9619,9619,0
September,30,2021,St. Clair,IL,Passenger,2,0,2,127,129,1.55
September,30,2021,Clallam,WA,Passenger,359,229,588,50550,51138,1.15
September,30,2021,Wilson,NC,Passenger,1,0,1,0,1,100
September,30,2021,Whitman,WA,Passenger,64,56,120,21929,22049,0.54
September,30,2021,Denton,TX,Passenger,1,0,1,74,75,1.33
September,30,2021,Grays Harbor,WA,Passenger,183,150,333,49489,49822,0.67
September,30,2021,Platte,MO,Passenger,1,0,1,16,17,5.88
September,30,2021,King,WA,Passenger,32879,9690,42569,1365552,1408121,3.02
September,30,2021,Boulder,CO,Passenger,0,1,1,39,40,2.5
September,30,2021,Charles,MD,Passenger,1,1,2,67,69,2.9
September,30,2021,Monterey,CA,Passenger,0,1,1,143,144,0.69
September,30,2021,Benton,WA,Passenger,581,414,995,136268,137263,0.72
September,30,2021,Klamath,OR,Passenger,1,0,1,28,29,3.45
September,30,2021,Pacific,WA,Truck,0,0,0,7998,7998,0
September,30,2021,Riverside,CA,Passenger,4,1,5,522,527,0.95
September,30,2021,Virginia Beach,VA,Passenger,2,0,2,590,592,0.34
September,30,2021,Okanogan,WA,Passenger,67,44,111,26541,26652,0.42
September,30,2021,DeKalb,GA,Passenger,1,0,1,57,58,1.72
September,30,2021,Las Animas,CO,Passenger,1,0,1,0,1,100
September,30,2021,Asotin,WA,Truck,0,0,0,6755,6755,0
September,30,2021,Alexandria,VA,Passenger,2,0,2,122,124,1.61
September,30,2021,Sevier,AR,Passenger,0,1,1,0,1,100
September,30,2021,Hawaii,HI,Passenger,1,0,1,42,43,2.33
September,30,2021,Escambia,FL,Passenger,0,1,1,143,144,0.69
September,30,2021,Onslow,NC,Passenger,0,1,1,174,175,0.57
September,30,2021,Middlesex,MA,Passenger,1,1,2,87,89,2.25
September,30,2021,Placer,CA,Passenger,2,0,2,70,72,2.78
September,30,2021,Santa Clara,CA,Passenger,8,2,10,241,251,3.98
September,30,2021,Whatcom,WA,Passenger,1540,641,2181,150546,152727,1.43
September,30,2021,Kern,CA,Passenger,0,1,1,197,198,0.51
September,30,2021,Pinellas,FL,Passenger,0,1,1,90,91,1.1
September,30,2021,Charleston,SC,Passenger,2,1,3,81,84,3.57
September,30,2021,Montgomery,MD,Passenger,3,2,5,206,211,2.37
September,30,2021,Allen,IN,Passenger,1,0,1,15,16,6.25
September,30,2021,Stevens,WA,Passenger,51,42,93,30327,30420,0.31
September,30,2021,Island,WA,Passenger,661,329,990,63226,64216,1.54
September,30,2021,Pacific,WA,Passenger,49,57,106,16073,16179,0.66
September,30,2021,Bartow,GA,Passenger,0,1,1,3,4,25
September,30,2021,Anne Arundel,MD,Passenger,4,3,7,368,375,1.87
September,30,2021,New York,NY,Passenger,1,0,1,38,39,2.56
September,30,2021,District of Columbia,DC,Passenger,5,0,5,196,201,2.49
September,30,2021,Cumberland,NC,Passenger,0,2,2,404,406,0.49
September,30,2021,Powhatan,VA,Passenger,1,0,1,1,2,50
September,30,2021,Washington,OR,Passenger,1,0,1,363,364,0.27
September,30,2021,Klickitat,WA,Passenger,83,51,134,15391,15525,0.86
September,30,2021,Collin,TX,Passenger,1,0,1,102,103,0.97
September,30,2021,San Juan,WA,Passenger,462,143,605,14187,14792,4.09
September,30,2021,Klickitat,WA,Truck,0,0,0,8341,8341,0
September,30,2021,Fairbanks North Star,AK,Passenger,0,1,1,79,80,1.25
September,30,2021,Boone,MO,Passenger,0,1,1,9,10,10
September,30,2021,Clallam,WA,Truck,1,0,1,22018,22019,0
April,30,2022,Okaloosa,FL,Passenger,0,1,1,99,100,1
April,30,2022,Whitman,WA,Truck,0,0,0,8586,8586,0
April,30,2022,Moore,NC,Passenger,0,1,1,117,118,0.85
April,30,2022,Prince George's,MD,Passenger,2,1,3,124,127,2.36
April,30,2022,Anchorage,AK,Passenger,1,0,1,123,124,0.81
April,30,2022,Harrison,MS,Passenger,2,0,2,44,46,4.35
April,30,2022,Cowlitz,WA,Truck,0,1,1,28734,28735,0
April,30,2022,Sedgwick,KS,Passenger,1,1,2,78,80,2.5
April,30,2022,Clackamas,OR,Passenger,2,0,2,146,148,1.35
April,30,2022,Richmond,GA,Passenger,0,1,1,67,68,1.47
April,30,2022,New London,CT,Passenger,2,5,7,197,204,3.43
April,30,2022,Montgomery,AL,Passenger,0,1,1,33,34,2.94
April,30,2022,Wood,OH,Passenger,0,1,1,4,5,20
April,30,2022,Wichita,TX,Passenger,1,0,1,39,40,2.5
April,30,2022,Clark,NV,Passenger,4,2,6,529,535,1.12
April,30,2022,El Paso,TX,Passenger,2,0,2,338,340,0.59
April,30,2022,Lincoln,OR,Passenger,0,1,1,30,31,3.23
April,30,2022,Plaquemines,LA,Passenger,1,1,2,16,18,11.11
April,30,2022,Marin,CA,Passenger,0,1,1,30,31,3.23
April,30,2022,Rockingham,NH,Passenger,1,0,1,16,17,5.88
April,30,2022,Fresno,CA,Passenger,1,0,1,142,143,0.7
April,30,2022,Alameda,CA,Passenger,4,0,4,192,196,2.04
April,30,2022,Goochland,VA,Passenger,3,2,5,138,143,3.5
April,30,2022,Hudson,NJ,Passenger,2,0,2,34,36,5.56
April,30,2022,Denton,TX,Passenger,1,0,1,63,64,1.56
April,30,2022,Pierce,WA,Truck,3,0,3,143016,143019,0
April,30,2022,Camden,NJ,Passenger,0,1,1,13,14,7.14
April,30,2022,Leavenworth,KS,Passenger,0,1,1,102,103,0.97
April,30,2022,St. Mary's,MD,Passenger,1,0,1,192,193,0.52
April,30,2022,Essex,NJ,Passenger,2,0,2,9,11,18.18
April,30,2022,Duval,FL,Passenger,0,2,2,282,284,0.7
April,30,2022,Mason,WA,Passenger,294,178,472,47516,47988,0.98
April,30,2022,Walla Walla,WA,Passenger,163,92,255,36040,36295,0.7
April,30,2022,Columbia,WA,Truck,0,0,0,1588,1588,0
April,30,2022,Richmond,NY,Passenger,1,0,1,6,7,14.29
April,30,2022,Wahkiakum,WA,Truck,0,0,0,1817,1817,0
April,30,2022,Tarrant,TX,Passenger,1,0,1,118,119,0.84
April,30,2022,Santa Cruz,CA,Passenger,1,0,1,24,25,4
April,30,2022,Manassas,VA,Passenger,0,1,1,7,8,12.5
April,30,2022,Houston,GA,Passenger,1,0,1,37,38,2.63
April,30,2022,Bexar,TX,Passenger,4,4,8,442,450,1.78
April,30,2022,Pennington,SD,Passenger,2,0,2,28,30,6.67
April,30,2022,Rock Island,IL,Passenger,0,1,1,15,16,6.25
April,30,2022,Skamania,WA,Truck,0,0,0,3981,3981,0
April,30,2022,Philadelphia,PA,Passenger,1,0,1,35,36,2.78
April,30,2022,Nassau,NY,Passenger,2,0,2,26,28,7.14
April,30,2022,Burlington,NJ,Passenger,0,2,2,109,111,1.8
April,30,2022,Island,WA,Passenger,779,367,1146,62227,63373,1.81
April,30,2022,Clark,WA,Truck,3,0,3,83236,83239,0
April,30,2022,Cumberland,NC,Passenger,1,2,3,369,372,0.81
April,30,2022,Chesapeake,VA,Passenger,2,3,5,346,351,1.42
April,30,2022,Adams,CO,Passenger,1,0,1,37,38,2.63
April,30,2022,Fairbanks North Star,AK,Passenger,0,1,1,77,78,1.28
April,30,2022,King,WA,Truck,26,1,27,181794,181821,0.01
April,30,2022,Pinellas,FL,Passenger,0,1,1,77,78,1.28
April,30,2022,Orange,FL,Passenger,1,0,1,94,95,1.05
April,30,2022,Ventura,CA,Passenger,2,1,3,231,234,1.28
April,30,2022,Sonoma,CA,Passenger,0,1,1,72,73,1.37
April,30,2022,Honolulu,HI,Passenger,5,4,9,331,340,2.65
April,30,2022,Columbia,WA,Passenger,7,0,7,2446,2453,0.29
April,30,2022,Rogers,OK,Passenger,1,0,1,2,3,33.33
April,30,2022,Randolph,NC,Passenger,1,0,1,5,6,16.67
April,30,2022,Yakima,WA,Truck,0,0,0,61533,61533,0
April,30,2022,Thurston,WA,Passenger,2073,1015,3088,195014,198102,1.56
April,30,2022,Pacific,WA,Truck,0,0,0,7978,7978,0
April,30,2022,Miami-Dade,FL,Passenger,1,0,1,84,85,1.18
April,30,2022,Ferry,WA,Truck,0,0,0,3568,3568,0
April,30,2022,San Diego,CA,Passenger,13,8,21,2307,2328,0.9
April,30,2022,Benton,WA,Truck,1,0,1,43588,43589,0
April,30,2022,Lewis,WA,Truck,0,0,0,26439,26439,0
April,30,2022,Las Animas,CO,Passenger,1,0,1,1,2,50
April,30,2022,Yakima,WA,Passenger,318,183,501,167415,167916,0.3
April,30,2022,Chelan,WA,Truck,0,0,0,23067,23067,0
April,30,2022,Arlington,VA,Passenger,1,0,1,129,130,0.77
April,30,2022,San Juan,WA,Passenger,494,155,649,14128,14777,4.39
April,30,2022,San Luis Obispo,CA,Passenger,1,0,1,55,56,1.79
April,30,2022,Skagit,WA,Truck,1,0,1,32485,32486,0
April,30,2022,Wilson,TX,Passenger,0,1,1,2,3,33.33
April,30,2022,Cowlitz,WA,Passenger,314,172,486,70917,71403,0.68
April,30,2022,Queens,NY,Passenger,1,0,1,41,42,2.38
April,30,2022,Stevens,WA,Truck,0,0,0,18994,18994,0
April,30,2022,DuPage,IL,Passenger,1,0,1,45,46,2.17
April,30,2022,Arapahoe,CO,Passenger,0,1,1,80,81,1.23
April,30,2022,Walla Walla,WA,Truck,0,0,0,14018,14018,0
April,30,2022,Saratoga,NY,Passenger,1,0,1,38,39,2.56
April,30,2022,Elmore,ID,Passenger,1,0,1,12,13,7.69
April,30,2022,Baltimore,MD,Passenger,1,0,1,73,74,1.35
April,30,2022,Lane,OR,Passenger,0,1,1,98,99,1.01
April,30,2022,Anne Arundel,MD,Passenger,4,3,7,355,362,1.93
April,30,2022,Kittitas,WA,Passenger,236,77,313,29746,30059,1.04
April,30,2022,Platte,MO,Passenger,1,0,1,20,21,4.76
April,30,2022,Solano,CA,Passenger,1,0,1,160,161,0.62
April,30,2022,Middlesex,MA,Passenger,1,1,2,80,82,2.44
April,30,2022,Douglas,WA,Passenger,126,57,183,28526,28709,0.64
April,30,2022,Boulder,CO,Passenger,1,0,1,34,35,2.86
April,30,2022,Sarpy,NE,Passenger,1,0,1,51,52,1.92
April,30,2022,Hidalgo,TX,Passenger,0,1,1,52,53,1.89
April,30,2022,RÃ­o Grande,PR,Passenger,1,0,1,0,1,100
April,30,2022,Virginia Beach,VA,Passenger,2,0,2,523,525,0.38
April,30,2022,Franklin,WA,Passenger,179,105,284,62000,62284,0.46
April,30,2022,St. Clair,IL,Passenger,2,0,2,121,123,1.63
April,30,2022,Frederick,MD,Passenger,1,1,2,66,68,2.94
April,30,2022,Grant,WA,Truck,0,0,0,28082,28082,0
April,30,2022,Loudoun,VA,Passenger,2,1,3,64,67,4.48
April,30,2022,Clallam,WA,Passenger,404,241,645,49821,50466,1.28
April,30,2022,Adams,WA,Truck,0,0,0,5481,5481,0
April,30,2022,Clallam,WA,Truck,1,0,1,21998,21999,0
April,30,2022,San Joaquin,CA,Passenger,1,1,2,89,91,2.2
April,30,2022,Spokane,WA,Truck,0,0,0,102417,102417,0
April,30,2022,Carroll,NH,Passenger,0,1,1,5,6,16.67
April,30,2022,Asotin,WA,Truck,0,0,0,6749,6749,0
April,30,2022,Shelby,OH,Passenger,0,1,1,2,3,33.33
April,30,2022,St. Louis,MO,Passenger,1,0,1,66,67,1.49
April,30,2022,Allen,IN,Passenger,1,0,1,13,14,7.14
April,30,2022,Orange,CA,Passenger,5,2,7,357,364,1.92
April,30,2022,Juneau,AK,Passenger,0,1,1,29,30,3.33
April,30,2022,Fairfax,VA,Passenger,5,3,8,612,620,1.29
April,30,2022,Albemarle,VA,Passenger,1,0,1,17,18,5.56
April,30,2022,Wahkiakum,WA,Passenger,20,11,31,3079,3110,1
April,30,2022,Wilson,NC,Passenger,1,0,1,0,1,100
April,30,2022,Kittitas,WA,Truck,0,0,0,14715,14715,0
April,30,2022,Dorchester,SC,Passenger,1,0,1,57,58,1.72
April,30,2022,Broward,FL,Passenger,2,0,2,81,83,2.41
April,30,2022,Whatcom,WA,Truck,4,0,4,43460,43464,0.01
April,30,2022,Spokane,WA,Passenger,1511,810,2321,325760,328081,0.71
April,30,2022,Sumter,SC,Passenger,0,1,1,31,32,3.12
April,30,2022,Yellowstone,MT,Passenger,0,1,1,26,27,3.7
April,30,2022,San Mateo,CA,Passenger,2,0,2,78,80,2.5
April,30,2022,Sevier,AR,Passenger,0,1,1,0,1,100
April,30,2022,Thurston,WA,Truck,3,0,3,55595,55598,0.01
April,30,2022,Montgomery,PA,Passenger,2,0,2,21,23,8.7
April,30,2022,Kauai,HI,Passenger,1,0,1,18,19,5.26
April,30,2022,Bell,TX,Passenger,1,0,1,322,323,0.31
April,30,2022,Oldham,KY,Passenger,0,1,1,4,5,20
April,30,2022,Hawaii,HI,Passenger,1,0,1,36,37,2.7
April,30,2022,Lincoln,WA,Passenger,7,18,25,7670,7695,0.32
April,30,2022,Collin,TX,Passenger,2,0,2,92,94,2.13
April,30,2022,Lewis,WA,Passenger,232,171,403,59518,59921,0.67
April,30,2022,Santa Clara,CA,Passenger,9,1,10,217,227,4.41
April,30,2022,Ray,MO,Passenger,0,1,1,1,2,50
April,30,2022,Chelan,WA,Passenger,447,124,571,54522,55093,1.04
April,30,2022,Douglas,CO,Passenger,0,1,1,73,74,1.35
April,30,2022,Kitsap,WA,Passenger,2325,1020,3345,179074,182419,1.83
April,30,2022,Lincoln,WA,Truck,0,0,0,4851,4851,0
April,30,2022,Hamilton,IN,Passenger,1,0,1,21,22,4.55
April,30,2022,Skagit,WA,Passenger,752,328,1080,90318,91398,1.18
April,30,2022,Jefferson,WA,Passenger,415,210,625,24734,25359,2.46
April,30,2022,San Bernardino,CA,Passenger,1,1,2,335,337,0.59
April,30,2022,Galveston,TX,Passenger,0,1,1,19,20,5
April,30,2022,Larimer,CO,Passenger,1,0,1,48,49,2.04
April,30,2022,Williams,ND,Passenger,0,1,1,7,8,12.5
April,30,2022,Greene,MO,Passenger,0,1,1,23,24,4.17
April,30,2022,Alexandria,VA,Passenger,3,0,3,107,110,2.73
April,30,2022,Williamson,TX,Passenger,1,2,3,82,85,3.53
April,30,2022,King,WA,Passenger,39326,10828,50154,1351160,1401314,3.58
April,30,2022,Nueces,TX,Passenger,1,1,2,57,59,3.39
April,30,2022,Hennepin,MN,Passenger,3,0,3,57,60,5
April,30,2022,Placer,CA,Passenger,2,0,2,69,71,2.82
April,30,2022,Pend Oreille,WA,Passenger,16,10,26,9032,9058,0.29
April,30,2022,Franklin,WA,Truck,0,0,0,20942,20942,0
April,30,2022,Mason,WA,Truck,0,0,0,21131,21131,0
April,30,2022,New York,NY,Passenger,1,0,1,35,36,2.78
April,30,2022,Sacramento,CA,Passenger,2,0,2,198,200,1
April,30,2022,El Paso,CO,Passenger,3,1,4,602,606,0.66
April,30,2022,Fort Bend,TX,Passenger,1,0,1,31,32,3.12
April,30,2022,Clark,WA,Passenger,3864,1692,5556,317894,323450,1.72
April,30,2022,Dallas,TX,Passenger,1,0,1,114,115,0.87
April,30,2022,New Haven,CT,Passenger,0,2,2,28,30,6.67
April,30,2022,Kitsap,WA,Truck,1,0,1,53850,53851,0
April,30,2022,Hillsborough,FL,Passenger,0,2,2,122,124,1.61
April,30,2022,Harris,TX,Passenger,2,0,2,146,148,1.35
April,30,2022,Charleston,SC,Passenger,2,1,3,61,64,4.69
April,30,2022,Onslow,NC,Passenger,0,1,1,159,160,0.62
April,30,2022,Whatcom,WA,Passenger,1775,717,2492,149078,151570,1.64
April,30,2022,Douglas,NE,Passenger,1,2,3,43,46,6.52
April,30,2022,Okanogan,WA,Passenger,79,48,127,26465,26592,0.48
April,30,2022,Rockdale,GA,Passenger,1,0,1,8,9,11.11
April,30,2022,Kings,NY,Passenger,1,0,1,59,60,1.67
April,30,2022,Whitman,WA,Passenger,83,56,139,22051,22190,0.63
April,30,2022,Spartanburg,SC,Passenger,0,1,1,40,41,2.44
April,30,2022,Benton,WA,Passenger,715,446,1161,135499,136660,0.85
April,30,2022,District of Columbia,DC,Passenger,4,0,4,180,184,2.17
April,30,2022,Stafford,VA,Passenger,2,1,3,89,92,3.26
April,30,2022,Owyhee,ID,Passenger,1,0,1,2,3,33.33
April,30,2022,Charles,MD,Passenger,0,1,1,56,57,1.75
April,30,2022,Danville,VA,Passenger,1,0,1,0,1,100
April,30,2022,Pima,AZ,Passenger,1,1,2,224,226,0.88
April,30,2022,Pierce,WA,Passenger,4836,2264,7100,548921,556021,1.28
April,30,2022,Allegheny,PA,Passenger,1,1,2,53,55,3.64
April,30,2022,Travis,TX,Passenger,1,0,1,110,111,0.9
April,30,2022,Grant,WA,Passenger,159,98,257,66893,67150,0.38
April,30,2022,Cape May,NJ,Passenger,0,1,1,7,8,12.5
April,30,2022,Washington,MD,Passenger,2,0,2,14,16,12.5
April,30,2022,Klickitat,WA,Truck,0,0,0,8281,8281,0
April,30,2022,Stevens,WA,Passenger,64,52,116,30125,30241,0.38
April,30,2022,Howard,IN,Passenger,0,1,1,5,6,16.67
April,30,2022,Ulster,NY,Passenger,1,0,1,8,9,11.11
April,30,2022,Suffolk,VA,Passenger,1,0,1,121,122,0.82
April,30,2022,St. Tammany,LA,Passenger,1,0,1,36,37,2.7
April,30,2022,Lake,FL,Passenger,1,0,1,20,21,4.76
April,30,2022,Boone,MO,Passenger,0,1,1,9,10,10
April,30,2022,Norfolk,VA,Passenger,3,3,6,294,300,2
April,30,2022,Howard,MD,Passenger,0,1,1,56,57,1.75
April,30,2022,Gwinnett,GA,Passenger,1,0,1,50,51,1.96
April,30,2022,Lee,FL,Passenger,1,0,1,28,29,3.45
April,30,2022,Sarasota,FL,Passenger,2,0,2,25,27,7.41
April,30,2022,Maricopa,AZ,Passenger,7,2,9,942,951,0.95
April,30,2022,Okanogan,WA,Truck,0,0,0,16687,16687,0
April,30,2022,Garfield,WA,Truck,0,0,0,990,990,0
April,30,2022,Carroll,MD,Passenger,0,1,1,15,16,6.25
April,30,2022,Snohomish,WA,Passenger,7965,2418,10383,534060,544443,1.91
April,30,2022,Bartow,GA,Passenger,0,1,1,3,4,25
April,30,2022,Skamania,WA,Passenger,67,46,113,8227,8340,1.35
April,30,2022,Grays Harbor,WA,Passenger,200,158,358,49216,49574,0.72
April,30,2022,Ferry,WA,Passenger,19,4,23,4406,4429,0.52
April,30,2022,,,Passenger,15,7,22,1124,1146,1.92
April,30,2022,Kern,CA,Passenger,0,1,1,191,192,0.52
April,30,2022,Coryell,TX,Passenger,1,0,1,100,101,0.99
April,30,2022,Prince William,VA,Passenger,0,1,1,196,197,0.51
April,30,2022,Multnomah,OR,Passenger,0,4,4,546,550,0.73
April,30,2022,Montgomery,MD,Passenger,4,2,6,193,199,3.02
April,30,2022,Portsmouth,VA,Passenger,0,1,1,74,75,1.33
April,30,2022,Los Angeles,CA,Passenger,8,7,15,777,792,1.89
April,30,2022,Wake,NC,Passenger,1,0,1,90,91,1.1
April,30,2022,Grays Harbor,WA,Truck,0,0,0,21346,21346,0
April,30,2022,Island,WA,Truck,1,0,1,21467,21468,0
April,30,2022,Harnett,NC,Passenger,2,0,2,140,142,1.41
April,30,2022,Suffolk,MA,Passenger,0,1,1,22,23,4.35
April,30,2022,Calvert,MD,Passenger,0,2,2,77,79,2.53
April,30,2022,Cook,IL,Passenger,3,0,3,187,190,1.58
April,30,2022,Asotin,WA,Passenger,24,19,43,12707,12750,0.34
April,30,2022,Hamilton,OH,Passenger,1,0,1,28,29,3.45
April,30,2022,Jefferson,NY,Passenger,0,1,1,203,204,0.49
April,30,2022,Riverside,CA,Passenger,7,1,8,471,479,1.67
April,30,2022,Douglas,WA,Truck,0,0,0,12748,12748,0
April,30,2022,Pend Oreille,WA,Truck,0,0,0,5657,5657,0
April,30,2022,Lake,IL,Passenger,3,0,3,140,143,2.1
April,30,2022,DeKalb,GA,Passenger,1,0,1,48,49,2.04
April,30,2022,Richland,SC,Passenger,0,1,1,127,128,0.78
April,30,2022,Powhatan,VA,Passenger,1,0,1,1,2,50
April,30,2022,Montgomery,TX,Passenger,1,0,1,31,32,3.12
April,30,2022,Penobscot,ME,Passenger,0,1,1,6,7,14.29
April,30,2022,Klickitat,WA,Passenger,100,55,155,15247,15402,1.01
April,30,2022,Kings,CA,Passenger,2,1,3,304,307,0.98
April,30,2022,Contra Costa,CA,Passenger,0,3,3,255,258,1.16
April,30,2022,Carson City,NV,Passenger,1,0,1,8,9,11.11
April,30,2022,Escambia,FL,Passenger,0,1,1,132,133,0.75
April,30,2022,Salt Lake,UT,Passenger,1,1,2,131,133,1.5
April,30,2022,Adams,WA,Passenger,16,10,26,12985,13011,0.2
April,30,2022,Snohomish,WA,Truck,4,0,4,124628,124632,0
April,30,2022,Pacific,WA,Passenger,60,68,128,15938,16066,0.8
April,30,2022,Jefferson,WA,Truck,0,0,0,9522,9522,0
April,30,2022,Geary,KS,Passenger,1,0,1,86,87,1.15
April,30,2022,Monterey,CA,Passenger,1,1,2,127,129,1.55
April,30,2022,Garfield,WA,Passenger,0,3,3,1332,1335,0.22
April,30,2022,San Juan,WA,Truck,1,0,1,5986,5987,0.02
August,31,2022,Hudson,NJ,Passenger,2,0,2,31,33,6.06
August,31,2022,Pierce,WA,Truck,34,0,34,140861,140895,0.02
August,31,2022,Jefferson,NY,Passenger,0,1,1,196,197,0.51
August,31,2022,Virginia Beach,VA,Passenger,2,0,2,490,492,0.41
August,31,2022,Cook,IL,Passenger,2,0,2,175,177,1.13
August,31,2022,Arapahoe,CO,Passenger,0,1,1,72,73,1.37
August,31,2022,Thurston,WA,Truck,17,0,17,55162,55179,0.03
August,31,2022,Douglas,NE,Passenger,1,2,3,35,38,7.89
August,31,2022,Coryell,TX,Passenger,1,0,1,89,90,1.11
August,31,2022,Philadelphia,PA,Passenger,1,0,1,35,36,2.78
August,31,2022,Wilson,TX,Passenger,0,1,1,2,3,33.33
August,31,2022,Lake,IL,Passenger,2,0,2,123,125,1.6
August,31,2022,Oldham,KY,Passenger,0,1,1,4,5,20
August,31,2022,Orange,FL,Passenger,1,0,1,79,80,1.25
August,31,2022,Yakima,WA,Truck,1,0,1,61393,61394,0
August,31,2022,Bartow,GA,Passenger,0,1,1,3,4,25
August,31,2022,Montgomery,PA,Passenger,1,0,1,20,21,4.76
August,31,2022,Honolulu,HI,Passenger,3,3,6,309,315,1.9
August,31,2022,Sumter,SC,Passenger,0,1,1,32,33,3.03
August,31,2022,Penobscot,ME,Passenger,0,1,1,8,9,11.11
August,31,2022,Santa Clara,CA,Passenger,10,2,12,203,215,5.58
August,31,2022,Ferry,WA,Truck,0,0,0,3585,3585,0
August,31,2022,Juneau,AK,Passenger,0,1,1,28,29,3.45
August,31,2022,Bexar,TX,Passenger,5,3,8,412,420,1.9
August,31,2022,Williamson,TX,Passenger,0,2,2,76,78,2.56
August,31,2022,Marin,CA,Passenger,0,1,1,27,28,3.57
August,31,2022,Spokane,WA,Truck,10,0,10,102018,102028,0.01
August,31,2022,Richmond,NY,Passenger,1,0,1,6,7,14.29
August,31,2022,Lewis,WA,Truck,0,0,0,26330,26330,0
August,31,2022,Snohomish,WA,Passenger,8928,2595,11523,531276,542799,2.12
August,31,2022,Okanogan,WA,Passenger,88,48,136,26317,26453,0.51
August,31,2022,District of Columbia,DC,Passenger,4,0,4,162,166,2.41
August,31,2022,Douglas,WA,Passenger,141,60,201,28384,28585,0.7
August,31,2022,Pend Oreille,WA,Truck,0,0,0,5635,5635,0
August,31,2022,Anne Arundel,MD,Passenger,4,4,8,324,332,2.41
August,31,2022,Lincoln,OR,Passenger,0,1,1,22,23,4.35
August,31,2022,Garfield,WA,Passenger,1,3,4,1322,1326,0.3
August,31,2022,Tarrant,TX,Passenger,1,0,1,99,100,1
August,31,2022,Yellowstone,MT,Passenger,0,1,1,20,21,4.76
August,31,2022,Garfield,WA,Truck,0,0,0,977,977,0
August,31,2022,Jackson,OK,Passenger,0,1,1,32,33,3.03
August,31,2022,Sonoma,CA,Passenger,0,1,1,69,70,1.43
August,31,2022,Cumberland,PA,Passenger,1,0,1,35,36,2.78
August,31,2022,Walla Walla,WA,Passenger,179,104,283,35818,36101,0.78
August,31,2022,Charles,MD,Passenger,1,1,2,53,55,3.64
August,31,2022,Placer,CA,Passenger,2,0,2,63,65,3.08
August,31,2022,Goochland,VA,Passenger,1,1,2,95,97,2.06
August,31,2022,Island,WA,Truck,9,0,9,21330,21339,0.04
August,31,2022,Pacific,WA,Passenger,70,72,142,15797,15939,0.89
August,31,2022,Albemarle,VA,Passenger,1,0,1,16,17,5.88
August,31,2022,Prince George's,MD,Passenger,3,1,4,113,117,3.42
August,31,2022,Loudoun,VA,Passenger,2,1,3,62,65,4.62
August,31,2022,Ferry,WA,Passenger,20,4,24,4399,4423,0.54
August,31,2022,Hawaii,HI,Passenger,1,0,1,31,32,3.12
August,31,2022,Moore,NC,Passenger,0,1,1,107,108,0.93
August,31,2022,Kings,CA,Passenger,2,1,3,290,293,1.02
August,31,2022,Asotin,WA,Truck,0,0,0,6695,6695,0
August,31,2022,Bell,TX,Passenger,1,0,1,295,296,0.34
August,31,2022,Washington,MD,Passenger,2,0,2,15,17,11.76
August,31,2022,Kittitas,WA,Passenger,284,88,372,29610,29982,1.24
August,31,2022,Norfolk,VA,Passenger,2,3,5,274,279,1.79
August,31,2022,Montgomery,AL,Passenger,0,1,1,32,33,3.03
August,31,2022,El Paso,TX,Passenger,2,0,2,309,311,0.64
August,31,2022,Columbia,WA,Truck,0,0,0,1574,1574,0
August,31,2022,Sarpy,NE,Passenger,1,0,1,49,50,2
August,31,2022,Pennington,SD,Passenger,2,0,2,23,25,8
August,31,2022,Harnett,NC,Passenger,2,0,2,140,142,1.41
August,31,2022,Multnomah,OR,Passenger,0,3,3,495,498,0.6
August,31,2022,Denton,TX,Passenger,1,0,1,57,58,1.72
August,31,2022,Benton,WA,Passenger,815,471,1286,135382,136668,0.94
August,31,2022,Kitsap,WA,Passenger,2523,1093,3616,177977,181593,1.99
August,31,2022,Elmore,ID,Passenger,1,0,1,12,13,7.69
August,31,2022,Gwinnett,GA,Passenger,1,0,1,50,51,1.96
August,31,2022,Douglas,WA,Truck,1,0,1,12758,12759,0.01
August,31,2022,Rockdale,GA,Passenger,1,0,1,6,7,14.29
August,31,2022,Jefferson,WA,Passenger,453,223,676,24508,25184,2.68
August,31,2022,Spokane,WA,Passenger,1743,881,2624,324740,327364,0.8
August,31,2022,Jefferson,WA,Truck,3,0,3,9424,9427,0.03
August,31,2022,Solano,CA,Passenger,2,0,2,151,153,1.31
August,31,2022,Adams,WA,Truck,1,0,1,5434,5435,0.02
August,31,2022,San Joaquin,CA,Passenger,1,1,2,80,82,2.44
August,31,2022,Platte,MO,Passenger,1,0,1,21,22,4.55
August,31,2022,Island,WA,Passenger,858,380,1238,61876,63114,1.96
August,31,2022,Columbia,WA,Passenger,8,0,8,2437,2445,0.33
August,31,2022,Hoke,NC,Passenger,1,0,1,62,63,1.59
August,31,2022,Lincoln,WA,Truck,0,0,0,4846,4846,0
August,31,2022,King,WA,Passenger,42950,11640,54590,1346237,1400827,3.9
August,31,2022,Pulaski,AR,Passenger,1,0,1,27,28,3.57
August,31,2022,Hennepin,MN,Passenger,1,0,1,45,46,2.17
August,31,2022,Harris,TX,Passenger,1,0,1,125,126,0.79
August,31,2022,New London,CT,Passenger,2,5,7,186,193,3.63
August,31,2022,Burlington,NJ,Passenger,0,2,2,101,103,1.94
August,31,2022,Lake,FL,Passenger,1,0,1,16,17,5.88
August,31,2022,Montgomery,MD,Passenger,4,2,6,184,190,3.16
August,31,2022,Allen,IN,Passenger,1,0,1,12,13,7.69
August,31,2022,Douglas,CO,Passenger,0,1,1,63,64,1.56
August,31,2022,Klickitat,WA,Passenger,106,54,160,15196,15356,1.04
August,31,2022,San Juan,WA,Passenger,530,162,692,13993,14685,4.71
August,31,2022,Frederick,MD,Passenger,1,0,1,57,58,1.72
August,31,2022,Grays Harbor,WA,Passenger,218,163,381,48843,49224,0.77
August,31,2022,Sheridan,WY,Passenger,1,0,1,6,7,14.29
August,31,2022,Cumberland,NC,Passenger,1,2,3,334,337,0.89
August,31,2022,Travis,TX,Passenger,1,0,1,93,94,1.06
August,31,2022,Hidalgo,TX,Passenger,0,1,1,53,54,1.85
August,31,2022,Suffolk,VA,Passenger,1,0,1,118,119,0.84
August,31,2022,Carroll,MD,Passenger,0,1,1,16,17,5.88
August,31,2022,Sevier,AR,Passenger,0,1,1,0,1,100
August,31,2022,Cape May,NJ,Passenger,0,1,1,7,8,12.5
August,31,2022,Kittitas,WA,Truck,3,0,3,14621,14624,0.02
August,31,2022,Pierce,WA,Passenger,5429,2399,7828,542983,550811,1.42
August,31,2022,St. Mary's,MD,Passenger,1,0,1,180,181,0.55
August,31,2022,Adams,WA,Passenger,21,9,30,12974,13004,0.23
August,31,2022,Grant,WA,Passenger,198,106,304,66772,67076,0.45
August,31,2022,Fort Bend,TX,Passenger,1,0,1,24,25,4
August,31,2022,Riverside,CA,Passenger,7,1,8,426,434,1.84
August,31,2022,Alexandria,VA,Passenger,3,0,3,102,105,2.86
August,31,2022,San Bernardino,CA,Passenger,1,1,2,302,304,0.66
August,31,2022,Escambia,FL,Passenger,0,1,1,124,125,0.8
August,31,2022,Rogers,OK,Passenger,1,0,1,1,2,50
August,31,2022,Sedgwick,KS,Passenger,1,1,2,65,67,2.99
August,31,2022,Wahkiakum,WA,Truck,1,0,1,1802,1803,0.06
August,31,2022,Miami-Dade,FL,Passenger,1,0,1,72,73,1.37
August,31,2022,Contra Costa,CA,Passenger,0,4,4,227,231,1.73
August,31,2022,Sacramento,CA,Passenger,3,0,3,184,187,1.6
August,31,2022,Klickitat,WA,Truck,2,0,2,8267,8269,0.02
August,31,2022,Okanogan,WA,Truck,1,0,1,16543,16544,0.01
August,31,2022,Boulder,CO,Passenger,1,0,1,31,32,3.12
August,31,2022,Adams,CO,Passenger,1,0,1,38,39,2.56
August,31,2022,Clark,WA,Truck,17,0,17,82407,82424,0.02
August,31,2022,Franklin,WA,Passenger,224,113,337,61955,62292,0.54
August,31,2022,Lewis,WA,Passenger,243,177,420,59723,60143,0.7
August,31,2022,Wood,OH,Passenger,0,1,1,3,4,25
August,31,2022,Clackamas,OR,Passenger,2,0,2,128,130,1.54
August,31,2022,Kauai,HI,Passenger,1,0,1,14,15,6.67
August,31,2022,Stevens,WA,Passenger,76,56,132,30060,30192,0.44
August,31,2022,San Juan,WA,Truck,5,0,5,5953,5958,0.08
August,31,2022,King,WA,Truck,204,2,206,180057,180263,0.11
August,31,2022,Randolph,NC,Passenger,1,0,1,5,6,16.67
August,31,2022,Las Animas,CO,Passenger,1,0,1,1,2,50
August,31,2022,Wahkiakum,WA,Passenger,24,12,36,3080,3116,1.16
August,31,2022,Camden,NJ,Passenger,0,1,1,12,13,7.69
August,31,2022,Skagit,WA,Passenger,855,348,1203,89814,91017,1.32
August,31,2022,Middlesex,MA,Passenger,2,1,3,66,69,4.35
August,31,2022,St. Louis,MO,Passenger,1,0,1,57,58,1.72
August,31,2022,Kootenai,ID,Truck,1,0,1,33,34,2.94
August,31,2022,Ray,MO,Passenger,0,1,1,1,2,50
August,31,2022,Asotin,WA,Passenger,24,18,42,12617,12659,0.33
August,31,2022,Essex,NJ,Passenger,2,0,2,8,10,20
August,31,2022,Carroll,NH,Passenger,0,1,1,5,6,16.67
August,31,2022,El Paso,CO,Passenger,3,1,4,561,565,0.71
August,31,2022,Rockingham,NH,Passenger,1,0,1,14,15,6.67
August,31,2022,Clallam,WA,Truck,4,0,4,21879,21883,0.02
August,31,2022,Alameda,CA,Passenger,4,0,4,174,178,2.25
August,31,2022,Franklin,WA,Truck,2,0,2,20905,20907,0.01
August,31,2022,San Mateo,CA,Passenger,1,0,1,70,71,1.41
August,31,2022,Skamania,WA,Truck,0,0,0,3906,3906,0
August,31,2022,Nueces,TX,Passenger,1,1,2,50,52,3.85
August,31,2022,Orange,CA,Passenger,6,2,8,321,329,2.43
August,31,2022,Cowlitz,WA,Passenger,353,172,525,70460,70985,0.74
August,31,2022,Mason,WA,Passenger,330,177,507,47021,47528,1.07
August,31,2022,Thurston,WA,Passenger,2326,1086,3412,193178,196590,1.74
August,31,2022,Dorchester,SC,Passenger,1,0,1,48,49,2.04
August,31,2022,Bryan,GA,Passenger,0,1,1,36,37,2.7
August,31,2022,Broward,FL,Passenger,1,0,1,68,69,1.45
August,31,2022,Grays Harbor,WA,Truck,2,0,2,21214,21216,0.01
August,31,2022,Berkeley,SC,Passenger,0,1,1,112,113,0.88
August,31,2022,Pacific,WA,Truck,0,0,0,7860,7860,0
August,31,2022,Hillsborough,FL,Passenger,0,1,1,113,114,0.88
August,31,2022,Fairbanks North Star,AK,Passenger,0,1,1,67,68,1.47
August,31,2022,Spartanburg,SC,Passenger,0,1,1,35,36,2.78
August,31,2022,St. Tammany,LA,Passenger,1,0,1,33,34,2.94
August,31,2022,Stevens,WA,Truck,1,0,1,18926,18927,0.01
August,31,2022,Saratoga,NY,Passenger,1,0,1,39,40,2.5
August,31,2022,Whatcom,WA,Truck,13,0,13,43149,43162,0.03
August,31,2022,Houston,GA,Passenger,1,0,1,31,32,3.12
August,31,2022,Owyhee,ID,Passenger,1,0,1,2,3,33.33
August,31,2022,Leavenworth,KS,Passenger,0,1,1,93,94,1.06
August,31,2022,Chelan,WA,Truck,5,0,5,23065,23070,0.02
August,31,2022,St. Clair,IL,Passenger,2,0,2,113,115,1.74
August,31,2022,Pend Oreille,WA,Passenger,18,12,30,9031,9061,0.33
August,31,2022,Portsmouth,VA,Passenger,0,1,1,73,74,1.35
August,31,2022,Anchorage,AK,Passenger,1,0,1,111,112,0.89
August,31,2022,New Haven,CT,Passenger,0,2,2,25,27,7.41
August,31,2022,Queens,NY,Passenger,1,0,1,37,38,2.63
August,31,2022,Geary,KS,Passenger,1,0,1,81,82,1.22
August,31,2022,Whitman,WA,Truck,2,0,2,8568,8570,0.02
August,31,2022,Stafford,VA,Passenger,2,1,3,83,86,3.49
August,31,2022,Chesapeake,VA,Passenger,3,3,6,312,318,1.89
August,31,2022,Collin,TX,Passenger,2,0,2,72,74,2.7
August,31,2022,Plaquemines,LA,Passenger,1,1,2,16,18,11.11
August,31,2022,Cowlitz,WA,Truck,2,0,2,28458,28460,0.01
August,31,2022,Fairfax,VA,Passenger,6,3,9,585,594,1.52
August,31,2022,Lee,FL,Passenger,1,0,1,25,26,3.85
August,31,2022,Howard,MD,Passenger,0,1,1,51,52,1.92
August,31,2022,Galveston,TX,Passenger,0,1,1,18,19,5.26
August,31,2022,Snohomish,WA,Truck,45,0,45,123227,123272,0.04
August,31,2022,Los Angeles,CA,Passenger,7,7,14,717,731,1.92
August,31,2022,Clark,NV,Passenger,4,2,6,464,470,1.28
August,31,2022,Arlington,VA,Passenger,1,0,1,120,121,0.83
August,31,2022,Whitman,WA,Passenger,94,62,156,22009,22165,0.7
August,31,2022,Manassas,VA,Passenger,0,1,1,8,9,11.11
August,31,2022,Harrison,MS,Passenger,1,0,1,36,37,2.7
August,31,2022,Onslow,NC,Passenger,0,1,1,157,158,0.63
August,31,2022,Kern,CA,Passenger,0,1,1,187,188,0.53
August,31,2022,Danville,VA,Passenger,1,0,1,0,1,100
August,31,2022,Santa Cruz,CA,Passenger,1,0,1,20,21,4.76
August,31,2022,Lincoln,WA,Passenger,9,16,25,7697,7722,0.32
August,31,2022,San Diego,CA,Passenger,18,10,28,2167,2195,1.28
August,31,2022,Monterey,CA,Passenger,1,1,2,125,127,1.57
August,31,2022,Rock Island,IL,Passenger,0,1,1,15,16,6.25
August,31,2022,Calvert,MD,Passenger,0,2,2,74,76,2.63
August,31,2022,Whatcom,WA,Passenger,1915,766,2681,148907,151588,1.77
August,31,2022,,,Passenger,17,8,25,1241,1266,1.97
August,31,2022,Fairfax,VA,Truck,1,0,1,109,110,0.91
August,31,2022,Allegheny,PA,Passenger,1,1,2,50,52,3.85
August,31,2022,Salt Lake,UT,Passenger,1,1,2,115,117,1.71
August,31,2022,Louisa,VA,Passenger,0,1,1,1,2,50
August,31,2022,Maricopa,AZ,Passenger,7,1,8,808,816,0.98
August,31,2022,Okaloosa,FL,Passenger,0,1,1,94,95,1.05
August,31,2022,Wichita,TX,Passenger,2,0,2,37,39,5.13
August,31,2022,Hamilton,IN,Passenger,1,0,1,16,17,5.88
August,31,2022,Walla Walla,WA,Truck,2,0,2,13914,13916,0.01
August,31,2022,Clark,WA,Passenger,4348,1852,6200,315595,321795,1.93
August,31,2022,Charleston,SC,Passenger,2,2,4,59,63,6.35
August,31,2022,Ventura,CA,Passenger,2,1,3,221,224,1.34
August,31,2022,Chelan,WA,Passenger,487,134,621,54190,54811,1.13
August,31,2022,Hamilton,OH,Passenger,1,0,1,27,28,3.57
August,31,2022,Nassau,NY,Passenger,2,0,2,23,25,8
August,31,2022,Skagit,WA,Truck,5,0,5,32237,32242,0.02
August,31,2022,Skamania,WA,Passenger,82,50,132,8155,8287,1.59
August,31,2022,Sarasota,FL,Passenger,2,0,2,22,24,8.33
August,31,2022,Grant,WA,Truck,1,0,1,27998,27999,0
August,31,2022,DeKalb,GA,Passenger,1,0,1,44,45,2.22
August,31,2022,Yakima,WA,Passenger,364,204,568,166544,167112,0.34
August,31,2022,Kitsap,WA,Truck,19,0,19,53291,53310,0.04
August,31,2022,Richmond,GA,Passenger,0,1,1,59,60,1.67
August,31,2022,Ulster,NY,Passenger,1,0,1,7,8,12.5
August,31,2022,Mason,WA,Truck,4,0,4,20986,20990,0.02
August,31,2022,Lane,OR,Passenger,0,1,1,84,85,1.18
August,31,2022,Clallam,WA,Passenger,435,247,682,49540,50222,1.36
August,31,2022,Duval,FL,Passenger,1,2,3,258,261,1.15
August,31,2022,Williams,ND,Passenger,0,1,1,5,6,16.67
August,31,2022,Benton,WA,Truck,5,0,5,43422,43427,0.01
December,31,2022,San Joaquin,CA,Passenger,1,0,1,75,76,1.32
December,31,2022,Stevens,WA,Truck,2,0,2,18846,18848,0.01
December,31,2022,Snohomish,WA,Passenger,10174,2763,12937,530310,543247,2.38
December,31,2022,Lewis,WA,Truck,1,0,1,26311,26312,0
December,31,2022,Stevens,WA,Passenger,90,56,146,30021,30167,0.48
December,31,2022,Napa,CA,Passenger,0,1,1,9,10,10
December,31,2022,Danville,VA,Passenger,1,0,1,0,1,100
December,31,2022,Pacific,WA,Passenger,74,80,154,15740,15894,0.97
December,31,2022,Duval,FL,Passenger,1,0,1,240,241,0.41
December,31,2022,Beaufort,SC,Passenger,1,0,1,20,21,4.76
December,31,2022,Wahkiakum,WA,Passenger,26,13,39,3037,3076,1.27
December,31,2022,Middlesex,MA,Passenger,2,1,3,60,63,4.76
December,31,2022,Ferry,WA,Passenger,24,4,28,4344,4372,0.64
December,31,2022,St. Clair,IL,Passenger,2,0,2,108,110,1.82
December,31,2022,St. Tammany,LA,Passenger,1,0,1,31,32,3.12
December,31,2022,Moore,NC,Passenger,0,1,1,103,104,0.96
December,31,2022,Cumberland,NC,Passenger,1,2,3,313,316,0.95
December,31,2022,Fairfax,VA,Passenger,5,3,8,569,577,1.39
December,31,2022,Sumter,SC,Passenger,0,1,1,31,32,3.12
December,31,2022,Harnett,NC,Passenger,2,0,2,131,133,1.5
December,31,2022,Columbia,WA,Truck,0,0,0,1587,1587,0
December,31,2022,Garfield,WA,Passenger,1,3,4,1313,1317,0.3
December,31,2022,Nueces,TX,Passenger,0,1,1,49,50,2
December,31,2022,Sarpy,NE,Passenger,1,0,1,46,47,2.13
December,31,2022,Dallas,TX,Passenger,1,0,1,83,84,1.19
December,31,2022,Skamania,WA,Passenger,89,52,141,8114,8255,1.71
December,31,2022,Lee,FL,Passenger,1,0,1,24,25,4
December,31,2022,El Paso,TX,Passenger,2,0,2,287,289,0.69
December,31,2022,Lake,FL,Passenger,1,0,1,16,17,5.88
December,31,2022,Hoke,NC,Passenger,1,0,1,58,59,1.69
December,31,2022,Cowlitz,WA,Passenger,405,190,595,70330,70925,0.84
December,31,2022,Frederick,MD,Passenger,1,0,1,57,58,1.72
December,31,2022,Hennepin,MN,Passenger,1,0,1,37,38,2.63
December,31,2022,Columbia,WA,Passenger,7,1,8,2441,2449,0.33
December,31,2022,Douglas,CO,Passenger,0,1,1,58,59,1.69
December,31,2022,San Juan,WA,Passenger,561,170,731,13907,14638,4.99
December,31,2022,Allen,IN,Passenger,1,0,1,11,12,8.33
December,31,2022,Skamania,WA,Truck,0,0,0,3884,3884,0
December,31,2022,Island,WA,Passenger,930,398,1328,61576,62904,2.11
December,31,2022,Portsmouth,VA,Passenger,0,1,1,64,65,1.54
December,31,2022,Mason,WA,Truck,6,0,6,20861,20867,0.03
December,31,2022,Jackson,OK,Passenger,0,1,1,32,33,3.03
December,31,2022,Adams,WA,Passenger,23,11,34,13019,13053,0.26
December,31,2022,Walla Walla,WA,Passenger,201,106,307,35691,35998,0.85
December,31,2022,San Bernardino,CA,Passenger,1,1,2,282,284,0.7
December,31,2022,Harris,TX,Passenger,1,0,1,123,124,0.81
December,31,2022,Collin,TX,Passenger,2,0,2,48,50,4
December,31,2022,Santa Cruz,CA,Passenger,1,0,1,15,16,6.25
December,31,2022,Sarasota,FL,Passenger,1,0,1,17,18,5.56
December,31,2022,Pierce,WA,Truck,82,0,82,139604,139686,0.06
December,31,2022,Rock Island,IL,Passenger,0,1,1,15,16,6.25
December,31,2022,New Haven,CT,Passenger,0,2,2,22,24,8.33
December,31,2022,Sheridan,WY,Passenger,1,0,1,5,6,16.67
December,31,2022,Broward,FL,Passenger,1,0,1,63,64,1.56
December,31,2022,Okaloosa,FL,Passenger,0,1,1,90,91,1.1
December,31,2022,Spokane,WA,Truck,20,0,20,101929,101949,0.02
December,31,2022,Bartow,GA,Passenger,0,1,1,3,4,25
December,31,2022,Spokane,WA,Passenger,1943,932,2875,324633,327508,0.88
December,31,2022,Wilson,TX,Passenger,0,1,1,2,3,33.33
December,31,2022,St. Louis,MO,Passenger,1,0,1,53,54,1.85
December,31,2022,Hamilton,OH,Truck,1,0,1,2,3,33.33
December,31,2022,Pend Oreille,WA,Passenger,21,13,34,8969,9003,0.38
December,31,2022,Whatcom,WA,Passenger,2110,809,2919,148844,151763,1.92
December,31,2022,Orange,CA,Passenger,7,2,9,301,310,2.9
December,31,2022,Fairfax,VA,Truck,1,0,1,99,100,1
December,31,2022,Whatcom,WA,Truck,26,0,26,43084,43110,0.06
December,31,2022,Stafford,VA,Passenger,3,1,4,80,84,4.76
December,31,2022,Williamson,TX,Passenger,0,2,2,61,63,3.17
December,31,2022,Yellowstone,MT,Passenger,0,1,1,17,18,5.56
December,31,2022,Ventura,CA,Passenger,2,1,3,205,208,1.44
December,31,2022,Garfield,WA,Truck,0,0,0,976,976,0
December,31,2022,Larimer,CO,Passenger,1,0,1,40,41,2.44
December,31,2022,Salt Lake,UT,Passenger,0,1,1,105,106,0.94
December,31,2022,Montgomery,MD,Passenger,3,2,5,173,178,2.81
December,31,2022,Placer,CA,Passenger,2,0,2,57,59,3.39
December,31,2022,Norfolk,VA,Passenger,3,3,6,271,277,2.17
December,31,2022,Escambia,FL,Passenger,0,1,1,113,114,0.88
December,31,2022,Kittitas,WA,Truck,5,0,5,14570,14575,0.03
December,31,2022,Walla Walla,WA,Truck,3,0,3,13871,13874,0.02
December,31,2022,Virginia Beach,VA,Passenger,2,0,2,454,456,0.44
December,31,2022,Calvert,MD,Passenger,0,2,2,77,79,2.53
December,31,2022,Gwinnett,GA,Passenger,1,0,1,41,42,2.38
December,31,2022,Grays Harbor,WA,Truck,2,0,2,21093,21095,0.01
December,31,2022,Essex,NJ,Passenger,2,0,2,8,10,20
December,31,2022,Jefferson,WA,Passenger,480,230,710,24301,25011,2.84
December,31,2022,Klickitat,WA,Truck,4,0,4,8233,8237,0.05
December,31,2022,Douglas,WA,Truck,3,0,3,12825,12828,0.02
December,31,2022,Clark,NV,Passenger,4,2,6,414,420,1.43
December,31,2022,Clark,WA,Passenger,4917,2031,6948,314946,321894,2.16
December,31,2022,Okanogan,WA,Truck,2,0,2,16442,16444,0.01
December,31,2022,Cook,IL,Passenger,2,0,2,156,158,1.27
December,31,2022,Cumberland,PA,Passenger,1,0,1,31,32,3.12
December,31,2022,Sacramento,CA,Passenger,4,0,4,165,169,2.37
December,31,2022,Bryan,GA,Passenger,0,1,1,38,39,2.56
December,31,2022,Dorchester,SC,Passenger,1,0,1,42,43,2.33
December,31,2022,Charleston,SC,Passenger,2,2,4,54,58,6.9
December,31,2022,Yavapai,AZ,Passenger,1,0,1,22,23,4.35
December,31,2022,Solano,CA,Passenger,2,0,2,142,144,1.39
December,31,2022,St. Mary's,MD,Passenger,1,0,1,170,171,0.58
December,31,2022,King,WA,Truck,386,2,388,178383,178771,0.22
December,31,2022,Prince George's,MD,Passenger,3,1,4,111,115,3.48
December,31,2022,Burlington,NJ,Passenger,0,2,2,97,99,2.02
December,31,2022,Clark,WA,Truck,51,0,51,81917,81968,0.06
December,31,2022,Lincoln,WA,Truck,0,0,0,4848,4848,0
December,31,2022,DeKalb,GA,Passenger,1,0,1,39,40,2.5
December,31,2022,Boulder,CO,Passenger,1,0,1,28,29,3.45
December,31,2022,Skagit,WA,Passenger,924,355,1279,89464,90743,1.41
December,31,2022,Champaign,IL,Passenger,1,0,1,7,8,12.5
December,31,2022,Clallam,WA,Truck,8,0,8,21879,21887,0.04
December,31,2022,Benton,WA,Passenger,933,500,1433,135784,137217,1.04
December,31,2022,Lincoln,WA,Passenger,12,18,30,7769,7799,0.38
December,31,2022,Ferry,WA,Truck,0,0,0,3548,3548,0
December,31,2022,Maricopa,AZ,Passenger,6,3,9,690,699,1.29
December,31,2022,Lane,OR,Passenger,0,1,1,73,74,1.35
December,31,2022,Goochland,VA,Passenger,0,1,1,64,65,1.54
December,31,2022,Hudson,NJ,Passenger,1,0,1,28,29,3.45
December,31,2022,Adams,CO,Passenger,1,0,1,33,34,2.94
December,31,2022,Owyhee,ID,Passenger,1,0,1,3,4,25
December,31,2022,Pend Oreille,WA,Truck,0,0,0,5582,5582,0
December,31,2022,Santa Barbara,CA,Passenger,1,0,1,65,66,1.52
December,31,2022,Skagit,WA,Truck,11,0,11,32151,32162,0.03
December,31,2022,Wahkiakum,WA,Truck,1,0,1,1790,1791,0.06
December,31,2022,Okanogan,WA,Passenger,97,52,149,26171,26320,0.57
December,31,2022,Marin,CA,Passenger,0,1,1,29,30,3.33
December,31,2022,Lee,AL,Passenger,1,0,1,11,12,8.33
December,31,2022,Thurston,WA,Truck,38,0,38,54686,54724,0.07
December,31,2022,Lincoln,OR,Passenger,0,1,1,15,16,6.25
December,31,2022,Plaquemines,LA,Passenger,1,1,2,16,18,11.11
December,31,2022,El Paso,CO,Passenger,3,1,4,517,521,0.77
December,31,2022,Alexandria,VA,Passenger,3,1,4,93,97,4.12
December,31,2022,Asotin,WA,Passenger,29,20,49,12492,12541,0.39
December,31,2022,Hawaii,HI,Passenger,1,0,1,25,26,3.85
December,31,2022,King,WA,Passenger,48110,12252,60362,1337864,1398226,4.32
December,31,2022,District of Columbia,DC,Passenger,4,0,4,152,156,2.56
December,31,2022,Hamilton,OH,Passenger,1,0,1,25,26,3.85
December,31,2022,Sedgwick,KS,Passenger,1,1,2,65,67,2.99
December,31,2022,Rockingham,NH,Passenger,1,0,1,12,13,7.69
December,31,2022,Benton,WA,Truck,10,0,10,43344,43354,0.02
December,31,2022,Adams,WA,Truck,1,0,1,5387,5388,0.02
December,31,2022,Vernon,LA,Passenger,1,0,1,74,75,1.33
December,31,2022,Rockdale,GA,Passenger,1,0,1,6,7,14.29
December,31,2022,Nassau,NY,Passenger,1,0,1,21,22,4.55
December,31,2022,San Juan,WA,Truck,8,0,8,5913,5921,0.14
December,31,2022,Hillsborough,FL,Passenger,0,1,1,104,105,0.95
December,31,2022,Houston,GA,Passenger,1,0,1,24,25,4
December,31,2022,Carroll,NH,Passenger,0,1,1,5,6,16.67
December,31,2022,Galveston,TX,Passenger,0,1,1,16,17,5.88
December,31,2022,Lewis,WA,Passenger,268,182,450,59910,60360,0.75
December,31,2022,Charles,MD,Passenger,1,1,2,48,50,4
December,31,2022,Yakima,WA,Truck,6,0,6,61209,61215,0.01
December,31,2022,Lake,IL,Passenger,1,0,1,118,119,0.84
December,31,2022,Fairbanks North Star,AK,Passenger,0,1,1,58,59,1.69
December,31,2022,Kent,DE,Passenger,1,0,1,49,50,2
December,31,2022,Arapahoe,CO,Passenger,0,1,1,67,68,1.47
December,31,2022,Jefferson,WA,Truck,6,0,6,9367,9373,0.06
December,31,2022,Saratoga,NY,Passenger,1,0,1,36,37,2.7
December,31,2022,Grays Harbor,WA,Passenger,246,160,406,48674,49080,0.83
December,31,2022,Newport News,VA,Passenger,1,0,1,94,95,1.05
December,31,2022,Snohomish,WA,Truck,92,0,92,122549,122641,0.08
December,31,2022,,,Passenger,16,6,22,1255,1277,1.72
December,31,2022,Grant,WA,Truck,4,0,4,28064,28068,0.01
December,31,2022,San Diego,CA,Passenger,17,9,26,2033,2059,1.26
December,31,2022,Miami-Dade,FL,Passenger,1,0,1,63,64,1.56
December,31,2022,Jefferson,NY,Passenger,1,1,2,186,188,1.06
December,31,2022,Las Animas,CO,Passenger,1,0,1,1,2,50
December,31,2022,Louisa,VA,Passenger,0,1,1,1,2,50
December,31,2022,Kootenai,ID,Truck,1,0,1,29,30,3.33
December,31,2022,Anne Arundel,MD,Passenger,4,4,8,300,308,2.6
December,31,2022,Travis,TX,Passenger,1,0,1,78,79,1.27
December,31,2022,Cowlitz,WA,Truck,4,0,4,28376,28380,0.01
December,31,2022,Whitman,WA,Passenger,110,67,177,21969,22146,0.8
December,31,2022,Allegheny,PA,Passenger,1,0,1,48,49,2.04
December,31,2022,Island,WA,Truck,17,0,17,21235,21252,0.08
December,31,2022,Douglas,WA,Passenger,169,59,228,28513,28741,0.79
December,31,2022,Whitman,WA,Truck,3,0,3,8661,8664,0.03
December,31,2022,Penobscot,ME,Passenger,0,1,1,8,9,11.11
December,31,2022,Bell,TX,Passenger,1,0,1,269,270,0.37
December,31,2022,Harrison,MS,Passenger,1,0,1,33,34,2.94
December,31,2022,Franklin,WA,Truck,4,0,4,20986,20990,0.02
December,31,2022,Alameda,CA,Passenger,3,0,3,158,161,1.86
December,31,2022,Polk,OR,Passenger,0,1,1,19,20,5
December,31,2022,Montgomery,PA,Passenger,1,0,1,17,18,5.56
December,31,2022,Kittitas,WA,Passenger,301,93,394,29550,29944,1.32
December,31,2022,Washington,MD,Passenger,2,0,2,14,16,12.5
December,31,2022,Chelan,WA,Passenger,536,143,679,54270,54949,1.24
December,31,2022,Thurston,WA,Passenger,2627,1134,3761,192301,196062,1.92
December,31,2022,Asotin,WA,Truck,0,0,0,6686,6686,0
December,31,2022,Mason,WA,Passenger,370,191,561,46879,47440,1.18
December,31,2022,Contra Costa,CA,Passenger,0,3,3,209,212,1.42
December,31,2022,Franklin,WA,Passenger,252,120,372,61769,62141,0.6
December,31,2022,Kern,CA,Passenger,1,1,2,187,189,1.06
December,31,2022,Ray,MO,Passenger,0,1,1,1,2,50
December,31,2022,Klickitat,WA,Passenger,123,51,174,15155,15329,1.14
December,31,2022,Los Angeles,CA,Passenger,5,6,11,655,666,1.65
December,31,2022,Platte,MO,Passenger,1,0,1,19,20,5
December,31,2022,Suffolk,VA,Passenger,1,0,1,113,114,0.88
December,31,2022,Ulster,NY,Passenger,1,0,1,4,5,20
December,31,2022,Richmond,NY,Passenger,1,0,1,6,7,14.29
December,31,2022,Kitsap,WA,Passenger,2765,1146,3911,177328,181239,2.16
December,31,2022,Yakima,WA,Passenger,425,218,643,166458,167101,0.38
December,31,2022,Cape May,NJ,Passenger,0,1,1,7,8,12.5
December,31,2022,Riverside,CA,Passenger,7,0,7,390,397,1.76
December,31,2022,Grant,WA,Passenger,230,112,342,66890,67232,0.51
December,31,2022,Kings,CA,Passenger,2,1,3,276,279,1.08
December,31,2022,Denton,TX,Passenger,1,0,1,50,51,1.96
December,31,2022,Pacific,WA,Truck,2,0,2,7838,7840,0.03
December,31,2022,Howard,MD,Passenger,0,1,1,43,44,2.27
December,31,2022,Carroll,MD,Passenger,0,1,1,17,18,5.56
December,31,2022,Camden,NJ,Passenger,0,1,1,12,13,7.69
December,31,2022,Monterey,CA,Passenger,1,1,2,117,119,1.68
December,31,2022,Berkeley,SC,Passenger,0,1,1,110,111,0.9
December,31,2022,Clallam,WA,Passenger,482,262,744,49422,50166,1.48
December,31,2022,Chesapeake,VA,Passenger,2,3,5,291,296,1.69
December,31,2022,Honolulu,HI,Passenger,3,3,6,283,289,2.08
December,31,2022,Richmond,GA,Passenger,0,1,1,59,60,1.67
December,31,2022,Loudoun,VA,Passenger,3,1,4,60,64,6.25
December,31,2022,Kauai,HI,Passenger,1,1,2,13,15,13.33
December,31,2022,New London,CT,Passenger,2,4,6,179,185,3.24
December,31,2022,Emmet,MI,Passenger,0,1,1,0,1,100
December,31,2022,Pierce,WA,Passenger,6159,2513,8672,539032,547704,1.58
December,31,2022,Queens,NY,Passenger,1,0,1,29,30,3.33
December,31,2022,Bexar,TX,Passenger,4,3,7,374,381,1.84
December,31,2022,Douglas,NE,Passenger,2,1,3,29,32,9.38
December,31,2022,Onslow,NC,Passenger,0,1,1,145,146,0.68
December,31,2022,Pulaski,AR,Passenger,3,0,3,24,27,11.11
December,31,2022,Arlington,VA,Passenger,1,0,1,104,105,0.95
December,31,2022,Multnomah,OR,Passenger,0,2,2,443,445,0.45
December,31,2022,Montgomery,AL,Passenger,0,1,1,29,30,3.33
December,31,2022,Hidalgo,TX,Passenger,0,1,1,47,48,2.08
December,31,2022,Chelan,WA,Truck,13,0,13,23093,23106,0.06
December,31,2022,Randolph,NC,Passenger,1,0,1,4,5,20
December,31,2022,Sonoma,CA,Passenger,1,1,2,61,63,3.17
December,31,2022,Kitsap,WA,Truck,34,0,34,52973,53007,0.06
December,31,2022,Oldham,KY,Passenger,0,1,1,4,5,20
December,31,2022,Wichita,TX,Passenger,2,0,2,37,39,5.13
December,31,2022,Elmore,ID,Passenger,1,0,1,12,13,7.69
December,31,2022,Leavenworth,KS,Passenger,0,1,1,92,93,1.08
December,31,2022,Geary,KS,Passenger,1,0,1,75,76,1.32
December,31,2022,Santa Clara,CA,Passenger,9,2,11,170,181,6.08
February,28,2022,Suffolk,MA,Passenger,0,2,2,23,25,8
February,28,2022,Pacific,WA,Passenger,58,65,123,16024,16147,0.76
February,28,2022,Sevier,AR,Passenger,0,1,1,0,1,100
February,28,2022,Whatcom,WA,Passenger,1690,685,2375,149351,151726,1.57
February,28,2022,Jefferson,NY,Passenger,0,1,1,201,202,0.5
February,28,2022,Lane,OR,Passenger,0,1,1,103,104,0.96
February,28,2022,El Paso,TX,Passenger,2,0,2,342,344,0.58
February,28,2022,St. Mary's,MD,Passenger,1,0,1,199,200,0.5
February,28,2022,Clark,NV,Passenger,4,2,6,541,547,1.1
February,28,2022,Clallam,WA,Passenger,393,243,636,50137,50773,1.25
February,28,2022,Mason,WA,Truck,0,0,0,21184,21184,0
February,28,2022,Cook,IL,Passenger,2,0,2,192,194,1.03
February,28,2022,Travis,TX,Passenger,1,0,1,118,119,0.84
February,28,2022,Stevens,WA,Truck,0,0,0,18976,18976,0
February,28,2022,Kings,CA,Passenger,2,1,3,311,314,0.96
February,28,2022,Multnomah,OR,Passenger,1,4,5,576,581,0.86
February,28,2022,Loudoun,VA,Passenger,1,0,1,65,66,1.52
February,28,2022,San Joaquin,CA,Passenger,1,1,2,89,91,2.2
February,28,2022,Williams,ND,Passenger,0,1,1,7,8,12.5
February,28,2022,Nueces,TX,Passenger,1,1,2,59,61,3.28
February,28,2022,San Juan,WA,Truck,1,0,1,6017,6018,0.02
February,28,2022,Moore,NC,Passenger,0,1,1,121,122,0.82
February,28,2022,Arlington,VA,Passenger,1,0,1,128,129,0.78
February,28,2022,Howard,IN,Passenger,0,1,1,6,7,14.29
February,28,2022,Coryell,TX,Passenger,1,0,1,102,103,0.97
February,28,2022,Benton,WA,Passenger,664,451,1115,135846,136961,0.81
February,28,2022,Spartanburg,SC,Passenger,0,1,1,44,45,2.22
February,28,2022,Essex,NJ,Passenger,2,0,2,10,12,16.67
February,28,2022,Montgomery,MD,Passenger,3,2,5,193,198,2.53
February,28,2022,Charleston,SC,Passenger,2,1,3,69,72,4.17
February,28,2022,Boulder,CO,Passenger,1,0,1,35,36,2.78
February,28,2022,Skagit,WA,Passenger,716,316,1032,90675,91707,1.13
February,28,2022,New Haven,CT,Passenger,0,2,2,29,31,6.45
February,28,2022,Thurston,WA,Passenger,1970,990,2960,196039,198999,1.49
February,28,2022,Contra Costa,CA,Passenger,1,4,5,259,264,1.89
February,28,2022,El Paso,CO,Passenger,3,1,4,628,632,0.63
February,28,2022,Monterey,CA,Passenger,0,1,1,130,131,0.76
February,28,2022,Erie,NY,Passenger,1,0,1,29,30,3.33
February,28,2022,Santa Clara,CA,Passenger,8,1,9,227,236,3.81
February,28,2022,Ulster,NY,Passenger,1,0,1,9,10,10
February,28,2022,Calvert,MD,Passenger,0,2,2,79,81,2.47
February,28,2022,Grays Harbor,WA,Truck,0,0,0,21340,21340,0
February,28,2022,Leavenworth,KS,Passenger,0,1,1,102,103,0.97
February,28,2022,Harnett,NC,Passenger,1,0,1,142,143,0.7
February,28,2022,Fort Bend,TX,Passenger,1,0,1,32,33,3.03
February,28,2022,,,Passenger,14,7,21,1108,1129,1.86
February,28,2022,Lincoln,OR,Passenger,0,1,1,30,31,3.23
February,28,2022,Ray,MO,Passenger,0,1,1,1,2,50
February,28,2022,Douglas,CO,Passenger,0,1,1,76,77,1.3
February,28,2022,Spokane,WA,Passenger,1392,784,2176,326237,328413,0.66
February,28,2022,Los Angeles,CA,Passenger,10,7,17,809,826,2.06
February,28,2022,Wood,OH,Passenger,0,1,1,4,5,20
February,28,2022,Clark,WA,Passenger,3627,1600,5227,319148,324375,1.61
February,28,2022,Garfield,WA,Passenger,0,3,3,1353,1356,0.22
February,28,2022,Washington,MD,Passenger,2,0,2,14,16,12.5
February,28,2022,Lincoln,WA,Truck,0,0,0,4845,4845,0
February,28,2022,Kitsap,WA,Passenger,2230,982,3212,179653,182865,1.76
February,28,2022,Platte,MO,Passenger,1,0,1,17,18,5.56
February,28,2022,Benton,WA,Truck,0,0,0,43644,43644,0
February,28,2022,Clallam,WA,Truck,1,0,1,22104,22105,0
February,28,2022,DeKalb,GA,Passenger,1,0,1,51,52,1.92
February,28,2022,Miami-Dade,FL,Passenger,1,0,1,87,88,1.14
February,28,2022,Lewis,WA,Truck,0,0,0,26607,26607,0
February,28,2022,Kauai,HI,Passenger,1,0,1,18,19,5.26
February,28,2022,Geary,KS,Passenger,1,0,1,89,90,1.11
February,28,2022,Suffolk,VA,Passenger,1,0,1,121,122,0.82
February,28,2022,Camden,NJ,Passenger,0,1,1,13,14,7.14
February,28,2022,San Diego,CA,Passenger,14,8,22,2347,2369,0.93
February,28,2022,Nassau,NY,Passenger,2,0,2,24,26,7.69
February,28,2022,San Francisco,CA,Passenger,0,1,1,76,77,1.3
February,28,2022,Greene,MO,Passenger,0,1,1,24,25,4
February,28,2022,Columbia,WA,Passenger,6,1,7,2457,2464,0.28
February,28,2022,San Juan,WA,Passenger,485,152,637,14178,14815,4.3
February,28,2022,Kittitas,WA,Truck,0,0,0,14753,14753,0
February,28,2022,Onslow,NC,Passenger,0,1,1,165,166,0.6
February,28,2022,Richmond,GA,Passenger,0,1,1,69,70,1.43
February,28,2022,Owyhee,ID,Passenger,1,0,1,2,3,33.33
February,28,2022,Jefferson,WA,Truck,0,0,0,9576,9576,0
February,28,2022,St. Louis,MO,Passenger,1,0,1,71,72,1.39
February,28,2022,Pierce,WA,Passenger,4484,2176,6660,552620,559280,1.19
February,28,2022,Adams,WA,Passenger,17,14,31,13020,13051,0.24
February,28,2022,Danville,VA,Passenger,1,0,1,0,1,100
February,28,2022,Sarasota,FL,Passenger,2,0,2,27,29,6.9
February,28,2022,Wahkiakum,WA,Truck,0,0,0,1815,1815,0
February,28,2022,Asotin,WA,Truck,0,0,0,6741,6741,0
February,28,2022,Rockdale,GA,Passenger,1,0,1,7,8,12.5
February,28,2022,Garfield,WA,Truck,0,0,0,998,998,0
February,28,2022,Escambia,FL,Passenger,0,1,1,136,137,0.73
February,28,2022,Allen,IN,Passenger,1,0,1,14,15,6.67
February,28,2022,Klickitat,WA,Truck,0,0,0,8332,8332,0
February,28,2022,Prince George's,MD,Passenger,2,1,3,134,137,2.19
February,28,2022,Penobscot,ME,Passenger,0,1,1,6,7,14.29
February,28,2022,Pend Oreille,WA,Truck,0,0,0,5718,5718,0
February,28,2022,Lake,FL,Passenger,1,0,1,22,23,4.35
February,28,2022,Kern,CA,Passenger,0,1,1,196,197,0.51
February,28,2022,New London,CT,Passenger,1,4,5,206,211,2.37
February,28,2022,Honolulu,HI,Passenger,4,4,8,338,346,2.31
February,28,2022,Island,WA,Passenger,745,351,1096,62408,63504,1.73
February,28,2022,Flathead,MT,Passenger,1,0,1,37,38,2.63
February,28,2022,Ventura,CA,Passenger,2,1,3,235,238,1.26
February,28,2022,Thurston,WA,Truck,3,0,3,55853,55856,0.01
February,28,2022,Grant,WA,Truck,0,0,0,28009,28009,0
February,28,2022,Elmore,ID,Passenger,1,0,1,15,16,6.25
February,28,2022,Larimer,CO,Passenger,1,0,1,49,50,2
February,28,2022,Powhatan,VA,Passenger,1,0,1,1,2,50
February,28,2022,Rock Island,IL,Passenger,0,1,1,16,17,5.88
February,28,2022,Clackamas,OR,Passenger,2,0,2,157,159,1.26
February,28,2022,Chesapeake,VA,Passenger,2,3,5,356,361,1.39
February,28,2022,Chelan,WA,Truck,0,0,0,23075,23075,0
February,28,2022,Pima,AZ,Passenger,1,1,2,241,243,0.82
February,28,2022,Oldham,KY,Passenger,0,1,1,4,5,20
February,28,2022,Snohomish,WA,Truck,3,0,3,125152,125155,0
February,28,2022,Juneau,AK,Passenger,0,1,1,28,29,3.45
February,28,2022,Orange,FL,Passenger,1,0,1,95,96,1.04
February,28,2022,Yellowstone,MT,Passenger,0,1,1,28,29,3.45
February,28,2022,Wilson,NC,Passenger,1,0,1,0,1,100
February,28,2022,Broward,FL,Passenger,2,0,2,86,88,2.27
February,28,2022,Howard,MD,Passenger,0,1,1,56,57,1.75
February,28,2022,Williamson,TX,Passenger,1,2,3,87,90,3.33
February,28,2022,Placer,CA,Passenger,2,0,2,70,72,2.78
February,28,2022,Hennepin,MN,Passenger,3,0,3,62,65,4.62
February,28,2022,Fairfax,VA,Passenger,3,3,6,629,635,0.94
February,28,2022,Klamath,OR,Passenger,1,0,1,27,28,3.57
February,28,2022,Yakima,WA,Passenger,301,178,479,168019,168498,0.28
February,28,2022,St. Tammany,LA,Passenger,1,0,1,37,38,2.63
February,28,2022,Grant,WA,Passenger,142,99,241,66798,67039,0.36
February,28,2022,Pennington,SD,Passenger,2,0,2,29,31,6.45
February,28,2022,Anne Arundel,MD,Passenger,4,3,7,357,364,1.92
February,28,2022,Boone,MO,Passenger,0,1,1,9,10,10
February,28,2022,Walla Walla,WA,Truck,0,0,0,14072,14072,0
February,28,2022,New York,NY,Passenger,1,0,1,34,35,2.86
February,28,2022,Middlesex,MA,Passenger,0,1,1,81,82,1.22
February,28,2022,Salt Lake,UT,Passenger,1,1,2,146,148,1.35
February,28,2022,San Bernardino,CA,Passenger,1,1,2,344,346,0.58
February,28,2022,Richmond,NY,Passenger,1,0,1,6,7,14.29
February,28,2022,Kittitas,WA,Passenger,218,72,290,29778,30068,0.96
February,28,2022,Tarrant,TX,Passenger,1,0,1,125,126,0.79
February,28,2022,Albemarle,VA,Passenger,1,0,1,18,19,5.26
February,28,2022,Anchorage,AK,Passenger,1,0,1,121,122,0.82
February,28,2022,Douglas,NE,Passenger,1,2,3,46,49,6.12
February,28,2022,Sumter,SC,Passenger,0,1,1,33,34,2.94
February,28,2022,Philadelphia,PA,Passenger,1,0,1,35,36,2.78
February,28,2022,Lee,FL,Passenger,1,0,1,28,29,3.45
February,28,2022,Champaign,IL,Passenger,1,0,1,11,12,8.33
February,28,2022,Dorchester,SC,Passenger,1,0,1,62,63,1.59
February,28,2022,Hidalgo,TX,Passenger,0,1,1,52,53,1.89
February,28,2022,Burlington,NJ,Passenger,0,1,1,115,116,0.86
February,28,2022,Rockingham,NH,Passenger,1,0,1,17,18,5.56
February,28,2022,Maricopa,AZ,Passenger,7,2,9,985,994,0.91
February,28,2022,Pierce,WA,Truck,2,0,2,144061,144063,0
February,28,2022,Prince William,VA,Passenger,1,1,2,200,202,0.99
February,28,2022,Okanogan,WA,Passenger,74,47,121,26474,26595,0.45
February,28,2022,Queens,NY,Passenger,1,0,1,46,47,2.13
February,28,2022,Vigo,IN,Passenger,1,0,1,5,6,16.67
February,28,2022,Franklin,WA,Truck,0,0,0,20925,20925,0
February,28,2022,Jefferson,WA,Passenger,394,202,596,24685,25281,2.36
February,28,2022,Ferry,WA,Passenger,15,3,18,4443,4461,0.4
February,28,2022,Whitman,WA,Truck,0,0,0,8578,8578,0
February,28,2022,Whitman,WA,Passenger,70,56,126,22020,22146,0.57
February,28,2022,Hamilton,OH,Passenger,1,0,1,30,31,3.23
February,28,2022,Manassas,VA,Passenger,0,1,1,7,8,12.5
February,28,2022,Randolph,NC,Passenger,1,0,1,5,6,16.67
February,28,2022,Denton,TX,Passenger,1,0,1,70,71,1.41
February,28,2022,Hudson,NJ,Passenger,2,0,2,35,37,5.41
February,28,2022,Sedgwick,KS,Passenger,1,1,2,82,84,2.38
February,28,2022,Kings,NY,Passenger,1,0,1,66,67,1.49
February,28,2022,Galveston,TX,Passenger,0,1,1,20,21,4.76
February,28,2022,Stevens,WA,Passenger,58,47,105,30105,30210,0.35
February,28,2022,Frederick,MD,Passenger,1,1,2,67,69,2.9
February,28,2022,Skagit,WA,Truck,1,0,1,32638,32639,0
February,28,2022,Saratoga,NY,Passenger,1,0,1,39,40,2.5
February,28,2022,Pinellas,FL,Passenger,0,1,1,81,82,1.22
February,28,2022,Island,WA,Truck,1,0,1,21490,21491,0
February,28,2022,Stafford,VA,Passenger,2,1,3,91,94,3.19
February,28,2022,San Luis Obispo,CA,Passenger,1,0,1,55,56,1.79
February,28,2022,Skamania,WA,Truck,0,0,0,4001,4001,0
February,28,2022,Kitsap,WA,Truck,0,0,0,54096,54096,0
February,28,2022,Rogers,OK,Passenger,1,0,1,2,3,33.33
February,28,2022,Montgomery,TX,Passenger,1,0,1,31,32,3.12
February,28,2022,Lincoln,WA,Passenger,7,17,24,7685,7709,0.31
February,28,2022,Pacific,WA,Truck,0,0,0,8006,8006,0
February,28,2022,Walla Walla,WA,Passenger,152,91,243,36233,36476,0.67
February,28,2022,Whatcom,WA,Truck,4,0,4,43608,43612,0.01
February,28,2022,Bexar,TX,Passenger,3,4,7,470,477,1.47
February,28,2022,Cape May,NJ,Passenger,0,1,1,8,9,11.11
February,28,2022,Gwinnett,GA,Passenger,1,0,1,56,57,1.75
February,28,2022,Santa Cruz,CA,Passenger,1,0,1,24,25,4
February,28,2022,Goochland,VA,Passenger,3,2,5,166,171,2.92
February,28,2022,Portsmouth,VA,Passenger,0,1,1,75,76,1.32
February,28,2022,Yamhill,OR,Passenger,1,0,1,31,32,3.12
February,28,2022,Wahkiakum,WA,Passenger,17,11,28,3096,3124,0.9
February,28,2022,Bell,TX,Passenger,1,0,1,330,331,0.3
February,28,2022,Houston,GA,Passenger,1,0,1,39,40,2.5
February,28,2022,Wilson,TX,Passenger,0,1,1,2,3,33.33
February,28,2022,Asotin,WA,Passenger,22,18,40,12641,12681,0.32
February,28,2022,Carroll,NH,Passenger,0,1,1,5,6,16.67
February,28,2022,Richland,SC,Passenger,0,1,1,126,127,0.79
February,28,2022,Lake,IL,Passenger,3,0,3,146,149,2.01
February,28,2022,Douglas,WA,Truck,0,0,0,12686,12686,0
February,28,2022,Carroll,MD,Passenger,0,1,1,15,16,6.25
February,28,2022,Okaloosa,FL,Passenger,0,1,1,103,104,0.96
February,28,2022,San Mateo,CA,Passenger,2,0,2,76,78,2.56
February,28,2022,Harris,TX,Passenger,1,0,1,154,155,0.65
February,28,2022,DuPage,IL,Passenger,1,0,1,48,49,2.04
February,28,2022,Plaquemines,LA,Passenger,0,1,1,17,18,5.56
February,28,2022,Norfolk,VA,Passenger,3,3,6,299,305,1.97
February,28,2022,King,WA,Passenger,37216,10526,47742,1354857,1402599,3.4
February,28,2022,Charles,MD,Passenger,0,1,1,61,62,1.61
February,28,2022,Adams,WA,Truck,0,0,0,5459,5459,0
February,28,2022,Alameda,CA,Passenger,4,0,4,202,206,1.94
February,28,2022,Sonoma,CA,Passenger,0,1,1,74,75,1.33
February,28,2022,Baltimore,MD,Passenger,1,0,1,76,77,1.3
February,28,2022,Cowlitz,WA,Passenger,280,168,448,71262,71710,0.62
February,28,2022,Wichita,TX,Passenger,1,0,1,41,42,2.38
February,28,2022,Louisa,VA,Passenger,0,1,1,1,2,50
February,28,2022,Snohomish,WA,Passenger,7454,2311,9765,535946,545711,1.79
February,28,2022,Las Animas,CO,Passenger,1,0,1,1,2,50
February,28,2022,Okanogan,WA,Truck,0,0,0,16714,16714,0
February,28,2022,St. Clair,IL,Passenger,2,0,2,121,123,1.63
February,28,2022,Harrison,MS,Passenger,2,0,2,45,47,4.26
February,28,2022,Bartow,GA,Passenger,0,1,1,3,4,25
February,28,2022,Chelan,WA,Passenger,429,121,550,54566,55116,1
February,28,2022,Lewis,WA,Passenger,221,166,387,59453,59840,0.65
February,28,2022,Allegheny,PA,Passenger,1,1,2,53,55,3.64
February,28,2022,Hamilton,IN,Passenger,2,0,2,21,23,8.7
February,28,2022,Solano,CA,Passenger,1,0,1,169,170,0.59
February,28,2022,Shelby,OH,Passenger,0,1,1,2,3,33.33
February,28,2022,Hillsborough,FL,Passenger,0,1,1,129,130,0.77
February,28,2022,Collin,TX,Passenger,2,0,2,97,99,2.02
February,28,2022,Alexandria,VA,Passenger,3,0,3,110,113,2.65
February,28,2022,Spokane,WA,Truck,0,0,0,102602,102602,0
February,28,2022,Sarpy,NE,Passenger,1,0,1,55,56,1.79
February,28,2022,Yakima,WA,Truck,0,0,0,61654,61654,0
February,28,2022,Montgomery,PA,Passenger,2,0,2,22,24,8.33
February,28,2022,Cowlitz,WA,Truck,0,1,1,28908,28909,0
February,28,2022,Riverside,CA,Passenger,5,1,6,476,482,1.24
February,28,2022,Duval,FL,Passenger,0,2,2,296,298,0.67
February,28,2022,Orange,CA,Passenger,4,2,6,369,375,1.6
February,28,2022,Carson City,NV,Passenger,1,0,1,7,8,12.5
February,28,2022,Clark,WA,Truck,2,0,2,83758,83760,0
February,28,2022,King,WA,Truck,22,1,23,182492,182515,0.01
February,28,2022,Sacramento,CA,Passenger,2,0,2,202,204,0.98
February,28,2022,Skamania,WA,Passenger,59,45,104,8311,8415,1.24
February,28,2022,Klickitat,WA,Passenger,92,53,145,15306,15451,0.94
February,28,2022,Pend Oreille,WA,Passenger,17,9,26,9075,9101,0.29
February,28,2022,Fairbanks North Star,AK,Passenger,0,1,1,76,77,1.3
February,28,2022,Wake,NC,Passenger,1,0,1,101,102,0.98
February,28,2022,Marin,CA,Passenger,0,1,1,30,31,3.23
February,28,2022,Cumberland,NC,Passenger,1,2,3,377,380,0.79
February,28,2022,Mason,WA,Passenger,280,166,446,47722,48168,0.93
February,28,2022,Virginia Beach,VA,Passenger,2,0,2,551,553,0.36
February,28,2022,Hawaii,HI,Passenger,1,0,1,37,38,2.63
February,28,2022,Grays Harbor,WA,Passenger,202,157,359,49318,49677,0.72
February,28,2022,Ferry,WA,Truck,0,0,0,3567,3567,0
February,28,2022,Columbia,WA,Truck,0,0,0,1571,1571,0
February,28,2022,Fresno,CA,Passenger,1,0,1,152,153,0.65
February,28,2022,RÃ­o Grande,PR,Passenger,1,0,1,0,1,100
February,28,2022,Dallas,TX,Passenger,1,0,1,125,126,0.79
February,28,2022,Douglas,WA,Passenger,122,55,177,28558,28735,0.62
February,28,2022,District of Columbia,DC,Passenger,5,0,5,184,189,2.65
February,28,2022,Franklin,WA,Passenger,175,102,277,62074,62351,0.44
January,31,2022,Hillsborough,FL,Passenger,0,1,1,132,133,0.75
January,31,2022,Ray,MO,Passenger,0,1,1,1,2,50
January,31,2022,Douglas,WA,Passenger,118,56,174,28586,28760,0.61
January,31,2022,Rogers,OK,Passenger,1,0,1,2,3,33.33
January,31,2022,New London,CT,Passenger,1,4,5,211,216,2.31
January,31,2022,Howard,MD,Passenger,0,1,1,55,56,1.79
January,31,2022,Duval,FL,Passenger,0,2,2,301,303,0.66
January,31,2022,Montgomery,TX,Passenger,1,1,2,31,33,6.06
January,31,2022,Whatcom,WA,Truck,3,0,3,43614,43617,0.01
January,31,2022,Asotin,WA,Truck,0,0,0,6736,6736,0
January,31,2022,Orange,FL,Passenger,1,0,1,99,100,1
January,31,2022,Onslow,NC,Passenger,0,1,1,167,168,0.6
January,31,2022,Garfield,WA,Truck,0,0,0,995,995,0
January,31,2022,Williams,ND,Passenger,0,1,1,8,9,11.11
January,31,2022,San Joaquin,CA,Passenger,1,1,2,90,92,2.17
January,31,2022,Flathead,MT,Passenger,1,0,1,37,38,2.63
January,31,2022,Whatcom,WA,Passenger,1665,673,2338,149528,151866,1.54
January,31,2022,King,WA,Passenger,36353,10406,46759,1356535,1403294,3.33
January,31,2022,Walla Walla,WA,Passenger,146,89,235,36290,36525,0.64
January,31,2022,Stevens,WA,Passenger,58,47,105,30190,30295,0.35
January,31,2022,Clark,WA,Passenger,3541,1572,5113,319486,324599,1.58
January,31,2022,Monterey,CA,Passenger,0,1,1,134,135,0.74
January,31,2022,Anchorage,AK,Passenger,1,0,1,122,123,0.81
January,31,2022,Owyhee,ID,Passenger,1,0,1,2,3,33.33
January,31,2022,San Juan,WA,Passenger,482,151,633,14173,14806,4.28
January,31,2022,Frederick,MD,Passenger,1,1,2,68,70,2.86
January,31,2022,King,WA,Truck,14,1,15,182672,182687,0.01
January,31,2022,Anne Arundel,MD,Passenger,4,3,7,353,360,1.94
January,31,2022,El Paso,CO,Passenger,3,0,3,641,644,0.47
January,31,2022,Chelan,WA,Truck,0,0,0,23062,23062,0
January,31,2022,Carroll,MD,Passenger,0,1,1,15,16,6.25
January,31,2022,Cowlitz,WA,Truck,0,1,1,28923,28924,0
January,31,2022,Cape May,NJ,Passenger,0,1,1,8,9,11.11
January,31,2022,Snohomish,WA,Truck,3,0,3,125304,125307,0
January,31,2022,Louisa,VA,Passenger,0,1,1,1,2,50
January,31,2022,Lewis,WA,Passenger,213,165,378,59516,59894,0.63
January,31,2022,District of Columbia,DC,Passenger,5,0,5,185,190,2.63
January,31,2022,Sonoma,CA,Passenger,0,1,1,75,76,1.32
January,31,2022,Gwinnett,GA,Passenger,1,0,1,56,57,1.75
January,31,2022,Richmond,GA,Passenger,0,1,1,70,71,1.41
January,31,2022,Okanogan,WA,Passenger,70,47,117,26533,26650,0.44
January,31,2022,New Haven,CT,Passenger,0,2,2,30,32,6.25
January,31,2022,Bartow,GA,Passenger,0,1,1,3,4,25
January,31,2022,Salt Lake,UT,Passenger,1,1,2,149,151,1.32
January,31,2022,Spokane,WA,Truck,0,0,0,102647,102647,0
January,31,2022,Goochland,VA,Passenger,3,2,5,172,177,2.82
January,31,2022,Pennington,SD,Passenger,2,0,2,29,31,6.45
January,31,2022,Kings,NY,Passenger,1,0,1,66,67,1.49
January,31,2022,Bexar,TX,Passenger,3,4,7,474,481,1.46
January,31,2022,Yakima,WA,Passenger,294,177,471,168293,168764,0.28
January,31,2022,Clackamas,OR,Passenger,2,0,2,157,159,1.26
January,31,2022,Hidalgo,TX,Passenger,0,1,1,53,54,1.85
January,31,2022,Las Animas,CO,Passenger,1,0,1,1,2,50
January,31,2022,Carroll,NH,Passenger,0,1,1,5,6,16.67
January,31,2022,Elmore,ID,Passenger,1,0,1,15,16,6.25
January,31,2022,Skamania,WA,Passenger,60,43,103,8316,8419,1.22
January,31,2022,St. Tammany,LA,Passenger,1,0,1,38,39,2.56
January,31,2022,Charles,MD,Passenger,1,1,2,64,66,3.03
January,31,2022,Jefferson,WA,Passenger,385,197,582,24693,25275,2.3
January,31,2022,Walla Walla,WA,Truck,0,0,0,14104,14104,0
January,31,2022,Arlington,VA,Passenger,1,0,1,130,131,0.76
January,31,2022,Richland,SC,Passenger,0,1,1,126,127,0.79
January,31,2022,Orange,CA,Passenger,5,2,7,379,386,1.81
January,31,2022,Sedgwick,KS,Passenger,1,1,2,82,84,2.38
January,31,2022,San Francisco,CA,Passenger,0,1,1,77,78,1.28
January,31,2022,Burlington,NJ,Passenger,0,1,1,116,117,0.85
January,31,2022,Island,WA,Passenger,734,344,1078,62598,63676,1.69
January,31,2022,Kitsap,WA,Truck,0,0,0,54155,54155,0
January,31,2022,Randolph,NC,Passenger,1,0,1,5,6,16.67
January,31,2022,Benton,WA,Passenger,654,453,1107,135958,137065,0.81
January,31,2022,Thurston,WA,Truck,3,0,3,55934,55937,0.01
January,31,2022,Harnett,NC,Passenger,1,1,2,143,145,1.38
January,31,2022,Calvert,MD,Passenger,0,2,2,79,81,2.47
January,31,2022,Miami-Dade,FL,Passenger,1,0,1,88,89,1.12
January,31,2022,RÃ­o Grande,PR,Passenger,1,0,1,0,1,100
January,31,2022,Norfolk,VA,Passenger,3,3,6,301,307,1.95
January,31,2022,Boulder,CO,Passenger,1,1,2,36,38,5.26
January,31,2022,El Paso,TX,Passenger,2,0,2,344,346,0.58
January,31,2022,Mason,WA,Truck,0,0,0,21187,21187,0
January,31,2022,Larimer,CO,Passenger,1,0,1,49,50,2
January,31,2022,Nueces,TX,Passenger,1,1,2,61,63,3.17
January,31,2022,Dallas,TX,Passenger,1,0,1,129,130,0.77
January,31,2022,Solano,CA,Passenger,1,0,1,172,173,0.58
January,31,2022,Alameda,CA,Passenger,4,0,4,204,208,1.92
January,31,2022,Kitsap,WA,Passenger,2191,970,3161,179910,183071,1.73
January,31,2022,St. Clair,IL,Passenger,2,0,2,119,121,1.65
January,31,2022,Santa Clara,CA,Passenger,8,1,9,228,237,3.8
January,31,2022,Benton,WA,Truck,0,0,0,43600,43600,0
January,31,2022,Pierce,WA,Passenger,4367,2153,6520,554116,560636,1.16
January,31,2022,Portsmouth,VA,Passenger,0,1,1,76,77,1.3
January,31,2022,Pierce,WA,Truck,0,0,0,144454,144454,0
January,31,2022,Hamilton,OH,Passenger,1,0,1,30,31,3.23
January,31,2022,Cumberland,NC,Passenger,1,2,3,385,388,0.77
January,31,2022,Plaquemines,LA,Passenger,0,1,1,17,18,5.56
January,31,2022,Washington,MD,Passenger,2,0,2,14,16,12.5
January,31,2022,Suffolk,VA,Passenger,1,0,1,120,121,0.83
January,31,2022,Howard,IN,Passenger,0,1,1,6,7,14.29
January,31,2022,Harrison,MS,Passenger,2,0,2,43,45,4.44
January,31,2022,Kittitas,WA,Truck,0,0,0,14768,14768,0
January,31,2022,Wake,NC,Passenger,1,0,1,103,104,0.96
January,31,2022,Virginia Beach,VA,Passenger,2,0,2,556,558,0.36
January,31,2022,Williamson,TX,Passenger,1,2,3,88,91,3.3
January,31,2022,Pacific,WA,Passenger,55,63,118,16055,16173,0.73
January,31,2022,,,Passenger,14,7,21,1101,1122,1.87
January,31,2022,Moore,NC,Passenger,0,1,1,122,123,0.81
January,31,2022,Grant,WA,Truck,0,0,0,27996,27996,0
January,31,2022,Shelby,OH,Passenger,0,1,1,2,3,33.33
January,31,2022,Clallam,WA,Passenger,391,241,632,50236,50868,1.24
January,31,2022,Klamath,OR,Passenger,1,0,1,28,29,3.45
January,31,2022,Broward,FL,Passenger,2,0,2,91,93,2.15
January,31,2022,Prince William,VA,Passenger,1,1,2,200,202,0.99
January,31,2022,Penobscot,ME,Passenger,0,1,1,7,8,12.5
January,31,2022,Wilson,NC,Passenger,1,0,1,0,1,100
January,31,2022,Garfield,WA,Passenger,0,3,3,1356,1359,0.22
January,31,2022,Placer,CA,Passenger,2,0,2,71,73,2.74
January,31,2022,San Mateo,CA,Passenger,2,0,2,77,79,2.53
January,31,2022,Philadelphia,PA,Passenger,1,0,1,35,36,2.78
January,31,2022,Franklin,WA,Truck,0,0,0,20891,20891,0
January,31,2022,Ferry,WA,Passenger,14,3,17,4436,4453,0.38
January,31,2022,Carson City,NV,Passenger,1,0,1,8,9,11.11
January,31,2022,San Juan,WA,Truck,1,0,1,6022,6023,0.02
January,31,2022,Montgomery,PA,Passenger,2,0,2,22,24,8.33
January,31,2022,Chelan,WA,Passenger,421,117,538,54587,55125,0.98
January,31,2022,Thurston,WA,Passenger,1920,973,2893,196481,199374,1.45
January,31,2022,Clark,NV,Passenger,4,2,6,551,557,1.08
January,31,2022,Klickitat,WA,Passenger,90,54,144,15313,15457,0.93
January,31,2022,Kittitas,WA,Passenger,216,71,287,29812,30099,0.95
January,31,2022,Clark,WA,Truck,2,0,2,83892,83894,0
January,31,2022,Baltimore,MD,Passenger,1,0,1,79,80,1.25
January,31,2022,Grays Harbor,WA,Passenger,197,158,355,49346,49701,0.71
January,31,2022,Sarpy,NE,Passenger,1,0,1,57,58,1.72
January,31,2022,Allen,IN,Passenger,1,0,1,14,15,6.67
January,31,2022,Adams,WA,Truck,0,0,0,5434,5434,0
January,31,2022,Essex,NJ,Passenger,2,0,2,10,12,16.67
January,31,2022,Wood,OH,Passenger,0,1,1,4,5,20
January,31,2022,Queens,NY,Passenger,1,0,1,49,50,2
January,31,2022,Montgomery,MD,Passenger,3,2,5,195,200,2.5
January,31,2022,Yakima,WA,Truck,0,0,0,61615,61615,0
January,31,2022,Pinellas,FL,Passenger,0,1,1,84,85,1.18
January,31,2022,Skagit,WA,Passenger,701,307,1008,90876,91884,1.1
January,31,2022,Clallam,WA,Truck,1,0,1,22143,22144,0
January,31,2022,DuPage,IL,Passenger,1,0,1,49,50,2
January,31,2022,Marin,CA,Passenger,0,1,1,31,32,3.12
January,31,2022,Lake,FL,Passenger,1,0,1,22,23,4.35
January,31,2022,Honolulu,HI,Passenger,4,4,8,341,349,2.29
January,31,2022,Yamhill,OR,Passenger,1,0,1,30,31,3.23
January,31,2022,Juneau,AK,Passenger,0,1,1,28,29,3.45
January,31,2022,Travis,TX,Passenger,1,0,1,123,124,0.81
January,31,2022,Fort Bend,TX,Passenger,1,0,1,31,32,3.12
January,31,2022,Lee,FL,Passenger,1,0,1,28,29,3.45
January,31,2022,Sumter,SC,Passenger,0,1,1,34,35,2.86
January,31,2022,Hawaii,HI,Passenger,1,0,1,37,38,2.63
January,31,2022,Hudson,NJ,Passenger,2,0,2,36,38,5.26
January,31,2022,Champaign,IL,Passenger,1,0,1,10,11,9.09
January,31,2022,Lewis,WA,Truck,0,0,0,26654,26654,0
January,31,2022,Maricopa,AZ,Passenger,7,2,9,1014,1023,0.88
January,31,2022,Nassau,NY,Passenger,2,0,2,25,27,7.41
January,31,2022,Okaloosa,FL,Passenger,0,1,1,105,106,0.94
January,31,2022,Adams,WA,Passenger,17,14,31,13041,13072,0.24
January,31,2022,Oldham,KY,Passenger,0,1,1,4,5,20
January,31,2022,Wichita,TX,Passenger,1,0,1,41,42,2.38
January,31,2022,Albemarle,VA,Passenger,1,0,1,18,19,5.26
January,31,2022,Los Angeles,CA,Passenger,10,7,17,817,834,2.04
January,31,2022,Jefferson,WA,Truck,0,0,0,9571,9571,0
January,31,2022,Rockingham,NH,Passenger,1,0,1,17,18,5.56
January,31,2022,Pend Oreille,WA,Passenger,17,9,26,9118,9144,0.28
January,31,2022,Richmond,NY,Passenger,1,0,1,6,7,14.29
January,31,2022,Middlesex,MA,Passenger,0,1,1,83,84,1.19
January,31,2022,Cook,IL,Passenger,2,0,2,191,193,1.04
January,31,2022,Leavenworth,KS,Passenger,0,1,1,105,106,0.94
January,31,2022,Cowlitz,WA,Passenger,273,164,437,71316,71753,0.61
January,31,2022,San Diego,CA,Passenger,15,8,23,2380,2403,0.96
January,31,2022,Franklin,WA,Passenger,169,101,270,62152,62422,0.43
January,31,2022,Stafford,VA,Passenger,2,1,3,90,93,3.23
January,31,2022,Columbia,WA,Truck,0,0,0,1557,1557,0
January,31,2022,San Bernardino,CA,Passenger,1,1,2,349,351,0.57
January,31,2022,Fairfax,VA,Passenger,3,3,6,637,643,0.93
January,31,2022,Jefferson,NY,Passenger,0,1,1,201,202,0.5
January,31,2022,Stevens,WA,Truck,0,0,0,18938,18938,0
January,31,2022,Fresno,CA,Passenger,1,0,1,154,155,0.65
January,31,2022,Lincoln,WA,Truck,0,0,0,4835,4835,0
January,31,2022,Sacramento,CA,Passenger,2,0,2,204,206,0.97
January,31,2022,Escambia,FL,Passenger,0,1,1,136,137,0.73
January,31,2022,Denton,TX,Passenger,1,0,1,70,71,1.41
January,31,2022,Wahkiakum,WA,Truck,0,0,0,1816,1816,0
January,31,2022,Yellowstone,MT,Passenger,0,1,1,32,33,3.03
January,31,2022,Riverside,CA,Passenger,5,1,6,490,496,1.21
January,31,2022,Okanogan,WA,Truck,0,0,0,16692,16692,0
January,31,2022,Island,WA,Truck,1,0,1,21481,21482,0
January,31,2022,Vigo,IN,Passenger,1,0,1,5,6,16.67
January,31,2022,Charleston,SC,Passenger,2,1,3,70,73,4.11
January,31,2022,Pend Oreille,WA,Truck,0,0,0,5731,5731,0
January,31,2022,Loudoun,VA,Passenger,1,0,1,66,67,1.49
January,31,2022,Columbia,WA,Passenger,6,2,8,2452,2460,0.33
January,31,2022,Houston,GA,Passenger,1,0,1,40,41,2.44
January,31,2022,Snohomish,WA,Passenger,7221,2278,9499,536658,546157,1.74
January,31,2022,Ferry,WA,Truck,0,0,0,3582,3582,0
January,31,2022,Spokane,WA,Passenger,1350,766,2116,326674,328790,0.64
January,31,2022,Alexandria,VA,Passenger,2,0,2,111,113,1.77
January,31,2022,Douglas,NE,Passenger,1,2,3,46,49,6.12
January,31,2022,Manassas,VA,Passenger,0,1,1,7,8,12.5
January,31,2022,Tarrant,TX,Passenger,1,0,1,126,127,0.79
January,31,2022,Skagit,WA,Truck,1,0,1,32658,32659,0
January,31,2022,Danville,VA,Passenger,1,0,1,0,1,100
January,31,2022,Kern,CA,Passenger,0,1,1,195,196,0.51
January,31,2022,Douglas,CO,Passenger,0,1,1,75,76,1.32
January,31,2022,Suffolk,MA,Passenger,0,2,2,24,26,7.69
January,31,2022,Harris,TX,Passenger,1,0,1,159,160,0.62
January,31,2022,Galveston,TX,Passenger,0,1,1,20,21,4.76
January,31,2022,New York,NY,Passenger,1,0,1,36,37,2.7
January,31,2022,Whitman,WA,Truck,0,0,0,8565,8565,0
January,31,2022,San Luis Obispo,CA,Passenger,1,0,1,55,56,1.79
January,31,2022,Wahkiakum,WA,Passenger,17,11,28,3075,3103,0.9
January,31,2022,Rockdale,GA,Passenger,1,0,1,7,8,12.5
January,31,2022,Dorchester,SC,Passenger,1,0,1,63,64,1.56
January,31,2022,Powhatan,VA,Passenger,1,0,1,1,2,50
January,31,2022,Fairbanks North Star,AK,Passenger,0,1,1,76,77,1.3
January,31,2022,Lincoln,OR,Passenger,0,1,1,32,33,3.03
January,31,2022,Grays Harbor,WA,Truck,0,0,0,21347,21347,0
January,31,2022,Boone,MO,Passenger,0,1,1,9,10,10
January,31,2022,Lincoln,WA,Passenger,6,17,23,7738,7761,0.3
January,31,2022,Ventura,CA,Passenger,2,1,3,237,240,1.25
January,31,2022,Saratoga,NY,Passenger,1,0,1,39,40,2.5
January,31,2022,Coryell,TX,Passenger,1,0,1,103,104,0.96
January,31,2022,Asotin,WA,Passenger,23,17,40,12668,12708,0.31
January,31,2022,Hennepin,MN,Passenger,3,0,3,62,65,4.62
January,31,2022,Contra Costa,CA,Passenger,1,4,5,255,260,1.92
January,31,2022,Santa Cruz,CA,Passenger,1,0,1,23,24,4.17
January,31,2022,Allegheny,PA,Passenger,1,1,2,55,57,3.51
January,31,2022,Erie,NY,Passenger,1,0,1,30,31,3.23
January,31,2022,Camden,NJ,Passenger,0,1,1,13,14,7.14
January,31,2022,Douglas,WA,Truck,0,0,0,12682,12682,0
January,31,2022,Geary,KS,Passenger,1,0,1,91,92,1.09
January,31,2022,Collin,TX,Passenger,1,0,1,100,101,0.99
January,31,2022,Chesapeake,VA,Passenger,2,3,5,366,371,1.35
January,31,2022,Grant,WA,Passenger,140,100,240,66811,67051,0.36
January,31,2022,Pima,AZ,Passenger,1,1,2,246,248,0.81
January,31,2022,Ulster,NY,Passenger,1,0,1,9,10,10
January,31,2022,Kauai,HI,Passenger,1,0,1,17,18,5.56
January,31,2022,Platte,MO,Passenger,1,0,1,17,18,5.56
January,31,2022,Mason,WA,Passenger,272,161,433,47766,48199,0.9
January,31,2022,Multnomah,OR,Passenger,1,4,5,587,592,0.84
January,31,2022,DeKalb,GA,Passenger,1,0,1,54,55,1.82
January,31,2022,St. Louis,MO,Passenger,1,0,1,72,73,1.37
January,31,2022,Pacific,WA,Truck,0,0,0,8024,8024,0
January,31,2022,Spartanburg,SC,Passenger,0,1,1,47,48,2.08
January,31,2022,Kings,CA,Passenger,2,1,3,317,320,0.94
January,31,2022,Lake,IL,Passenger,3,0,3,149,152,1.97
January,31,2022,Prince George's,MD,Passenger,2,1,3,138,141,2.13
January,31,2022,Sevier,AR,Passenger,0,1,1,0,1,100
January,31,2022,Skamania,WA,Truck,0,0,0,3990,3990,0
January,31,2022,Wilson,TX,Passenger,0,1,1,2,3,33.33
January,31,2022,Bell,TX,Passenger,1,0,1,337,338,0.3
January,31,2022,St. Mary's,MD,Passenger,1,0,1,200,201,0.5
January,31,2022,Whitman,WA,Passenger,69,58,127,21971,22098,0.57
January,31,2022,Hamilton,IN,Passenger,2,0,2,21,23,8.7
January,31,2022,Greene,MO,Passenger,0,1,1,24,25,4
January,31,2022,Klickitat,WA,Truck,0,0,0,8335,8335,0
January,31,2022,Lane,OR,Passenger,0,1,1,104,105,0.95
January,31,2022,Sarasota,FL,Passenger,2,0,2,28,30,6.67
July,31,2022,Norfolk,VA,Passenger,2,3,5,277,282,1.77
July,31,2022,Pacific,WA,Truck,0,0,0,7881,7881,0
July,31,2022,Hidalgo,TX,Passenger,0,1,1,53,54,1.85
July,31,2022,Rock Island,IL,Passenger,0,1,1,14,15,6.67
July,31,2022,Tarrant,TX,Passenger,1,0,1,100,101,0.99
July,31,2022,Clackamas,OR,Passenger,2,0,2,135,137,1.46
July,31,2022,Clark,WA,Passenger,4229,1806,6035,315632,321667,1.88
July,31,2022,Prince George's,MD,Passenger,3,1,4,114,118,3.39
July,31,2022,Moore,NC,Passenger,0,1,1,110,111,0.9
July,31,2022,Cowlitz,WA,Truck,2,0,2,28483,28485,0.01
July,31,2022,Grays Harbor,WA,Passenger,214,162,376,48927,49303,0.76
July,31,2022,Alexandria,VA,Passenger,3,0,3,106,109,2.75
July,31,2022,Boulder,CO,Passenger,1,0,1,32,33,3.03
July,31,2022,Collin,TX,Passenger,2,0,2,75,77,2.6
July,31,2022,Pend Oreille,WA,Passenger,18,12,30,9043,9073,0.33
July,31,2022,Santa Clara,CA,Passenger,10,2,12,207,219,5.48
July,31,2022,Prince William,VA,Passenger,0,1,1,185,186,0.54
July,31,2022,Benton,WA,Passenger,780,462,1242,135328,136570,0.91
July,31,2022,Kings,CA,Passenger,2,1,3,297,300,1
July,31,2022,Berkeley,SC,Passenger,0,1,1,115,116,0.86
July,31,2022,Richmond,GA,Passenger,0,1,1,60,61,1.64
July,31,2022,Skamania,WA,Passenger,76,47,123,8163,8286,1.48
July,31,2022,Harrison,MS,Passenger,1,0,1,39,40,2.5
July,31,2022,Allegheny,PA,Passenger,1,1,2,51,53,3.77
July,31,2022,Lee,FL,Passenger,1,0,1,28,29,3.45
July,31,2022,Loudoun,VA,Passenger,2,1,3,63,66,4.55
July,31,2022,Clark,WA,Truck,9,0,9,82552,82561,0.01
July,31,2022,Skagit,WA,Truck,5,0,5,32300,32305,0.02
July,31,2022,Escambia,FL,Passenger,0,1,1,125,126,0.79
July,31,2022,Santa Cruz,CA,Passenger,1,0,1,21,22,4.55
July,31,2022,Spokane,WA,Truck,8,0,8,102044,102052,0.01
July,31,2022,Lincoln,OR,Passenger,0,1,1,23,24,4.17
July,31,2022,Bexar,TX,Passenger,4,3,7,424,431,1.62
July,31,2022,Albemarle,VA,Passenger,1,0,1,16,17,5.88
July,31,2022,Thurston,WA,Passenger,2242,1065,3307,193613,196920,1.68
July,31,2022,Contra Costa,CA,Passenger,0,4,4,231,235,1.7
July,31,2022,Spokane,WA,Passenger,1676,864,2540,324816,327356,0.78
July,31,2022,Douglas,NE,Passenger,1,2,3,38,41,7.32
July,31,2022,Clallam,WA,Passenger,432,246,678,49651,50329,1.35
July,31,2022,Lake,FL,Passenger,1,0,1,16,17,5.88
July,31,2022,Asotin,WA,Passenger,24,19,43,12650,12693,0.34
July,31,2022,New London,CT,Passenger,2,5,7,187,194,3.61
July,31,2022,Dorchester,SC,Passenger,1,0,1,49,50,2
July,31,2022,Louisa,VA,Passenger,0,1,1,1,2,50
July,31,2022,Chesapeake,VA,Passenger,3,3,6,320,326,1.84
July,31,2022,Kern,CA,Passenger,0,1,1,186,187,0.53
July,31,2022,Whitman,WA,Truck,2,0,2,8570,8572,0.02
July,31,2022,Owyhee,ID,Passenger,1,0,1,2,3,33.33
July,31,2022,Ferry,WA,Truck,0,0,0,3566,3566,0
July,31,2022,Hillsborough,FL,Passenger,0,1,1,116,117,0.85
July,31,2022,Sheridan,WY,Passenger,1,0,1,7,8,12.5
July,31,2022,Richmond,NY,Passenger,1,0,1,6,7,14.29
July,31,2022,Multnomah,OR,Passenger,0,3,3,503,506,0.59
July,31,2022,Hoke,NC,Passenger,1,0,1,64,65,1.54
July,31,2022,Columbia,WA,Truck,0,0,0,1577,1577,0
July,31,2022,Danville,VA,Passenger,1,0,1,0,1,100
July,31,2022,Monterey,CA,Passenger,1,1,2,124,126,1.59
July,31,2022,Walla Walla,WA,Passenger,175,99,274,35828,36102,0.76
July,31,2022,Sedgwick,KS,Passenger,1,1,2,70,72,2.78
July,31,2022,Hawaii,HI,Passenger,1,0,1,34,35,2.86
July,31,2022,Essex,NJ,Passenger,2,0,2,9,11,18.18
July,31,2022,Stevens,WA,Truck,1,0,1,18912,18913,0.01
July,31,2022,Arlington,VA,Passenger,1,0,1,121,122,0.82
July,31,2022,San Mateo,CA,Passenger,2,0,2,75,77,2.6
July,31,2022,Harris,TX,Passenger,1,0,1,127,128,0.78
July,31,2022,Lewis,WA,Truck,0,0,0,26347,26347,0
July,31,2022,Bell,TX,Passenger,1,0,1,301,302,0.33
July,31,2022,Los Angeles,CA,Passenger,8,8,16,730,746,2.14
July,31,2022,Jefferson,WA,Passenger,442,219,661,24548,25209,2.62
July,31,2022,Kitsap,WA,Truck,13,0,13,53416,53429,0.02
July,31,2022,Walla Walla,WA,Truck,1,0,1,13918,13919,0.01
July,31,2022,Spartanburg,SC,Passenger,0,1,1,37,38,2.63
July,31,2022,Ulster,NY,Passenger,1,0,1,8,9,11.11
July,31,2022,St. Clair,IL,Passenger,2,0,2,115,117,1.71
July,31,2022,Randolph,NC,Passenger,1,0,1,5,6,16.67
July,31,2022,Alameda,CA,Passenger,4,0,4,177,181,2.21
July,31,2022,Snohomish,WA,Truck,27,0,27,123535,123562,0.02
July,31,2022,Adams,CO,Passenger,1,0,1,38,39,2.56
July,31,2022,Lane,OR,Passenger,0,1,1,88,89,1.12
July,31,2022,Suffolk,VA,Passenger,1,0,1,119,120,0.83
July,31,2022,Placer,CA,Passenger,2,0,2,64,66,3.03
July,31,2022,Stevens,WA,Passenger,72,54,126,30084,30210,0.42
July,31,2022,Whitman,WA,Passenger,88,60,148,21969,22117,0.67
July,31,2022,Marin,CA,Passenger,0,1,1,27,28,3.57
July,31,2022,Pierce,WA,Passenger,5245,2337,7582,543947,551529,1.37
July,31,2022,Wood,OH,Passenger,0,1,1,3,4,25
July,31,2022,Hennepin,MN,Passenger,1,0,1,45,46,2.17
July,31,2022,Goochland,VA,Passenger,2,1,3,109,112,2.68
July,31,2022,Wake,NC,Passenger,1,0,1,78,79,1.27
July,31,2022,San Juan,WA,Truck,4,0,4,5948,5952,0.07
July,31,2022,Okanogan,WA,Truck,1,0,1,16589,16590,0.01
July,31,2022,Carroll,NH,Passenger,0,1,1,5,6,16.67
July,31,2022,Burlington,NJ,Passenger,0,2,2,104,106,1.89
July,31,2022,Wahkiakum,WA,Truck,0,0,0,1801,1801,0
July,31,2022,St. Mary's,MD,Passenger,1,0,1,184,185,0.54
July,31,2022,Larimer,CO,Passenger,1,0,1,44,45,2.22
July,31,2022,Sevier,AR,Passenger,0,1,1,0,1,100
July,31,2022,Middlesex,MA,Passenger,2,1,3,71,74,4.05
July,31,2022,Charles,MD,Passenger,1,1,2,56,58,3.45
July,31,2022,Whatcom,WA,Passenger,1864,754,2618,148809,151427,1.73
July,31,2022,Lincoln,WA,Passenger,9,16,25,7715,7740,0.32
July,31,2022,Queens,NY,Passenger,1,0,1,39,40,2.5
July,31,2022,Allen,IN,Passenger,1,0,1,13,14,7.14
July,31,2022,Bartow,GA,Passenger,0,1,1,3,4,25
July,31,2022,Nueces,TX,Passenger,1,1,2,52,54,3.7
July,31,2022,Harnett,NC,Passenger,2,0,2,139,141,1.42
July,31,2022,Jefferson,NY,Passenger,0,1,1,199,200,0.5
July,31,2022,Franklin,WA,Passenger,203,110,313,61860,62173,0.5
July,31,2022,Orange,CA,Passenger,6,2,8,328,336,2.38
July,31,2022,Ferry,WA,Passenger,21,4,25,4378,4403,0.57
July,31,2022,Williams,ND,Passenger,0,1,1,5,6,16.67
July,31,2022,Maricopa,AZ,Passenger,7,1,8,845,853,0.94
July,31,2022,San Joaquin,CA,Passenger,1,1,2,81,83,2.41
July,31,2022,Arapahoe,CO,Passenger,0,1,1,76,77,1.3
July,31,2022,New Haven,CT,Passenger,0,2,2,26,28,7.14
July,31,2022,Wahkiakum,WA,Passenger,24,12,36,3071,3107,1.16
July,31,2022,Franklin,WA,Truck,1,0,1,20873,20874,0
July,31,2022,Garfield,WA,Passenger,1,3,4,1326,1330,0.3
July,31,2022,Grays Harbor,WA,Truck,2,0,2,21240,21242,0.01
July,31,2022,Rockdale,GA,Passenger,1,0,1,7,8,12.5
July,31,2022,Wichita,TX,Passenger,1,0,1,38,39,2.56
July,31,2022,Juneau,AK,Passenger,0,1,1,29,30,3.33
July,31,2022,Duval,FL,Passenger,1,2,3,263,266,1.13
July,31,2022,Manassas,VA,Passenger,0,1,1,8,9,11.11
July,31,2022,Frederick,MD,Passenger,1,0,1,60,61,1.64
July,31,2022,Kittitas,WA,Passenger,278,86,364,29692,30056,1.21
July,31,2022,Lincoln,WA,Truck,0,0,0,4833,4833,0
July,31,2022,Lake,IL,Passenger,2,0,2,129,131,1.53
July,31,2022,Skagit,WA,Passenger,813,345,1158,89848,91006,1.27
July,31,2022,Lewis,WA,Passenger,246,177,423,59694,60117,0.7
July,31,2022,Philadelphia,PA,Passenger,1,0,1,34,35,2.86
July,31,2022,Garfield,WA,Truck,0,0,0,976,976,0
July,31,2022,Gwinnett,GA,Passenger,1,0,1,48,49,2.04
July,31,2022,Saratoga,NY,Passenger,1,0,1,39,40,2.5
July,31,2022,Honolulu,HI,Passenger,4,3,7,312,319,2.19
July,31,2022,Coryell,TX,Passenger,1,0,1,91,92,1.09
July,31,2022,Benton,WA,Truck,3,0,3,43487,43490,0.01
July,31,2022,Salt Lake,UT,Passenger,1,1,2,118,120,1.67
July,31,2022,Pierce,WA,Truck,20,0,20,141272,141292,0.01
July,31,2022,Grant,WA,Passenger,183,100,283,66683,66966,0.42
July,31,2022,Howard,IN,Passenger,0,1,1,4,5,20
July,31,2022,Leavenworth,KS,Passenger,0,1,1,97,98,1.02
July,31,2022,Chelan,WA,Passenger,478,125,603,54238,54841,1.1
July,31,2022,Anchorage,AK,Passenger,1,0,1,114,115,0.87
July,31,2022,Fairfax,VA,Passenger,6,3,9,590,599,1.5
July,31,2022,Miami-Dade,FL,Passenger,1,0,1,75,76,1.32
July,31,2022,San Juan,WA,Passenger,521,160,681,14025,14706,4.63
July,31,2022,Kittitas,WA,Truck,1,0,1,14616,14617,0.01
July,31,2022,Wilson,TX,Passenger,0,1,1,2,3,33.33
July,31,2022,Onslow,NC,Passenger,0,1,1,157,158,0.63
July,31,2022,DeKalb,GA,Passenger,1,0,1,45,46,2.17
July,31,2022,Cumberland,NC,Passenger,1,2,3,339,342,0.88
July,31,2022,Denton,TX,Passenger,1,0,1,61,62,1.61
July,31,2022,Elmore,ID,Passenger,1,0,1,12,13,7.69
July,31,2022,Kauai,HI,Passenger,1,0,1,15,16,6.25
July,31,2022,Washington,MD,Passenger,2,0,2,15,17,11.76
July,31,2022,Ventura,CA,Passenger,2,1,3,222,225,1.33
July,31,2022,Thurston,WA,Truck,8,0,8,55356,55364,0.01
July,31,2022,Columbia,WA,Passenger,7,0,7,2430,2437,0.29
July,31,2022,San Diego,CA,Passenger,16,11,27,2199,2226,1.21
July,31,2022,Stafford,VA,Passenger,2,1,3,84,87,3.45
July,31,2022,Pacific,WA,Passenger,64,71,135,15841,15976,0.85
July,31,2022,Nassau,NY,Passenger,2,0,2,23,25,8
July,31,2022,Okanogan,WA,Passenger,88,49,137,26298,26435,0.52
July,31,2022,Cowlitz,WA,Passenger,349,171,520,70574,71094,0.73
July,31,2022,Rockingham,NH,Passenger,1,0,1,14,15,6.67
July,31,2022,Douglas,WA,Truck,1,0,1,12747,12748,0.01
July,31,2022,Yakima,WA,Passenger,353,198,551,166690,167241,0.33
July,31,2022,Pennington,SD,Passenger,2,0,2,24,26,7.69
July,31,2022,Portsmouth,VA,Passenger,0,1,1,73,74,1.35
July,31,2022,Plaquemines,LA,Passenger,1,1,2,16,18,11.11
July,31,2022,Las Animas,CO,Passenger,1,0,1,1,2,50
July,31,2022,Douglas,WA,Passenger,138,60,198,28404,28602,0.69
July,31,2022,Penobscot,ME,Passenger,0,1,1,8,9,11.11
July,31,2022,Yellowstone,MT,Passenger,0,1,1,21,22,4.55
July,31,2022,Williamson,TX,Passenger,1,2,3,77,80,3.75
July,31,2022,Klickitat,WA,Truck,0,0,0,8286,8286,0
July,31,2022,Island,WA,Truck,6,0,6,21337,21343,0.03
July,31,2022,St. Louis,MO,Passenger,1,0,1,59,60,1.67
July,31,2022,Fort Bend,TX,Passenger,1,0,1,24,25,4
July,31,2022,Rogers,OK,Passenger,1,0,1,1,2,50
July,31,2022,San Bernardino,CA,Passenger,1,1,2,310,312,0.64
July,31,2022,Hamilton,IN,Passenger,1,0,1,17,18,5.56
July,31,2022,Bryan,GA,Passenger,0,1,1,39,40,2.5
July,31,2022,Ray,MO,Passenger,0,1,1,1,2,50
July,31,2022,King,WA,Passenger,41908,11450,53358,1347349,1400707,3.81
July,31,2022,Sumter,SC,Passenger,0,1,1,32,33,3.03
July,31,2022,Adams,WA,Truck,1,0,1,5458,5459,0.02
July,31,2022,Sonoma,CA,Passenger,0,1,1,73,74,1.35
July,31,2022,Klickitat,WA,Passenger,106,56,162,15204,15366,1.05
July,31,2022,Camden,NJ,Passenger,0,1,1,12,13,7.69
July,31,2022,Skamania,WA,Truck,0,0,0,3948,3948,0
July,31,2022,Fairbanks North Star,AK,Passenger,0,1,1,70,71,1.41
July,31,2022,Chelan,WA,Truck,4,0,4,23054,23058,0.02
July,31,2022,Cape May,NJ,Passenger,0,1,1,7,8,12.5
July,31,2022,Mason,WA,Truck,4,0,4,20985,20989,0.02
July,31,2022,Houston,GA,Passenger,1,0,1,30,31,3.23
July,31,2022,Clallam,WA,Truck,3,0,3,21895,21898,0.01
July,31,2022,Whatcom,WA,Truck,11,0,11,43223,43234,0.03
July,31,2022,Douglas,CO,Passenger,0,1,1,68,69,1.45
July,31,2022,Sarasota,FL,Passenger,2,0,2,22,24,8.33
July,31,2022,Hamilton,OH,Passenger,1,0,1,26,27,3.7
July,31,2022,Montgomery,AL,Passenger,0,1,1,33,34,2.94
July,31,2022,Mason,WA,Passenger,320,176,496,47125,47621,1.04
July,31,2022,District of Columbia,DC,Passenger,4,0,4,167,171,2.34
July,31,2022,Adams,WA,Passenger,19,10,29,12942,12971,0.22
July,31,2022,Virginia Beach,VA,Passenger,2,0,2,493,495,0.4
July,31,2022,Sacramento,CA,Passenger,3,0,3,188,191,1.57
July,31,2022,El Paso,TX,Passenger,2,0,2,317,319,0.63
July,31,2022,Pend Oreille,WA,Truck,0,0,0,5648,5648,0
July,31,2022,Oldham,KY,Passenger,0,1,1,4,5,20
July,31,2022,Calvert,MD,Passenger,0,2,2,75,77,2.6
July,31,2022,Okaloosa,FL,Passenger,0,1,1,97,98,1.02
July,31,2022,Travis,TX,Passenger,1,0,1,98,99,1.01
July,31,2022,Asotin,WA,Truck,0,0,0,6688,6688,0
July,31,2022,,,Passenger,15,7,22,1187,1209,1.82
July,31,2022,Pulaski,AR,Passenger,1,0,1,26,27,3.7
July,31,2022,St. Tammany,LA,Passenger,1,0,1,33,34,2.94
July,31,2022,Montgomery,MD,Passenger,4,2,6,191,197,3.05
July,31,2022,Hudson,NJ,Passenger,2,0,2,32,34,5.88
July,31,2022,Island,WA,Passenger,835,380,1215,61863,63078,1.93
July,31,2022,Charleston,SC,Passenger,2,2,4,59,63,6.35
July,31,2022,Anne Arundel,MD,Passenger,4,4,8,330,338,2.37
July,31,2022,Orange,FL,Passenger,1,0,1,81,82,1.22
July,31,2022,Montgomery,PA,Passenger,1,0,1,20,21,4.76
July,31,2022,Sarpy,NE,Passenger,1,0,1,52,53,1.89
July,31,2022,Cumberland,PA,Passenger,1,0,1,36,37,2.7
July,31,2022,Grant,WA,Truck,0,0,0,27963,27963,0
July,31,2022,Geary,KS,Passenger,1,0,1,83,84,1.19
July,31,2022,Riverside,CA,Passenger,7,1,8,439,447,1.79
July,31,2022,Cook,IL,Passenger,2,0,2,175,177,1.13
July,31,2022,Yakima,WA,Truck,1,0,1,61344,61345,0
July,31,2022,Kitsap,WA,Passenger,2463,1074,3537,178200,181737,1.95
July,31,2022,Howard,MD,Passenger,0,1,1,52,53,1.89
July,31,2022,King,WA,Truck,123,2,125,180390,180515,0.07
July,31,2022,Platte,MO,Passenger,1,0,1,21,22,4.55
July,31,2022,Jefferson,WA,Truck,3,0,3,9457,9460,0.03
July,31,2022,Greene,MO,Passenger,0,1,1,19,20,5
July,31,2022,Broward,FL,Passenger,1,0,1,73,74,1.35
July,31,2022,El Paso,CO,Passenger,2,1,3,567,570,0.53
July,31,2022,Snohomish,WA,Passenger,8662,2565,11227,531561,542788,2.07
July,31,2022,Clark,NV,Passenger,4,2,6,485,491,1.22
July,31,2022,Carroll,MD,Passenger,0,1,1,16,17,5.88
July,31,2022,Galveston,TX,Passenger,0,1,1,18,19,5.26
July,31,2022,Solano,CA,Passenger,1,0,1,154,155,0.65
June,30,2022,San Joaquin,CA,Passenger,1,1,2,85,87,2.3
June,30,2022,Broward,FL,Passenger,1,0,1,74,75,1.33
June,30,2022,Boulder,CO,Passenger,1,0,1,33,34,2.94
June,30,2022,Clallam,WA,Truck,3,0,3,21937,21940,0.01
June,30,2022,Fairfax,VA,Passenger,6,3,9,597,606,1.49
June,30,2022,Middlesex,MA,Passenger,2,1,3,73,76,3.95
June,30,2022,Albemarle,VA,Passenger,1,0,1,16,17,5.88
June,30,2022,San Mateo,CA,Passenger,2,0,2,78,80,2.5
June,30,2022,Montgomery,AL,Passenger,0,1,1,33,34,2.94
June,30,2022,Cumberland,NC,Passenger,1,2,3,351,354,0.85
June,30,2022,Hudson,NJ,Passenger,2,0,2,34,36,5.56
June,30,2022,Lane,OR,Passenger,0,1,1,88,89,1.12
June,30,2022,Sonoma,CA,Passenger,0,1,1,74,75,1.33
June,30,2022,Howard,IN,Passenger,0,1,1,4,5,20
June,30,2022,Denton,TX,Passenger,1,0,1,62,63,1.59
June,30,2022,Whitman,WA,Truck,1,0,1,8572,8573,0.01
June,30,2022,Yakima,WA,Truck,1,0,1,61408,61409,0
June,30,2022,Los Angeles,CA,Passenger,8,8,16,745,761,2.1
June,30,2022,Lee,FL,Passenger,1,0,1,29,30,3.33
June,30,2022,Collin,TX,Passenger,2,0,2,79,81,2.47
June,30,2022,Essex,NJ,Passenger,2,0,2,9,11,18.18
June,30,2022,Adams,WA,Truck,1,0,1,5468,5469,0.02
June,30,2022,Ferry,WA,Passenger,19,4,23,4409,4432,0.52
June,30,2022,Howard,MD,Passenger,0,1,1,54,55,1.82
June,30,2022,El Paso,CO,Passenger,3,1,4,588,592,0.68
June,30,2022,Lewis,WA,Truck,0,0,0,26412,26412,0
June,30,2022,Pima,AZ,Passenger,1,0,1,216,217,0.46
June,30,2022,Arlington,VA,Passenger,1,0,1,123,124,0.81
June,30,2022,San Diego,CA,Passenger,15,11,26,2238,2264,1.15
June,30,2022,Dorchester,SC,Passenger,1,0,1,53,54,1.85
June,30,2022,Island,WA,Passenger,818,379,1197,61948,63145,1.9
June,30,2022,Kitsap,WA,Truck,4,0,4,53663,53667,0.01
June,30,2022,Kauai,HI,Passenger,1,0,1,15,16,6.25
June,30,2022,Washington,MD,Passenger,2,0,2,15,17,11.76
June,30,2022,Lincoln,WA,Passenger,8,18,26,7710,7736,0.34
June,30,2022,Stevens,WA,Truck,0,0,0,18951,18951,0
June,30,2022,Oldham,KY,Passenger,0,1,1,4,5,20
June,30,2022,Allegheny,PA,Passenger,1,1,2,51,53,3.77
June,30,2022,Adams,WA,Passenger,17,10,27,12936,12963,0.21
June,30,2022,Lake,IL,Passenger,2,0,2,134,136,1.47
June,30,2022,Mason,WA,Truck,1,0,1,21067,21068,0
June,30,2022,Okanogan,WA,Truck,1,0,1,16648,16649,0.01
June,30,2022,Jefferson,WA,Passenger,434,217,651,24594,25245,2.58
June,30,2022,Kern,CA,Passenger,0,1,1,186,187,0.53
June,30,2022,Island,WA,Truck,4,0,4,21382,21386,0.02
June,30,2022,Monterey,CA,Passenger,1,1,2,126,128,1.56
June,30,2022,Bell,TX,Passenger,1,0,1,307,308,0.32
June,30,2022,Thurston,WA,Passenger,2182,1055,3237,194425,197662,1.64
June,30,2022,Rogers,OK,Passenger,1,0,1,1,2,50
June,30,2022,Walla Walla,WA,Truck,0,0,0,13934,13934,0
June,30,2022,Fairbanks North Star,AK,Passenger,0,1,1,72,73,1.37
June,30,2022,Whatcom,WA,Truck,7,0,7,43365,43372,0.02
June,30,2022,Garfield,WA,Truck,0,0,0,984,984,0
June,30,2022,Clark,NV,Passenger,4,2,6,502,508,1.18
June,30,2022,Camden,NJ,Passenger,0,1,1,13,14,7.14
June,30,2022,Mason,WA,Passenger,311,177,488,47350,47838,1.02
June,30,2022,St. Tammany,LA,Passenger,1,0,1,33,34,2.94
June,30,2022,Cook,IL,Passenger,2,0,2,182,184,1.09
June,30,2022,Pennington,SD,Passenger,2,0,2,26,28,7.14
June,30,2022,Sacramento,CA,Passenger,3,0,3,187,190,1.58
June,30,2022,Riverside,CA,Passenger,8,1,9,449,458,1.97
June,30,2022,Benton,WA,Truck,3,0,3,43576,43579,0.01
June,30,2022,Douglas,CO,Passenger,0,1,1,70,71,1.41
June,30,2022,Carson City,NV,Passenger,1,0,1,7,8,12.5
June,30,2022,Spokane,WA,Truck,1,0,1,102259,102260,0
June,30,2022,Douglas,WA,Truck,0,0,0,12790,12790,0
June,30,2022,Duval,FL,Passenger,1,2,3,267,270,1.11
June,30,2022,San Luis Obispo,CA,Passenger,1,0,1,53,54,1.85
June,30,2022,Hillsborough,FL,Passenger,0,1,1,119,120,0.83
June,30,2022,Danville,VA,Passenger,1,0,1,0,1,100
June,30,2022,Prince George's,MD,Passenger,3,1,4,118,122,3.28
June,30,2022,Maricopa,AZ,Passenger,7,2,9,873,882,1.02
June,30,2022,Harrison,MS,Passenger,1,0,1,42,43,2.33
June,30,2022,Gwinnett,GA,Passenger,1,0,1,47,48,2.08
June,30,2022,Geary,KS,Passenger,1,0,1,83,84,1.19
June,30,2022,Skamania,WA,Passenger,73,47,120,8213,8333,1.44
June,30,2022,Wahkiakum,WA,Passenger,23,11,34,3072,3106,1.09
June,30,2022,Pend Oreille,WA,Passenger,17,11,28,9056,9084,0.31
June,30,2022,Wahkiakum,WA,Truck,0,0,0,1804,1804,0
June,30,2022,Lincoln,OR,Passenger,0,1,1,26,27,3.7
June,30,2022,Las Animas,CO,Passenger,1,0,1,1,2,50
June,30,2022,,,Passenger,15,7,22,1153,1175,1.87
June,30,2022,Loudoun,VA,Passenger,2,1,3,64,67,4.48
June,30,2022,Placer,CA,Passenger,2,0,2,65,67,2.99
June,30,2022,San Juan,WA,Passenger,513,157,670,14067,14737,4.55
June,30,2022,Stevens,WA,Passenger,68,54,122,30173,30295,0.4
June,30,2022,Platte,MO,Passenger,1,0,1,21,22,4.55
June,30,2022,San Bernardino,CA,Passenger,1,1,2,320,322,0.62
June,30,2022,Skagit,WA,Passenger,780,337,1117,90139,91256,1.22
June,30,2022,Douglas,NE,Passenger,1,2,3,39,42,7.14
June,30,2022,Pinellas,FL,Passenger,0,1,1,71,72,1.39
June,30,2022,Leavenworth,KS,Passenger,0,1,1,102,103,0.97
June,30,2022,Skagit,WA,Truck,3,0,3,32352,32355,0.01
June,30,2022,Clallam,WA,Passenger,421,249,670,49776,50446,1.33
June,30,2022,Rock Island,IL,Passenger,0,1,1,14,15,6.67
June,30,2022,New Haven,CT,Passenger,0,2,2,27,29,6.9
June,30,2022,Stafford,VA,Passenger,2,1,3,87,90,3.33
June,30,2022,Yellowstone,MT,Passenger,0,1,1,22,23,4.35
June,30,2022,Coryell,TX,Passenger,1,0,1,97,98,1.02
June,30,2022,Galveston,TX,Passenger,0,1,1,18,19,5.26
June,30,2022,Burlington,NJ,Passenger,0,2,2,108,110,1.82
June,30,2022,Nueces,TX,Passenger,1,1,2,52,54,3.7
June,30,2022,Klickitat,WA,Truck,0,0,0,8294,8294,0
June,30,2022,Orange,FL,Passenger,1,0,1,87,88,1.14
June,30,2022,Santa Clara,CA,Passenger,10,2,12,216,228,5.26
June,30,2022,Montgomery,TX,Passenger,1,0,1,28,29,3.45
June,30,2022,Chelan,WA,Truck,3,0,3,23068,23071,0.01
June,30,2022,Queens,NY,Passenger,1,0,1,38,39,2.56
June,30,2022,Boone,MO,Passenger,0,1,1,8,9,11.11
June,30,2022,Berkeley,SC,Passenger,0,1,1,117,118,0.85
June,30,2022,Richmond,NY,Passenger,1,0,1,6,7,14.29
June,30,2022,Okaloosa,FL,Passenger,0,1,1,98,99,1.01
June,30,2022,Cape May,NJ,Passenger,0,1,1,7,8,12.5
June,30,2022,Harris,TX,Passenger,1,0,1,136,137,0.73
June,30,2022,Alexandria,VA,Passenger,3,0,3,108,111,2.7
June,30,2022,Jefferson,NY,Passenger,0,1,1,201,202,0.5
June,30,2022,Plaquemines,LA,Passenger,1,1,2,16,18,11.11
June,30,2022,Allen,IN,Passenger,1,0,1,13,14,7.14
June,30,2022,Lincoln,WA,Truck,0,0,0,4832,4832,0
June,30,2022,Williams,ND,Passenger,0,1,1,6,7,14.29
June,30,2022,New London,CT,Passenger,2,5,7,183,190,3.68
June,30,2022,Sumter,SC,Passenger,0,1,1,32,33,3.03
June,30,2022,Sarasota,FL,Passenger,2,0,2,23,25,8
June,30,2022,Garfield,WA,Passenger,0,3,3,1322,1325,0.23
June,30,2022,Franklin,WA,Truck,0,0,0,20900,20900,0
June,30,2022,DuPage,IL,Passenger,1,0,1,45,46,2.17
June,30,2022,King,WA,Truck,66,1,67,180923,180990,0.04
June,30,2022,Benton,WA,Passenger,751,461,1212,135364,136576,0.89
June,30,2022,Asotin,WA,Truck,0,0,0,6720,6720,0
June,30,2022,Charles,MD,Passenger,1,1,2,55,57,3.51
June,30,2022,Penobscot,ME,Passenger,0,1,1,7,8,12.5
June,30,2022,Asotin,WA,Passenger,23,19,42,12740,12782,0.33
June,30,2022,Montgomery,PA,Passenger,2,0,2,21,23,8.7
June,30,2022,Kittitas,WA,Truck,1,0,1,14655,14656,0.01
June,30,2022,Moore,NC,Passenger,0,1,1,113,114,0.88
June,30,2022,Salt Lake,UT,Passenger,1,1,2,123,125,1.6
June,30,2022,St. Louis,MO,Passenger,1,0,1,61,62,1.61
June,30,2022,Pend Oreille,WA,Truck,0,0,0,5670,5670,0
June,30,2022,Spartanburg,SC,Passenger,0,1,1,38,39,2.56
June,30,2022,King,WA,Passenger,40732,11318,52050,1349910,1401960,3.71
June,30,2022,Sarpy,NE,Passenger,1,0,1,52,53,1.89
June,30,2022,Pacific,WA,Truck,0,0,0,7916,7916,0
June,30,2022,Calvert,MD,Passenger,0,2,2,76,78,2.56
June,30,2022,Owyhee,ID,Passenger,1,0,1,2,3,33.33
June,30,2022,Charleston,SC,Passenger,2,2,4,59,63,6.35
June,30,2022,Skamania,WA,Truck,0,0,0,3971,3971,0
June,30,2022,Hennepin,MN,Passenger,1,0,1,46,47,2.13
June,30,2022,El Paso,TX,Passenger,2,0,2,324,326,0.61
June,30,2022,Kittitas,WA,Passenger,266,83,349,29763,30112,1.16
June,30,2022,Montgomery,MD,Passenger,4,2,6,195,201,2.99
June,30,2022,Bexar,TX,Passenger,4,3,7,429,436,1.61
June,30,2022,Okanogan,WA,Passenger,83,50,133,26390,26523,0.5
June,30,2022,Chelan,WA,Passenger,461,126,587,54351,54938,1.07
June,30,2022,Spokane,WA,Passenger,1602,848,2450,325470,327920,0.75
June,30,2022,Wichita,TX,Passenger,1,0,1,38,39,2.56
June,30,2022,Contra Costa,CA,Passenger,0,4,4,241,245,1.63
June,30,2022,Lake,FL,Passenger,1,0,1,18,19,5.26
June,30,2022,Ulster,NY,Passenger,1,0,1,9,10,10
June,30,2022,Grant,WA,Truck,0,0,0,28025,28025,0
June,30,2022,Hamilton,OH,Passenger,1,0,1,27,28,3.57
June,30,2022,Carroll,NH,Passenger,0,1,1,5,6,16.67
June,30,2022,Kitsap,WA,Passenger,2393,1054,3447,178654,182101,1.89
June,30,2022,Pierce,WA,Passenger,5062,2311,7373,546060,553433,1.33
June,30,2022,Tarrant,TX,Passenger,1,0,1,107,108,0.93
June,30,2022,Whitman,WA,Passenger,87,60,147,22018,22165,0.66
June,30,2022,Travis,TX,Passenger,1,0,1,104,105,0.95
June,30,2022,Snohomish,WA,Passenger,8361,2528,10889,532982,543871,2
June,30,2022,Columbia,WA,Passenger,7,0,7,2444,2451,0.29
June,30,2022,Elmore,ID,Passenger,1,0,1,12,13,7.69
June,30,2022,San Juan,WA,Truck,1,0,1,5986,5987,0.02
June,30,2022,Walla Walla,WA,Passenger,172,101,273,35914,36187,0.75
June,30,2022,Bartow,GA,Passenger,0,1,1,3,4,25
June,30,2022,Suffolk,VA,Passenger,1,0,1,121,122,0.82
June,30,2022,Randolph,NC,Passenger,1,0,1,5,6,16.67
June,30,2022,Saratoga,NY,Passenger,1,0,1,39,40,2.5
June,30,2022,Richmond,GA,Passenger,0,1,1,63,64,1.56
June,30,2022,Sheridan,WY,Passenger,1,0,1,6,7,14.29
June,30,2022,Goochland,VA,Passenger,2,2,4,114,118,3.39
June,30,2022,Rockingham,NH,Passenger,1,0,1,14,15,6.67
June,30,2022,Prince William,VA,Passenger,0,1,1,188,189,0.53
June,30,2022,Escambia,FL,Passenger,0,1,1,126,127,0.79
June,30,2022,Douglas,WA,Passenger,131,58,189,28498,28687,0.66
June,30,2022,Grant,WA,Passenger,175,99,274,66817,67091,0.41
June,30,2022,Louisa,VA,Passenger,0,1,1,1,2,50
June,30,2022,Clark,WA,Passenger,4095,1781,5876,316688,322564,1.82
June,30,2022,Grays Harbor,WA,Truck,1,0,1,21324,21325,0
June,30,2022,Wilson,TX,Passenger,0,1,1,2,3,33.33
June,30,2022,Carroll,MD,Passenger,0,1,1,15,16,6.25
June,30,2022,Greene,MO,Passenger,0,1,1,20,21,4.76
June,30,2022,Richland,SC,Passenger,0,1,1,123,124,0.81
June,30,2022,DeKalb,GA,Passenger,1,0,1,46,47,2.13
June,30,2022,Sedgwick,KS,Passenger,1,1,2,74,76,2.63
June,30,2022,Orange,CA,Passenger,5,2,7,338,345,2.03
June,30,2022,Multnomah,OR,Passenger,0,3,3,520,523,0.57
June,30,2022,Juneau,AK,Passenger,0,1,1,29,30,3.33
June,30,2022,Adams,CO,Passenger,1,0,1,37,38,2.63
June,30,2022,Larimer,CO,Passenger,1,0,1,45,46,2.17
June,30,2022,Hamilton,IN,Passenger,1,0,1,20,21,4.76
June,30,2022,Sevier,AR,Passenger,0,1,1,0,1,100
June,30,2022,Philadelphia,PA,Passenger,1,0,1,33,34,2.94
June,30,2022,Clackamas,OR,Passenger,2,0,2,139,141,1.42
June,30,2022,Honolulu,HI,Passenger,4,4,8,315,323,2.48
June,30,2022,Norfolk,VA,Passenger,2,3,5,283,288,1.74
June,30,2022,Onslow,NC,Passenger,0,1,1,159,160,0.62
June,30,2022,Solano,CA,Passenger,1,0,1,157,158,0.63
June,30,2022,Anne Arundel,MD,Passenger,4,4,8,335,343,2.33
June,30,2022,Kings,CA,Passenger,2,1,3,298,301,1
June,30,2022,Cowlitz,WA,Truck,2,1,3,28556,28559,0.01
June,30,2022,Cowlitz,WA,Passenger,336,172,508,70742,71250,0.71
June,30,2022,Anchorage,AK,Passenger,1,0,1,116,117,0.85
June,30,2022,Marin,CA,Passenger,0,1,1,29,30,3.33
June,30,2022,Hidalgo,TX,Passenger,0,1,1,56,57,1.75
June,30,2022,Whatcom,WA,Passenger,1814,737,2551,149016,151567,1.68
June,30,2022,Grays Harbor,WA,Passenger,210,160,370,49043,49413,0.75
June,30,2022,District of Columbia,DC,Passenger,4,0,4,171,175,2.29
June,30,2022,St. Clair,IL,Passenger,2,0,2,116,118,1.69
June,30,2022,Klickitat,WA,Passenger,103,55,158,15251,15409,1.03
June,30,2022,Frederick,MD,Passenger,1,1,2,61,63,3.17
June,30,2022,St. Mary's,MD,Passenger,1,0,1,191,192,0.52
June,30,2022,Williamson,TX,Passenger,1,2,3,78,81,3.7
June,30,2022,Santa Cruz,CA,Passenger,1,0,1,22,23,4.35
June,30,2022,Portsmouth,VA,Passenger,0,1,1,75,76,1.32
June,30,2022,Ray,MO,Passenger,0,1,1,1,2,50
June,30,2022,Lewis,WA,Passenger,235,177,412,59751,60163,0.68
June,30,2022,Virginia Beach,VA,Passenger,2,0,2,501,503,0.4
June,30,2022,Fort Bend,TX,Passenger,1,0,1,26,27,3.7
June,30,2022,Clark,WA,Truck,7,0,7,82837,82844,0.01
June,30,2022,Ferry,WA,Truck,0,0,0,3577,3577,0
June,30,2022,Nassau,NY,Passenger,2,0,2,23,25,8
June,30,2022,Hawaii,HI,Passenger,1,0,1,36,37,2.7
June,30,2022,Chesapeake,VA,Passenger,2,3,5,330,335,1.49
June,30,2022,Franklin,WA,Passenger,186,109,295,62000,62295,0.47
June,30,2022,Alameda,CA,Passenger,4,0,4,180,184,2.17
June,30,2022,Columbia,WA,Truck,0,0,0,1579,1579,0
June,30,2022,Manassas,VA,Passenger,0,1,1,8,9,11.11
June,30,2022,Pierce,WA,Truck,6,0,6,141892,141898,0
June,30,2022,Yakima,WA,Passenger,336,190,526,167038,167564,0.31
June,30,2022,Fresno,CA,Passenger,1,0,1,134,135,0.74
June,30,2022,Wood,OH,Passenger,0,1,1,4,5,20
June,30,2022,Suffolk,MA,Passenger,0,1,1,19,20,5
June,30,2022,Wake,NC,Passenger,1,0,1,80,81,1.23
June,30,2022,Ventura,CA,Passenger,1,1,2,226,228,0.88
June,30,2022,Miami-Dade,FL,Passenger,1,0,1,77,78,1.28
June,30,2022,Arapahoe,CO,Passenger,0,1,1,77,78,1.28
June,30,2022,Pacific,WA,Passenger,61,71,132,15895,16027,0.82
June,30,2022,Thurston,WA,Truck,7,0,7,55513,55520,0.01
June,30,2022,Snohomish,WA,Truck,12,0,12,123913,123925,0.01
June,30,2022,Harnett,NC,Passenger,2,0,2,141,143,1.4
June,30,2022,Rockdale,GA,Passenger,1,0,1,8,9,11.11
June,30,2022,Jefferson,WA,Truck,2,0,2,9461,9463,0.02
June,30,2022,Houston,GA,Passenger,1,0,1,30,31,3.23
March,31,2022,Wood,OH,Passenger,0,1,1,4,5,20
March,31,2022,Whatcom,WA,Truck,4,0,4,43546,43550,0.01
March,31,2022,Powhatan,VA,Passenger,1,0,1,1,2,50
March,31,2022,Cowlitz,WA,Passenger,293,172,465,71084,71549,0.65
March,31,2022,Wake,NC,Passenger,1,0,1,93,94,1.06
March,31,2022,Tarrant,TX,Passenger,1,0,1,122,123,0.81
March,31,2022,Collin,TX,Passenger,2,0,2,95,97,2.06
March,31,2022,Platte,MO,Passenger,1,0,1,18,19,5.26
March,31,2022,Nassau,NY,Passenger,2,0,2,24,26,7.69
March,31,2022,Okanogan,WA,Passenger,77,46,123,26522,26645,0.46
March,31,2022,Leavenworth,KS,Passenger,0,1,1,101,102,0.98
March,31,2022,San Bernardino,CA,Passenger,1,1,2,337,339,0.59
March,31,2022,Columbia,WA,Passenger,6,0,6,2448,2454,0.24
March,31,2022,El Paso,CO,Passenger,3,1,4,617,621,0.64
March,31,2022,Howard,IN,Passenger,0,1,1,6,7,14.29
March,31,2022,El Paso,TX,Passenger,2,0,2,343,345,0.58
March,31,2022,RÃ­o Grande,PR,Passenger,1,0,1,0,1,100
March,31,2022,Skagit,WA,Passenger,731,326,1057,90496,91553,1.15
March,31,2022,Sedgwick,KS,Passenger,1,1,2,81,83,2.41
March,31,2022,Kings,NY,Passenger,1,0,1,63,64,1.56
March,31,2022,Sarpy,NE,Passenger,1,0,1,52,53,1.89
March,31,2022,Kern,CA,Passenger,0,1,1,190,191,0.52
March,31,2022,Alexandria,VA,Passenger,3,0,3,107,110,2.73
March,31,2022,Maricopa,AZ,Passenger,7,2,9,960,969,0.93
March,31,2022,Kittitas,WA,Passenger,225,74,299,29794,30093,0.99
March,31,2022,Hillsborough,FL,Passenger,0,2,2,122,124,1.61
March,31,2022,San Mateo,CA,Passenger,2,0,2,76,78,2.56
March,31,2022,Hennepin,MN,Passenger,3,0,3,61,64,4.69
March,31,2022,Pennington,SD,Passenger,2,0,2,28,30,6.67
March,31,2022,Orange,CA,Passenger,4,2,6,362,368,1.63
March,31,2022,Richmond,GA,Passenger,0,1,1,69,70,1.43
March,31,2022,Burlington,NJ,Passenger,0,1,1,110,111,0.9
March,31,2022,Pend Oreille,WA,Truck,0,0,0,5689,5689,0
March,31,2022,Frederick,MD,Passenger,1,1,2,67,69,2.9
March,31,2022,Solano,CA,Passenger,1,0,1,167,168,0.6
March,31,2022,Albemarle,VA,Passenger,1,0,1,17,18,5.56
March,31,2022,Ventura,CA,Passenger,2,1,3,234,237,1.27
March,31,2022,Larimer,CO,Passenger,1,0,1,50,51,1.96
March,31,2022,Jefferson,WA,Passenger,408,207,615,24697,25312,2.43
March,31,2022,Fresno,CA,Passenger,1,0,1,146,147,0.68
March,31,2022,Williamson,TX,Passenger,1,2,3,84,87,3.45
March,31,2022,Walla Walla,WA,Truck,0,0,0,14031,14031,0
March,31,2022,Montgomery,MD,Passenger,3,2,5,193,198,2.53
March,31,2022,Norfolk,VA,Passenger,3,3,6,298,304,1.97
March,31,2022,Cowlitz,WA,Truck,0,1,1,28868,28869,0
March,31,2022,Ferry,WA,Truck,0,0,0,3571,3571,0
March,31,2022,San Diego,CA,Passenger,14,8,22,2332,2354,0.93
March,31,2022,Jefferson,NY,Passenger,0,1,1,203,204,0.49
March,31,2022,Wilson,NC,Passenger,1,0,1,0,1,100
March,31,2022,Charleston,SC,Passenger,2,1,3,63,66,4.55
March,31,2022,Goochland,VA,Passenger,3,2,5,151,156,3.21
March,31,2022,Adams,WA,Truck,0,0,0,5488,5488,0
March,31,2022,Thurston,WA,Truck,3,0,3,55747,55750,0.01
March,31,2022,Clark,WA,Passenger,3744,1656,5400,318350,323750,1.67
March,31,2022,Bartow,GA,Passenger,0,1,1,3,4,25
March,31,2022,Harris,TX,Passenger,1,0,1,145,146,0.68
March,31,2022,Oldham,KY,Passenger,0,1,1,4,5,20
March,31,2022,Lake,IL,Passenger,3,0,3,143,146,2.05
March,31,2022,Juneau,AK,Passenger,0,1,1,30,31,3.23
March,31,2022,Mason,WA,Passenger,286,171,457,47633,48090,0.95
March,31,2022,Montgomery,PA,Passenger,2,0,2,22,24,8.33
March,31,2022,Douglas,WA,Truck,0,0,0,12726,12726,0
March,31,2022,DeKalb,GA,Passenger,1,0,1,49,50,2
March,31,2022,Rockingham,NH,Passenger,1,0,1,17,18,5.56
March,31,2022,Queens,NY,Passenger,1,0,1,45,46,2.17
March,31,2022,Whitman,WA,Passenger,79,54,133,22044,22177,0.6
March,31,2022,Richmond,NY,Passenger,1,0,1,6,7,14.29
March,31,2022,Prince William,VA,Passenger,0,1,1,196,197,0.51
March,31,2022,Pierce,WA,Passenger,4629,2234,6863,550172,557035,1.23
March,31,2022,Travis,TX,Passenger,1,0,1,113,114,0.88
March,31,2022,Clallam,WA,Truck,1,0,1,22058,22059,0
March,31,2022,Fairfax,VA,Passenger,3,3,6,614,620,0.97
March,31,2022,Baltimore,MD,Passenger,1,0,1,76,77,1.3
March,31,2022,Wilson,TX,Passenger,0,1,1,2,3,33.33
March,31,2022,Carroll,MD,Passenger,0,1,1,15,16,6.25
March,31,2022,Boulder,CO,Passenger,1,0,1,35,36,2.78
March,31,2022,Danville,VA,Passenger,1,0,1,0,1,100
March,31,2022,Boone,MO,Passenger,0,1,1,9,10,10
March,31,2022,Arlington,VA,Passenger,1,0,1,128,129,0.78
March,31,2022,Riverside,CA,Passenger,7,1,8,467,475,1.68
March,31,2022,Asotin,WA,Truck,0,0,0,6757,6757,0
March,31,2022,St. Mary's,MD,Passenger,1,0,1,198,199,0.5
March,31,2022,Stafford,VA,Passenger,2,1,3,88,91,3.3
March,31,2022,Hamilton,OH,Passenger,1,0,1,30,31,3.23
March,31,2022,Houston,GA,Passenger,1,0,1,38,39,2.56
March,31,2022,Benton,WA,Truck,1,0,1,43613,43614,0
March,31,2022,Allegheny,PA,Passenger,1,1,2,53,55,3.64
March,31,2022,Benton,WA,Passenger,698,444,1142,135765,136907,0.83
March,31,2022,Williams,ND,Passenger,0,1,1,7,8,12.5
March,31,2022,Bell,TX,Passenger,1,0,1,328,329,0.3
March,31,2022,Chesapeake,VA,Passenger,2,3,5,352,357,1.4
March,31,2022,Gwinnett,GA,Passenger,1,0,1,54,55,1.82
March,31,2022,Essex,NJ,Passenger,2,0,2,9,11,18.18
March,31,2022,Lake,FL,Passenger,1,0,1,21,22,4.55
March,31,2022,Harnett,NC,Passenger,2,0,2,139,141,1.42
March,31,2022,Walla Walla,WA,Passenger,157,91,248,36119,36367,0.68
March,31,2022,Jefferson,WA,Truck,0,0,0,9544,9544,0
March,31,2022,Orange,FL,Passenger,1,0,1,94,95,1.05
March,31,2022,Fairbanks North Star,AK,Passenger,0,1,1,76,77,1.3
March,31,2022,Grays Harbor,WA,Truck,0,0,0,21365,21365,0
March,31,2022,Loudoun,VA,Passenger,1,1,2,66,68,2.94
March,31,2022,Yellowstone,MT,Passenger,0,1,1,28,29,3.45
March,31,2022,Skamania,WA,Truck,0,0,0,3973,3973,0
March,31,2022,Dallas,TX,Passenger,1,0,1,117,118,0.85
March,31,2022,Greene,MO,Passenger,0,1,1,23,24,4.17
March,31,2022,Los Angeles,CA,Passenger,8,7,15,793,808,1.86
March,31,2022,Onslow,NC,Passenger,0,1,1,164,165,0.61
March,31,2022,Carroll,NH,Passenger,0,1,1,5,6,16.67
March,31,2022,Denton,TX,Passenger,1,0,1,68,69,1.45
March,31,2022,Cape May,NJ,Passenger,0,1,1,8,9,11.11
March,31,2022,Garfield,WA,Passenger,0,3,3,1332,1335,0.22
March,31,2022,Elmore,ID,Passenger,1,0,1,14,15,6.67
March,31,2022,Duval,FL,Passenger,0,2,2,286,288,0.69
March,31,2022,San Juan,WA,Passenger,492,152,644,14129,14773,4.36
March,31,2022,Multnomah,OR,Passenger,1,4,5,564,569,0.88
March,31,2022,Randolph,NC,Passenger,1,0,1,4,5,20
March,31,2022,Rock Island,IL,Passenger,0,1,1,15,16,6.25
March,31,2022,Suffolk,VA,Passenger,1,0,1,119,120,0.83
March,31,2022,Owyhee,ID,Passenger,1,0,1,2,3,33.33
March,31,2022,Kittitas,WA,Truck,0,0,0,14720,14720,0
March,31,2022,Cumberland,NC,Passenger,1,2,3,372,375,0.8
March,31,2022,Camden,NJ,Passenger,0,1,1,13,14,7.14
March,31,2022,Pima,AZ,Passenger,1,1,2,235,237,0.84
March,31,2022,Lewis,WA,Passenger,226,164,390,59495,59885,0.65
March,31,2022,Howard,MD,Passenger,0,1,1,57,58,1.72
March,31,2022,Mason,WA,Truck,0,0,0,21168,21168,0
March,31,2022,Montgomery,AL,Passenger,0,1,1,34,35,2.86
March,31,2022,Sonoma,CA,Passenger,0,1,1,74,75,1.33
March,31,2022,Miami-Dade,FL,Passenger,1,0,1,84,85,1.18
March,31,2022,Kings,CA,Passenger,2,1,3,305,308,0.97
March,31,2022,Shelby,OH,Passenger,0,1,1,2,3,33.33
March,31,2022,Columbia,WA,Truck,0,0,0,1589,1589,0
March,31,2022,Placer,CA,Passenger,2,0,2,69,71,2.82
March,31,2022,Contra Costa,CA,Passenger,0,3,3,252,255,1.18
March,31,2022,St. Tammany,LA,Passenger,1,0,1,35,36,2.78
March,31,2022,New London,CT,Passenger,1,5,6,202,208,2.88
March,31,2022,New York,NY,Passenger,1,0,1,35,36,2.78
March,31,2022,Harrison,MS,Passenger,2,0,2,44,46,4.35
March,31,2022,Stevens,WA,Truck,0,0,0,19002,19002,0
March,31,2022,Broward,FL,Passenger,2,0,2,83,85,2.35
March,31,2022,Washington,MD,Passenger,2,0,2,14,16,12.5
March,31,2022,Richland,SC,Passenger,0,1,1,128,129,0.78
March,31,2022,Allen,IN,Passenger,1,0,1,14,15,6.67
March,31,2022,Alameda,CA,Passenger,4,0,4,196,200,2
March,31,2022,Plaquemines,LA,Passenger,0,1,1,17,18,5.56
March,31,2022,King,WA,Passenger,37937,10707,48644,1352308,1400952,3.47
March,31,2022,Geary,KS,Passenger,1,0,1,88,89,1.12
March,31,2022,Snohomish,WA,Passenger,7665,2362,10027,534917,544944,1.84
March,31,2022,Lincoln,WA,Passenger,7,18,25,7668,7693,0.32
March,31,2022,St. Louis,MO,Passenger,1,0,1,68,69,1.45
March,31,2022,Island,WA,Passenger,758,360,1118,62387,63505,1.76
March,31,2022,Ferry,WA,Passenger,17,3,20,4431,4451,0.45
March,31,2022,Hawaii,HI,Passenger,1,0,1,37,38,2.63
March,31,2022,Clallam,WA,Passenger,402,240,642,49973,50615,1.27
March,31,2022,District of Columbia,DC,Passenger,4,0,4,184,188,2.13
March,31,2022,Penobscot,ME,Passenger,0,1,1,6,7,14.29
March,31,2022,Escambia,FL,Passenger,0,1,1,134,135,0.74
March,31,2022,Prince George's,MD,Passenger,2,1,3,130,133,2.26
March,31,2022,Rogers,OK,Passenger,1,0,1,2,3,33.33
March,31,2022,Lane,OR,Passenger,0,1,1,102,103,0.97
March,31,2022,Klickitat,WA,Truck,0,0,0,8311,8311,0
March,31,2022,Middlesex,MA,Passenger,1,1,2,80,82,2.44
March,31,2022,Carson City,NV,Passenger,1,0,1,7,8,12.5
March,31,2022,Santa Cruz,CA,Passenger,1,0,1,24,25,4
March,31,2022,Spartanburg,SC,Passenger,0,1,1,43,44,2.27
March,31,2022,Skagit,WA,Truck,1,0,1,32552,32553,0
March,31,2022,Montgomery,TX,Passenger,1,0,1,31,32,3.12
March,31,2022,San Juan,WA,Truck,1,0,1,5995,5996,0.02
March,31,2022,Lincoln,OR,Passenger,0,1,1,30,31,3.23
March,31,2022,Chelan,WA,Passenger,437,122,559,54596,55155,1.01
March,31,2022,Grays Harbor,WA,Passenger,205,157,362,49309,49671,0.73
March,31,2022,Klickitat,WA,Passenger,96,54,150,15336,15486,0.97
March,31,2022,Manassas,VA,Passenger,0,1,1,7,8,12.5
March,31,2022,Pend Oreille,WA,Passenger,16,10,26,9051,9077,0.29
March,31,2022,Louisa,VA,Passenger,0,1,1,1,2,50
March,31,2022,Marin,CA,Passenger,0,1,1,30,31,3.23
March,31,2022,Sumter,SC,Passenger,0,1,1,32,33,3.03
March,31,2022,Franklin,WA,Passenger,179,106,285,62085,62370,0.46
March,31,2022,Douglas,WA,Passenger,125,56,181,28528,28709,0.63
March,31,2022,Fort Bend,TX,Passenger,1,0,1,32,33,3.03
March,31,2022,Kauai,HI,Passenger,1,0,1,18,19,5.26
March,31,2022,Clark,WA,Truck,2,0,2,83493,83495,0
March,31,2022,Rockdale,GA,Passenger,1,0,1,7,8,12.5
March,31,2022,Clackamas,OR,Passenger,2,0,2,149,151,1.32
March,31,2022,Island,WA,Truck,1,0,1,21479,21480,0
March,31,2022,Salt Lake,UT,Passenger,1,1,2,141,143,1.4
March,31,2022,Adams,WA,Passenger,16,11,27,12982,13009,0.21
March,31,2022,Pacific,WA,Truck,0,0,0,8008,8008,0
March,31,2022,Santa Clara,CA,Passenger,9,1,10,225,235,4.26
March,31,2022,Bexar,TX,Passenger,4,4,8,461,469,1.71
March,31,2022,Hidalgo,TX,Passenger,0,1,1,50,51,1.96
March,31,2022,Snohomish,WA,Truck,4,0,4,124827,124831,0
March,31,2022,Douglas,NE,Passenger,1,2,3,46,49,6.12
March,31,2022,Sacramento,CA,Passenger,2,0,2,202,204,0.98
March,31,2022,Okaloosa,FL,Passenger,0,1,1,102,103,0.97
March,31,2022,Lee,FL,Passenger,1,0,1,28,29,3.45
March,31,2022,Wahkiakum,WA,Passenger,18,11,29,3077,3106,0.93
March,31,2022,Hamilton,IN,Passenger,1,0,1,21,22,4.55
March,31,2022,Whatcom,WA,Passenger,1735,695,2430,149237,151667,1.6
March,31,2022,New Haven,CT,Passenger,0,2,2,28,30,6.67
March,31,2022,Virginia Beach,VA,Passenger,2,0,2,540,542,0.37
March,31,2022,Garfield,WA,Truck,0,0,0,999,999,0
March,31,2022,Sevier,AR,Passenger,0,1,1,0,1,100
March,31,2022,Grant,WA,Truck,0,0,0,28046,28046,0
March,31,2022,Pinellas,FL,Passenger,0,1,1,80,81,1.23
March,31,2022,Nueces,TX,Passenger,1,1,2,58,60,3.33
March,31,2022,Douglas,CO,Passenger,0,1,1,74,75,1.33
March,31,2022,Dorchester,SC,Passenger,1,0,1,58,59,1.69
March,31,2022,Franklin,WA,Truck,0,0,0,20940,20940,0
March,31,2022,Suffolk,MA,Passenger,0,1,1,23,24,4.17
March,31,2022,Philadelphia,PA,Passenger,1,0,1,35,36,2.78
March,31,2022,Galveston,TX,Passenger,0,1,1,19,20,5
March,31,2022,Yakima,WA,Passenger,312,181,493,167703,168196,0.29
March,31,2022,Portsmouth,VA,Passenger,0,1,1,75,76,1.32
March,31,2022,Spokane,WA,Truck,0,0,0,102463,102463,0
March,31,2022,Moore,NC,Passenger,0,1,1,121,122,0.82
March,31,2022,St. Clair,IL,Passenger,2,0,2,122,124,1.61
March,31,2022,Adams,CO,Passenger,1,0,1,39,40,2.5
March,31,2022,Ulster,NY,Passenger,1,0,1,9,10,10
March,31,2022,DuPage,IL,Passenger,1,0,1,47,48,2.08
March,31,2022,Pacific,WA,Passenger,61,68,129,15997,16126,0.8
March,31,2022,Cook,IL,Passenger,3,0,3,190,193,1.55
March,31,2022,San Luis Obispo,CA,Passenger,1,0,1,55,56,1.79
March,31,2022,Yakima,WA,Truck,0,0,0,61589,61589,0
March,31,2022,Asotin,WA,Passenger,22,18,40,12658,12698,0.32
March,31,2022,Hudson,NJ,Passenger,2,0,2,34,36,5.56
March,31,2022,Wichita,TX,Passenger,1,0,1,39,40,2.5
March,31,2022,Kitsap,WA,Passenger,2274,1006,3280,179292,182572,1.8
March,31,2022,Sarasota,FL,Passenger,2,0,2,25,27,7.41
March,31,2022,Lewis,WA,Truck,0,0,0,26519,26519,0
March,31,2022,Wahkiakum,WA,Truck,0,0,0,1814,1814,0
March,31,2022,Skamania,WA,Passenger,65,45,110,8278,8388,1.31
March,31,2022,Stevens,WA,Passenger,60,50,110,30089,30199,0.36
March,31,2022,Thurston,WA,Passenger,2028,1000,3028,195451,198479,1.53
March,31,2022,Saratoga,NY,Passenger,1,0,1,40,41,2.44
March,31,2022,Whitman,WA,Truck,0,0,0,8588,8588,0
March,31,2022,Coryell,TX,Passenger,1,0,1,101,102,0.98
March,31,2022,Chelan,WA,Truck,0,0,0,23048,23048,0
March,31,2022,Calvert,MD,Passenger,0,2,2,76,78,2.56
March,31,2022,Anchorage,AK,Passenger,1,0,1,120,121,0.83
March,31,2022,King,WA,Truck,25,1,26,182051,182077,0.01
March,31,2022,Clark,NV,Passenger,4,2,6,532,538,1.12
March,31,2022,Monterey,CA,Passenger,1,1,2,129,131,1.53
March,31,2022,,,Passenger,15,7,22,1119,1141,1.93
March,31,2022,Flathead,MT,Passenger,1,0,1,31,32,3.12
March,31,2022,Charles,MD,Passenger,0,1,1,59,60,1.67
March,31,2022,San Joaquin,CA,Passenger,1,1,2,88,90,2.22
March,31,2022,Honolulu,HI,Passenger,5,4,9,328,337,2.67
March,31,2022,Spokane,WA,Passenger,1443,799,2242,325888,328130,0.68
March,31,2022,Anne Arundel,MD,Passenger,4,3,7,353,360,1.94
March,31,2022,Grant,WA,Passenger,151,100,251,66866,67117,0.37
March,31,2022,Lincoln,WA,Truck,0,0,0,4834,4834,0
March,31,2022,Ray,MO,Passenger,0,1,1,1,2,50
March,31,2022,Okanogan,WA,Truck,0,0,0,16693,16693,0
March,31,2022,Las Animas,CO,Passenger,1,0,1,1,2,50
March,31,2022,Pierce,WA,Truck,2,0,2,143506,143508,0
March,31,2022,Kitsap,WA,Truck,1,0,1,53996,53997,0
May,31,2022,Danville,VA,Passenger,1,0,1,0,1,100
May,31,2022,Kittitas,WA,Passenger,248,79,327,29757,30084,1.09
May,31,2022,Baltimore,MD,Passenger,1,0,1,69,70,1.43
May,31,2022,Camden,NJ,Passenger,0,1,1,13,14,7.14
May,31,2022,Tarrant,TX,Passenger,1,0,1,110,111,0.9
May,31,2022,Bartow,GA,Passenger,0,1,1,3,4,25
May,31,2022,Yellowstone,MT,Passenger,0,1,1,27,28,3.57
May,31,2022,New London,CT,Passenger,2,5,7,191,198,3.54
May,31,2022,Frederick,MD,Passenger,1,1,2,63,65,3.08
May,31,2022,Virginia Beach,VA,Passenger,2,0,2,511,513,0.39
May,31,2022,Duval,FL,Passenger,0,2,2,276,278,0.72
May,31,2022,Pima,AZ,Passenger,1,0,1,221,222,0.45
May,31,2022,Burlington,NJ,Passenger,0,2,2,109,111,1.8
May,31,2022,Skagit,WA,Passenger,759,332,1091,90123,91214,1.2
May,31,2022,Spokane,WA,Truck,1,0,1,102240,102241,0
May,31,2022,Maricopa,AZ,Passenger,7,2,9,913,922,0.98
May,31,2022,Lake,FL,Passenger,1,0,1,19,20,5
May,31,2022,Powhatan,VA,Passenger,1,0,1,1,2,50
May,31,2022,Wahkiakum,WA,Truck,0,0,0,1805,1805,0
May,31,2022,Lee,FL,Passenger,1,0,1,29,30,3.33
May,31,2022,Boone,MO,Passenger,0,1,1,9,10,10
May,31,2022,Placer,CA,Passenger,2,0,2,64,66,3.03
May,31,2022,Asotin,WA,Passenger,23,19,42,12730,12772,0.33
May,31,2022,Montgomery,MD,Passenger,4,2,6,197,203,2.96
May,31,2022,San Luis Obispo,CA,Passenger,1,0,1,54,55,1.82
May,31,2022,Kings,NY,Passenger,1,0,1,58,59,1.69
May,31,2022,Grays Harbor,WA,Passenger,205,158,363,49085,49448,0.73
May,31,2022,Prince George's,MD,Passenger,2,1,3,119,122,2.46
May,31,2022,Hidalgo,TX,Passenger,0,1,1,52,53,1.89
May,31,2022,Fresno,CA,Passenger,1,0,1,137,138,0.72
May,31,2022,Clark,NV,Passenger,4,2,6,511,517,1.16
May,31,2022,St. Mary's,MD,Passenger,1,0,1,190,191,0.52
May,31,2022,Spartanburg,SC,Passenger,0,1,1,40,41,2.44
May,31,2022,Chesapeake,VA,Passenger,2,3,5,335,340,1.47
May,31,2022,Multnomah,OR,Passenger,0,4,4,533,537,0.74
May,31,2022,Oldham,KY,Passenger,0,1,1,4,5,20
May,31,2022,Adams,WA,Passenger,16,10,26,12957,12983,0.2
May,31,2022,Harnett,NC,Passenger,2,0,2,140,142,1.41
May,31,2022,Kitsap,WA,Passenger,2354,1031,3385,178653,182038,1.86
May,31,2022,Wichita,TX,Passenger,1,0,1,38,39,2.56
May,31,2022,Suffolk,VA,Passenger,1,0,1,119,120,0.83
May,31,2022,Collin,TX,Passenger,2,0,2,84,86,2.33
May,31,2022,New Haven,CT,Passenger,0,2,2,27,29,6.9
May,31,2022,Geary,KS,Passenger,1,0,1,82,83,1.2
May,31,2022,Owyhee,ID,Passenger,1,0,1,2,3,33.33
May,31,2022,Pacific,WA,Passenger,60,68,128,15915,16043,0.8
May,31,2022,El Paso,CO,Passenger,3,1,4,590,594,0.67
May,31,2022,El Paso,TX,Passenger,2,0,2,330,332,0.6
May,31,2022,New York,NY,Passenger,1,0,1,33,34,2.94
May,31,2022,DeKalb,GA,Passenger,1,0,1,46,47,2.13
May,31,2022,Hudson,NJ,Passenger,2,0,2,34,36,5.56
May,31,2022,Elmore,ID,Passenger,1,0,1,12,13,7.69
May,31,2022,Sonoma,CA,Passenger,0,1,1,74,75,1.33
May,31,2022,Richmond,GA,Passenger,0,1,1,64,65,1.54
May,31,2022,Middlesex,MA,Passenger,1,1,2,74,76,2.63
May,31,2022,King,WA,Truck,43,1,44,181226,181270,0.02
May,31,2022,Spokane,WA,Passenger,1543,832,2375,325374,327749,0.72
May,31,2022,Rogers,OK,Passenger,1,0,1,1,2,50
May,31,2022,Travis,TX,Passenger,1,0,1,106,107,0.93
May,31,2022,Louisa,VA,Passenger,0,1,1,1,2,50
May,31,2022,Manassas,VA,Passenger,0,1,1,7,8,12.5
May,31,2022,Cumberland,NC,Passenger,1,2,3,359,362,0.83
May,31,2022,Santa Clara,CA,Passenger,10,1,11,216,227,4.85
May,31,2022,Washington,MD,Passenger,2,0,2,14,16,12.5
May,31,2022,Pennington,SD,Passenger,2,0,2,27,29,6.9
May,31,2022,Kauai,HI,Passenger,1,0,1,16,17,5.88
May,31,2022,Miami-Dade,FL,Passenger,1,0,1,77,78,1.28
May,31,2022,San Juan,WA,Truck,1,0,1,5979,5980,0.02
May,31,2022,Douglas,NE,Passenger,1,2,3,42,45,6.67
May,31,2022,Plaquemines,LA,Passenger,1,1,2,16,18,11.11
May,31,2022,Kitsap,WA,Truck,3,0,3,53699,53702,0.01
May,31,2022,District of Columbia,DC,Passenger,5,0,5,177,182,2.75
May,31,2022,Sarpy,NE,Passenger,1,0,1,51,52,1.92
May,31,2022,Houston,GA,Passenger,1,0,1,33,34,2.94
May,31,2022,Harris,TX,Passenger,2,0,2,140,142,1.41
May,31,2022,Franklin,WA,Truck,0,0,0,20926,20926,0
May,31,2022,Ray,MO,Passenger,0,1,1,1,2,50
May,31,2022,Howard,MD,Passenger,0,1,1,54,55,1.82
May,31,2022,Columbia,WA,Passenger,7,0,7,2441,2448,0.29
May,31,2022,Pierce,WA,Truck,5,0,5,142329,142334,0
May,31,2022,Adams,WA,Truck,0,0,0,5475,5475,0
May,31,2022,Walla Walla,WA,Truck,0,0,0,13969,13969,0
May,31,2022,Lincoln,WA,Truck,0,0,0,4839,4839,0
May,31,2022,Clallam,WA,Passenger,410,244,654,49775,50429,1.3
May,31,2022,Rockdale,GA,Passenger,1,0,1,8,9,11.11
May,31,2022,Douglas,WA,Truck,0,0,0,12770,12770,0
May,31,2022,Clark,WA,Truck,5,0,5,82915,82920,0.01
May,31,2022,Howard,IN,Passenger,0,1,1,4,5,20
May,31,2022,,,Passenger,15,7,22,1129,1151,1.91
May,31,2022,Anne Arundel,MD,Passenger,4,4,8,343,351,2.28
May,31,2022,Stevens,WA,Passenger,64,54,118,30097,30215,0.39
May,31,2022,Philadelphia,PA,Passenger,1,0,1,34,35,2.86
May,31,2022,Bell,TX,Passenger,1,0,1,318,319,0.31
May,31,2022,San Bernardino,CA,Passenger,1,1,2,323,325,0.62
May,31,2022,Richmond,NY,Passenger,1,0,1,6,7,14.29
May,31,2022,Jefferson,NY,Passenger,0,1,1,203,204,0.49
May,31,2022,Douglas,CO,Passenger,0,1,1,71,72,1.39
May,31,2022,Richland,SC,Passenger,0,1,1,124,125,0.8
May,31,2022,Jefferson,WA,Truck,0,0,0,9493,9493,0
May,31,2022,Sevier,AR,Passenger,0,1,1,0,1,100
May,31,2022,Kittitas,WA,Truck,1,0,1,14675,14676,0.01
May,31,2022,Harrison,MS,Passenger,2,0,2,44,46,4.35
May,31,2022,Honolulu,HI,Passenger,5,4,9,319,328,2.74
May,31,2022,Contra Costa,CA,Passenger,0,4,4,251,255,1.57
May,31,2022,Fairbanks North Star,AK,Passenger,0,1,1,75,76,1.32
May,31,2022,Hawaii,HI,Passenger,1,0,1,35,36,2.78
May,31,2022,Okanogan,WA,Passenger,82,51,133,26409,26542,0.5
May,31,2022,Pinellas,FL,Passenger,0,1,1,74,75,1.33
May,31,2022,Grant,WA,Passenger,166,97,263,66720,66983,0.39
May,31,2022,Ulster,NY,Passenger,1,0,1,9,10,10
May,31,2022,Cowlitz,WA,Truck,1,1,2,28601,28603,0.01
May,31,2022,Pend Oreille,WA,Truck,0,0,0,5629,5629,0
May,31,2022,Lane,OR,Passenger,0,1,1,91,92,1.09
May,31,2022,Lake,IL,Passenger,3,0,3,139,142,2.11
May,31,2022,Klickitat,WA,Passenger,99,54,153,15249,15402,0.99
May,31,2022,Lewis,WA,Passenger,231,173,404,59518,59922,0.67
May,31,2022,Ventura,CA,Passenger,1,1,2,229,231,0.87
May,31,2022,Moore,NC,Passenger,0,1,1,114,115,0.87
May,31,2022,Los Angeles,CA,Passenger,8,8,16,763,779,2.05
May,31,2022,Adams,CO,Passenger,1,0,1,38,39,2.56
May,31,2022,Okanogan,WA,Truck,0,0,0,16665,16665,0
May,31,2022,Broward,FL,Passenger,2,0,2,76,78,2.56
May,31,2022,Leavenworth,KS,Passenger,0,1,1,102,103,0.97
May,31,2022,Orange,FL,Passenger,1,0,1,91,92,1.09
May,31,2022,Asotin,WA,Truck,0,0,0,6709,6709,0
May,31,2022,Yakima,WA,Passenger,325,189,514,167089,167603,0.31
May,31,2022,San Diego,CA,Passenger,14,9,23,2265,2288,1.01
May,31,2022,Onslow,NC,Passenger,0,1,1,158,159,0.63
May,31,2022,Albemarle,VA,Passenger,1,0,1,16,17,5.88
May,31,2022,Garfield,WA,Truck,0,0,0,981,981,0
May,31,2022,Nassau,NY,Passenger,2,0,2,26,28,7.14
May,31,2022,Charleston,SC,Passenger,2,1,3,59,62,4.84
May,31,2022,Santa Cruz,CA,Passenger,1,0,1,23,24,4.17
May,31,2022,Bexar,TX,Passenger,4,3,7,434,441,1.59
May,31,2022,Alameda,CA,Passenger,4,0,4,185,189,2.12
May,31,2022,Las Animas,CO,Passenger,1,0,1,1,2,50
May,31,2022,St. Louis,MO,Passenger,1,0,1,64,65,1.54
May,31,2022,Clackamas,OR,Passenger,2,0,2,143,145,1.38
May,31,2022,Williams,ND,Passenger,0,1,1,6,7,14.29
May,31,2022,Escambia,FL,Passenger,0,1,1,130,131,0.76
May,31,2022,Skamania,WA,Truck,0,0,0,3971,3971,0
May,31,2022,Whitman,WA,Truck,0,0,0,8562,8562,0
May,31,2022,Sumter,SC,Passenger,0,1,1,32,33,3.03
May,31,2022,Wahkiakum,WA,Passenger,22,10,32,3085,3117,1.03
May,31,2022,Fairfax,VA,Passenger,6,3,9,607,616,1.46
May,31,2022,Arapahoe,CO,Passenger,0,1,1,77,78,1.28
May,31,2022,Galveston,TX,Passenger,0,1,1,17,18,5.56
May,31,2022,Portsmouth,VA,Passenger,0,1,1,74,75,1.33
May,31,2022,Orange,CA,Passenger,5,2,7,351,358,1.96
May,31,2022,Monterey,CA,Passenger,1,1,2,126,128,1.56
May,31,2022,Platte,MO,Passenger,1,0,1,21,22,4.55
May,31,2022,Nueces,TX,Passenger,1,1,2,54,56,3.57
May,31,2022,Hillsborough,FL,Passenger,0,1,1,120,121,0.83
May,31,2022,Rockingham,NH,Passenger,1,0,1,15,16,6.25
May,31,2022,Kern,CA,Passenger,0,1,1,188,189,0.53
May,31,2022,San Mateo,CA,Passenger,2,0,2,79,81,2.47
May,31,2022,Rock Island,IL,Passenger,0,1,1,15,16,6.25
May,31,2022,Coryell,TX,Passenger,1,0,1,98,99,1.01
May,31,2022,Stafford,VA,Passenger,2,1,3,89,92,3.26
May,31,2022,Dorchester,SC,Passenger,1,0,1,55,56,1.79
May,31,2022,St. Tammany,LA,Passenger,1,0,1,34,35,2.86
May,31,2022,Whatcom,WA,Passenger,1799,729,2528,148935,151463,1.67
May,31,2022,Riverside,CA,Passenger,8,1,9,462,471,1.91
May,31,2022,Salt Lake,UT,Passenger,1,1,2,130,132,1.52
May,31,2022,Thurston,WA,Passenger,2127,1028,3155,194514,197669,1.6
May,31,2022,Lincoln,OR,Passenger,0,1,1,26,27,3.7
May,31,2022,Lewis,WA,Truck,0,0,0,26423,26423,0
May,31,2022,Queens,NY,Passenger,1,0,1,41,42,2.38
May,31,2022,Marin,CA,Passenger,0,1,1,29,30,3.33
May,31,2022,Snohomish,WA,Truck,6,0,6,124132,124138,0
May,31,2022,Larimer,CO,Passenger,1,0,1,46,47,2.13
May,31,2022,Pacific,WA,Truck,0,0,0,7950,7950,0
May,31,2022,Douglas,WA,Passenger,131,58,189,28516,28705,0.66
May,31,2022,Ferry,WA,Truck,0,0,0,3569,3569,0
May,31,2022,Wilson,TX,Passenger,0,1,1,2,3,33.33
May,31,2022,Randolph,NC,Passenger,1,0,1,5,6,16.67
May,31,2022,Gwinnett,GA,Passenger,1,0,1,49,50,2
May,31,2022,San Juan,WA,Passenger,499,152,651,14097,14748,4.41
May,31,2022,Fort Bend,TX,Passenger,1,0,1,26,27,3.7
May,31,2022,Lincoln,WA,Passenger,8,18,26,7692,7718,0.34
May,31,2022,Okaloosa,FL,Passenger,0,1,1,96,97,1.03
May,31,2022,Wood,OH,Passenger,0,1,1,4,5,20
May,31,2022,Loudoun,VA,Passenger,2,1,3,63,66,4.55
May,31,2022,Pend Oreille,WA,Passenger,16,11,27,9013,9040,0.3
May,31,2022,Benton,WA,Truck,2,0,2,43549,43551,0
May,31,2022,San Joaquin,CA,Passenger,1,1,2,89,91,2.2
May,31,2022,Chelan,WA,Truck,2,0,2,23067,23069,0.01
May,31,2022,Hamilton,IN,Passenger,1,0,1,20,21,4.76
May,31,2022,Jefferson,WA,Passenger,425,215,640,24617,25257,2.53
May,31,2022,Denton,TX,Passenger,1,0,1,62,63,1.59
May,31,2022,Sacramento,CA,Passenger,2,0,2,190,192,1.04
May,31,2022,DuPage,IL,Passenger,1,0,1,46,47,2.13
May,31,2022,Chelan,WA,Passenger,450,126,576,54379,54955,1.05
May,31,2022,Columbia,WA,Truck,0,0,0,1581,1581,0
May,31,2022,Anchorage,AK,Passenger,1,0,1,119,120,0.83
May,31,2022,Essex,NJ,Passenger,2,0,2,9,11,18.18
May,31,2022,Thurston,WA,Truck,4,0,4,55452,55456,0.01
May,31,2022,Pierce,WA,Passenger,4952,2291,7243,546758,554001,1.31
May,31,2022,Solano,CA,Passenger,1,0,1,162,163,0.61
May,31,2022,Montgomery,PA,Passenger,2,0,2,20,22,9.09
May,31,2022,Skamania,WA,Passenger,70,45,115,8209,8324,1.38
May,31,2022,Grays Harbor,WA,Truck,0,0,0,21307,21307,0
May,31,2022,Whitman,WA,Passenger,84,58,142,22034,22176,0.64
May,31,2022,Kings,CA,Passenger,2,1,3,298,301,1
May,31,2022,Franklin,WA,Passenger,181,110,291,62027,62318,0.47
May,31,2022,Skagit,WA,Truck,2,0,2,32401,32403,0.01
May,31,2022,Klickitat,WA,Truck,1,0,1,8293,8294,0.01
May,31,2022,Grant,WA,Truck,0,0,0,27995,27995,0
May,31,2022,Norfolk,VA,Passenger,3,3,6,289,295,2.03
May,31,2022,Cape May,NJ,Passenger,0,1,1,7,8,12.5
May,31,2022,Island,WA,Truck,1,0,1,21433,21434,0
May,31,2022,Suffolk,MA,Passenger,0,1,1,21,22,4.55
May,31,2022,Garfield,WA,Passenger,0,3,3,1329,1332,0.23
May,31,2022,St. Clair,IL,Passenger,2,0,2,118,120,1.67
May,31,2022,Hennepin,MN,Passenger,2,0,2,53,55,3.64
May,31,2022,Charles,MD,Passenger,1,1,2,54,56,3.57
May,31,2022,Snohomish,WA,Passenger,8141,2474,10615,533059,543674,1.95
May,31,2022,Wake,NC,Passenger,1,0,1,86,87,1.15
May,31,2022,Allen,IN,Passenger,1,0,1,13,14,7.14
May,31,2022,Sedgwick,KS,Passenger,1,1,2,74,76,2.63
May,31,2022,Cook,IL,Passenger,3,0,3,184,187,1.6
May,31,2022,Ferry,WA,Passenger,20,4,24,4434,4458,0.54
May,31,2022,Mason,WA,Truck,1,0,1,21058,21059,0
May,31,2022,Montgomery,AL,Passenger,0,1,1,32,33,3.03
May,31,2022,Boulder,CO,Passenger,1,0,1,34,35,2.86
May,31,2022,Carson City,NV,Passenger,1,0,1,8,9,11.11
May,31,2022,Juneau,AK,Passenger,0,1,1,29,30,3.33
May,31,2022,Island,WA,Passenger,797,373,1170,62040,63210,1.85
May,31,2022,Prince William,VA,Passenger,0,1,1,191,192,0.52
May,31,2022,Clallam,WA,Truck,1,0,1,21957,21958,0
May,31,2022,Mason,WA,Passenger,304,179,483,47338,47821,1.01
May,31,2022,Williamson,TX,Passenger,1,2,3,81,84,3.57
May,31,2022,Stevens,WA,Truck,0,0,0,18961,18961,0
May,31,2022,Cowlitz,WA,Passenger,322,175,497,70710,71207,0.7
May,31,2022,Montgomery,TX,Passenger,1,0,1,29,30,3.33
May,31,2022,Arlington,VA,Passenger,1,0,1,124,125,0.8
May,31,2022,Penobscot,ME,Passenger,0,1,1,7,8,12.5
May,31,2022,Hamilton,OH,Passenger,1,0,1,28,29,3.45
May,31,2022,King,WA,Passenger,40013,11054,51067,1349163,1400230,3.65
May,31,2022,Saratoga,NY,Passenger,1,0,1,38,39,2.56
May,31,2022,Goochland,VA,Passenger,3,2,5,130,135,3.7
May,31,2022,Carroll,MD,Passenger,0,1,1,15,16,6.25
May,31,2022,Alexandria,VA,Passenger,3,0,3,105,108,2.78
May,31,2022,Greene,MO,Passenger,0,1,1,23,24,4.17
May,31,2022,Calvert,MD,Passenger,0,2,2,76,78,2.56
May,31,2022,Yakima,WA,Truck,0,0,0,61425,61425,0
May,31,2022,Walla Walla,WA,Passenger,171,97,268,35973,36241,0.74
May,31,2022,Allegheny,PA,Passenger,1,1,2,52,54,3.7
May,31,2022,Sarasota,FL,Passenger,2,0,2,25,27,7.41
May,31,2022,Clark,WA,Passenger,3936,1735,5671,316813,322484,1.76
May,31,2022,Carroll,NH,Passenger,0,1,1,5,6,16.67
May,31,2022,Benton,WA,Passenger,729,455,1184,135276,136460,0.87
May,31,2022,Whatcom,WA,Truck,5,0,5,43377,43382,0.01
November,30,2022,Solano,CA,Passenger,2,0,2,146,148,1.35
November,30,2022,Wichita,TX,Passenger,2,0,2,36,38,5.26
November,30,2022,Saratoga,NY,Passenger,1,0,1,36,37,2.7
November,30,2022,Goochland,VA,Passenger,0,1,1,71,72,1.39
November,30,2022,Whitman,WA,Passenger,109,65,174,21989,22163,0.79
November,30,2022,Montgomery,PA,Passenger,1,0,1,18,19,5.26
November,30,2022,Grays Harbor,WA,Passenger,242,161,403,48681,49084,0.82
November,30,2022,Essex,NJ,Passenger,2,0,2,8,10,20
November,30,2022,Hidalgo,TX,Passenger,0,1,1,48,49,2.04
November,30,2022,Prince George's,MD,Passenger,3,1,4,111,115,3.48
November,30,2022,Whatcom,WA,Passenger,2054,800,2854,148864,151718,1.88
November,30,2022,St. Tammany,LA,Passenger,1,0,1,32,33,3.03
November,30,2022,Honolulu,HI,Passenger,3,3,6,287,293,2.05
November,30,2022,King,WA,Truck,337,2,339,179007,179346,0.19
November,30,2022,Clark,NV,Passenger,5,2,7,427,434,1.61
November,30,2022,Bartow,GA,Passenger,0,1,1,3,4,25
November,30,2022,Orange,CA,Passenger,6,2,8,304,312,2.56
November,30,2022,Wahkiakum,WA,Passenger,25,13,38,3045,3083,1.23
November,30,2022,Franklin,WA,Passenger,246,117,363,61801,62164,0.58
November,30,2022,Douglas,WA,Passenger,162,59,221,28510,28731,0.77
November,30,2022,Charles,MD,Passenger,1,1,2,49,51,3.92
November,30,2022,Island,WA,Passenger,922,394,1316,61562,62878,2.09
November,30,2022,Multnomah,OR,Passenger,0,2,2,454,456,0.44
November,30,2022,Douglas,WA,Truck,2,0,2,12811,12813,0.02
November,30,2022,Kootenai,ID,Truck,1,0,1,29,30,3.33
November,30,2022,San Diego,CA,Passenger,17,10,27,2066,2093,1.29
November,30,2022,Hawaii,HI,Passenger,1,0,1,26,27,3.7
November,30,2022,Anne Arundel,MD,Passenger,4,4,8,301,309,2.59
November,30,2022,Bexar,TX,Passenger,4,3,7,379,386,1.81
November,30,2022,Chelan,WA,Truck,11,0,11,23139,23150,0.05
November,30,2022,San Joaquin,CA,Passenger,1,0,1,75,76,1.32
November,30,2022,Boulder,CO,Passenger,1,0,1,30,31,3.23
November,30,2022,Allen,IN,Passenger,1,0,1,11,12,8.33
November,30,2022,Travis,TX,Passenger,1,0,1,83,84,1.19
November,30,2022,El Paso,CO,Passenger,3,1,4,525,529,0.76
November,30,2022,Galveston,TX,Passenger,0,1,1,16,17,5.88
November,30,2022,San Bernardino,CA,Passenger,1,1,2,290,292,0.68
November,30,2022,Frederick,MD,Passenger,1,0,1,57,58,1.72
November,30,2022,Newport News,VA,Passenger,1,0,1,95,96,1.04
November,30,2022,Fairfax,VA,Truck,1,0,1,101,102,0.98
November,30,2022,San Juan,WA,Truck,7,0,7,5939,5946,0.12
November,30,2022,Pierce,WA,Truck,71,0,71,139968,140039,0.05
November,30,2022,Champaign,IL,Passenger,1,0,1,7,8,12.5
November,30,2022,Plaquemines,LA,Passenger,1,1,2,16,18,11.11
November,30,2022,Santa Cruz,CA,Passenger,1,0,1,18,19,5.26
November,30,2022,Ferry,WA,Passenger,24,4,28,4370,4398,0.64
November,30,2022,Benton,WA,Truck,7,0,7,43416,43423,0.02
November,30,2022,Montgomery,MD,Passenger,3,2,5,175,180,2.78
November,30,2022,Yellowstone,MT,Passenger,0,1,1,17,18,5.56
November,30,2022,Richmond,NY,Passenger,1,0,1,6,7,14.29
November,30,2022,Penobscot,ME,Passenger,0,1,1,8,9,11.11
November,30,2022,Sonoma,CA,Passenger,1,1,2,64,66,3.03
November,30,2022,Alexandria,VA,Passenger,4,1,5,95,100,5
November,30,2022,Arlington,VA,Passenger,1,0,1,107,108,0.93
November,30,2022,Adams,CO,Passenger,1,0,1,33,34,2.94
November,30,2022,Elmore,ID,Passenger,1,0,1,11,12,8.33
November,30,2022,Pierce,WA,Passenger,5996,2477,8473,540119,548592,1.54
November,30,2022,Salt Lake,UT,Passenger,1,1,2,106,108,1.85
November,30,2022,Middlesex,MA,Passenger,2,1,3,61,64,4.69
November,30,2022,Garfield,WA,Truck,0,0,0,981,981,0
November,30,2022,St. Louis,MO,Passenger,1,0,1,54,55,1.82
November,30,2022,Arapahoe,CO,Passenger,0,1,1,70,71,1.41
November,30,2022,Stevens,WA,Passenger,88,56,144,30077,30221,0.48
November,30,2022,Montgomery,AL,Passenger,0,1,1,29,30,3.33
November,30,2022,Howard,MD,Passenger,0,1,1,46,47,2.13
November,30,2022,Louisa,VA,Passenger,0,1,1,1,2,50
November,30,2022,Cook,IL,Passenger,2,0,2,158,160,1.25
November,30,2022,Houston,GA,Passenger,1,0,1,25,26,3.85
November,30,2022,Danville,VA,Passenger,1,0,1,0,1,100
November,30,2022,Bryan,GA,Passenger,0,1,1,38,39,2.56
November,30,2022,Adams,WA,Passenger,22,11,33,13032,13065,0.25
November,30,2022,Duval,FL,Passenger,1,1,2,242,244,0.82
November,30,2022,Ferry,WA,Truck,0,0,0,3579,3579,0
November,30,2022,Harnett,NC,Passenger,2,0,2,133,135,1.48
November,30,2022,Calvert,MD,Passenger,0,2,2,74,76,2.63
November,30,2022,Asotin,WA,Passenger,29,20,49,12522,12571,0.39
November,30,2022,Berkeley,SC,Passenger,0,1,1,109,110,0.91
November,30,2022,Contra Costa,CA,Passenger,0,3,3,209,212,1.42
November,30,2022,Cowlitz,WA,Passenger,389,188,577,70283,70860,0.81
November,30,2022,Jefferson,WA,Truck,6,0,6,9386,9392,0.06
November,30,2022,Benton,WA,Passenger,914,491,1405,135879,137284,1.02
November,30,2022,Alameda,CA,Passenger,3,0,3,163,166,1.81
November,30,2022,Norfolk,VA,Passenger,3,3,6,272,278,2.16
November,30,2022,Richmond,GA,Passenger,0,1,1,58,59,1.69
November,30,2022,Wilson,TX,Passenger,0,1,1,2,3,33.33
November,30,2022,Hennepin,MN,Passenger,1,0,1,39,40,2.5
November,30,2022,Lewis,WA,Passenger,260,178,438,59990,60428,0.72
November,30,2022,Ray,MO,Passenger,0,1,1,1,2,50
November,30,2022,Island,WA,Truck,15,0,15,21264,21279,0.07
November,30,2022,Harrison,MS,Passenger,1,0,1,32,33,3.03
November,30,2022,Sarasota,FL,Passenger,1,0,1,18,19,5.26
November,30,2022,Clallam,WA,Passenger,470,261,731,49431,50162,1.46
November,30,2022,Williamson,TX,Passenger,0,2,2,64,66,3.03
November,30,2022,El Paso,TX,Passenger,2,0,2,292,294,0.68
November,30,2022,Clark,WA,Passenger,4776,1979,6755,315151,321906,2.1
November,30,2022,Escambia,FL,Passenger,0,1,1,117,118,0.85
November,30,2022,Clackamas,OR,Passenger,1,0,1,117,118,0.85
November,30,2022,DeKalb,GA,Passenger,1,0,1,40,41,2.44
November,30,2022,Kings,CA,Passenger,2,1,3,282,285,1.05
November,30,2022,Grant,WA,Passenger,220,110,330,66830,67160,0.49
November,30,2022,Kitsap,WA,Passenger,2699,1134,3833,177551,181384,2.11
November,30,2022,Napa,CA,Passenger,0,1,1,9,10,10
November,30,2022,Los Angeles,CA,Passenger,5,6,11,672,683,1.61
November,30,2022,Lincoln,WA,Passenger,12,19,31,7772,7803,0.4
November,30,2022,Pennington,SD,Passenger,2,0,2,24,26,7.69
November,30,2022,Hoke,NC,Passenger,1,0,1,57,58,1.72
November,30,2022,Grant,WA,Truck,4,0,4,27996,28000,0.01
November,30,2022,Queens,NY,Passenger,1,0,1,32,33,3.03
November,30,2022,New London,CT,Passenger,2,4,6,182,188,3.19
November,30,2022,Lee,FL,Passenger,1,0,1,25,26,3.85
November,30,2022,Whatcom,WA,Truck,21,0,21,43111,43132,0.05
November,30,2022,Hamilton,OH,Passenger,1,0,1,27,28,3.57
November,30,2022,Spokane,WA,Truck,19,0,19,101973,101992,0.02
November,30,2022,Las Animas,CO,Passenger,1,0,1,1,2,50
November,30,2022,Stafford,VA,Passenger,3,1,4,80,84,4.76
November,30,2022,Allegheny,PA,Passenger,1,0,1,48,49,2.04
November,30,2022,Whitman,WA,Truck,3,0,3,8630,8633,0.03
November,30,2022,Fairbanks North Star,AK,Passenger,0,1,1,60,61,1.64
November,30,2022,Larimer,CO,Passenger,1,0,1,41,42,2.38
November,30,2022,Lewis,WA,Truck,2,0,2,26343,26345,0.01
November,30,2022,Geary,KS,Passenger,1,0,1,77,78,1.28
November,30,2022,Bell,TX,Passenger,1,0,1,281,282,0.35
November,30,2022,New Haven,CT,Passenger,0,2,2,23,25,8
November,30,2022,Chesapeake,VA,Passenger,2,3,5,293,298,1.68
November,30,2022,Grays Harbor,WA,Truck,3,0,3,21117,21120,0.01
November,30,2022,Lincoln,OR,Passenger,0,1,1,17,18,5.56
November,30,2022,Columbia,WA,Truck,0,0,0,1591,1591,0
November,30,2022,Hillsborough,FL,Passenger,0,1,1,110,111,0.9
November,30,2022,Loudoun,VA,Passenger,3,1,4,60,64,6.25
November,30,2022,Lincoln,WA,Truck,0,0,0,4862,4862,0
November,30,2022,Yakima,WA,Passenger,410,218,628,166511,167139,0.38
November,30,2022,St. Mary's,MD,Passenger,1,0,1,170,171,0.58
November,30,2022,San Juan,WA,Passenger,554,168,722,13981,14703,4.91
November,30,2022,Clark,WA,Truck,39,0,39,82070,82109,0.05
November,30,2022,Kittitas,WA,Passenger,297,93,390,29569,29959,1.3
November,30,2022,Douglas,CO,Passenger,0,1,1,58,59,1.69
November,30,2022,Cumberland,NC,Passenger,1,2,3,320,323,0.93
November,30,2022,Carroll,NH,Passenger,0,1,1,5,6,16.67
November,30,2022,Cowlitz,WA,Truck,4,0,4,28412,28416,0.01
November,30,2022,Collin,TX,Passenger,2,0,2,54,56,3.57
November,30,2022,Skagit,WA,Passenger,908,352,1260,89513,90773,1.39
November,30,2022,Polk,OR,Passenger,0,1,1,20,21,4.76
November,30,2022,Lake,IL,Passenger,1,0,1,117,118,0.85
November,30,2022,Onslow,NC,Passenger,0,1,1,150,151,0.66
November,30,2022,Pend Oreille,WA,Truck,0,0,0,5602,5602,0
November,30,2022,Monterey,CA,Passenger,1,1,2,119,121,1.65
November,30,2022,Adams,WA,Truck,1,0,1,5396,5397,0.02
November,30,2022,Kern,CA,Passenger,1,1,2,188,190,1.05
November,30,2022,Walla Walla,WA,Passenger,201,108,309,35703,36012,0.86
November,30,2022,Thurston,WA,Passenger,2552,1116,3668,192629,196297,1.87
November,30,2022,District of Columbia,DC,Passenger,4,0,4,155,159,2.52
November,30,2022,Leavenworth,KS,Passenger,0,1,1,92,93,1.08
November,30,2022,Charleston,SC,Passenger,2,2,4,53,57,7.02
November,30,2022,Denton,TX,Passenger,1,0,1,53,54,1.85
November,30,2022,Kitsap,WA,Truck,28,0,28,53049,53077,0.05
November,30,2022,Owyhee,ID,Passenger,1,0,1,3,4,25
November,30,2022,Suffolk,VA,Passenger,1,0,1,113,114,0.88
November,30,2022,Sacramento,CA,Passenger,3,0,3,171,174,1.72
November,30,2022,King,WA,Passenger,46991,12053,59044,1341209,1400253,4.22
November,30,2022,Jefferson,NY,Passenger,0,1,1,191,192,0.52
November,30,2022,Rockingham,NH,Passenger,1,0,1,12,13,7.69
November,30,2022,Asotin,WA,Truck,0,0,0,6694,6694,0
November,30,2022,Cumberland,PA,Passenger,1,0,1,35,36,2.78
November,30,2022,Moore,NC,Passenger,0,1,1,106,107,0.93
November,30,2022,Harris,TX,Passenger,1,0,1,124,125,0.8
November,30,2022,Skamania,WA,Passenger,89,51,140,8127,8267,1.69
November,30,2022,Beaufort,SC,Passenger,1,0,1,21,22,4.55
November,30,2022,Gwinnett,GA,Passenger,1,0,1,46,47,2.13
November,30,2022,Kauai,HI,Passenger,1,1,2,13,15,13.33
November,30,2022,Burlington,NJ,Passenger,0,2,2,97,99,2.02
November,30,2022,Dallas,TX,Passenger,1,0,1,87,88,1.14
November,30,2022,Fairfax,VA,Passenger,5,3,8,572,580,1.38
November,30,2022,Santa Clara,CA,Passenger,9,2,11,177,188,5.85
November,30,2022,,,Passenger,16,7,23,1251,1274,1.81
November,30,2022,Randolph,NC,Passenger,1,0,1,4,5,20
November,30,2022,Santa Barbara,CA,Passenger,1,0,1,66,67,1.49
November,30,2022,Stevens,WA,Truck,2,0,2,18874,18876,0.01
November,30,2022,Hamilton,OH,Truck,1,0,1,2,3,33.33
November,30,2022,Riverside,CA,Passenger,7,0,7,406,413,1.69
November,30,2022,Yakima,WA,Truck,6,0,6,61264,61270,0.01
November,30,2022,Douglas,NE,Passenger,2,2,4,29,33,12.12
November,30,2022,Lake,FL,Passenger,1,0,1,16,17,5.88
November,30,2022,Maricopa,AZ,Passenger,6,2,8,721,729,1.1
November,30,2022,Pacific,WA,Passenger,70,79,149,15759,15908,0.94
November,30,2022,Snohomish,WA,Truck,79,0,79,122767,122846,0.06
November,30,2022,Kittitas,WA,Truck,5,0,5,14582,14587,0.03
November,30,2022,Spokane,WA,Passenger,1896,915,2811,324763,327574,0.86
November,30,2022,Virginia Beach,VA,Passenger,2,0,2,460,462,0.43
November,30,2022,Jefferson,WA,Passenger,474,229,703,24392,25095,2.8
November,30,2022,Wahkiakum,WA,Truck,1,0,1,1804,1805,0.06
November,30,2022,Ulster,NY,Passenger,1,0,1,5,6,16.67
November,30,2022,Skamania,WA,Truck,0,0,0,3892,3892,0
November,30,2022,Sheridan,WY,Passenger,1,0,1,5,6,16.67
November,30,2022,Oldham,KY,Passenger,0,1,1,4,5,20
November,30,2022,Pend Oreille,WA,Passenger,19,13,32,8989,9021,0.35
November,30,2022,Columbia,WA,Passenger,8,1,9,2431,2440,0.37
November,30,2022,Camden,NJ,Passenger,0,1,1,12,13,7.69
November,30,2022,Washington,MD,Passenger,2,0,2,14,16,12.5
November,30,2022,Snohomish,WA,Passenger,9877,2716,12593,530771,543364,2.32
November,30,2022,Klickitat,WA,Truck,3,0,3,8251,8254,0.04
November,30,2022,Pulaski,AR,Passenger,3,0,3,26,29,10.34
November,30,2022,Franklin,WA,Truck,3,0,3,20955,20958,0.01
November,30,2022,Clallam,WA,Truck,8,0,8,21885,21893,0.04
November,30,2022,Marin,CA,Passenger,0,1,1,29,30,3.33
November,30,2022,Broward,FL,Passenger,1,0,1,64,65,1.54
November,30,2022,Kent,DE,Passenger,1,0,1,49,50,2
November,30,2022,Okanogan,WA,Truck,2,0,2,16474,16476,0.01
November,30,2022,Carroll,MD,Passenger,0,1,1,17,18,5.56
November,30,2022,Sedgwick,KS,Passenger,1,1,2,65,67,2.99
November,30,2022,Rockdale,GA,Passenger,1,0,1,6,7,14.29
November,30,2022,Okanogan,WA,Passenger,98,51,149,26251,26400,0.56
November,30,2022,Sevier,AR,Passenger,0,1,1,0,1,100
November,30,2022,Sarpy,NE,Passenger,1,0,1,49,50,2
November,30,2022,St. Clair,IL,Passenger,2,0,2,112,114,1.75
November,30,2022,Walla Walla,WA,Truck,3,0,3,13912,13915,0.02
November,30,2022,Dorchester,SC,Passenger,1,0,1,44,45,2.22
November,30,2022,Lane,OR,Passenger,0,1,1,74,75,1.33
November,30,2022,Yavapai,AZ,Passenger,1,0,1,22,23,4.35
November,30,2022,Pacific,WA,Truck,1,0,1,7853,7854,0.01
November,30,2022,Placer,CA,Passenger,2,0,2,59,61,3.28
November,30,2022,Jackson,OK,Passenger,0,1,1,32,33,3.03
November,30,2022,Mason,WA,Truck,7,0,7,20895,20902,0.03
November,30,2022,Okaloosa,FL,Passenger,0,1,1,92,93,1.08
November,30,2022,Ventura,CA,Passenger,2,1,3,212,215,1.4
November,30,2022,Portsmouth,VA,Passenger,0,1,1,70,71,1.41
November,30,2022,Garfield,WA,Passenger,1,3,4,1307,1311,0.31
November,30,2022,Hudson,NJ,Passenger,1,0,1,30,31,3.23
November,30,2022,Thurston,WA,Truck,34,0,34,54782,54816,0.06
November,30,2022,Cape May,NJ,Passenger,0,1,1,7,8,12.5
November,30,2022,Platte,MO,Passenger,1,0,1,19,20,5
November,30,2022,Rock Island,IL,Passenger,0,1,1,15,16,6.25
November,30,2022,Williams,ND,Passenger,0,1,1,5,6,16.67
November,30,2022,Sumter,SC,Passenger,0,1,1,33,34,2.94
November,30,2022,Klickitat,WA,Passenger,120,53,173,15133,15306,1.13
November,30,2022,Skagit,WA,Truck,8,0,8,32208,32216,0.02
November,30,2022,Mason,WA,Passenger,360,190,550,46961,47511,1.16
November,30,2022,Nueces,TX,Passenger,0,1,1,50,51,1.96
November,30,2022,Chelan,WA,Passenger,525,142,667,54281,54948,1.21
November,30,2022,Nassau,NY,Passenger,1,0,1,21,22,4.55
November,30,2022,Miami-Dade,FL,Passenger,1,0,1,64,65,1.54
October,31,2022,Hamilton,OH,Passenger,1,0,1,28,29,3.45
October,31,2022,Walla Walla,WA,Passenger,190,107,297,35711,36008,0.82
October,31,2022,Lane,OR,Passenger,0,1,1,75,76,1.32
October,31,2022,Pend Oreille,WA,Passenger,18,12,30,9012,9042,0.33
October,31,2022,Montgomery,AL,Passenger,0,1,1,29,30,3.33
October,31,2022,Ferry,WA,Passenger,24,4,28,4384,4412,0.63
October,31,2022,Hudson,NJ,Passenger,2,0,2,30,32,6.25
October,31,2022,Santa Cruz,CA,Passenger,1,0,1,19,20,5
October,31,2022,Mason,WA,Passenger,350,187,537,46978,47515,1.13
October,31,2022,Kern,CA,Passenger,1,1,2,186,188,1.06
October,31,2022,Collin,TX,Passenger,2,0,2,60,62,3.23
October,31,2022,Yakima,WA,Passenger,394,214,608,166433,167041,0.36
October,31,2022,Middlesex,MA,Passenger,2,1,3,61,64,4.69
October,31,2022,New Haven,CT,Passenger,0,2,2,24,26,7.69
October,31,2022,Geary,KS,Passenger,1,0,1,78,79,1.27
October,31,2022,Escambia,FL,Passenger,0,1,1,119,120,0.83
October,31,2022,Solano,CA,Passenger,2,0,2,148,150,1.33
October,31,2022,Moore,NC,Passenger,0,1,1,108,109,0.92
October,31,2022,Walla Walla,WA,Truck,3,0,3,13949,13952,0.02
October,31,2022,Whitman,WA,Passenger,103,65,168,21978,22146,0.76
October,31,2022,Washington,MD,Passenger,2,0,2,14,16,12.5
October,31,2022,Snohomish,WA,Passenger,9424,2670,12094,531029,543123,2.23
October,31,2022,Wilson,TX,Passenger,0,1,1,2,3,33.33
October,31,2022,Norfolk,VA,Passenger,3,3,6,273,279,2.15
October,31,2022,Grant,WA,Truck,2,0,2,28024,28026,0.01
October,31,2022,Manassas,VA,Passenger,0,1,1,7,8,12.5
October,31,2022,Goochland,VA,Passenger,0,1,1,74,75,1.33
October,31,2022,District of Columbia,DC,Passenger,4,0,4,158,162,2.47
October,31,2022,Wichita,TX,Passenger,2,0,2,36,38,5.26
October,31,2022,Pierce,WA,Passenger,5747,2449,8196,540967,549163,1.49
October,31,2022,Thurston,WA,Truck,30,0,30,54906,54936,0.05
October,31,2022,Grays Harbor,WA,Truck,2,0,2,21098,21100,0.01
October,31,2022,Chelan,WA,Truck,8,0,8,23087,23095,0.03
October,31,2022,Montgomery,PA,Passenger,1,0,1,19,20,5
October,31,2022,Pend Oreille,WA,Truck,0,0,0,5614,5614,0
October,31,2022,Fairfax,VA,Passenger,6,3,9,570,579,1.55
October,31,2022,Clark,WA,Truck,31,0,31,82151,82182,0.04
October,31,2022,Sedgwick,KS,Passenger,1,1,2,65,67,2.99
October,31,2022,Spartanburg,SC,Passenger,0,1,1,29,30,3.33
October,31,2022,Alexandria,VA,Passenger,4,0,4,97,101,3.96
October,31,2022,Whatcom,WA,Truck,20,0,20,43123,43143,0.05
October,31,2022,Jefferson,WA,Truck,5,0,5,9394,9399,0.05
October,31,2022,Bexar,TX,Passenger,5,3,8,389,397,2.02
October,31,2022,Sumter,SC,Passenger,0,1,1,33,34,2.94
October,31,2022,Portsmouth,VA,Passenger,0,1,1,71,72,1.39
October,31,2022,Travis,TX,Passenger,1,0,1,88,89,1.12
October,31,2022,Placer,CA,Passenger,2,0,2,58,60,3.33
October,31,2022,Bell,TX,Passenger,1,0,1,283,284,0.35
October,31,2022,Calvert,MD,Passenger,0,2,2,74,76,2.63
October,31,2022,Asotin,WA,Truck,0,0,0,6692,6692,0
October,31,2022,Denton,TX,Passenger,1,0,1,54,55,1.82
October,31,2022,Essex,NJ,Passenger,2,0,2,8,10,20
October,31,2022,Adams,CO,Passenger,1,0,1,35,36,2.78
October,31,2022,Chesapeake,VA,Passenger,3,3,6,299,305,1.97
October,31,2022,El Paso,CO,Passenger,3,1,4,536,540,0.74
October,31,2022,Elmore,ID,Passenger,1,0,1,12,13,7.69
October,31,2022,Monterey,CA,Passenger,1,1,2,120,122,1.64
October,31,2022,Kittitas,WA,Passenger,291,94,385,29590,29975,1.28
October,31,2022,Jackson,OK,Passenger,0,1,1,32,33,3.03
October,31,2022,Rockingham,NH,Passenger,1,0,1,12,13,7.69
October,31,2022,Sheridan,WY,Passenger,1,0,1,5,6,16.67
October,31,2022,Garfield,WA,Passenger,1,3,4,1315,1319,0.3
October,31,2022,Champaign,IL,Passenger,1,0,1,8,9,11.11
October,31,2022,Miami-Dade,FL,Passenger,1,0,1,67,68,1.47
October,31,2022,Contra Costa,CA,Passenger,0,3,3,214,217,1.38
October,31,2022,Oldham,KY,Passenger,0,1,1,4,5,20
October,31,2022,Santa Clara,CA,Passenger,9,2,11,184,195,5.64
October,31,2022,Jefferson,WA,Passenger,464,225,689,24416,25105,2.74
October,31,2022,Prince George's,MD,Passenger,3,1,4,110,114,3.51
October,31,2022,Salt Lake,UT,Passenger,1,1,2,108,110,1.82
October,31,2022,Hamilton,OH,Truck,1,0,1,2,3,33.33
October,31,2022,Stafford,VA,Passenger,2,1,3,81,84,3.57
October,31,2022,Kings,CA,Passenger,2,1,3,284,287,1.05
October,31,2022,San Juan,WA,Truck,7,0,7,5952,5959,0.12
October,31,2022,Skagit,WA,Truck,8,0,8,32247,32255,0.02
October,31,2022,Franklin,WA,Passenger,239,112,351,61817,62168,0.56
October,31,2022,San Juan,WA,Passenger,549,165,714,13992,14706,4.86
October,31,2022,Lincoln,WA,Truck,0,0,0,4863,4863,0
October,31,2022,Rockdale,GA,Passenger,1,0,1,6,7,14.29
October,31,2022,DeKalb,GA,Passenger,1,0,1,41,42,2.38
October,31,2022,,,Passenger,16,7,23,1251,1274,1.81
October,31,2022,Pulaski,AR,Passenger,3,0,3,27,30,10
October,31,2022,Carroll,NH,Passenger,0,1,1,5,6,16.67
October,31,2022,Charles,MD,Passenger,1,1,2,51,53,3.77
October,31,2022,Loudoun,VA,Passenger,3,1,4,61,65,6.15
October,31,2022,Lewis,WA,Truck,2,0,2,26372,26374,0.01
October,31,2022,Louisa,VA,Passenger,0,1,1,1,2,50
October,31,2022,Galveston,TX,Passenger,0,1,1,16,17,5.88
October,31,2022,Ray,MO,Passenger,0,1,1,1,2,50
October,31,2022,Clark,WA,Passenger,4606,1925,6531,315200,321731,2.03
October,31,2022,Spokane,WA,Truck,14,0,14,101936,101950,0.01
October,31,2022,Douglas,WA,Passenger,158,59,217,28437,28654,0.76
October,31,2022,Fairbanks North Star,AK,Passenger,0,1,1,63,64,1.56
October,31,2022,Hidalgo,TX,Passenger,0,1,1,50,51,1.96
October,31,2022,Allegheny,PA,Passenger,1,1,2,48,50,4
October,31,2022,Stevens,WA,Passenger,84,56,140,30055,30195,0.46
October,31,2022,Danville,VA,Passenger,1,0,1,0,1,100
October,31,2022,Philadelphia,PA,Passenger,1,0,1,36,37,2.7
October,31,2022,Queens,NY,Passenger,1,0,1,33,34,2.94
October,31,2022,Columbia,WA,Passenger,8,1,9,2442,2451,0.37
October,31,2022,Chelan,WA,Passenger,508,140,648,54201,54849,1.18
October,31,2022,Hoke,NC,Passenger,1,0,1,60,61,1.64
October,31,2022,Harrison,MS,Passenger,1,0,1,34,35,2.86
October,31,2022,Fairfax,VA,Truck,1,0,1,105,106,0.94
October,31,2022,Clark,NV,Passenger,4,2,6,441,447,1.34
October,31,2022,Cumberland,PA,Passenger,1,0,1,35,36,2.78
October,31,2022,Virginia Beach,VA,Passenger,2,0,2,469,471,0.42
October,31,2022,Whitman,WA,Truck,3,0,3,8609,8612,0.03
October,31,2022,Garfield,WA,Truck,0,0,0,977,977,0
October,31,2022,Kittitas,WA,Truck,5,0,5,14601,14606,0.03
October,31,2022,Sonoma,CA,Passenger,1,1,2,67,69,2.9
October,31,2022,Wahkiakum,WA,Truck,1,0,1,1800,1801,0.06
October,31,2022,Whatcom,WA,Passenger,1993,786,2779,148767,151546,1.83
October,31,2022,Arapahoe,CO,Passenger,0,1,1,72,73,1.37
October,31,2022,Alameda,CA,Passenger,4,0,4,165,169,2.37
October,31,2022,Leavenworth,KS,Passenger,0,1,1,93,94,1.06
October,31,2022,El Paso,TX,Passenger,2,0,2,296,298,0.67
October,31,2022,Honolulu,HI,Passenger,3,3,6,294,300,2
October,31,2022,Harnett,NC,Passenger,2,0,2,134,136,1.47
October,31,2022,San Diego,CA,Passenger,17,10,27,2100,2127,1.27
October,31,2022,Cowlitz,WA,Truck,4,0,4,28459,28463,0.01
October,31,2022,Franklin,WA,Truck,2,0,2,20887,20889,0.01
October,31,2022,Williamson,TX,Passenger,0,2,2,66,68,2.94
October,31,2022,Carroll,MD,Passenger,0,1,1,17,18,5.56
October,31,2022,Rock Island,IL,Passenger,0,1,1,15,16,6.25
October,31,2022,Owyhee,ID,Passenger,1,0,1,3,4,25
October,31,2022,Platte,MO,Passenger,1,0,1,19,20,5
October,31,2022,Richmond,GA,Passenger,0,1,1,57,58,1.72
October,31,2022,Yellowstone,MT,Passenger,0,1,1,18,19,5.26
October,31,2022,Okanogan,WA,Truck,1,0,1,16478,16479,0.01
October,31,2022,Lewis,WA,Passenger,261,179,440,59898,60338,0.73
October,31,2022,Gwinnett,GA,Passenger,1,0,1,47,48,2.08
October,31,2022,King,WA,Passenger,45341,11925,57266,1343327,1400593,4.09
October,31,2022,Sevier,AR,Passenger,0,1,1,0,1,100
October,31,2022,Wood,OH,Passenger,0,1,1,3,4,25
October,31,2022,Onslow,NC,Passenger,0,1,1,153,154,0.65
October,31,2022,St. Clair,IL,Passenger,2,0,2,115,117,1.71
October,31,2022,Benton,WA,Passenger,867,485,1352,135773,137125,0.99
October,31,2022,Grant,WA,Passenger,210,108,318,66743,67061,0.47
October,31,2022,Asotin,WA,Passenger,26,19,45,12566,12611,0.36
October,31,2022,Clallam,WA,Passenger,456,256,712,49453,50165,1.42
October,31,2022,Pierce,WA,Truck,62,0,62,140244,140306,0.04
October,31,2022,Frederick,MD,Passenger,1,0,1,57,58,1.72
October,31,2022,Bartow,GA,Passenger,0,1,1,3,4,25
October,31,2022,Plaquemines,LA,Passenger,1,1,2,16,18,11.11
October,31,2022,St. Tammany,LA,Passenger,1,0,1,33,34,2.94
October,31,2022,Hillsborough,FL,Passenger,0,1,1,112,113,0.88
October,31,2022,Napa,CA,Passenger,0,1,1,10,11,9.09
October,31,2022,Richmond,NY,Passenger,1,0,1,6,7,14.29
October,31,2022,San Bernardino,CA,Passenger,1,1,2,291,293,0.68
October,31,2022,Kauai,HI,Passenger,1,0,1,14,15,6.67
October,31,2022,Kitsap,WA,Passenger,2634,1125,3759,177642,181401,2.07
October,31,2022,Yakima,WA,Truck,5,0,5,61277,61282,0.01
October,31,2022,Spokane,WA,Passenger,1837,910,2747,324785,327532,0.84
October,31,2022,Nassau,NY,Passenger,1,0,1,21,22,4.55
October,31,2022,Lee,FL,Passenger,1,0,1,24,25,4
October,31,2022,Los Angeles,CA,Passenger,6,6,12,685,697,1.72
October,31,2022,Saratoga,NY,Passenger,1,0,1,37,38,2.63
October,31,2022,Cook,IL,Passenger,2,0,2,162,164,1.22
October,31,2022,Maricopa,AZ,Passenger,7,2,9,739,748,1.2
October,31,2022,Penobscot,ME,Passenger,0,1,1,8,9,11.11
October,31,2022,Camden,NJ,Passenger,0,1,1,12,13,7.69
October,31,2022,Polk,OR,Passenger,0,1,1,19,20,5
October,31,2022,Anne Arundel,MD,Passenger,4,4,8,304,312,2.56
October,31,2022,Montgomery,MD,Passenger,4,2,6,177,183,3.28
October,31,2022,Hennepin,MN,Passenger,1,0,1,41,42,2.38
October,31,2022,Williams,ND,Passenger,0,1,1,5,6,16.67
October,31,2022,Skagit,WA,Passenger,886,349,1235,89523,90758,1.36
October,31,2022,Bryan,GA,Passenger,0,1,1,37,38,2.63
October,31,2022,Hawaii,HI,Passenger,1,0,1,29,30,3.33
October,31,2022,Duval,FL,Passenger,1,2,3,246,249,1.2
October,31,2022,Lincoln,WA,Passenger,12,17,29,7735,7764,0.37
October,31,2022,Nueces,TX,Passenger,0,1,1,49,50,2
October,31,2022,Harris,TX,Passenger,1,0,1,126,127,0.79
October,31,2022,Skamania,WA,Truck,0,0,0,3897,3897,0
October,31,2022,Broward,FL,Passenger,1,0,1,65,66,1.52
October,31,2022,Boulder,CO,Passenger,1,0,1,31,32,3.12
October,31,2022,Sarasota,FL,Passenger,1,0,1,17,18,5.56
October,31,2022,Benton,WA,Truck,7,0,7,43350,43357,0.02
October,31,2022,Mason,WA,Truck,6,0,6,20938,20944,0.03
October,31,2022,Ferry,WA,Truck,0,0,0,3593,3593,0
October,31,2022,Las Animas,CO,Passenger,1,0,1,1,2,50
October,31,2022,Allen,IN,Passenger,1,0,1,12,13,7.69
October,31,2022,Lincoln,OR,Passenger,0,1,1,19,20,5
October,31,2022,Randolph,NC,Passenger,1,0,1,5,6,16.67
October,31,2022,Jefferson,NY,Passenger,0,1,1,193,194,0.52
October,31,2022,Suffolk,VA,Passenger,1,0,1,114,115,0.87
October,31,2022,St. Mary's,MD,Passenger,1,0,1,171,172,0.58
October,31,2022,Berkeley,SC,Passenger,0,1,1,111,112,0.89
October,31,2022,Lake,IL,Passenger,1,0,1,119,120,0.83
October,31,2022,Island,WA,Passenger,901,389,1290,61684,62974,2.05
October,31,2022,Cape May,NJ,Passenger,0,1,1,7,8,12.5
October,31,2022,Houston,GA,Passenger,1,0,1,27,28,3.57
October,31,2022,Ulster,NY,Passenger,1,0,1,5,6,16.67
October,31,2022,Douglas,WA,Truck,2,0,2,12811,12813,0.02
October,31,2022,Kootenai,ID,Truck,1,0,1,30,31,3.23
October,31,2022,Sarpy,NE,Passenger,1,0,1,49,50,2
October,31,2022,New London,CT,Passenger,2,4,6,185,191,3.14
October,31,2022,Howard,MD,Passenger,0,1,1,49,50,2
October,31,2022,Wahkiakum,WA,Passenger,24,12,36,3064,3100,1.16
October,31,2022,Thurston,WA,Passenger,2467,1109,3576,192794,196370,1.82
October,31,2022,Douglas,CO,Passenger,0,1,1,61,62,1.61
October,31,2022,Grays Harbor,WA,Passenger,231,166,397,48742,49139,0.81
October,31,2022,Dorchester,SC,Passenger,1,0,1,45,46,2.17
October,31,2022,Island,WA,Truck,14,0,14,21277,21291,0.07
October,31,2022,Marin,CA,Passenger,0,1,1,28,29,3.45
October,31,2022,Okanogan,WA,Passenger,95,49,144,26284,26428,0.54
October,31,2022,Pacific,WA,Passenger,68,74,142,15756,15898,0.89
October,31,2022,Pacific,WA,Truck,1,0,1,7875,7876,0.01
October,31,2022,Adams,WA,Truck,1,0,1,5429,5430,0.02
October,31,2022,Columbia,WA,Truck,0,0,0,1583,1583,0
October,31,2022,Cumberland,NC,Passenger,1,2,3,326,329,0.91
October,31,2022,Orange,CA,Passenger,5,2,7,308,315,2.22
October,31,2022,Burlington,NJ,Passenger,0,2,2,96,98,2.04
October,31,2022,Lake,FL,Passenger,1,0,1,16,17,5.88
October,31,2022,Cowlitz,WA,Passenger,381,184,565,70323,70888,0.8
October,31,2022,Stevens,WA,Truck,2,0,2,18903,18905,0.01
October,31,2022,Dallas,TX,Passenger,1,0,1,91,92,1.09
October,31,2022,Adams,WA,Passenger,22,12,34,13045,13079,0.26
October,31,2022,San Joaquin,CA,Passenger,1,0,1,76,77,1.3
October,31,2022,Sacramento,CA,Passenger,3,0,3,177,180,1.67
October,31,2022,Pennington,SD,Passenger,2,0,2,24,26,7.69
October,31,2022,Fort Bend,TX,Passenger,1,0,1,22,23,4.35
October,31,2022,Ventura,CA,Passenger,2,1,3,213,216,1.39
October,31,2022,Douglas,NE,Passenger,2,2,4,31,35,11.43
October,31,2022,Snohomish,WA,Truck,76,0,76,122941,123017,0.06
October,31,2022,King,WA,Truck,300,2,302,179312,179614,0.17
October,31,2022,Multnomah,OR,Passenger,0,3,3,469,472,0.64
October,31,2022,Klickitat,WA,Passenger,114,51,165,15116,15281,1.08
October,31,2022,Skamania,WA,Passenger,85,51,136,8110,8246,1.65
October,31,2022,Beaufort,SC,Passenger,1,0,1,21,22,4.55
October,31,2022,Klickitat,WA,Truck,3,0,3,8250,8253,0.04
October,31,2022,Charleston,SC,Passenger,2,2,4,53,57,7.02
October,31,2022,Clallam,WA,Truck,7,0,7,21890,21897,0.03
October,31,2022,Riverside,CA,Passenger,7,0,7,417,424,1.65
October,31,2022,Kitsap,WA,Truck,25,0,25,53166,53191,0.05
October,31,2022,Clackamas,OR,Passenger,1,0,1,121,122,0.82
October,31,2022,St. Louis,MO,Passenger,1,0,1,55,56,1.79
October,31,2022,Arlington,VA,Passenger,1,0,1,107,108,0.93
October,31,2022,Okaloosa,FL,Passenger,0,1,1,92,93,1.08
September,30,2022,Calvert,MD,Passenger,0,2,2,74,76,2.63
September,30,2022,Pend Oreille,WA,Truck,0,0,0,5638,5638,0
September,30,2022,St. Louis,MO,Passenger,1,0,1,55,56,1.79
September,30,2022,Douglas,WA,Truck,1,0,1,12781,12782,0.01
September,30,2022,Walla Walla,WA,Truck,2,0,2,13946,13948,0.01
September,30,2022,Collin,TX,Passenger,2,0,2,67,69,2.9
September,30,2022,Skagit,WA,Passenger,869,349,1218,89712,90930,1.34
September,30,2022,Denton,TX,Passenger,1,0,1,57,58,1.72
September,30,2022,Grays Harbor,WA,Passenger,224,166,390,48799,49189,0.79
September,30,2022,Randolph,NC,Passenger,1,0,1,5,6,16.67
September,30,2022,Thurston,WA,Passenger,2380,1102,3482,192946,196428,1.77
September,30,2022,Ventura,CA,Passenger,2,1,3,218,221,1.36
September,30,2022,Whitman,WA,Passenger,96,64,160,21991,22151,0.72
September,30,2022,Anchorage,AK,Passenger,1,0,1,107,108,0.93
September,30,2022,Kootenai,ID,Truck,1,0,1,33,34,2.94
September,30,2022,King,WA,Passenger,43484,11789,55273,1345189,1400462,3.95
September,30,2022,Juneau,AK,Passenger,0,1,1,28,29,3.45
September,30,2022,Broward,FL,Passenger,1,0,1,67,68,1.47
September,30,2022,Galveston,TX,Passenger,0,1,1,17,18,5.56
September,30,2022,St. Mary's,MD,Passenger,1,0,1,178,179,0.56
September,30,2022,Skagit,WA,Truck,6,0,6,32229,32235,0.02
September,30,2022,Bartow,GA,Passenger,0,1,1,3,4,25
September,30,2022,Essex,NJ,Passenger,2,0,2,8,10,20
September,30,2022,Fairbanks North Star,AK,Passenger,0,1,1,64,65,1.54
September,30,2022,Wood,OH,Passenger,0,1,1,3,4,25
September,30,2022,King,WA,Truck,241,2,243,179679,179922,0.14
September,30,2022,Columbia,WA,Passenger,8,0,8,2439,2447,0.33
September,30,2022,Clark,WA,Truck,19,0,19,82316,82335,0.02
September,30,2022,Fairfax,VA,Truck,1,0,1,106,107,0.93
September,30,2022,Lewis,WA,Truck,1,0,1,26365,26366,0
September,30,2022,Clark,WA,Passenger,4480,1890,6370,315618,321988,1.98
September,30,2022,Okaloosa,FL,Passenger,0,1,1,93,94,1.06
September,30,2022,Wichita,TX,Passenger,2,0,2,35,37,5.41
September,30,2022,Salt Lake,UT,Passenger,1,1,2,112,114,1.75
September,30,2022,Santa Cruz,CA,Passenger,1,0,1,19,20,5
September,30,2022,El Paso,TX,Passenger,2,0,2,301,303,0.66
September,30,2022,Arapahoe,CO,Passenger,0,1,1,70,71,1.41
September,30,2022,Allen,IN,Passenger,1,0,1,12,13,7.69
September,30,2022,Pacific,WA,Truck,0,0,0,7871,7871,0
September,30,2022,Benton,WA,Passenger,833,480,1313,135629,136942,0.96
September,30,2022,Monterey,CA,Passenger,1,1,2,118,120,1.67
September,30,2022,Napa,CA,Passenger,0,1,1,10,11,9.09
September,30,2022,Pacific,WA,Passenger,70,74,144,15784,15928,0.9
September,30,2022,Hudson,NJ,Passenger,2,0,2,30,32,6.25
September,30,2022,Cowlitz,WA,Passenger,368,180,548,70395,70943,0.77
September,30,2022,Klickitat,WA,Truck,2,0,2,8263,8265,0.02
September,30,2022,Grant,WA,Passenger,200,108,308,66776,67084,0.46
September,30,2022,Douglas,CO,Passenger,0,1,1,62,63,1.59
September,30,2022,Fairfax,VA,Passenger,6,3,9,579,588,1.53
September,30,2022,Allegheny,PA,Passenger,1,1,2,49,51,3.92
September,30,2022,Chelan,WA,Passenger,495,135,630,54143,54773,1.15
September,30,2022,Lincoln,WA,Passenger,10,16,26,7725,7751,0.34
September,30,2022,Oldham,KY,Passenger,0,1,1,4,5,20
September,30,2022,Suffolk,VA,Passenger,1,0,1,116,117,0.85
September,30,2022,San Diego,CA,Passenger,17,10,27,2135,2162,1.25
September,30,2022,Portsmouth,VA,Passenger,0,1,1,72,73,1.37
September,30,2022,Stevens,WA,Passenger,81,56,137,30090,30227,0.45
September,30,2022,Pierce,WA,Passenger,5530,2431,7961,541956,549917,1.45
September,30,2022,St. Clair,IL,Passenger,2,0,2,114,116,1.72
September,30,2022,Richmond,GA,Passenger,0,1,1,58,59,1.69
September,30,2022,Lane,OR,Passenger,0,1,1,78,79,1.27
September,30,2022,Yakima,WA,Passenger,376,210,586,166551,167137,0.35
September,30,2022,Travis,TX,Passenger,1,0,1,95,96,1.04
September,30,2022,Douglas,WA,Passenger,147,61,208,28445,28653,0.73
September,30,2022,Bexar,TX,Passenger,5,3,8,401,409,1.96
September,30,2022,Hoke,NC,Passenger,1,0,1,59,60,1.67
September,30,2022,Whatcom,WA,Truck,14,0,14,43119,43133,0.03
September,30,2022,Kings,CA,Passenger,2,1,3,286,289,1.04
September,30,2022,Burlington,NJ,Passenger,0,2,2,99,101,1.98
September,30,2022,Frederick,MD,Passenger,1,0,1,58,59,1.69
September,30,2022,Charleston,SC,Passenger,2,2,4,56,60,6.67
September,30,2022,Ray,MO,Passenger,0,1,1,1,2,50
September,30,2022,Carroll,MD,Passenger,0,1,1,17,18,5.56
September,30,2022,Grant,WA,Truck,2,0,2,28018,28020,0.01
September,30,2022,Spokane,WA,Passenger,1770,889,2659,324764,327423,0.81
September,30,2022,Island,WA,Truck,10,0,10,21293,21303,0.05
September,30,2022,Solano,CA,Passenger,2,0,2,151,153,1.31
September,30,2022,Asotin,WA,Passenger,25,19,44,12615,12659,0.35
September,30,2022,Rockdale,GA,Passenger,1,0,1,6,7,14.29
September,30,2022,Hawaii,HI,Passenger,1,0,1,30,31,3.23
September,30,2022,Sheridan,WY,Passenger,1,0,1,5,6,16.67
September,30,2022,Jefferson,WA,Truck,3,0,3,9383,9386,0.03
September,30,2022,Howard,MD,Passenger,0,1,1,51,52,1.92
September,30,2022,Richmond,NY,Passenger,1,0,1,6,7,14.29
September,30,2022,Snohomish,WA,Truck,59,0,59,123094,123153,0.05
September,30,2022,Alameda,CA,Passenger,4,0,4,169,173,2.31
September,30,2022,Wahkiakum,WA,Truck,1,0,1,1801,1802,0.06
September,30,2022,Owyhee,ID,Passenger,1,0,1,3,4,25
September,30,2022,Asotin,WA,Truck,0,0,0,6710,6710,0
September,30,2022,Kern,CA,Passenger,1,1,2,188,190,1.05
September,30,2022,Saratoga,NY,Passenger,1,0,1,37,38,2.63
September,30,2022,Bryan,GA,Passenger,0,1,1,37,38,2.63
September,30,2022,Elmore,ID,Passenger,1,0,1,12,13,7.69
September,30,2022,Nueces,TX,Passenger,1,1,2,49,51,3.92
September,30,2022,Lake,FL,Passenger,1,0,1,16,17,5.88
September,30,2022,Whitman,WA,Truck,2,0,2,8588,8590,0.02
September,30,2022,Plaquemines,LA,Passenger,1,1,2,16,18,11.11
September,30,2022,San Joaquin,CA,Passenger,1,0,1,78,79,1.27
September,30,2022,Montgomery,AL,Passenger,0,1,1,32,33,3.03
September,30,2022,Franklin,WA,Passenger,231,112,343,61926,62269,0.55
September,30,2022,Yakima,WA,Truck,3,0,3,61428,61431,0
September,30,2022,Cook,IL,Passenger,2,0,2,164,166,1.2
September,30,2022,Rockingham,NH,Passenger,1,0,1,13,14,7.14
September,30,2022,Klickitat,WA,Passenger,109,53,162,15150,15312,1.06
September,30,2022,Wilson,TX,Passenger,0,1,1,2,3,33.33
September,30,2022,Yellowstone,MT,Passenger,0,1,1,19,20,5
September,30,2022,Grays Harbor,WA,Truck,2,0,2,21184,21186,0.01
September,30,2022,Spartanburg,SC,Passenger,0,1,1,32,33,3.03
September,30,2022,Montgomery,MD,Passenger,4,2,6,178,184,3.26
September,30,2022,Middlesex,MA,Passenger,2,1,3,65,68,4.41
September,30,2022,Virginia Beach,VA,Passenger,2,0,2,481,483,0.41
September,30,2022,Philadelphia,PA,Passenger,1,0,1,37,38,2.63
September,30,2022,Columbia,WA,Truck,0,0,0,1577,1577,0
September,30,2022,Moore,NC,Passenger,0,1,1,107,108,0.93
September,30,2022,Onslow,NC,Passenger,0,1,1,157,158,0.63
September,30,2022,Dorchester,SC,Passenger,1,0,1,48,49,2.04
September,30,2022,New London,CT,Passenger,2,4,6,186,192,3.12
September,30,2022,El Paso,CO,Passenger,3,1,4,548,552,0.72
September,30,2022,Adams,WA,Truck,1,0,1,5425,5426,0.02
September,30,2022,Okanogan,WA,Truck,1,0,1,16528,16529,0.01
September,30,2022,Wahkiakum,WA,Passenger,24,12,36,3078,3114,1.16
September,30,2022,Clackamas,OR,Passenger,1,0,1,128,129,0.78
September,30,2022,Escambia,FL,Passenger,0,1,1,121,122,0.82
September,30,2022,Garfield,WA,Truck,0,0,0,970,970,0
September,30,2022,San Bernardino,CA,Passenger,1,1,2,295,297,0.67
September,30,2022,San Mateo,CA,Passenger,1,0,1,70,71,1.41
September,30,2022,Kitsap,WA,Passenger,2572,1110,3682,177870,181552,2.03
September,30,2022,Stevens,WA,Truck,1,0,1,18922,18923,0.01
September,30,2022,Leavenworth,KS,Passenger,0,1,1,94,95,1.05
September,30,2022,Pulaski,AR,Passenger,1,0,1,27,28,3.57
September,30,2022,Cowlitz,WA,Truck,3,0,3,28470,28473,0.01
September,30,2022,Ulster,NY,Passenger,1,0,1,7,8,12.5
September,30,2022,Kittitas,WA,Passenger,290,91,381,29618,29999,1.27
September,30,2022,Sedgwick,KS,Passenger,1,1,2,65,67,2.99
September,30,2022,Goochland,VA,Passenger,0,1,1,83,84,1.19
September,30,2022,San Juan,WA,Truck,6,0,6,5955,5961,0.1
September,30,2022,Lewis,WA,Passenger,252,176,428,59836,60264,0.71
September,30,2022,DeKalb,GA,Passenger,1,0,1,42,43,2.33
September,30,2022,Orange,CA,Passenger,5,2,7,313,320,2.19
September,30,2022,Polk,OR,Passenger,0,1,1,20,21,4.76
September,30,2022,San Juan,WA,Passenger,536,162,698,14006,14704,4.75
September,30,2022,Lincoln,OR,Passenger,0,1,1,22,23,4.35
September,30,2022,Las Animas,CO,Passenger,1,0,1,1,2,50
September,30,2022,Thurston,WA,Truck,21,0,21,55058,55079,0.04
September,30,2022,Adams,CO,Passenger,1,0,1,36,37,2.7
September,30,2022,Lincoln,WA,Truck,0,0,0,4853,4853,0
September,30,2022,Sevier,AR,Passenger,0,1,1,0,1,100
September,30,2022,District of Columbia,DC,Passenger,4,0,4,158,162,2.47
September,30,2022,Charles,MD,Passenger,1,1,2,52,54,3.7
September,30,2022,Contra Costa,CA,Passenger,0,3,3,222,225,1.33
September,30,2022,Louisa,VA,Passenger,0,1,1,1,2,50
September,30,2022,Franklin,WA,Truck,2,0,2,20933,20935,0.01
September,30,2022,Ferry,WA,Truck,0,0,0,3616,3616,0
September,30,2022,,,Passenger,16,7,23,1251,1274,1.81
September,30,2022,Alexandria,VA,Passenger,3,0,3,99,102,2.94
September,30,2022,Cape May,NJ,Passenger,0,1,1,7,8,12.5
September,30,2022,Camden,NJ,Passenger,0,1,1,12,13,7.69
September,30,2022,Cumberland,NC,Passenger,1,2,3,330,333,0.9
September,30,2022,Harrison,MS,Passenger,1,0,1,35,36,2.78
September,30,2022,Chelan,WA,Truck,6,0,6,23093,23099,0.03
September,30,2022,Multnomah,OR,Passenger,0,3,3,482,485,0.62
September,30,2022,Snohomish,WA,Passenger,9066,2624,11690,531280,542970,2.15
September,30,2022,Pennington,SD,Passenger,2,0,2,24,26,7.69
September,30,2022,Benton,WA,Truck,5,0,5,43402,43407,0.01
September,30,2022,Skamania,WA,Passenger,85,51,136,8126,8262,1.65
September,30,2022,Stafford,VA,Passenger,2,1,3,83,86,3.49
September,30,2022,Harnett,NC,Passenger,2,0,2,135,137,1.46
September,30,2022,Maricopa,AZ,Passenger,7,1,8,771,779,1.03
September,30,2022,Jackson,OK,Passenger,0,1,1,32,33,3.03
September,30,2022,Penobscot,ME,Passenger,0,1,1,8,9,11.11
September,30,2022,Sacramento,CA,Passenger,3,0,3,181,184,1.63
September,30,2022,Boulder,CO,Passenger,1,0,1,31,32,3.12
September,30,2022,Santa Clara,CA,Passenger,10,2,12,194,206,5.83
September,30,2022,Adams,WA,Passenger,22,10,32,13017,13049,0.25
September,30,2022,Lake,IL,Passenger,2,0,2,121,123,1.63
September,30,2022,Sonoma,CA,Passenger,0,1,1,67,68,1.47
September,30,2022,Dallas,TX,Passenger,1,0,1,95,96,1.04
September,30,2022,Garfield,WA,Passenger,1,3,4,1324,1328,0.3
September,30,2022,Anne Arundel,MD,Passenger,4,4,8,318,326,2.45
September,30,2022,Honolulu,HI,Passenger,3,3,6,301,307,1.95
September,30,2022,Washington,MD,Passenger,2,0,2,15,17,11.76
September,30,2022,Geary,KS,Passenger,1,0,1,80,81,1.23
September,30,2022,Okanogan,WA,Passenger,93,49,142,26316,26458,0.54
September,30,2022,Whatcom,WA,Passenger,1952,772,2724,148826,151550,1.8
September,30,2022,Riverside,CA,Passenger,7,0,7,425,432,1.62
September,30,2022,Mason,WA,Truck,4,0,4,21008,21012,0.02
September,30,2022,Platte,MO,Passenger,1,0,1,21,22,4.55
September,30,2022,Hennepin,MN,Passenger,1,0,1,43,44,2.27
September,30,2022,Island,WA,Passenger,877,382,1259,61751,63010,2
September,30,2022,Hidalgo,TX,Passenger,0,1,1,53,54,1.85
September,30,2022,Norfolk,VA,Passenger,3,3,6,275,281,2.14
September,30,2022,Walla Walla,WA,Passenger,187,105,292,35831,36123,0.81
September,30,2022,Tarrant,TX,Passenger,1,0,1,93,94,1.06
September,30,2022,Sumter,SC,Passenger,0,1,1,32,33,3.03
September,30,2022,Harris,TX,Passenger,1,0,1,127,128,0.78
September,30,2022,Chesapeake,VA,Passenger,3,3,6,306,312,1.92
September,30,2022,Spokane,WA,Truck,12,0,12,101973,101985,0.01
September,30,2022,Danville,VA,Passenger,1,0,1,0,1,100
September,30,2022,Sarpy,NE,Passenger,1,0,1,49,50,2
September,30,2022,Kitsap,WA,Truck,23,0,23,53242,53265,0.04
September,30,2022,St. Tammany,LA,Passenger,1,0,1,33,34,2.94
September,30,2022,Jefferson,WA,Passenger,454,224,678,24444,25122,2.7
September,30,2022,Rock Island,IL,Passenger,0,1,1,15,16,6.25
September,30,2022,Bell,TX,Passenger,1,0,1,292,293,0.34
September,30,2022,Arlington,VA,Passenger,1,0,1,114,115,0.87
September,30,2022,Douglas,NE,Passenger,2,2,4,34,38,10.53
September,30,2022,Berkeley,SC,Passenger,0,1,1,112,113,0.88
September,30,2022,Pierce,WA,Truck,46,0,46,140496,140542,0.03
September,30,2022,Pend Oreille,WA,Passenger,18,12,30,9024,9054,0.33
September,30,2022,Clallam,WA,Passenger,442,249,691,49482,50173,1.38
September,30,2022,Hillsborough,FL,Passenger,0,1,1,111,112,0.89
September,30,2022,Cumberland,PA,Passenger,1,0,1,35,36,2.78
September,30,2022,Lee,FL,Passenger,1,0,1,24,25,4
September,30,2022,Miami-Dade,FL,Passenger,1,0,1,71,72,1.39
September,30,2022,Duval,FL,Passenger,1,2,3,254,257,1.17
September,30,2022,Williams,ND,Passenger,0,1,1,5,6,16.67
September,30,2022,Los Angeles,CA,Passenger,7,6,13,695,708,1.84
September,30,2022,Loudoun,VA,Passenger,2,1,3,62,65,4.62
September,30,2022,Clallam,WA,Truck,6,0,6,21889,21895,0.03
September,30,2022,Kauai,HI,Passenger,1,0,1,15,16,6.25
September,30,2022,Manassas,VA,Passenger,0,1,1,8,9,11.11
September,30,2022,Williamson,TX,Passenger,0,2,2,71,73,2.74
September,30,2022,Hamilton,OH,Passenger,1,0,1,27,28,3.57
September,30,2022,New Haven,CT,Passenger,0,2,2,24,26,7.69
September,30,2022,Prince George's,MD,Passenger,3,1,4,112,116,3.45
September,30,2022,Nassau,NY,Passenger,1,0,1,21,22,4.55
September,30,2022,Kittitas,WA,Truck,4,0,4,14604,14608,0.03
September,30,2022,Montgomery,PA,Passenger,1,0,1,20,21,4.76
September,30,2022,Gwinnett,GA,Passenger,1,0,1,49,50,2
September,30,2022,Skamania,WA,Truck,0,0,0,3908,3908,0
September,30,2022,Placer,CA,Passenger,2,0,2,61,63,3.17
September,30,2022,Queens,NY,Passenger,1,0,1,36,37,2.7
September,30,2022,Carroll,NH,Passenger,0,1,1,5,6,16.67
September,30,2022,Ferry,WA,Passenger,22,4,26,4400,4426,0.59
September,30,2022,Houston,GA,Passenger,1,0,1,30,31,3.23
September,30,2022,Jefferson,NY,Passenger,0,1,1,195,196,0.51
September,30,2022,Clark,NV,Passenger,4,2,6,453,459,1.31
September,30,2022,Sarasota,FL,Passenger,1,0,1,20,21,4.76
September,30,2022,Coryell,TX,Passenger,1,0,1,86,87,1.15
September,30,2022,Fort Bend,TX,Passenger,1,0,1,24,25,4
September,30,2022,Mason,WA,Passenger,339,178,517,46951,47468,1.09
September,30,2022,Marin,CA,Passenger,0,1,1,27,28,3.57
April,30,2023,Hamilton,OH,Truck,1,0,1,2,3,33.33
April,30,2023,Kings,CA,Passenger,2,1,3,264,267,1.12
April,30,2023,Madison,IL,Passenger,1,0,1,16,17,5.88
April,30,2023,Frederick,MD,Passenger,1,0,1,52,53,1.89
April,30,2023,Arlington,VA,Passenger,1,0,1,98,99,1.01
April,30,2023,Mason,WA,Passenger,417,204,621,46162,46783,1.33
April,30,2023,Sedgwick,KS,Passenger,1,0,1,52,53,1.89
April,30,2023,Marin,CA,Passenger,0,1,1,26,27,3.7
April,30,2023,Denton,TX,Passenger,1,0,1,44,45,2.22
April,30,2023,Newport News,VA,Passenger,1,0,1,91,92,1.09
April,30,2023,Leavenworth,KS,Passenger,0,1,1,89,90,1.11
April,30,2023,Richmond,GA,Passenger,0,1,1,54,55,1.82
April,30,2023,Sonoma,CA,Passenger,1,1,2,51,53,3.77
April,30,2023,Oldham,KY,Passenger,0,1,1,4,5,20
April,30,2023,Kittitas,WA,Passenger,328,95,423,29339,29762,1.42
April,30,2023,Okaloosa,FL,Passenger,0,1,1,85,86,1.16
April,30,2023,Richmond,NY,Passenger,1,0,1,6,7,14.29
April,30,2023,Ventura,CA,Passenger,2,1,3,194,197,1.52
April,30,2023,Benton,OR,Passenger,1,0,1,33,34,2.94
April,30,2023,Rock Island,IL,Passenger,0,1,1,14,15,6.67
April,30,2023,Carroll,MD,Passenger,0,1,1,17,18,5.56
April,30,2023,Wichita,TX,Passenger,2,0,2,30,32,6.25
April,30,2023,Contra Costa,CA,Passenger,0,3,3,193,196,1.53
April,30,2023,Wahkiakum,WA,Passenger,27,16,43,3044,3087,1.39
April,30,2023,St. Louis,MO,Passenger,1,0,1,50,51,1.96
April,30,2023,King,WA,Passenger,53639,13733,67372,1318485,1385857,4.86
April,30,2023,Elmore,ID,Passenger,1,0,1,9,10,10
April,30,2023,Polk,OR,Passenger,0,1,1,15,16,6.25
April,30,2023,Asotin,WA,Passenger,33,21,54,12339,12393,0.44
April,30,2023,Montgomery,PA,Passenger,1,0,1,14,15,6.67
April,30,2023,Essex,NJ,Passenger,2,0,2,4,6,33.33
April,30,2023,Grays Harbor,WA,Truck,4,0,4,20911,20915,0.02
April,30,2023,Stafford,VA,Passenger,3,1,4,73,77,5.19
April,30,2023,Williamson,TX,Passenger,0,1,1,51,52,1.92
April,30,2023,Broward,FL,Passenger,1,0,1,54,55,1.82
April,30,2023,San Bernardino,CA,Passenger,2,1,3,253,256,1.17
April,30,2023,St. Clair,IL,Passenger,2,0,2,101,103,1.94
April,30,2023,Honolulu,HI,Passenger,2,3,5,240,245,2.04
April,30,2023,Montgomery,MD,Passenger,3,3,6,168,174,3.45
April,30,2023,Adams,CO,Passenger,1,0,1,27,28,3.57
April,30,2023,Walla Walla,WA,Truck,5,0,5,13674,13679,0.04
April,30,2023,New London,CT,Passenger,1,4,5,169,174,2.87
April,30,2023,Escambia,FL,Passenger,0,1,1,106,107,0.93
April,30,2023,Kern,CA,Passenger,1,1,2,171,173,1.16
April,30,2023,Klickitat,WA,Truck,8,0,8,8230,8238,0.1
April,30,2023,Jefferson,WA,Truck,10,0,10,9292,9302,0.11
April,30,2023,Thurston,WA,Truck,55,0,55,53886,53941,0.1
April,30,2023,Lane,OR,Passenger,0,1,1,63,64,1.56
April,30,2023,Fairbanks North Star,AK,Passenger,0,1,1,48,49,2.04
April,30,2023,Allen,IN,Passenger,1,0,1,9,10,10
April,30,2023,Rockingham,NH,Passenger,1,0,1,10,11,9.09
April,30,2023,Douglas,WA,Truck,7,0,7,12882,12889,0.05
April,30,2023,Bell,TX,Passenger,1,0,1,242,243,0.41
April,30,2023,San Juan,WA,Truck,12,0,12,5895,5907,0.2
April,30,2023,Cowlitz,WA,Passenger,433,203,636,69749,70385,0.9
April,30,2023,Spokane,WA,Truck,34,0,34,101402,101436,0.03
April,30,2023,Douglas,NE,Passenger,1,1,2,25,27,7.41
April,30,2023,Wahkiakum,WA,Truck,2,0,2,1779,1781,0.11
April,30,2023,St. Tammany,LA,Passenger,1,0,1,30,31,3.23
April,30,2023,Douglas,WA,Passenger,189,61,250,28557,28807,0.87
April,30,2023,Hawaii,HI,Passenger,1,0,1,23,24,4.17
April,30,2023,Charleston,SC,Passenger,2,2,4,52,56,7.14
April,30,2023,Washington,MD,Passenger,2,0,2,13,15,13.33
April,30,2023,Calvert,MD,Passenger,1,1,2,72,74,2.7
April,30,2023,Whatcom,WA,Passenger,2323,857,3180,147179,150359,2.11
April,30,2023,Mason,WA,Truck,10,0,10,20712,20722,0.05
April,30,2023,Lincoln,OR,Passenger,0,1,1,12,13,7.69
April,30,2023,Norfolk,VA,Passenger,3,2,5,254,259,1.93
April,30,2023,Multnomah,OR,Passenger,0,2,2,404,406,0.49
April,30,2023,Santa Barbara,CA,Passenger,1,0,1,61,62,1.61
April,30,2023,Yakima,WA,Passenger,468,242,710,165211,165921,0.43
April,30,2023,Suffolk,VA,Passenger,1,0,1,101,102,0.98
April,30,2023,Travis,TX,Passenger,1,0,1,76,77,1.3
April,30,2023,Ray,MO,Passenger,0,1,1,0,1,100
April,30,2023,Champaign,IL,Passenger,1,0,1,7,8,12.5
April,30,2023,Rockdale,GA,Passenger,1,0,1,3,4,25
April,30,2023,Kauai,HI,Passenger,1,1,2,13,15,13.33
April,30,2023,Solano,CA,Passenger,5,0,5,134,139,3.6
April,30,2023,Clark,WA,Passenger,5444,2212,7656,312447,320103,2.39
April,30,2023,Jefferson,NY,Passenger,1,1,2,167,169,1.18
April,30,2023,Coryell,TX,Passenger,1,0,1,72,73,1.37
April,30,2023,Placer,CA,Passenger,1,0,1,51,52,1.92
April,30,2023,Bexar,TX,Passenger,3,3,6,340,346,1.73
April,30,2023,Hidalgo,TX,Passenger,0,1,1,45,46,2.17
April,30,2023,Howard,MD,Passenger,0,1,1,42,43,2.33
April,30,2023,Lake,IL,Passenger,2,0,2,110,112,1.79
April,30,2023,Chesapeake,VA,Passenger,2,3,5,272,277,1.81
April,30,2023,Snohomish,WA,Passenger,11666,2925,14591,526766,541357,2.7
April,30,2023,Stevens,WA,Passenger,108,62,170,29693,29863,0.57
April,30,2023,Okanogan,WA,Truck,3,0,3,16397,16400,0.02
April,30,2023,Nassau,NY,Passenger,1,0,1,21,22,4.55
April,30,2023,District of Columbia,DC,Passenger,4,0,4,147,151,2.65
April,30,2023,Pacific,WA,Truck,3,0,3,7787,7790,0.04
April,30,2023,Cowlitz,WA,Truck,8,0,8,28099,28107,0.03
April,30,2023,Beaufort,SC,Passenger,1,0,1,18,19,5.26
April,30,2023,Island,WA,Passenger,1012,423,1435,61224,62659,2.29
April,30,2023,Adams,WA,Truck,2,0,2,5293,5295,0.04
April,30,2023,Ferry,WA,Passenger,19,4,23,4330,4353,0.53
April,30,2023,Monterey,CA,Passenger,1,1,2,108,110,1.82
April,30,2023,DeKalb,GA,Passenger,1,0,1,38,39,2.56
April,30,2023,Walla Walla,WA,Passenger,213,115,328,35303,35631,0.92
April,30,2023,Orange,CA,Passenger,7,2,9,269,278,3.24
April,30,2023,Moore,NC,Passenger,0,1,1,102,103,0.97
April,30,2023,,,Passenger,17,6,23,1226,1249,1.84
April,30,2023,Hamilton,OH,Passenger,1,0,1,24,25,4
April,30,2023,Skamania,WA,Passenger,99,53,152,8037,8189,1.86
April,30,2023,Prince George's,MD,Passenger,2,1,3,104,107,2.8
April,30,2023,Pulaski,AR,Passenger,3,0,3,21,24,12.5
April,30,2023,Dallas,TX,Passenger,1,0,1,73,74,1.35
April,30,2023,Chelan,WA,Passenger,605,154,759,54000,54759,1.39
April,30,2023,Clark,WA,Truck,82,0,82,81044,81126,0.1
April,30,2023,Galveston,TX,Passenger,0,1,1,15,16,6.25
April,30,2023,Virginia Beach,VA,Passenger,2,0,2,419,421,0.48
April,30,2023,Hoke,NC,Passenger,1,0,1,55,56,1.79
April,30,2023,Salt Lake,UT,Passenger,0,1,1,88,89,1.12
April,30,2023,Clark,NV,Passenger,4,2,6,375,381,1.57
April,30,2023,Larimer,CO,Passenger,1,0,1,36,37,2.7
April,30,2023,Randolph,NC,Passenger,1,0,1,3,4,25
April,30,2023,Vernon,LA,Passenger,1,0,1,68,69,1.45
April,30,2023,Harnett,NC,Passenger,4,0,4,120,124,3.23
April,30,2023,Hillsborough,FL,Passenger,0,1,1,100,101,0.99
April,30,2023,Ferry,WA,Truck,0,0,0,3556,3556,0
April,30,2023,Skagit,WA,Passenger,1055,389,1444,88585,90029,1.6
April,30,2023,Grant,WA,Truck,10,0,10,27865,27875,0.04
April,30,2023,San Juan,WA,Passenger,605,173,778,13782,14560,5.34
April,30,2023,Lincoln,WA,Passenger,18,16,34,7641,7675,0.44
April,30,2023,New Haven,CT,Passenger,0,2,2,21,23,8.7
April,30,2023,Lee,AL,Passenger,1,0,1,11,12,8.33
April,30,2023,Goochland,VA,Passenger,0,1,1,39,40,2.5
April,30,2023,Anne Arundel,MD,Passenger,4,4,8,287,295,2.71
April,30,2023,Kootenai,ID,Truck,1,0,1,27,28,3.57
April,30,2023,Grant,WA,Passenger,265,114,379,66651,67030,0.57
April,30,2023,San Diego,CA,Passenger,16,9,25,1874,1899,1.32
April,30,2023,Las Animas,CO,Passenger,1,0,1,0,1,100
April,30,2023,Pend Oreille,WA,Passenger,31,13,44,8881,8925,0.49
April,30,2023,Yavapai,AZ,Passenger,1,0,1,20,21,4.76
April,30,2023,Boulder,CO,Passenger,1,0,1,24,25,4
April,30,2023,Camden,NJ,Passenger,0,1,1,12,13,7.69
April,30,2023,Clallam,WA,Truck,18,0,18,21654,21672,0.08
April,30,2023,Emmet,MI,Passenger,0,1,1,0,1,100
April,30,2023,Hennepin,MN,Passenger,1,0,1,30,31,3.23
April,30,2023,Pacific,WA,Passenger,76,89,165,15580,15745,1.05
April,30,2023,Nueces,TX,Passenger,0,1,1,49,50,2
April,30,2023,Skagit,WA,Truck,18,0,18,31863,31881,0.06
April,30,2023,Collin,TX,Passenger,2,0,2,39,41,4.88
April,30,2023,Pierce,WA,Truck,139,0,139,137180,137319,0.1
April,30,2023,Maricopa,AZ,Passenger,7,3,10,578,588,1.7
April,30,2023,Santa Clara,CA,Passenger,8,2,10,146,156,6.41
April,30,2023,Berkeley,SC,Passenger,0,1,1,99,100,1
April,30,2023,Gwinnett,GA,Passenger,1,0,1,41,42,2.38
April,30,2023,Fairfax,VA,Passenger,4,3,7,529,536,1.31
April,30,2023,King,WA,Truck,634,2,636,175590,176226,0.36
April,30,2023,Hudson,NJ,Passenger,1,0,1,16,17,5.88
April,30,2023,Columbia,WA,Truck,0,0,0,1552,1552,0
April,30,2023,Alexandria,VA,Passenger,3,1,4,87,91,4.4
April,30,2023,Harrison,MS,Passenger,1,0,1,29,30,3.33
April,30,2023,Loudoun,VA,Passenger,3,0,3,56,59,5.08
April,30,2023,Whatcom,WA,Truck,52,0,52,42622,42674,0.12
April,30,2023,Pierce,WA,Passenger,7128,2668,9796,530958,540754,1.81
April,30,2023,Clallam,WA,Passenger,518,278,796,48898,49694,1.6
April,30,2023,Franklin,WA,Passenger,298,132,430,61650,62080,0.69
April,30,2023,Fairfax,VA,Truck,1,0,1,86,87,1.15
April,30,2023,El Paso,CO,Passenger,3,1,4,475,479,0.84
April,30,2023,Portsmouth,VA,Passenger,0,1,1,61,62,1.61
April,30,2023,Whitman,WA,Truck,4,0,4,8571,8575,0.05
April,30,2023,Duval,FL,Passenger,1,0,1,221,222,0.45
April,30,2023,Douglas,CO,Passenger,0,1,1,50,51,1.96
April,30,2023,Lewis,WA,Truck,6,0,6,26003,26009,0.02
April,30,2023,Cape May,NJ,Passenger,0,1,1,7,8,12.5
April,30,2023,Lincoln,WA,Truck,0,0,0,4841,4841,0
April,30,2023,Platte,MO,Passenger,1,0,1,16,17,5.88
April,30,2023,Snohomish,WA,Truck,145,0,145,121227,121372,0.12
April,30,2023,Chelan,WA,Truck,26,0,26,23050,23076,0.11
April,30,2023,Arapahoe,CO,Passenger,1,1,2,66,68,2.94
April,30,2023,Grays Harbor,WA,Passenger,286,182,468,48238,48706,0.96
April,30,2023,Los Angeles,CA,Passenger,4,5,9,585,594,1.52
April,30,2023,Stevens,WA,Truck,1,0,1,18709,18710,0.01
April,30,2023,El Paso,TX,Passenger,2,0,2,258,260,0.77
April,30,2023,Dorchester,SC,Passenger,1,0,1,39,40,2.5
April,30,2023,Alameda,CA,Passenger,3,0,3,149,152,1.97
April,30,2023,Kittitas,WA,Truck,8,0,8,14470,14478,0.06
April,30,2023,Jefferson,WA,Passenger,531,253,784,24161,24945,3.14
April,30,2023,Geary,KS,Passenger,1,0,1,69,70,1.43
April,30,2023,Cook,IL,Passenger,2,0,2,142,144,1.39
April,30,2023,St. Mary's,MD,Passenger,1,0,1,163,164,0.61
April,30,2023,Saratoga,NY,Passenger,1,1,2,30,32,6.25
April,30,2023,Jackson,OK,Passenger,0,1,1,30,31,3.23
April,30,2023,Cumberland,PA,Passenger,1,0,1,31,32,3.12
April,30,2023,Sacramento,CA,Passenger,4,0,4,134,138,2.9
April,30,2023,Sheridan,WY,Passenger,1,0,1,5,6,16.67
April,30,2023,Columbia,WA,Passenger,8,1,9,2407,2416,0.37
April,30,2023,Yellowstone,MT,Passenger,0,1,1,16,17,5.88
April,30,2023,Wilson,TX,Passenger,0,1,1,2,3,33.33
April,30,2023,Whitman,WA,Passenger,138,73,211,21935,22146,0.95
April,30,2023,Spokane,WA,Passenger,2159,1032,3191,321308,324499,0.98
April,30,2023,Kitsap,WA,Passenger,3049,1231,4280,175820,180100,2.38
April,30,2023,Yakima,WA,Truck,11,0,11,60803,60814,0.02
April,30,2023,Plaquemines,LA,Passenger,1,1,2,14,16,12.5
April,30,2023,Klickitat,WA,Passenger,139,59,198,15114,15312,1.29
April,30,2023,Island,WA,Truck,28,0,28,21017,21045,0.13
April,30,2023,Garfield,WA,Truck,0,0,0,976,976,0
April,30,2023,Santa Cruz,CA,Passenger,1,0,1,13,14,7.14
April,30,2023,Adams,WA,Passenger,24,12,36,12970,13006,0.28
April,30,2023,Kent,DE,Passenger,1,0,1,44,45,2.22
April,30,2023,Cumberland,NC,Passenger,1,2,3,285,288,1.04
April,30,2023,Pend Oreille,WA,Truck,0,0,0,5600,5600,0
April,30,2023,Asotin,WA,Truck,0,0,0,6607,6607,0
April,30,2023,Ulster,NY,Passenger,1,0,1,4,5,20
April,30,2023,Skamania,WA,Truck,1,0,1,3828,3829,0.03
April,30,2023,Riverside,CA,Passenger,6,1,7,357,364,1.92
April,30,2023,Benton,WA,Passenger,1089,545,1634,135049,136683,1.2
April,30,2023,Miami-Dade,FL,Passenger,1,0,1,54,55,1.82
April,30,2023,Napa,CA,Passenger,0,1,1,10,11,9.09
April,30,2023,Thurston,WA,Passenger,2918,1188,4106,190129,194235,2.11
April,30,2023,Sarpy,NE,Passenger,1,0,1,45,46,2.17
April,30,2023,Kitsap,WA,Truck,64,0,64,52364,52428,0.12
April,30,2023,Burlington,NJ,Passenger,0,2,2,89,91,2.2
April,30,2023,Lewis,WA,Passenger,302,195,497,58597,59094,0.84
April,30,2023,Franklin,WA,Truck,4,0,4,20798,20802,0.02
April,30,2023,Garfield,WA,Passenger,1,3,4,1316,1320,0.3
April,30,2023,Okanogan,WA,Passenger,119,58,177,25969,26146,0.68
April,30,2023,Charles,MD,Passenger,1,1,2,49,51,3.92
April,30,2023,Sarasota,FL,Passenger,1,0,1,14,15,6.67
April,30,2023,Houston,GA,Passenger,1,0,1,26,27,3.7
April,30,2023,Benton,WA,Truck,19,0,19,43089,43108,0.04
April,30,2023,Middlesex,MA,Passenger,2,1,3,57,60,5
April,30,2023,Onslow,NC,Passenger,0,1,1,136,137,0.73
February,28,2023,Santa Clara,CA,Passenger,8,2,10,163,173,5.78
February,28,2023,Nassau,NY,Passenger,1,0,1,21,22,4.55
February,28,2023,Santa Cruz,CA,Passenger,1,0,1,12,13,7.69
February,28,2023,Monterey,CA,Passenger,1,1,2,113,115,1.74
February,28,2023,Solano,CA,Passenger,4,0,4,135,139,2.88
February,28,2023,Vernon,LA,Passenger,1,0,1,71,72,1.39
February,28,2023,Skagit,WA,Passenger,987,377,1364,89175,90539,1.51
February,28,2023,Platte,MO,Passenger,1,0,1,17,18,5.56
February,28,2023,Leavenworth,KS,Passenger,0,1,1,90,91,1.1
February,28,2023,Cowlitz,WA,Passenger,424,193,617,70210,70827,0.87
February,28,2023,Benton,WA,Truck,15,0,15,43323,43338,0.03
February,28,2023,Rockingham,NH,Passenger,1,0,1,10,11,9.09
February,28,2023,Emmet,MI,Passenger,0,1,1,0,1,100
February,28,2023,Gwinnett,GA,Passenger,1,0,1,42,43,2.33
February,28,2023,El Paso,CO,Passenger,3,1,4,497,501,0.8
February,28,2023,Ferry,WA,Truck,0,0,0,3565,3565,0
February,28,2023,Galveston,TX,Passenger,0,1,1,17,18,5.56
February,28,2023,Salt Lake,UT,Passenger,0,1,1,97,98,1.02
February,28,2023,Lewis,WA,Truck,4,0,4,26200,26204,0.02
February,28,2023,Pulaski,AR,Passenger,3,0,3,22,25,12
February,28,2023,Collin,TX,Passenger,2,0,2,44,46,4.35
February,28,2023,Clark,WA,Passenger,5174,2109,7283,313862,321145,2.27
February,28,2023,Lee,AL,Passenger,1,0,1,11,12,8.33
February,28,2023,Whitman,WA,Truck,4,0,4,8658,8662,0.05
February,28,2023,Cook,IL,Passenger,2,0,2,148,150,1.33
February,28,2023,New Haven,CT,Passenger,0,2,2,22,24,8.33
February,28,2023,Honolulu,HI,Passenger,2,3,5,266,271,1.85
February,28,2023,Hamilton,OH,Truck,1,0,1,2,3,33.33
February,28,2023,Columbia,WA,Truck,0,0,0,1574,1574,0
February,28,2023,Klickitat,WA,Truck,4,0,4,8261,8265,0.05
February,28,2023,El Paso,TX,Passenger,2,0,2,273,275,0.73
February,28,2023,Spokane,WA,Passenger,2041,983,3024,323909,326933,0.92
February,28,2023,Larimer,CO,Passenger,1,0,1,37,38,2.63
February,28,2023,Clallam,WA,Passenger,504,272,776,49281,50057,1.55
February,28,2023,Portsmouth,VA,Passenger,0,1,1,62,63,1.59
February,28,2023,San Juan,WA,Passenger,580,172,752,13878,14630,5.14
February,28,2023,Douglas,CO,Passenger,0,1,1,55,56,1.79
February,28,2023,Travis,TX,Passenger,1,0,1,77,78,1.28
February,28,2023,Island,WA,Truck,20,0,20,21105,21125,0.09
February,28,2023,Yakima,WA,Passenger,445,240,685,166120,166805,0.41
February,28,2023,Kitsap,WA,Passenger,2890,1171,4061,176810,180871,2.25
February,28,2023,Geary,KS,Passenger,1,0,1,71,72,1.39
February,28,2023,Hennepin,MN,Passenger,1,0,1,31,32,3.12
February,28,2023,Rock Island,IL,Passenger,0,1,1,14,15,6.67
February,28,2023,Hillsborough,FL,Passenger,0,1,1,103,104,0.96
February,28,2023,Onslow,NC,Passenger,0,1,1,140,141,0.71
February,28,2023,Sarpy,NE,Passenger,1,0,1,45,46,2.17
February,28,2023,Hoke,NC,Passenger,1,0,1,58,59,1.69
February,28,2023,Snohomish,WA,Truck,122,0,122,122092,122214,0.1
February,28,2023,Stevens,WA,Truck,2,0,2,18777,18779,0.01
February,28,2023,Marin,CA,Passenger,0,1,1,27,28,3.57
February,28,2023,Adams,WA,Passenger,21,11,32,13008,13040,0.25
February,28,2023,Garfield,WA,Truck,0,0,0,979,979,0
February,28,2023,Virginia Beach,VA,Passenger,2,0,2,438,440,0.45
February,28,2023,Whitman,WA,Passenger,124,71,195,22018,22213,0.88
February,28,2023,Ray,MO,Passenger,0,1,1,0,1,100
February,28,2023,Kootenai,ID,Truck,1,0,1,26,27,3.7
February,28,2023,DeKalb,GA,Passenger,1,0,1,39,40,2.5
February,28,2023,San Juan,WA,Truck,10,0,10,5886,5896,0.17
February,28,2023,Louisa,VA,Passenger,0,1,1,1,2,50
February,28,2023,Wahkiakum,WA,Truck,1,0,1,1793,1794,0.06
February,28,2023,Sumter,SC,Passenger,0,1,1,32,33,3.03
February,28,2023,Douglas,WA,Truck,6,0,6,12882,12888,0.05
February,28,2023,Lincoln,WA,Truck,0,0,0,4846,4846,0
February,28,2023,Douglas,NE,Passenger,2,1,3,27,30,10
February,28,2023,Broward,FL,Passenger,1,0,1,58,59,1.69
February,28,2023,Arapahoe,CO,Passenger,1,1,2,64,66,3.03
February,28,2023,Klickitat,WA,Passenger,127,57,184,15144,15328,1.2
February,28,2023,Kent,DE,Passenger,1,0,1,48,49,2.04
February,28,2023,Nueces,TX,Passenger,0,1,1,50,51,1.96
February,28,2023,Walla Walla,WA,Passenger,206,108,314,35642,35956,0.87
February,28,2023,Arlington,VA,Passenger,1,0,1,103,104,0.96
February,28,2023,Madison,IL,Passenger,1,0,1,15,16,6.25
February,28,2023,Alameda,CA,Passenger,3,0,3,152,155,1.94
February,28,2023,Okaloosa,FL,Passenger,0,1,1,89,90,1.11
February,28,2023,Lake,IL,Passenger,1,0,1,114,115,0.87
February,28,2023,Chelan,WA,Truck,19,0,19,23120,23139,0.08
February,28,2023,Newport News,VA,Passenger,1,0,1,93,94,1.06
February,28,2023,Clark,NV,Passenger,4,2,6,398,404,1.49
February,28,2023,Kittitas,WA,Truck,6,0,6,14560,14566,0.04
February,28,2023,Fairfax,VA,Passenger,5,3,8,546,554,1.44
February,28,2023,Grays Harbor,WA,Truck,2,0,2,21049,21051,0.01
February,28,2023,Montgomery,MD,Passenger,3,3,6,173,179,3.35
February,28,2023,Skamania,WA,Passenger,93,53,146,8095,8241,1.77
February,28,2023,Island,WA,Passenger,977,411,1388,61460,62848,2.21
February,28,2023,San Diego,CA,Passenger,17,9,26,1971,1997,1.3
February,28,2023,Randolph,NC,Passenger,1,0,1,4,5,20
February,28,2023,Dallas,TX,Passenger,1,0,1,75,76,1.32
February,28,2023,Sonoma,CA,Passenger,1,1,2,58,60,3.33
February,28,2023,Lewis,WA,Passenger,292,186,478,59690,60168,0.79
February,28,2023,District of Columbia,DC,Passenger,4,0,4,150,154,2.6
February,28,2023,Carroll,MD,Passenger,0,1,1,17,18,5.56
February,28,2023,Stafford,VA,Passenger,3,1,4,77,81,4.94
February,28,2023,Frederick,MD,Passenger,1,0,1,54,55,1.82
February,28,2023,Hawaii,HI,Passenger,1,0,1,24,25,4
February,28,2023,Allegheny,PA,Passenger,1,0,1,46,47,2.13
February,28,2023,Yavapai,AZ,Passenger,1,0,1,22,23,4.35
February,28,2023,Pierce,WA,Passenger,6593,2579,9172,535692,544864,1.68
February,28,2023,King,WA,Truck,495,2,497,177291,177788,0.28
February,28,2023,Whatcom,WA,Truck,44,0,44,42882,42926,0.1
February,28,2023,Sheridan,WY,Passenger,1,0,1,5,6,16.67
February,28,2023,Danville,VA,Passenger,1,0,1,0,1,100
February,28,2023,Spokane,WA,Truck,26,0,26,101868,101894,0.03
February,28,2023,Ferry,WA,Passenger,21,4,25,4341,4366,0.57
February,28,2023,Los Angeles,CA,Passenger,4,5,9,618,627,1.44
February,28,2023,Yellowstone,MT,Passenger,0,1,1,15,16,6.25
February,28,2023,Suffolk,VA,Passenger,1,0,1,110,111,0.9
February,28,2023,Oldham,KY,Passenger,0,1,1,4,5,20
February,28,2023,Calvert,MD,Passenger,0,2,2,75,77,2.6
February,28,2023,Washington,MD,Passenger,2,0,2,14,16,12.5
February,28,2023,Coryell,TX,Passenger,1,0,1,78,79,1.27
February,28,2023,Grays Harbor,WA,Passenger,272,171,443,48597,49040,0.9
February,28,2023,Hudson,NJ,Passenger,1,0,1,24,25,4
February,28,2023,Elmore,ID,Passenger,1,0,1,10,11,9.09
February,28,2023,Douglas,WA,Passenger,180,59,239,28618,28857,0.83
February,28,2023,San Joaquin,CA,Passenger,1,0,1,73,74,1.35
February,28,2023,Thurston,WA,Truck,49,0,49,54485,54534,0.09
February,28,2023,Skagit,WA,Truck,13,0,13,32041,32054,0.04
February,28,2023,Rockdale,GA,Passenger,1,0,1,5,6,16.67
February,28,2023,Jefferson,NY,Passenger,1,1,2,178,180,1.11
February,28,2023,Santa Barbara,CA,Passenger,1,0,1,63,64,1.56
February,28,2023,Asotin,WA,Passenger,30,20,50,12475,12525,0.4
February,28,2023,Essex,NJ,Passenger,2,0,2,6,8,25
February,28,2023,Charles,MD,Passenger,1,1,2,49,51,3.92
February,28,2023,Placer,CA,Passenger,1,0,1,53,54,1.85
February,28,2023,Norfolk,VA,Passenger,3,3,6,263,269,2.23
February,28,2023,Lane,OR,Passenger,0,1,1,70,71,1.41
February,28,2023,King,WA,Passenger,50928,12806,63734,1330234,1393968,4.57
February,28,2023,St. Louis,MO,Passenger,1,0,1,50,51,1.96
February,28,2023,Lincoln,OR,Passenger,0,1,1,13,14,7.14
February,28,2023,Orange,CA,Passenger,7,2,9,286,295,3.05
February,28,2023,Miami-Dade,FL,Passenger,1,0,1,60,61,1.64
February,28,2023,Okanogan,WA,Truck,2,0,2,16449,16451,0.01
February,28,2023,Adams,CO,Passenger,1,0,1,30,31,3.23
February,28,2023,Champaign,IL,Passenger,1,0,1,8,9,11.11
February,28,2023,Loudoun,VA,Passenger,3,0,3,57,60,5
February,28,2023,Harris,TX,Passenger,1,0,1,116,117,0.85
February,28,2023,Montgomery,AL,Passenger,0,1,1,29,30,3.33
February,28,2023,Jefferson,WA,Truck,9,0,9,9332,9341,0.1
February,28,2023,Sedgwick,KS,Passenger,1,1,2,61,63,3.17
February,28,2023,Middlesex,MA,Passenger,2,1,3,59,62,4.84
February,28,2023,Montgomery,PA,Passenger,1,0,1,16,17,5.88
February,28,2023,Alexandria,VA,Passenger,3,1,4,89,93,4.3
February,28,2023,Jackson,OK,Passenger,0,1,1,31,32,3.12
February,28,2023,St. Mary's,MD,Passenger,1,0,1,167,168,0.6
February,28,2023,Ventura,CA,Passenger,2,1,3,200,203,1.48
February,28,2023,Jefferson,WA,Passenger,508,242,750,24237,24987,3
February,28,2023,Moore,NC,Passenger,0,1,1,101,102,0.98
February,28,2023,Allen,IN,Passenger,1,0,1,11,12,8.33
February,28,2023,Pend Oreille,WA,Truck,0,0,0,5573,5573,0
February,28,2023,Walla Walla,WA,Truck,3,0,3,13814,13817,0.02
February,28,2023,Harrison,MS,Passenger,1,0,1,31,32,3.12
February,28,2023,Mason,WA,Truck,9,0,9,20863,20872,0.04
February,28,2023,Sarasota,FL,Passenger,1,0,1,16,17,5.88
February,28,2023,Clallam,WA,Truck,12,0,12,21812,21824,0.05
February,28,2023,Benton,WA,Passenger,989,517,1506,135708,137214,1.1
February,28,2023,Lake,FL,Passenger,1,0,1,14,15,6.67
February,28,2023,Cape May,NJ,Passenger,0,1,1,7,8,12.5
February,28,2023,Grant,WA,Truck,7,0,7,28056,28063,0.02
February,28,2023,Lincoln,WA,Passenger,16,17,33,7744,7777,0.42
February,28,2023,Bartow,GA,Passenger,0,1,1,3,4,25
February,28,2023,Cumberland,NC,Passenger,1,2,3,302,305,0.98
February,28,2023,Bell,TX,Passenger,1,0,1,259,260,0.38
February,28,2023,Burlington,NJ,Passenger,0,2,2,92,94,2.13
February,28,2023,Riverside,CA,Passenger,7,0,7,380,387,1.81
February,28,2023,Snohomish,WA,Passenger,10921,2841,13762,529463,543225,2.53
February,28,2023,Stevens,WA,Passenger,99,58,157,29968,30125,0.52
February,28,2023,,,Passenger,16,6,22,1247,1269,1.73
February,28,2023,Dorchester,SC,Passenger,1,0,1,41,42,2.38
February,28,2023,Berkeley,SC,Passenger,0,1,1,104,105,0.95
February,28,2023,Hidalgo,TX,Passenger,0,1,1,46,47,2.13
February,28,2023,Clark,WA,Truck,70,0,70,81540,81610,0.09
February,28,2023,Chelan,WA,Passenger,566,151,717,54278,54995,1.3
February,28,2023,Bexar,TX,Passenger,4,3,7,356,363,1.93
February,28,2023,Pacific,WA,Passenger,71,82,153,15680,15833,0.97
February,28,2023,New London,CT,Passenger,2,4,6,174,180,3.33
February,28,2023,Fairfax,VA,Truck,1,0,1,94,95,1.05
February,28,2023,Fairbanks North Star,AK,Passenger,0,1,1,56,57,1.75
February,28,2023,Wilson,TX,Passenger,0,1,1,2,3,33.33
February,28,2023,Howard,MD,Passenger,0,1,1,43,44,2.27
February,28,2023,Adams,WA,Truck,2,0,2,5362,5364,0.04
February,28,2023,Multnomah,OR,Passenger,0,2,2,423,425,0.47
February,28,2023,Richmond,NY,Passenger,1,0,1,6,7,14.29
February,28,2023,Goochland,VA,Passenger,0,1,1,53,54,1.85
February,28,2023,Wahkiakum,WA,Passenger,26,15,41,3046,3087,1.33
February,28,2023,Hamilton,OH,Passenger,1,0,1,24,25,4
February,28,2023,Charleston,SC,Passenger,2,2,4,54,58,6.9
February,28,2023,Yakima,WA,Truck,9,0,9,61121,61130,0.01
February,28,2023,Kitsap,WA,Truck,49,0,49,52804,52853,0.09
February,28,2023,Okanogan,WA,Passenger,107,56,163,26100,26263,0.62
February,28,2023,Garfield,WA,Passenger,1,3,4,1315,1319,0.3
February,28,2023,Camden,NJ,Passenger,0,1,1,12,13,7.69
February,28,2023,Houston,GA,Passenger,1,0,1,24,25,4
February,28,2023,Harnett,NC,Passenger,2,0,2,124,126,1.59
February,28,2023,Chesapeake,VA,Passenger,2,3,5,282,287,1.74
February,28,2023,Wichita,TX,Passenger,2,0,2,34,36,5.56
February,28,2023,Richmond,GA,Passenger,0,1,1,56,57,1.75
February,28,2023,Ulster,NY,Passenger,1,0,1,4,5,20
February,28,2023,Kings,CA,Passenger,2,1,3,273,276,1.09
February,28,2023,Thurston,WA,Passenger,2773,1153,3926,191440,195366,2.01
February,28,2023,St. Clair,IL,Passenger,2,0,2,106,108,1.85
February,28,2023,Denton,TX,Passenger,1,0,1,46,47,2.13
February,28,2023,Columbia,WA,Passenger,8,1,9,2424,2433,0.37
February,28,2023,Franklin,WA,Passenger,275,128,403,61808,62211,0.65
February,28,2023,Kern,CA,Passenger,1,1,2,182,184,1.09
February,28,2023,Franklin,WA,Truck,4,0,4,20960,20964,0.02
February,28,2023,Lee,FL,Passenger,1,0,1,24,25,4
February,28,2023,Pierce,WA,Truck,111,0,111,138554,138665,0.08
February,28,2023,St. Tammany,LA,Passenger,1,0,1,30,31,3.23
February,28,2023,Pacific,WA,Truck,2,0,2,7825,7827,0.03
February,28,2023,Prince George's,MD,Passenger,3,1,4,113,117,3.42
February,28,2023,Saratoga,NY,Passenger,1,1,2,32,34,5.88
February,28,2023,Asotin,WA,Truck,0,0,0,6661,6661,0
February,28,2023,Williamson,TX,Passenger,0,2,2,57,59,3.39
February,28,2023,Maricopa,AZ,Passenger,7,3,10,643,653,1.53
February,28,2023,Cowlitz,WA,Truck,7,0,7,28319,28326,0.02
February,28,2023,Sacramento,CA,Passenger,4,0,4,152,156,2.56
February,28,2023,Duval,FL,Passenger,1,0,1,232,233,0.43
February,28,2023,Anne Arundel,MD,Passenger,4,4,8,297,305,2.62
February,28,2023,Contra Costa,CA,Passenger,0,3,3,199,202,1.49
February,28,2023,Grant,WA,Passenger,241,114,355,66906,67261,0.53
February,28,2023,Boulder,CO,Passenger,1,0,1,26,27,3.7
February,28,2023,Beaufort,SC,Passenger,1,0,1,19,20,5
February,28,2023,Mason,WA,Passenger,394,199,593,46628,47221,1.26
February,28,2023,Whatcom,WA,Passenger,2212,826,3038,148577,151615,2
February,28,2023,Kauai,HI,Passenger,1,1,2,13,15,13.33
February,28,2023,Pend Oreille,WA,Passenger,26,13,39,8936,8975,0.43
February,28,2023,Napa,CA,Passenger,0,1,1,9,10,10
February,28,2023,Polk,OR,Passenger,0,1,1,17,18,5.56
February,28,2023,Kittitas,WA,Passenger,322,92,414,29510,29924,1.38
February,28,2023,Skamania,WA,Truck,1,0,1,3860,3861,0.03
February,28,2023,San Bernardino,CA,Passenger,2,1,3,272,275,1.09
February,28,2023,Plaquemines,LA,Passenger,1,1,2,16,18,11.11
February,28,2023,Cumberland,PA,Passenger,1,0,1,32,33,3.03
February,28,2023,Escambia,FL,Passenger,0,1,1,110,111,0.9
February,28,2023,Las Animas,CO,Passenger,1,0,1,0,1,100
January,31,2023,St. Mary's,MD,Passenger,1,0,1,169,170,0.59
January,31,2023,Chelan,WA,Truck,15,0,15,23105,23120,0.06
January,31,2023,Hawaii,HI,Passenger,1,0,1,25,26,3.85
January,31,2023,Randolph,NC,Passenger,1,0,1,4,5,20
January,31,2023,Sarasota,FL,Passenger,1,0,1,16,17,5.88
January,31,2023,San Joaquin,CA,Passenger,1,0,1,74,75,1.33
January,31,2023,Clark,WA,Passenger,5070,2078,7148,314583,321731,2.22
January,31,2023,Island,WA,Passenger,955,401,1356,61553,62909,2.16
January,31,2023,Harnett,NC,Passenger,2,0,2,129,131,1.53
January,31,2023,Douglas,NE,Passenger,2,1,3,28,31,9.68
January,31,2023,Hamilton,OH,Passenger,1,0,1,25,26,3.85
January,31,2023,Rock Island,IL,Passenger,0,1,1,14,15,6.67
January,31,2023,Williamson,TX,Passenger,0,2,2,58,60,3.33
January,31,2023,Allegheny,PA,Passenger,1,0,1,48,49,2.04
January,31,2023,Santa Clara,CA,Passenger,9,2,11,167,178,6.18
January,31,2023,Berkeley,SC,Passenger,0,1,1,108,109,0.92
January,31,2023,Kent,DE,Passenger,1,0,1,48,49,2.04
January,31,2023,Richmond,GA,Passenger,0,1,1,58,59,1.69
January,31,2023,Rockdale,GA,Passenger,1,0,1,6,7,14.29
January,31,2023,Prince George's,MD,Passenger,3,1,4,110,114,3.51
January,31,2023,Yellowstone,MT,Passenger,0,1,1,16,17,5.88
January,31,2023,San Juan,WA,Truck,9,0,9,5904,5913,0.15
January,31,2023,Skamania,WA,Passenger,93,53,146,8110,8256,1.77
January,31,2023,Whatcom,WA,Truck,37,0,37,42986,43023,0.09
January,31,2023,Danville,VA,Passenger,1,0,1,0,1,100
January,31,2023,Harris,TX,Passenger,1,0,1,118,119,0.84
January,31,2023,Whitman,WA,Passenger,120,70,190,22014,22204,0.86
January,31,2023,Montgomery,PA,Passenger,1,0,1,17,18,5.56
January,31,2023,Harrison,MS,Passenger,1,0,1,32,33,3.03
January,31,2023,Okaloosa,FL,Passenger,0,1,1,89,90,1.11
January,31,2023,St. Louis,MO,Passenger,1,0,1,51,52,1.92
January,31,2023,Galveston,TX,Passenger,0,1,1,16,17,5.88
January,31,2023,Bexar,TX,Passenger,4,3,7,365,372,1.88
January,31,2023,Grays Harbor,WA,Passenger,260,164,424,48595,49019,0.86
January,31,2023,Cowlitz,WA,Truck,7,0,7,28344,28351,0.02
January,31,2023,Arlington,VA,Passenger,1,0,1,104,105,0.95
January,31,2023,Miami-Dade,FL,Passenger,1,0,1,61,62,1.61
January,31,2023,Wahkiakum,WA,Truck,1,0,1,1794,1795,0.06
January,31,2023,Ulster,NY,Passenger,1,0,1,4,5,20
January,31,2023,Gwinnett,GA,Passenger,1,0,1,43,44,2.27
January,31,2023,Chesapeake,VA,Passenger,2,3,5,286,291,1.72
January,31,2023,King,WA,Truck,461,2,463,177951,178414,0.26
January,31,2023,Honolulu,HI,Passenger,3,3,6,272,278,2.16
January,31,2023,Elmore,ID,Passenger,1,0,1,11,12,8.33
January,31,2023,Stevens,WA,Passenger,96,57,153,29986,30139,0.51
January,31,2023,Frederick,MD,Passenger,1,0,1,55,56,1.79
January,31,2023,Lewis,WA,Passenger,281,185,466,59747,60213,0.77
January,31,2023,Broward,FL,Passenger,1,0,1,60,61,1.64
January,31,2023,St. Clair,IL,Passenger,2,0,2,107,109,1.83
January,31,2023,Asotin,WA,Passenger,30,20,50,12490,12540,0.4
January,31,2023,Douglas,WA,Passenger,172,58,230,28592,28822,0.8
January,31,2023,St. Tammany,LA,Passenger,1,0,1,29,30,3.33
January,31,2023,Kittitas,WA,Truck,5,0,5,14551,14556,0.03
January,31,2023,Camden,NJ,Passenger,0,1,1,12,13,7.69
January,31,2023,Plaquemines,LA,Passenger,1,1,2,16,18,11.11
January,31,2023,Alexandria,VA,Passenger,3,1,4,91,95,4.21
January,31,2023,Contra Costa,CA,Passenger,0,3,3,203,206,1.46
January,31,2023,Collin,TX,Passenger,2,0,2,46,48,4.17
January,31,2023,Jefferson,WA,Truck,6,0,6,9368,9374,0.06
January,31,2023,Riverside,CA,Passenger,7,0,7,384,391,1.79
January,31,2023,Sedgwick,KS,Passenger,1,1,2,62,64,3.12
January,31,2023,Virginia Beach,VA,Passenger,2,0,2,448,450,0.44
January,31,2023,Bartow,GA,Passenger,0,1,1,3,4,25
January,31,2023,Thurston,WA,Truck,42,0,42,54598,54640,0.08
January,31,2023,Louisa,VA,Passenger,0,1,1,1,2,50
January,31,2023,Fairbanks North Star,AK,Passenger,0,1,1,57,58,1.72
January,31,2023,Adams,WA,Passenger,22,11,33,13010,13043,0.25
January,31,2023,Los Angeles,CA,Passenger,4,5,9,635,644,1.4
January,31,2023,Skagit,WA,Passenger,958,364,1322,89336,90658,1.46
January,31,2023,Platte,MO,Passenger,1,0,1,18,19,5.26
January,31,2023,Adams,CO,Passenger,1,0,1,32,33,3.03
January,31,2023,Grant,WA,Truck,5,0,5,28035,28040,0.02
January,31,2023,Richmond,NY,Passenger,1,0,1,6,7,14.29
January,31,2023,Saratoga,NY,Passenger,1,1,2,34,36,5.56
January,31,2023,Ferry,WA,Truck,0,0,0,3552,3552,0
January,31,2023,Larimer,CO,Passenger,1,0,1,39,40,2.5
January,31,2023,Nassau,NY,Passenger,1,0,1,21,22,4.55
January,31,2023,Lee,FL,Passenger,1,0,1,24,25,4
January,31,2023,Santa Barbara,CA,Passenger,1,0,1,65,66,1.52
January,31,2023,Chelan,WA,Passenger,556,147,703,54338,55041,1.28
January,31,2023,Douglas,WA,Truck,5,0,5,12874,12879,0.04
January,31,2023,Klickitat,WA,Truck,4,0,4,8231,8235,0.05
January,31,2023,Marin,CA,Passenger,0,1,1,29,30,3.33
January,31,2023,Hoke,NC,Passenger,1,0,1,58,59,1.69
January,31,2023,Island,WA,Truck,20,0,20,21176,21196,0.09
January,31,2023,Clark,WA,Truck,62,0,62,81807,81869,0.08
January,31,2023,San Bernardino,CA,Passenger,2,1,3,276,279,1.08
January,31,2023,Essex,NJ,Passenger,2,0,2,7,9,22.22
January,31,2023,Ray,MO,Passenger,0,1,1,0,1,100
January,31,2023,Boulder,CO,Passenger,1,0,1,27,28,3.57
January,31,2023,Geary,KS,Passenger,1,0,1,73,74,1.35
January,31,2023,Pacific,WA,Passenger,72,81,153,15730,15883,0.96
January,31,2023,Walla Walla,WA,Passenger,203,107,310,35733,36043,0.86
January,31,2023,Bell,TX,Passenger,1,0,1,263,264,0.38
January,31,2023,Lake,IL,Passenger,1,0,1,115,116,0.86
January,31,2023,Norfolk,VA,Passenger,3,3,6,265,271,2.21
January,31,2023,District of Columbia,DC,Passenger,4,0,4,152,156,2.56
January,31,2023,Las Animas,CO,Passenger,1,0,1,0,1,100
January,31,2023,DeKalb,GA,Passenger,1,0,1,39,40,2.5
January,31,2023,Clark,NV,Passenger,4,2,6,405,411,1.46
January,31,2023,Salt Lake,UT,Passenger,0,1,1,100,101,0.99
January,31,2023,Oldham,KY,Passenger,0,1,1,4,5,20
January,31,2023,Kitsap,WA,Passenger,2835,1163,3998,177157,181155,2.21
January,31,2023,Montgomery,MD,Passenger,3,3,6,172,178,3.37
January,31,2023,Hillsborough,FL,Passenger,0,1,1,103,104,0.96
January,31,2023,Yakima,WA,Passenger,435,228,663,166438,167101,0.4
January,31,2023,Lake,FL,Passenger,1,0,1,15,16,6.25
January,31,2023,Cumberland,NC,Passenger,1,2,3,306,309,0.97
January,31,2023,Garfield,WA,Passenger,1,3,4,1319,1323,0.3
January,31,2023,Coryell,TX,Passenger,1,0,1,79,80,1.25
January,31,2023,Yavapai,AZ,Passenger,1,0,1,22,23,4.35
January,31,2023,Snohomish,WA,Truck,113,0,113,122400,122513,0.09
January,31,2023,Wichita,TX,Passenger,2,0,2,34,36,5.56
January,31,2023,Burlington,NJ,Passenger,0,2,2,93,95,2.11
January,31,2023,Leavenworth,KS,Passenger,0,1,1,92,93,1.08
January,31,2023,Kauai,HI,Passenger,1,1,2,13,15,13.33
January,31,2023,Houston,GA,Passenger,1,0,1,24,25,4
January,31,2023,Lincoln,WA,Truck,0,0,0,4853,4853,0
January,31,2023,Santa Cruz,CA,Passenger,1,0,1,13,14,7.14
January,31,2023,Lee,AL,Passenger,1,0,1,11,12,8.33
January,31,2023,Sumter,SC,Passenger,0,1,1,31,32,3.12
January,31,2023,Thurston,WA,Passenger,2703,1144,3847,191970,195817,1.96
January,31,2023,Fairfax,VA,Passenger,5,3,8,559,567,1.41
January,31,2023,Howard,MD,Passenger,0,1,1,43,44,2.27
January,31,2023,Denton,TX,Passenger,1,0,1,45,46,2.17
January,31,2023,Kittitas,WA,Passenger,312,94,406,29546,29952,1.36
January,31,2023,Jefferson,NY,Passenger,1,1,2,183,185,1.08
January,31,2023,Lane,OR,Passenger,0,1,1,74,75,1.33
January,31,2023,Jackson,OK,Passenger,0,1,1,32,33,3.03
January,31,2023,Dorchester,SC,Passenger,1,0,1,42,43,2.33
January,31,2023,San Diego,CA,Passenger,17,9,26,1998,2024,1.28
January,31,2023,Suffolk,VA,Passenger,1,0,1,113,114,0.88
January,31,2023,Beaufort,SC,Passenger,1,0,1,19,20,5
January,31,2023,New London,CT,Passenger,2,4,6,179,185,3.24
January,31,2023,Whitman,WA,Truck,3,0,3,8648,8651,0.03
January,31,2023,,,Passenger,16,6,22,1253,1275,1.73
January,31,2023,Okanogan,WA,Passenger,105,53,158,26127,26285,0.6
January,31,2023,Douglas,CO,Passenger,0,1,1,55,56,1.79
January,31,2023,Okanogan,WA,Truck,2,0,2,16435,16437,0.01
January,31,2023,Grays Harbor,WA,Truck,2,0,2,21070,21072,0.01
January,31,2023,Cape May,NJ,Passenger,0,1,1,7,8,12.5
January,31,2023,Snohomish,WA,Passenger,10586,2793,13379,530262,543641,2.46
January,31,2023,Charles,MD,Passenger,1,1,2,47,49,4.08
January,31,2023,Lincoln,OR,Passenger,0,1,1,13,14,7.14
January,31,2023,Mason,WA,Passenger,380,192,572,46777,47349,1.21
January,31,2023,Garfield,WA,Truck,0,0,0,976,976,0
January,31,2023,Rockingham,NH,Passenger,1,0,1,10,11,9.09
January,31,2023,Clallam,WA,Truck,9,0,9,21848,21857,0.04
January,31,2023,Franklin,WA,Passenger,262,124,386,61842,62228,0.62
January,31,2023,Carroll,MD,Passenger,0,1,1,17,18,5.56
January,31,2023,Spokane,WA,Truck,22,0,22,101916,101938,0.02
January,31,2023,Stafford,VA,Passenger,3,1,4,78,82,4.88
January,31,2023,Cowlitz,WA,Passenger,417,193,610,70247,70857,0.86
January,31,2023,Wilson,TX,Passenger,0,1,1,2,3,33.33
January,31,2023,Grant,WA,Passenger,230,113,343,66923,67266,0.51
January,31,2023,Washington,MD,Passenger,2,0,2,14,16,12.5
January,31,2023,Hamilton,OH,Truck,1,0,1,2,3,33.33
January,31,2023,Moore,NC,Passenger,0,1,1,102,103,0.97
January,31,2023,Fairfax,VA,Truck,1,0,1,96,97,1.03
January,31,2023,Sacramento,CA,Passenger,4,0,4,159,163,2.45
January,31,2023,Goochland,VA,Passenger,0,1,1,57,58,1.72
January,31,2023,Columbia,WA,Truck,0,0,0,1579,1579,0
January,31,2023,Portsmouth,VA,Passenger,0,1,1,63,64,1.56
January,31,2023,Maricopa,AZ,Passenger,7,3,10,669,679,1.47
January,31,2023,Polk,OR,Passenger,0,1,1,17,18,5.56
January,31,2023,Newport News,VA,Passenger,1,0,1,94,95,1.05
January,31,2023,King,WA,Passenger,49761,12517,62278,1334257,1396535,4.46
January,31,2023,Placer,CA,Passenger,2,0,2,53,55,3.64
January,31,2023,Mason,WA,Truck,8,0,8,20880,20888,0.04
January,31,2023,Kootenai,ID,Truck,1,0,1,28,29,3.45
January,31,2023,Ventura,CA,Passenger,2,1,3,201,204,1.47
January,31,2023,Hidalgo,TX,Passenger,0,1,1,47,48,2.08
January,31,2023,Pulaski,AR,Passenger,3,0,3,23,26,11.54
January,31,2023,Clallam,WA,Passenger,499,267,766,49348,50114,1.53
January,31,2023,Hennepin,MN,Passenger,1,0,1,35,36,2.78
January,31,2023,Allen,IN,Passenger,1,0,1,11,12,8.33
January,31,2023,El Paso,TX,Passenger,2,0,2,276,278,0.72
January,31,2023,Kitsap,WA,Truck,41,0,41,52943,52984,0.08
January,31,2023,Pend Oreille,WA,Truck,0,0,0,5572,5572,0
January,31,2023,Lincoln,WA,Passenger,14,19,33,7764,7797,0.42
January,31,2023,Skagit,WA,Truck,11,0,11,32085,32096,0.03
January,31,2023,Anne Arundel,MD,Passenger,4,4,8,298,306,2.61
January,31,2023,Monterey,CA,Passenger,1,1,2,113,115,1.74
January,31,2023,Nueces,TX,Passenger,0,1,1,50,51,1.96
January,31,2023,Emmet,MI,Passenger,0,1,1,0,1,100
January,31,2023,Spokane,WA,Passenger,1998,953,2951,324493,327444,0.9
January,31,2023,Arapahoe,CO,Passenger,0,1,1,65,66,1.52
January,31,2023,Pierce,WA,Passenger,6394,2548,8942,537638,546580,1.64
January,31,2023,Calvert,MD,Passenger,0,2,2,77,79,2.53
January,31,2023,Napa,CA,Passenger,0,1,1,9,10,10
January,31,2023,Vernon,LA,Passenger,1,0,1,71,72,1.39
January,31,2023,Asotin,WA,Truck,0,0,0,6681,6681,0
January,31,2023,Klickitat,WA,Passenger,127,53,180,15178,15358,1.17
January,31,2023,Loudoun,VA,Passenger,3,1,4,58,62,6.45
January,31,2023,Middlesex,MA,Passenger,2,1,3,60,63,4.76
January,31,2023,Adams,WA,Truck,1,0,1,5377,5378,0.02
January,31,2023,Yakima,WA,Truck,8,0,8,61183,61191,0.01
January,31,2023,Duval,FL,Passenger,1,0,1,236,237,0.42
January,31,2023,Kings,CA,Passenger,2,1,3,273,276,1.09
January,31,2023,Franklin,WA,Truck,4,0,4,20981,20985,0.02
January,31,2023,Escambia,FL,Passenger,0,1,1,109,110,0.91
January,31,2023,San Juan,WA,Passenger,572,173,745,13878,14623,5.09
January,31,2023,Columbia,WA,Passenger,8,1,9,2438,2447,0.37
January,31,2023,Alameda,CA,Passenger,3,0,3,154,157,1.91
January,31,2023,Montgomery,AL,Passenger,0,1,1,29,30,3.33
January,31,2023,Onslow,NC,Passenger,0,1,1,141,142,0.7
January,31,2023,Hudson,NJ,Passenger,1,0,1,27,28,3.57
January,31,2023,Ferry,WA,Passenger,24,4,28,4346,4374,0.64
January,31,2023,Lewis,WA,Truck,2,0,2,26285,26287,0.01
January,31,2023,Charleston,SC,Passenger,2,2,4,54,58,6.9
January,31,2023,Pacific,WA,Truck,2,0,2,7831,7833,0.03
January,31,2023,Pend Oreille,WA,Passenger,23,14,37,8954,8991,0.41
January,31,2023,Sarpy,NE,Passenger,1,0,1,46,47,2.13
January,31,2023,Stevens,WA,Truck,2,0,2,18772,18774,0.01
January,31,2023,Solano,CA,Passenger,4,0,4,140,144,2.78
January,31,2023,El Paso,CO,Passenger,3,1,4,511,515,0.78
January,31,2023,Cook,IL,Passenger,2,0,2,152,154,1.3
January,31,2023,Whatcom,WA,Passenger,2153,822,2975,148714,151689,1.96
January,31,2023,Dallas,TX,Passenger,1,0,1,79,80,1.25
January,31,2023,Walla Walla,WA,Truck,3,0,3,13863,13866,0.02
January,31,2023,Sheridan,WY,Passenger,1,0,1,5,6,16.67
January,31,2023,Cumberland,PA,Passenger,1,0,1,32,33,3.03
January,31,2023,Bryan,GA,Passenger,0,1,1,37,38,2.63
January,31,2023,Orange,CA,Passenger,7,2,9,289,298,3.02
January,31,2023,Benton,WA,Passenger,961,512,1473,135906,137379,1.07
January,31,2023,Pierce,WA,Truck,97,0,97,139157,139254,0.07
January,31,2023,Madison,IL,Passenger,1,0,1,15,16,6.25
January,31,2023,Kern,CA,Passenger,1,1,2,186,188,1.06
January,31,2023,Champaign,IL,Passenger,1,0,1,7,8,12.5
January,31,2023,New Haven,CT,Passenger,0,2,2,22,24,8.33
January,31,2023,Jefferson,WA,Passenger,495,236,731,24276,25007,2.92
January,31,2023,Travis,TX,Passenger,1,0,1,77,78,1.28
January,31,2023,Wahkiakum,WA,Passenger,25,15,40,3050,3090,1.29
January,31,2023,Skamania,WA,Truck,1,0,1,3877,3878,0.03
January,31,2023,Multnomah,OR,Passenger,0,2,2,432,434,0.46
January,31,2023,Sonoma,CA,Passenger,1,1,2,60,62,3.23
January,31,2023,Benton,WA,Truck,13,0,13,43322,43335,0.03
July,31,2023,Madison,IL,Passenger,1,0,1,14,15,6.67
July,31,2023,Oldham,KY,Passenger,0,1,1,3,4,25
July,31,2023,Arapahoe,CO,Passenger,1,1,2,55,57,3.51
July,31,2023,Bell,TX,Passenger,1,0,1,213,214,0.47
July,31,2023,San Bernardino,CA,Passenger,2,1,3,231,234,1.28
July,31,2023,Skagit,WA,Passenger,1139,417,1556,86446,88002,1.77
July,31,2023,Grays Harbor,WA,Passenger,311,192,503,47081,47584,1.06
July,31,2023,Chelan,WA,Truck,31,0,31,22570,22601,0.14
July,31,2023,Yakima,WA,Truck,13,0,13,58999,59012,0.02
July,31,2023,King,WA,Passenger,58610,14725,73335,1297605,1370940,5.35
July,31,2023,Fairfax,VA,Passenger,5,3,8,487,495,1.62
July,31,2023,Yakima,WA,Passenger,511,253,764,161420,162184,0.47
July,31,2023,Beaufort,SC,Passenger,1,0,1,19,20,5
July,31,2023,Stevens,WA,Truck,2,0,2,18253,18255,0.01
July,31,2023,Pend Oreille,WA,Passenger,30,15,45,8645,8690,0.52
July,31,2023,El Paso,CO,Passenger,3,1,4,425,429,0.93
July,31,2023,Adams,CO,Passenger,1,0,1,21,22,4.55
July,31,2023,Yellowstone,MT,Passenger,0,1,1,13,14,7.14
July,31,2023,San Diego,CA,Passenger,14,9,23,1711,1734,1.33
July,31,2023,Pierce,WA,Passenger,7775,2805,10580,516969,527549,2.01
July,31,2023,Wahkiakum,WA,Passenger,27,17,44,2972,3016,1.46
July,31,2023,Elmore,ID,Passenger,1,0,1,8,9,11.11
July,31,2023,Kent,DE,Passenger,1,0,1,38,39,2.56
July,31,2023,Pulaski,AR,Passenger,2,0,2,17,19,10.53
July,31,2023,Virginia Beach,VA,Passenger,2,1,3,392,395,0.76
July,31,2023,Jefferson,WA,Truck,12,0,12,9094,9106,0.13
July,31,2023,Whitman,WA,Truck,5,0,5,8455,8460,0.06
July,31,2023,Wahkiakum,WA,Truck,3,0,3,1728,1731,0.17
July,31,2023,Marin,CA,Passenger,0,1,1,26,27,3.7
July,31,2023,Travis,TX,Passenger,1,0,1,69,70,1.43
July,31,2023,Columbia,WA,Passenger,10,1,11,2365,2376,0.46
July,31,2023,Rockdale,GA,Passenger,1,0,1,3,4,25
July,31,2023,Rock Island,IL,Passenger,0,1,1,13,14,7.14
July,31,2023,San Juan,WA,Passenger,622,165,787,13491,14278,5.51
July,31,2023,Jefferson,WA,Passenger,571,261,832,23782,24614,3.38
July,31,2023,Franklin,WA,Truck,6,0,6,20274,20280,0.03
July,31,2023,Santa Cruz,CA,Passenger,1,0,1,11,12,8.33
July,31,2023,Lincoln,WA,Passenger,18,19,37,7476,7513,0.49
July,31,2023,Allen,IN,Passenger,1,0,1,5,6,16.67
July,31,2023,Boulder,CO,Passenger,1,0,1,21,22,4.55
July,31,2023,King,WA,Truck,780,2,782,170537,171319,0.46
July,31,2023,Ventura,CA,Passenger,1,1,2,182,184,1.09
July,31,2023,Bexar,TX,Passenger,2,2,4,308,312,1.28
July,31,2023,Lee,AL,Passenger,1,0,1,9,10,10
July,31,2023,Ray,MO,Passenger,0,1,1,0,1,100
July,31,2023,Houston,GA,Passenger,1,0,1,26,27,3.7
July,31,2023,Columbia,WA,Truck,0,0,0,1509,1509,0
July,31,2023,Collin,TX,Passenger,1,0,1,29,30,3.33
July,31,2023,Okanogan,WA,Passenger,128,62,190,25306,25496,0.75
July,31,2023,Sedgwick,KS,Passenger,1,0,1,46,47,2.13
July,31,2023,Kootenai,ID,Truck,1,0,1,20,21,4.76
July,31,2023,Montgomery,MD,Passenger,3,2,5,153,158,3.16
July,31,2023,Miami-Dade,FL,Passenger,1,0,1,47,48,2.08
July,31,2023,Clark,NV,Passenger,2,2,4,328,332,1.2
July,31,2023,Newport News,VA,Passenger,1,0,1,85,86,1.16
July,31,2023,Snohomish,WA,Truck,187,0,187,117767,117954,0.16
July,31,2023,Alexandria,VA,Passenger,2,1,3,81,84,3.57
July,31,2023,El Paso,TX,Passenger,2,0,2,225,227,0.88
July,31,2023,Camden,NJ,Passenger,0,1,1,10,11,9.09
July,31,2023,Clallam,WA,Passenger,563,289,852,47919,48771,1.75
July,31,2023,Orange,CA,Passenger,6,2,8,246,254,3.15
July,31,2023,Prince George's,MD,Passenger,3,1,4,97,101,3.96
July,31,2023,Norfolk,VA,Passenger,2,2,4,238,242,1.65
July,31,2023,Chesapeake,VA,Passenger,1,3,4,250,254,1.57
July,31,2023,Asotin,WA,Passenger,35,23,58,12154,12212,0.47
July,31,2023,DeKalb,GA,Passenger,1,0,1,30,31,3.23
July,31,2023,Asotin,WA,Truck,0,0,0,6500,6500,0
July,31,2023,Whitman,WA,Passenger,159,77,236,21502,21738,1.09
July,31,2023,Galveston,TX,Passenger,0,1,1,13,14,7.14
July,31,2023,Loudoun,VA,Passenger,2,0,2,55,57,3.51
July,31,2023,Washington,MD,Passenger,1,0,1,12,13,7.69
July,31,2023,Kauai,HI,Passenger,0,1,1,13,14,7.14
July,31,2023,Sacramento,CA,Passenger,5,0,5,117,122,4.1
July,31,2023,Kitsap,WA,Passenger,3267,1302,4569,172227,176796,2.58
July,31,2023,District of Columbia,DC,Passenger,5,0,5,135,140,3.57
July,31,2023,Yavapai,AZ,Passenger,1,0,1,17,18,5.56
July,31,2023,Lincoln,OR,Passenger,0,1,1,12,13,7.69
July,31,2023,Cowlitz,WA,Passenger,477,222,699,68070,68769,1.02
July,31,2023,Charles,MD,Passenger,1,1,2,45,47,4.26
July,31,2023,Sheridan,WY,Passenger,1,0,1,5,6,16.67
July,31,2023,Solano,CA,Passenger,5,0,5,123,128,3.91
July,31,2023,Kittitas,WA,Passenger,358,104,462,28484,28946,1.6
July,31,2023,Pend Oreille,WA,Truck,0,0,0,5446,5446,0
July,31,2023,Alameda,CA,Passenger,3,0,3,132,135,2.22
July,31,2023,Cowlitz,WA,Truck,10,0,10,27395,27405,0.04
July,31,2023,Gwinnett,GA,Passenger,1,0,1,33,34,2.94
July,31,2023,Mason,WA,Truck,11,0,11,19979,19990,0.06
July,31,2023,St. Tammany,LA,Passenger,1,0,1,26,27,3.7
July,31,2023,Broward,FL,Passenger,1,0,1,50,51,1.96
July,31,2023,Adams,WA,Truck,3,0,3,5136,5139,0.06
July,31,2023,Douglas,WA,Passenger,213,65,278,28117,28395,0.98
July,31,2023,Benton,WA,Truck,25,0,25,41955,41980,0.06
July,31,2023,Jefferson,NY,Passenger,1,1,2,162,164,1.22
July,31,2023,Skamania,WA,Passenger,105,56,161,7814,7975,2.02
July,31,2023,Frederick,MD,Passenger,1,1,2,45,47,4.26
July,31,2023,Wichita,TX,Passenger,2,0,2,29,31,6.45
July,31,2023,Vernon,LA,Passenger,1,0,1,65,66,1.52
July,31,2023,Fairfax,VA,Truck,1,0,1,77,78,1.28
July,31,2023,Rockingham,NH,Passenger,1,0,1,10,11,9.09
July,31,2023,Chelan,WA,Passenger,641,165,806,52924,53730,1.5
July,31,2023,Leavenworth,KS,Passenger,0,1,1,86,87,1.15
July,31,2023,Okanogan,WA,Truck,7,0,7,15946,15953,0.04
July,31,2023,San Juan,WA,Truck,16,0,16,5767,5783,0.28
July,31,2023,Goochland,VA,Passenger,0,1,1,22,23,4.35
July,31,2023,Ferry,WA,Truck,0,0,0,3476,3476,0
July,31,2023,Emmet,MI,Passenger,0,1,1,0,1,100
July,31,2023,Clark,WA,Passenger,5943,2342,8285,305963,314248,2.64
July,31,2023,Benton,OR,Passenger,1,0,1,27,28,3.57
July,31,2023,Lewis,WA,Truck,7,0,7,25247,25254,0.03
July,31,2023,St. Louis,MO,Passenger,1,0,1,42,43,2.33
July,31,2023,Douglas,NE,Passenger,1,1,2,17,19,10.53
July,31,2023,Lane,OR,Passenger,0,1,1,50,51,1.96
July,31,2023,Lake,IL,Passenger,3,0,3,99,102,2.94
July,31,2023,Thurston,WA,Passenger,3153,1230,4383,185812,190195,2.3
July,31,2023,Garfield,WA,Passenger,0,3,3,1282,1285,0.23
July,31,2023,Lewis,WA,Passenger,328,217,545,57742,58287,0.94
July,31,2023,Suffolk,VA,Passenger,1,0,1,87,88,1.14
July,31,2023,Klickitat,WA,Truck,11,0,11,8015,8026,0.14
July,31,2023,Arlington,VA,Passenger,1,0,1,93,94,1.06
July,31,2023,Snohomish,WA,Passenger,13023,3087,16110,515187,531297,3.03
July,31,2023,Spokane,WA,Passenger,2340,1124,3464,315617,319081,1.09
July,31,2023,Island,WA,Truck,33,0,33,20607,20640,0.16
July,31,2023,Harrison,MS,Passenger,1,0,1,25,26,3.85
July,31,2023,Benton,WA,Passenger,1158,568,1726,131666,133392,1.29
July,31,2023,Carroll,MD,Passenger,0,1,1,16,17,5.88
July,31,2023,Platte,MO,Passenger,1,0,1,16,17,5.88
July,31,2023,Calvert,MD,Passenger,1,1,2,66,68,2.94
July,31,2023,Maricopa,AZ,Passenger,6,3,9,510,519,1.73
July,31,2023,New London,CT,Passenger,1,4,5,159,164,3.05
July,31,2023,St. Clair,IL,Passenger,1,0,1,89,90,1.11
July,31,2023,Mason,WA,Passenger,462,212,674,45044,45718,1.47
July,31,2023,Ulster,NY,Passenger,1,0,1,4,5,20
July,31,2023,Garfield,WA,Truck,0,0,0,950,950,0
July,31,2023,Champaign,IL,Passenger,1,0,1,7,8,12.5
July,31,2023,Coryell,TX,Passenger,1,0,1,67,68,1.47
July,31,2023,Plaquemines,LA,Passenger,1,1,2,12,14,14.29
July,31,2023,Honolulu,HI,Passenger,2,3,5,211,216,2.31
July,31,2023,Placer,CA,Passenger,1,0,1,49,50,2
July,31,2023,Polk,OR,Passenger,0,1,1,13,14,7.14
July,31,2023,Charleston,SC,Passenger,1,2,3,42,45,6.67
July,31,2023,Pacific,WA,Truck,4,0,4,7654,7658,0.05
July,31,2023,Napa,CA,Passenger,0,1,1,8,9,11.11
July,31,2023,Clallam,WA,Truck,19,0,19,21216,21235,0.09
July,31,2023,Island,WA,Passenger,1106,442,1548,59897,61445,2.52
July,31,2023,Walla Walla,WA,Truck,5,0,5,13311,13316,0.04
July,31,2023,Grant,WA,Truck,12,0,12,27240,27252,0.04
July,31,2023,Jackson,OK,Passenger,0,1,1,29,30,3.33
July,31,2023,Harnett,NC,Passenger,4,0,4,111,115,3.48
July,31,2023,Clark,WA,Truck,102,0,102,79248,79350,0.13
July,31,2023,Cumberland,PA,Passenger,1,0,1,25,26,3.85
July,31,2023,Klickitat,WA,Passenger,156,65,221,14764,14985,1.47
July,31,2023,,,Passenger,16,6,22,1231,1253,1.76
July,31,2023,Onslow,NC,Passenger,0,1,1,129,130,0.77
July,31,2023,Douglas,CO,Passenger,0,1,1,44,45,2.22
July,31,2023,Richmond,NY,Passenger,1,0,1,5,6,16.67
July,31,2023,Middlesex,MA,Passenger,2,1,3,53,56,5.36
July,31,2023,Ferry,WA,Passenger,21,4,25,4197,4222,0.59
July,31,2023,Saratoga,NY,Passenger,1,1,2,27,29,6.9
July,31,2023,New Haven,CT,Passenger,0,2,2,19,21,9.52
July,31,2023,Cape May,NJ,Passenger,0,1,1,7,8,12.5
July,31,2023,Escambia,FL,Passenger,0,1,1,98,99,1.01
July,31,2023,Spokane,WA,Truck,42,0,42,99373,99415,0.04
July,31,2023,Grant,WA,Passenger,287,131,418,65201,65619,0.64
July,31,2023,Douglas,WA,Truck,5,0,5,12696,12701,0.04
July,31,2023,Randolph,NC,Passenger,1,0,1,3,4,25
July,31,2023,Hidalgo,TX,Passenger,0,1,1,38,39,2.56
July,31,2023,Pacific,WA,Passenger,78,88,166,15312,15478,1.07
July,31,2023,Kittitas,WA,Truck,10,0,10,14172,14182,0.07
July,31,2023,Wilson,TX,Passenger,0,1,1,2,3,33.33
July,31,2023,Thurston,WA,Truck,64,0,64,52520,52584,0.12
July,31,2023,Santa Clara,CA,Passenger,8,1,9,127,136,6.62
July,31,2023,Howard,MD,Passenger,0,1,1,38,39,2.56
July,31,2023,Contra Costa,CA,Passenger,0,3,3,172,175,1.71
July,31,2023,Sarpy,NE,Passenger,1,0,1,41,42,2.38
July,31,2023,Skamania,WA,Truck,1,0,1,3727,3728,0.03
July,31,2023,Whatcom,WA,Passenger,2522,891,3413,144372,147785,2.31
July,31,2023,St. Mary's,MD,Passenger,1,0,1,158,159,0.63
July,31,2023,Berkeley,SC,Passenger,0,1,1,87,88,1.14
July,31,2023,Richmond,GA,Passenger,0,1,1,50,51,1.96
July,31,2023,Franklin,WA,Passenger,315,141,456,60118,60574,0.75
July,31,2023,Kern,CA,Passenger,1,1,2,154,156,1.28
July,31,2023,Burlington,NJ,Passenger,0,2,2,80,82,2.44
July,31,2023,Monterey,CA,Passenger,1,0,1,94,95,1.05
July,31,2023,Whatcom,WA,Truck,63,0,63,41534,41597,0.15
July,31,2023,Hudson,NJ,Passenger,1,0,1,13,14,7.14
July,31,2023,Kings,CA,Passenger,2,1,3,242,245,1.22
July,31,2023,Hennepin,MN,Passenger,1,0,1,23,24,4.17
July,31,2023,Larimer,CO,Passenger,1,0,1,28,29,3.45
July,31,2023,Portsmouth,VA,Passenger,0,1,1,56,57,1.75
July,31,2023,Lincoln,WA,Truck,0,0,0,4756,4756,0
July,31,2023,Grays Harbor,WA,Truck,9,0,9,20411,20420,0.04
July,31,2023,Dallas,TX,Passenger,1,0,1,62,63,1.59
July,31,2023,Moore,NC,Passenger,0,1,1,95,96,1.04
July,31,2023,Stafford,VA,Passenger,3,1,4,65,69,5.8
July,31,2023,Hillsborough,FL,Passenger,0,1,1,86,87,1.15
July,31,2023,Kitsap,WA,Truck,80,0,80,51022,51102,0.16
July,31,2023,Adams,WA,Passenger,24,12,36,12621,12657,0.28
July,31,2023,Walla Walla,WA,Passenger,223,113,336,34442,34778,0.97
July,31,2023,Cook,IL,Passenger,2,0,2,122,124,1.61
July,31,2023,Sarasota,FL,Passenger,1,0,1,15,16,6.25
July,31,2023,Hamilton,OH,Passenger,1,0,1,24,25,4
July,31,2023,Stevens,WA,Passenger,117,69,186,28933,29119,0.64
July,31,2023,Hamilton,OH,Truck,1,0,1,2,3,33.33
July,31,2023,Anne Arundel,MD,Passenger,6,4,10,262,272,3.68
July,31,2023,Riverside,CA,Passenger,6,0,6,325,331,1.81
July,31,2023,Salt Lake,UT,Passenger,0,1,1,77,78,1.28
July,31,2023,Williamson,TX,Passenger,0,1,1,38,39,2.56
July,31,2023,Pierce,WA,Truck,166,0,166,132850,133016,0.12
July,31,2023,Las Animas,CO,Passenger,1,0,1,0,1,100
July,31,2023,Los Angeles,CA,Passenger,4,4,8,509,517,1.55
July,31,2023,Santa Barbara,CA,Passenger,1,0,1,57,58,1.72
July,31,2023,Hoke,NC,Passenger,1,0,1,47,48,2.08
July,31,2023,Hawaii,HI,Passenger,1,0,1,23,24,4.17
July,31,2023,Essex,NJ,Passenger,2,0,2,4,6,33.33
July,31,2023,Dorchester,SC,Passenger,1,0,1,33,34,2.94
July,31,2023,Skagit,WA,Truck,23,0,23,30998,31021,0.07
July,31,2023,Multnomah,OR,Passenger,0,2,2,359,361,0.55
July,31,2023,Nueces,TX,Passenger,1,1,2,48,50,4
July,31,2023,Sonoma,CA,Passenger,1,1,2,43,45,4.44
July,31,2023,Cumberland,NC,Passenger,1,2,3,268,271,1.11
June,30,2023,Thurston,WA,Truck,60,0,60,53269,53329,0.11
June,30,2023,Santa Barbara,CA,Passenger,1,0,1,58,59,1.69
June,30,2023,Spokane,WA,Truck,40,0,40,100674,100714,0.04
June,30,2023,Lincoln,WA,Truck,0,0,0,4817,4817,0
June,30,2023,Clark,WA,Passenger,5813,2318,8131,309808,317939,2.56
June,30,2023,Jefferson,NY,Passenger,1,1,2,165,167,1.2
June,30,2023,Middlesex,MA,Passenger,2,1,3,57,60,5
June,30,2023,Sarasota,FL,Passenger,1,0,1,15,16,6.25
June,30,2023,Ferry,WA,Passenger,21,4,25,4268,4293,0.58
June,30,2023,Sonoma,CA,Passenger,1,1,2,45,47,4.26
June,30,2023,Grays Harbor,WA,Passenger,296,186,482,47792,48274,1
June,30,2023,Island,WA,Passenger,1074,439,1513,60607,62120,2.44
June,30,2023,Vernon,LA,Passenger,1,0,1,64,65,1.54
June,30,2023,Boulder,CO,Passenger,1,0,1,22,23,4.35
June,30,2023,San Juan,WA,Passenger,616,172,788,13654,14442,5.46
June,30,2023,Virginia Beach,VA,Passenger,2,0,2,399,401,0.5
June,30,2023,Bell,TX,Passenger,1,0,1,223,224,0.45
June,30,2023,Collin,TX,Passenger,1,0,1,33,34,2.94
June,30,2023,Larimer,CO,Passenger,1,0,1,30,31,3.23
June,30,2023,Ray,MO,Passenger,0,1,1,0,1,100
June,30,2023,Coryell,TX,Passenger,1,0,1,68,69,1.45
June,30,2023,Island,WA,Truck,32,0,32,20856,20888,0.15
June,30,2023,Adams,CO,Passenger,1,0,1,23,24,4.17
June,30,2023,Platte,MO,Passenger,1,0,1,16,17,5.88
June,30,2023,Douglas,WA,Truck,5,0,5,12829,12834,0.04
June,30,2023,Stevens,WA,Truck,1,0,1,18505,18506,0.01
June,30,2023,Suffolk,VA,Passenger,1,0,1,95,96,1.04
June,30,2023,Maricopa,AZ,Passenger,6,3,9,531,540,1.67
June,30,2023,Santa Clara,CA,Passenger,8,1,9,137,146,6.16
June,30,2023,Whitman,WA,Truck,4,0,4,8514,8518,0.05
June,30,2023,Garfield,WA,Truck,0,0,0,957,957,0
June,30,2023,Wahkiakum,WA,Passenger,27,17,44,3011,3055,1.44
June,30,2023,Miami-Dade,FL,Passenger,1,0,1,51,52,1.92
June,30,2023,Gwinnett,GA,Passenger,1,0,1,36,37,2.7
June,30,2023,San Bernardino,CA,Passenger,2,1,3,241,244,1.23
June,30,2023,Grant,WA,Passenger,277,126,403,66206,66609,0.61
June,30,2023,Napa,CA,Passenger,0,1,1,8,9,11.11
June,30,2023,Rockingham,NH,Passenger,1,0,1,10,11,9.09
June,30,2023,San Diego,CA,Passenger,16,9,25,1770,1795,1.39
June,30,2023,Hillsborough,FL,Passenger,0,1,1,93,94,1.06
June,30,2023,Berkeley,SC,Passenger,0,1,1,90,91,1.1
June,30,2023,Douglas,CO,Passenger,0,1,1,45,46,2.17
June,30,2023,Ferry,WA,Truck,0,0,0,3530,3530,0
June,30,2023,Washington,MD,Passenger,1,0,1,12,13,7.69
June,30,2023,Clallam,WA,Truck,20,0,20,21479,21499,0.09
June,30,2023,Solano,CA,Passenger,5,0,5,129,134,3.73
June,30,2023,Los Angeles,CA,Passenger,4,4,8,540,548,1.46
June,30,2023,Santa Cruz,CA,Passenger,1,0,1,12,13,7.69
June,30,2023,Yakima,WA,Passenger,501,257,758,163736,164494,0.46
June,30,2023,Goochland,VA,Passenger,0,1,1,29,30,3.33
June,30,2023,Hudson,NJ,Passenger,1,0,1,13,14,7.14
June,30,2023,Richmond,NY,Passenger,1,0,1,6,7,14.29
June,30,2023,Franklin,WA,Truck,5,0,5,20588,20593,0.02
June,30,2023,Harnett,NC,Passenger,4,0,4,114,118,3.39
June,30,2023,Hennepin,MN,Passenger,1,0,1,27,28,3.57
June,30,2023,Lake,IL,Passenger,3,0,3,102,105,2.86
June,30,2023,El Paso,TX,Passenger,2,0,2,238,240,0.83
June,30,2023,Pend Oreille,WA,Truck,0,0,0,5519,5519,0
June,30,2023,Fairbanks North Star,AK,Passenger,0,1,1,44,45,2.22
June,30,2023,Alameda,CA,Passenger,3,0,3,140,143,2.1
June,30,2023,District of Columbia,DC,Passenger,5,0,5,138,143,3.5
June,30,2023,Calvert,MD,Passenger,1,1,2,66,68,2.94
June,30,2023,Hamilton,OH,Passenger,1,0,1,24,25,4
June,30,2023,Skamania,WA,Truck,1,0,1,3776,3777,0.03
June,30,2023,Snohomish,WA,Passenger,12560,3041,15601,521750,537351,2.9
June,30,2023,Howard,MD,Passenger,0,1,1,40,41,2.44
June,30,2023,Ulster,NY,Passenger,1,0,1,4,5,20
June,30,2023,Rock Island,IL,Passenger,0,1,1,13,14,7.14
June,30,2023,Contra Costa,CA,Passenger,0,3,3,182,185,1.62
June,30,2023,Dallas,TX,Passenger,1,0,1,67,68,1.47
June,30,2023,Pacific,WA,Truck,4,0,4,7732,7736,0.05
June,30,2023,Cumberland,PA,Passenger,1,0,1,26,27,3.7
June,30,2023,Hoke,NC,Passenger,1,0,1,50,51,1.96
June,30,2023,Fairfax,VA,Truck,1,0,1,81,82,1.22
June,30,2023,Stafford,VA,Passenger,3,1,4,68,72,5.56
June,30,2023,Sarpy,NE,Passenger,1,0,1,42,43,2.33
June,30,2023,Arapahoe,CO,Passenger,1,1,2,59,61,3.28
June,30,2023,Benton,WA,Passenger,1136,563,1699,133564,135263,1.26
June,30,2023,Kern,CA,Passenger,1,1,2,158,160,1.25
June,30,2023,Richmond,GA,Passenger,0,1,1,54,55,1.82
June,30,2023,Ventura,CA,Passenger,1,1,2,185,187,1.07
June,30,2023,Asotin,WA,Truck,0,0,0,6592,6592,0
June,30,2023,Madison,IL,Passenger,1,0,1,14,15,6.67
June,30,2023,New London,CT,Passenger,1,4,5,163,168,2.98
June,30,2023,Moore,NC,Passenger,0,1,1,96,97,1.03
June,30,2023,Loudoun,VA,Passenger,2,0,2,55,57,3.51
June,30,2023,Burlington,NJ,Passenger,0,2,2,84,86,2.33
June,30,2023,Spokane,WA,Passenger,2298,1094,3392,319256,322648,1.05
June,30,2023,San Juan,WA,Truck,11,0,11,5823,5834,0.19
June,30,2023,Kitsap,WA,Passenger,3208,1283,4491,174228,178719,2.51
June,30,2023,Adams,WA,Passenger,25,12,37,12863,12900,0.29
June,30,2023,Oldham,KY,Passenger,0,1,1,3,4,25
June,30,2023,St. Tammany,LA,Passenger,1,0,1,28,29,3.45
June,30,2023,Wahkiakum,WA,Truck,2,0,2,1746,1748,0.11
June,30,2023,Mason,WA,Passenger,442,206,648,45684,46332,1.4
June,30,2023,Jefferson,WA,Truck,12,0,12,9231,9243,0.13
June,30,2023,Pend Oreille,WA,Passenger,30,13,43,8795,8838,0.49
June,30,2023,Kent,DE,Passenger,1,0,1,41,42,2.38
June,30,2023,Benton,WA,Truck,24,0,24,42574,42598,0.06
June,30,2023,Walla Walla,WA,Truck,5,0,5,13510,13515,0.04
June,30,2023,Kittitas,WA,Truck,8,0,8,14383,14391,0.06
June,30,2023,Skamania,WA,Passenger,104,59,163,7905,8068,2.02
June,30,2023,Saratoga,NY,Passenger,1,1,2,27,29,6.9
June,30,2023,Stevens,WA,Passenger,112,68,180,29348,29528,0.61
June,30,2023,Portsmouth,VA,Passenger,0,1,1,56,57,1.75
June,30,2023,Garfield,WA,Passenger,1,3,4,1291,1295,0.31
June,30,2023,Lewis,WA,Truck,7,0,7,25651,25658,0.03
June,30,2023,Adams,WA,Truck,3,0,3,5232,5235,0.06
June,30,2023,Pacific,WA,Passenger,76,88,164,15453,15617,1.05
June,30,2023,Cape May,NJ,Passenger,0,1,1,7,8,12.5
June,30,2023,Houston,GA,Passenger,1,0,1,26,27,3.7
June,30,2023,Escambia,FL,Passenger,0,1,1,99,100,1
June,30,2023,Galveston,TX,Passenger,0,1,1,13,14,7.14
June,30,2023,Lincoln,WA,Passenger,16,18,34,7573,7607,0.45
June,30,2023,Anne Arundel,MD,Passenger,5,4,9,270,279,3.23
June,30,2023,Yellowstone,MT,Passenger,0,1,1,13,14,7.14
June,30,2023,Leavenworth,KS,Passenger,0,1,1,88,89,1.12
June,30,2023,Plaquemines,LA,Passenger,1,1,2,12,14,14.29
June,30,2023,DeKalb,GA,Passenger,1,0,1,35,36,2.78
June,30,2023,Yavapai,AZ,Passenger,1,0,1,18,19,5.26
June,30,2023,Okanogan,WA,Truck,7,0,7,16188,16195,0.04
June,30,2023,Las Animas,CO,Passenger,1,0,1,0,1,100
June,30,2023,Arlington,VA,Passenger,1,0,1,95,96,1.04
June,30,2023,Beaufort,SC,Passenger,1,0,1,19,20,5
June,30,2023,Carroll,MD,Passenger,0,1,1,16,17,5.88
June,30,2023,Sedgwick,KS,Passenger,1,0,1,50,51,1.96
June,30,2023,St. Clair,IL,Passenger,1,0,1,91,92,1.09
June,30,2023,St. Louis,MO,Passenger,1,0,1,44,45,2.22
June,30,2023,Columbia,WA,Truck,0,0,0,1535,1535,0
June,30,2023,Benton,OR,Passenger,1,0,1,29,30,3.33
June,30,2023,Jefferson,WA,Passenger,560,258,818,24060,24878,3.29
June,30,2023,Riverside,CA,Passenger,6,0,6,337,343,1.75
June,30,2023,Hamilton,OH,Truck,1,0,1,2,3,33.33
June,30,2023,Bexar,TX,Passenger,2,2,4,317,321,1.25
June,30,2023,Snohomish,WA,Truck,173,0,173,119726,119899,0.14
June,30,2023,,,Passenger,16,6,22,1201,1223,1.8
June,30,2023,Allen,IN,Passenger,1,0,1,7,8,12.5
June,30,2023,Wichita,TX,Passenger,2,0,2,30,32,6.25
June,30,2023,New Haven,CT,Passenger,0,2,2,20,22,9.09
June,30,2023,Clark,NV,Passenger,3,2,5,345,350,1.43
June,30,2023,Broward,FL,Passenger,1,0,1,52,53,1.89
June,30,2023,Columbia,WA,Passenger,11,1,12,2395,2407,0.5
June,30,2023,Kings,CA,Passenger,2,1,3,246,249,1.2
June,30,2023,Pierce,WA,Passenger,7556,2770,10326,524039,534365,1.93
June,30,2023,Dorchester,SC,Passenger,1,0,1,34,35,2.86
June,30,2023,Hidalgo,TX,Passenger,0,1,1,38,39,2.56
June,30,2023,Onslow,NC,Passenger,0,1,1,131,132,0.76
June,30,2023,Champaign,IL,Passenger,1,0,1,7,8,12.5
June,30,2023,Sheridan,WY,Passenger,1,0,1,5,6,16.67
June,30,2023,Williamson,TX,Passenger,0,1,1,43,44,2.27
June,30,2023,Newport News,VA,Passenger,1,0,1,88,89,1.12
June,30,2023,Hawaii,HI,Passenger,1,0,1,25,26,3.85
June,30,2023,Charles,MD,Passenger,1,1,2,48,50,4
June,30,2023,Kitsap,WA,Truck,76,0,76,51739,51815,0.15
June,30,2023,Frederick,MD,Passenger,1,1,2,47,49,4.08
June,30,2023,Clallam,WA,Passenger,545,283,828,48445,49273,1.68
June,30,2023,Franklin,WA,Passenger,302,137,439,61004,61443,0.71
June,30,2023,Lewis,WA,Passenger,327,206,533,58421,58954,0.9
June,30,2023,Chesapeake,VA,Passenger,2,3,5,258,263,1.9
June,30,2023,Randolph,NC,Passenger,1,0,1,3,4,25
June,30,2023,Whatcom,WA,Passenger,2467,871,3338,145997,149335,2.24
June,30,2023,Kootenai,ID,Truck,1,0,1,23,24,4.17
June,30,2023,Polk,OR,Passenger,0,1,1,14,15,6.67
June,30,2023,Multnomah,OR,Passenger,0,2,2,382,384,0.52
June,30,2023,Wilson,TX,Passenger,0,1,1,2,3,33.33
June,30,2023,Mason,WA,Truck,11,0,11,20405,20416,0.05
June,30,2023,Pierce,WA,Truck,163,0,163,135232,135395,0.12
June,30,2023,Skagit,WA,Truck,21,0,21,31455,31476,0.07
June,30,2023,Nueces,TX,Passenger,1,1,2,48,50,4
June,30,2023,Alexandria,VA,Passenger,2,1,3,83,86,3.49
June,30,2023,Cumberland,NC,Passenger,1,2,3,276,279,1.08
June,30,2023,Cowlitz,WA,Truck,9,0,9,27797,27806,0.03
June,30,2023,Camden,NJ,Passenger,0,1,1,12,13,7.69
June,30,2023,Skagit,WA,Passenger,1105,413,1518,87670,89188,1.7
June,30,2023,Monterey,CA,Passenger,1,0,1,98,99,1.01
June,30,2023,Grays Harbor,WA,Truck,7,0,7,20684,20691,0.03
June,30,2023,Kittitas,WA,Passenger,350,103,453,28878,29331,1.54
June,30,2023,El Paso,CO,Passenger,3,1,4,441,445,0.9
June,30,2023,Cook,IL,Passenger,2,0,2,127,129,1.55
June,30,2023,Lane,OR,Passenger,0,1,1,55,56,1.79
June,30,2023,Elmore,ID,Passenger,1,0,1,8,9,11.11
June,30,2023,Chelan,WA,Truck,31,0,31,22830,22861,0.14
June,30,2023,Whatcom,WA,Truck,58,0,58,42106,42164,0.14
June,30,2023,Walla Walla,WA,Passenger,219,111,330,34992,35322,0.93
June,30,2023,Clark,WA,Truck,97,0,97,80308,80405,0.12
June,30,2023,Douglas,WA,Passenger,209,64,273,28488,28761,0.95
June,30,2023,Prince George's,MD,Passenger,3,1,4,97,101,3.96
June,30,2023,Pulaski,AR,Passenger,3,0,3,17,20,15
June,30,2023,Lee,AL,Passenger,1,0,1,11,12,8.33
June,30,2023,Yakima,WA,Truck,13,0,13,60023,60036,0.02
June,30,2023,Okanogan,WA,Passenger,123,63,186,25802,25988,0.72
June,30,2023,Kauai,HI,Passenger,1,1,2,14,16,12.5
June,30,2023,Rockdale,GA,Passenger,1,0,1,3,4,25
June,30,2023,Placer,CA,Passenger,1,0,1,50,51,1.96
June,30,2023,Geary,KS,Passenger,1,0,1,66,67,1.49
June,30,2023,Montgomery,MD,Passenger,3,2,5,160,165,3.03
June,30,2023,Chelan,WA,Passenger,637,162,799,53633,54432,1.47
June,30,2023,St. Mary's,MD,Passenger,1,0,1,158,159,0.63
June,30,2023,Sacramento,CA,Passenger,5,0,5,126,131,3.82
June,30,2023,Essex,NJ,Passenger,2,0,2,4,6,33.33
June,30,2023,Thurston,WA,Passenger,3092,1222,4314,188101,192415,2.24
June,30,2023,Klickitat,WA,Truck,12,0,12,8137,8149,0.15
June,30,2023,Travis,TX,Passenger,1,0,1,73,74,1.35
June,30,2023,Grant,WA,Truck,11,0,11,27666,27677,0.04
June,30,2023,Honolulu,HI,Passenger,2,3,5,225,230,2.17
June,30,2023,Douglas,NE,Passenger,1,1,2,22,24,8.33
June,30,2023,Whitman,WA,Passenger,150,79,229,21790,22019,1.04
June,30,2023,Norfolk,VA,Passenger,2,2,4,243,247,1.62
June,30,2023,Marin,CA,Passenger,0,1,1,26,27,3.7
June,30,2023,Lincoln,OR,Passenger,0,1,1,12,13,7.69
June,30,2023,Emmet,MI,Passenger,0,1,1,0,1,100
June,30,2023,King,WA,Passenger,56981,14563,71544,1312113,1383657,5.17
June,30,2023,King,WA,Truck,723,2,725,173265,173990,0.42
June,30,2023,Harrison,MS,Passenger,1,0,1,26,27,3.7
June,30,2023,Fairfax,VA,Passenger,5,3,8,508,516,1.55
June,30,2023,Orange,CA,Passenger,6,2,8,249,257,3.11
June,30,2023,Jackson,OK,Passenger,0,1,1,30,31,3.23
June,30,2023,Asotin,WA,Passenger,35,22,57,12311,12368,0.46
June,30,2023,Klickitat,WA,Passenger,151,63,214,14939,15153,1.41
June,30,2023,Charleston,SC,Passenger,1,2,3,45,48,6.25
June,30,2023,Cowlitz,WA,Passenger,470,215,685,68949,69634,0.98
June,30,2023,Salt Lake,UT,Passenger,0,1,1,80,81,1.23
March,31,2023,Beaufort,SC,Passenger,1,0,1,17,18,5.56
March,31,2023,St. Tammany,LA,Passenger,1,0,1,30,31,3.23
March,31,2023,El Paso,TX,Passenger,2,0,2,262,264,0.76
March,31,2023,Benton,WA,Passenger,1041,531,1572,135436,137008,1.15
March,31,2023,Frederick,MD,Passenger,1,0,1,53,54,1.85
March,31,2023,Okanogan,WA,Passenger,114,58,172,26014,26186,0.66
March,31,2023,Moore,NC,Passenger,0,1,1,101,102,0.98
March,31,2023,Madison,IL,Passenger,1,0,1,16,17,5.88
March,31,2023,Travis,TX,Passenger,1,0,1,76,77,1.3
March,31,2023,Lee,AL,Passenger,1,0,1,11,12,8.33
March,31,2023,Yavapai,AZ,Passenger,1,0,1,22,23,4.35
March,31,2023,Riverside,CA,Passenger,6,0,6,375,381,1.57
March,31,2023,Los Angeles,CA,Passenger,4,5,9,602,611,1.47
March,31,2023,Norfolk,VA,Passenger,3,2,5,258,263,1.9
March,31,2023,Escambia,FL,Passenger,0,1,1,107,108,0.93
March,31,2023,Anne Arundel,MD,Passenger,4,4,8,288,296,2.7
March,31,2023,Grant,WA,Truck,8,0,8,28019,28027,0.03
March,31,2023,Lake,IL,Passenger,1,0,1,113,114,0.88
March,31,2023,Kittitas,WA,Passenger,325,94,419,29410,29829,1.4
March,31,2023,Plaquemines,LA,Passenger,1,1,2,14,16,12.5
March,31,2023,Nueces,TX,Passenger,0,1,1,49,50,2
March,31,2023,Sumter,SC,Passenger,0,1,1,33,34,2.94
March,31,2023,Rock Island,IL,Passenger,0,1,1,14,15,6.67
March,31,2023,Denton,TX,Passenger,1,0,1,43,44,2.27
March,31,2023,Lewis,WA,Passenger,295,191,486,58567,59053,0.82
March,31,2023,Klickitat,WA,Truck,6,0,6,8273,8279,0.07
March,31,2023,,,Passenger,16,6,22,1231,1253,1.76
March,31,2023,Snohomish,WA,Truck,134,0,134,121787,121921,0.11
March,31,2023,Columbia,WA,Passenger,8,1,9,2416,2425,0.37
March,31,2023,Geary,KS,Passenger,1,0,1,70,71,1.41
March,31,2023,Walla Walla,WA,Passenger,209,112,321,35444,35765,0.9
March,31,2023,Grant,WA,Passenger,253,113,366,66819,67185,0.54
March,31,2023,Arlington,VA,Passenger,1,0,1,102,103,0.97
March,31,2023,New Haven,CT,Passenger,0,2,2,22,24,8.33
March,31,2023,Cape May,NJ,Passenger,0,1,1,7,8,12.5
March,31,2023,Boulder,CO,Passenger,1,0,1,25,26,3.85
March,31,2023,Newport News,VA,Passenger,1,0,1,91,92,1.09
March,31,2023,Ferry,WA,Truck,0,0,0,3563,3563,0
March,31,2023,Harrison,MS,Passenger,1,0,1,30,31,3.23
March,31,2023,Ventura,CA,Passenger,2,1,3,196,199,1.51
March,31,2023,Loudoun,VA,Passenger,3,0,3,56,59,5.08
March,31,2023,Dallas,TX,Passenger,1,0,1,74,75,1.33
March,31,2023,Clallam,WA,Truck,17,0,17,21712,21729,0.08
March,31,2023,Kern,CA,Passenger,1,1,2,178,180,1.11
March,31,2023,Island,WA,Passenger,987,421,1408,61377,62785,2.24
March,31,2023,Allen,IN,Passenger,1,0,1,10,11,9.09
March,31,2023,Hudson,NJ,Passenger,1,0,1,18,19,5.26
March,31,2023,Nassau,NY,Passenger,1,0,1,21,22,4.55
March,31,2023,Sheridan,WY,Passenger,1,0,1,5,6,16.67
March,31,2023,Goochland,VA,Passenger,0,1,1,48,49,2.04
March,31,2023,Virginia Beach,VA,Passenger,2,0,2,432,434,0.46
March,31,2023,Hamilton,OH,Truck,1,0,1,2,3,33.33
March,31,2023,Hillsborough,FL,Passenger,0,1,1,102,103,0.97
March,31,2023,Stevens,WA,Truck,2,0,2,18741,18743,0.01
March,31,2023,El Paso,CO,Passenger,3,1,4,481,485,0.82
March,31,2023,Cowlitz,WA,Truck,7,0,7,28202,28209,0.02
March,31,2023,Bartow,GA,Passenger,0,1,1,3,4,25
March,31,2023,King,WA,Truck,566,2,568,176388,176956,0.32
March,31,2023,Sedgwick,KS,Passenger,1,1,2,56,58,3.45
March,31,2023,Randolph,NC,Passenger,1,0,1,3,4,25
March,31,2023,Chelan,WA,Truck,23,0,23,23105,23128,0.1
March,31,2023,San Bernardino,CA,Passenger,2,1,3,260,263,1.14
March,31,2023,Camden,NJ,Passenger,0,1,1,12,13,7.69
March,31,2023,Adams,WA,Passenger,23,11,34,13010,13044,0.26
March,31,2023,Lane,OR,Passenger,0,1,1,65,66,1.52
March,31,2023,Sacramento,CA,Passenger,4,0,4,144,148,2.7
March,31,2023,Richmond,GA,Passenger,0,1,1,55,56,1.79
March,31,2023,Cowlitz,WA,Passenger,433,195,628,69990,70618,0.89
March,31,2023,Columbia,WA,Truck,0,0,0,1572,1572,0
March,31,2023,Bexar,TX,Passenger,3,3,6,350,356,1.69
March,31,2023,San Diego,CA,Passenger,17,9,26,1922,1948,1.33
March,31,2023,Wahkiakum,WA,Passenger,25,16,41,3059,3100,1.32
March,31,2023,Multnomah,OR,Passenger,0,2,2,413,415,0.48
March,31,2023,Harnett,NC,Passenger,3,0,3,122,125,2.4
March,31,2023,Grays Harbor,WA,Truck,2,0,2,20979,20981,0.01
March,31,2023,Franklin,WA,Truck,5,0,5,20848,20853,0.02
March,31,2023,Douglas,WA,Passenger,181,59,240,28627,28867,0.83
March,31,2023,Kittitas,WA,Truck,7,0,7,14530,14537,0.05
March,31,2023,Skagit,WA,Truck,17,0,17,31985,32002,0.05
March,31,2023,Kauai,HI,Passenger,1,1,2,13,15,13.33
March,31,2023,Grays Harbor,WA,Passenger,278,179,457,48396,48853,0.94
March,31,2023,Skagit,WA,Passenger,1026,382,1408,88921,90329,1.56
March,31,2023,Kitsap,WA,Truck,58,0,58,52601,52659,0.11
March,31,2023,Garfield,WA,Truck,0,0,0,977,977,0
March,31,2023,Pierce,WA,Passenger,6832,2624,9456,533215,542671,1.74
March,31,2023,Wichita,TX,Passenger,2,0,2,32,34,5.88
March,31,2023,Cumberland,PA,Passenger,1,0,1,32,33,3.03
March,31,2023,Yellowstone,MT,Passenger,0,1,1,15,16,6.25
March,31,2023,Spokane,WA,Passenger,2099,1005,3104,322078,325182,0.95
March,31,2023,Coryell,TX,Passenger,1,0,1,75,76,1.32
March,31,2023,Adams,WA,Truck,2,0,2,5333,5335,0.04
March,31,2023,Hennepin,MN,Passenger,1,0,1,30,31,3.23
March,31,2023,Asotin,WA,Passenger,31,21,52,12420,12472,0.42
March,31,2023,Howard,MD,Passenger,0,1,1,41,42,2.38
March,31,2023,Whatcom,WA,Truck,48,0,48,42816,42864,0.11
March,31,2023,Cook,IL,Passenger,2,0,2,145,147,1.36
March,31,2023,Sarasota,FL,Passenger,1,0,1,15,16,6.25
March,31,2023,Lincoln,WA,Truck,0,0,0,4848,4848,0
March,31,2023,Clark,WA,Passenger,5285,2161,7446,313218,320664,2.32
March,31,2023,Clark,NV,Passenger,3,2,5,388,393,1.27
March,31,2023,Stafford,VA,Passenger,3,1,4,74,78,5.13
March,31,2023,Placer,CA,Passenger,1,0,1,52,53,1.89
March,31,2023,Pacific,WA,Passenger,74,84,158,15627,15785,1
March,31,2023,Harris,TX,Passenger,1,0,1,112,113,0.88
March,31,2023,Skamania,WA,Passenger,95,53,148,8092,8240,1.8
March,31,2023,Ulster,NY,Passenger,1,0,1,4,5,20
March,31,2023,Cumberland,NC,Passenger,1,2,3,293,296,1.01
March,31,2023,Benton,OR,Passenger,1,0,1,34,35,2.86
March,31,2023,Rockingham,NH,Passenger,1,0,1,10,11,9.09
March,31,2023,Okanogan,WA,Truck,3,0,3,16460,16463,0.02
March,31,2023,Charleston,SC,Passenger,2,2,4,52,56,7.14
March,31,2023,Hidalgo,TX,Passenger,0,1,1,46,47,2.13
March,31,2023,Mason,WA,Passenger,403,200,603,46356,46959,1.28
March,31,2023,Pulaski,AR,Passenger,3,0,3,21,24,12.5
March,31,2023,St. Louis,MO,Passenger,1,0,1,50,51,1.96
March,31,2023,Platte,MO,Passenger,1,0,1,16,17,5.88
March,31,2023,Marin,CA,Passenger,0,1,1,27,28,3.57
March,31,2023,Prince George's,MD,Passenger,2,1,3,108,111,2.7
March,31,2023,Orange,CA,Passenger,7,2,9,276,285,3.16
March,31,2023,Miami-Dade,FL,Passenger,1,0,1,57,58,1.72
March,31,2023,Jefferson,NY,Passenger,1,1,2,175,177,1.13
March,31,2023,Leavenworth,KS,Passenger,0,1,1,89,90,1.11
March,31,2023,Honolulu,HI,Passenger,2,3,5,251,256,1.95
March,31,2023,Pacific,WA,Truck,3,0,3,7805,7808,0.04
March,31,2023,San Juan,WA,Passenger,596,172,768,13839,14607,5.26
March,31,2023,Ray,MO,Passenger,0,1,1,0,1,100
March,31,2023,Burlington,NJ,Passenger,0,2,2,90,92,2.17
March,31,2023,Fairbanks North Star,AK,Passenger,0,1,1,54,55,1.82
March,31,2023,Collin,TX,Passenger,2,0,2,41,43,4.65
March,31,2023,Polk,OR,Passenger,0,1,1,16,17,5.88
March,31,2023,Okaloosa,FL,Passenger,0,1,1,88,89,1.12
March,31,2023,Chelan,WA,Passenger,582,150,732,54135,54867,1.33
March,31,2023,Garfield,WA,Passenger,1,3,4,1323,1327,0.3
March,31,2023,Louisa,VA,Passenger,0,1,1,1,2,50
March,31,2023,Santa Clara,CA,Passenger,8,2,10,151,161,6.21
March,31,2023,Elmore,ID,Passenger,1,0,1,9,10,10
March,31,2023,Lewis,WA,Truck,5,0,5,26061,26066,0.02
March,31,2023,Champaign,IL,Passenger,1,0,1,8,9,11.11
March,31,2023,Maricopa,AZ,Passenger,7,3,10,610,620,1.61
March,31,2023,Alameda,CA,Passenger,3,0,3,152,155,1.94
March,31,2023,Clark,WA,Truck,77,0,77,81356,81433,0.09
March,31,2023,Island,WA,Truck,24,0,24,21070,21094,0.11
March,31,2023,Saratoga,NY,Passenger,1,1,2,31,33,6.06
March,31,2023,Hawaii,HI,Passenger,1,0,1,23,24,4.17
March,31,2023,Salt Lake,UT,Passenger,0,1,1,92,93,1.08
March,31,2023,Emmet,MI,Passenger,0,1,1,0,1,100
March,31,2023,Sonoma,CA,Passenger,1,1,2,53,55,3.64
March,31,2023,Yakima,WA,Truck,9,0,9,60996,61005,0.01
March,31,2023,Berkeley,SC,Passenger,0,1,1,101,102,0.98
March,31,2023,San Juan,WA,Truck,10,0,10,5884,5894,0.17
March,31,2023,Thurston,WA,Passenger,2830,1176,4006,190713,194719,2.06
March,31,2023,Ferry,WA,Passenger,19,4,23,4330,4353,0.53
March,31,2023,Douglas,NE,Passenger,2,1,3,26,29,10.34
March,31,2023,St. Clair,IL,Passenger,2,0,2,102,104,1.92
March,31,2023,Adams,CO,Passenger,1,0,1,27,28,3.57
March,31,2023,Pend Oreille,WA,Passenger,28,13,41,8917,8958,0.46
March,31,2023,Houston,GA,Passenger,1,0,1,25,26,3.85
March,31,2023,Montgomery,MD,Passenger,3,3,6,171,177,3.39
March,31,2023,Skamania,WA,Truck,1,0,1,3842,3843,0.03
March,31,2023,Stevens,WA,Passenger,103,60,163,29814,29977,0.54
March,31,2023,Klickitat,WA,Passenger,133,59,192,15155,15347,1.25
March,31,2023,Vernon,LA,Passenger,1,0,1,68,69,1.45
March,31,2023,Sarpy,NE,Passenger,1,0,1,46,47,2.13
March,31,2023,Kootenai,ID,Truck,1,0,1,27,28,3.57
March,31,2023,Mason,WA,Truck,11,0,11,20792,20803,0.05
March,31,2023,Whitman,WA,Passenger,131,72,203,21998,22201,0.91
March,31,2023,Snohomish,WA,Passenger,11288,2890,14178,528298,542476,2.61
March,31,2023,Broward,FL,Passenger,1,0,1,56,57,1.75
March,31,2023,Yakima,WA,Passenger,458,238,696,165666,166362,0.42
March,31,2023,DeKalb,GA,Passenger,1,0,1,38,39,2.56
March,31,2023,Calvert,MD,Passenger,0,2,2,72,74,2.7
March,31,2023,Santa Cruz,CA,Passenger,1,0,1,13,14,7.14
March,31,2023,Middlesex,MA,Passenger,2,1,3,57,60,5
March,31,2023,Napa,CA,Passenger,0,1,1,10,11,9.09
March,31,2023,Benton,WA,Truck,16,0,16,43262,43278,0.04
March,31,2023,Hoke,NC,Passenger,1,0,1,57,58,1.72
March,31,2023,Jefferson,WA,Passenger,522,247,769,24231,25000,3.08
March,31,2023,Jackson,OK,Passenger,0,1,1,30,31,3.23
March,31,2023,Fairfax,VA,Passenger,5,3,8,533,541,1.48
March,31,2023,Franklin,WA,Passenger,284,129,413,61766,62179,0.66
March,31,2023,Contra Costa,CA,Passenger,0,3,3,196,199,1.51
March,31,2023,New London,CT,Passenger,1,4,5,171,176,2.84
March,31,2023,Clallam,WA,Passenger,507,275,782,49127,49909,1.57
March,31,2023,Richmond,NY,Passenger,1,0,1,6,7,14.29
March,31,2023,Arapahoe,CO,Passenger,1,1,2,66,68,2.94
March,31,2023,Galveston,TX,Passenger,0,1,1,16,17,5.88
March,31,2023,Washington,MD,Passenger,2,0,2,13,15,13.33
March,31,2023,Thurston,WA,Truck,52,0,52,54221,54273,0.1
March,31,2023,Larimer,CO,Passenger,1,0,1,37,38,2.63
March,31,2023,District of Columbia,DC,Passenger,4,0,4,149,153,2.61
March,31,2023,Kent,DE,Passenger,1,0,1,45,46,2.17
March,31,2023,Wahkiakum,WA,Truck,2,0,2,1779,1781,0.11
March,31,2023,Carroll,MD,Passenger,0,1,1,17,18,5.56
March,31,2023,Rockdale,GA,Passenger,1,0,1,3,4,25
March,31,2023,Las Animas,CO,Passenger,1,0,1,0,1,100
March,31,2023,Asotin,WA,Truck,0,0,0,6642,6642,0
March,31,2023,Santa Barbara,CA,Passenger,1,0,1,62,63,1.59
March,31,2023,Onslow,NC,Passenger,0,1,1,138,139,0.72
March,31,2023,Whatcom,WA,Passenger,2264,837,3101,147416,150517,2.06
March,31,2023,Williamson,TX,Passenger,0,1,1,54,55,1.82
March,31,2023,Wilson,TX,Passenger,0,1,1,2,3,33.33
March,31,2023,Chesapeake,VA,Passenger,2,3,5,279,284,1.76
March,31,2023,Lincoln,OR,Passenger,0,1,1,13,14,7.14
March,31,2023,Portsmouth,VA,Passenger,0,1,1,62,63,1.59
March,31,2023,Lincoln,WA,Passenger,18,16,34,7696,7730,0.44
March,31,2023,Spokane,WA,Truck,30,0,30,101755,101785,0.03
March,31,2023,Pierce,WA,Truck,126,0,126,137873,137999,0.09
March,31,2023,Bell,TX,Passenger,1,0,1,248,249,0.4
March,31,2023,Dorchester,SC,Passenger,1,0,1,40,41,2.44
March,31,2023,Monterey,CA,Passenger,1,1,2,110,112,1.79
March,31,2023,Alexandria,VA,Passenger,3,1,4,87,91,4.4
March,31,2023,St. Mary's,MD,Passenger,1,0,1,166,167,0.6
March,31,2023,Fairfax,VA,Truck,1,0,1,92,93,1.08
March,31,2023,Kitsap,WA,Passenger,2952,1199,4151,176394,180545,2.3
March,31,2023,Jefferson,WA,Truck,9,0,9,9314,9323,0.1
March,31,2023,Oldham,KY,Passenger,0,1,1,4,5,20
March,31,2023,Hamilton,OH,Passenger,1,0,1,24,25,4
March,31,2023,Pend Oreille,WA,Truck,0,0,0,5572,5572,0
March,31,2023,Charles,MD,Passenger,1,1,2,49,51,3.92
March,31,2023,Montgomery,PA,Passenger,1,0,1,15,16,6.25
March,31,2023,Duval,FL,Passenger,1,0,1,229,230,0.43
March,31,2023,Suffolk,VA,Passenger,1,0,1,106,107,0.93
March,31,2023,King,WA,Passenger,51947,13141,65088,1321285,1386373,4.69
March,31,2023,Douglas,CO,Passenger,0,1,1,54,55,1.82
March,31,2023,Essex,NJ,Passenger,2,0,2,5,7,28.57
March,31,2023,Kings,CA,Passenger,2,1,3,268,271,1.11
March,31,2023,Gwinnett,GA,Passenger,1,0,1,42,43,2.33
March,31,2023,Whitman,WA,Truck,4,0,4,8597,8601,0.05
March,31,2023,Solano,CA,Passenger,4,0,4,134,138,2.9
March,31,2023,Walla Walla,WA,Truck,5,0,5,13756,13761,0.04
March,31,2023,Douglas,WA,Truck,6,0,6,12871,12877,0.05
May,31,2023,Loudoun,VA,Passenger,2,0,2,55,57,3.51
May,31,2023,Richmond,GA,Passenger,0,1,1,55,56,1.79
May,31,2023,Gwinnett,GA,Passenger,1,0,1,38,39,2.56
May,31,2023,New London,CT,Passenger,1,4,5,165,170,2.94
May,31,2023,Boulder,CO,Passenger,1,0,1,23,24,4.17
May,31,2023,Maricopa,AZ,Passenger,7,3,10,551,561,1.78
May,31,2023,Bexar,TX,Passenger,3,3,6,328,334,1.8
May,31,2023,Pulaski,AR,Passenger,3,0,3,21,24,12.5
May,31,2023,King,WA,Truck,684,2,686,174691,175377,0.39
May,31,2023,Denton,TX,Passenger,1,0,1,44,45,2.22
May,31,2023,Larimer,CO,Passenger,1,0,1,33,34,2.94
May,31,2023,Kern,CA,Passenger,1,1,2,164,166,1.2
May,31,2023,Sarpy,NE,Passenger,1,0,1,45,46,2.17
May,31,2023,Dorchester,SC,Passenger,1,0,1,35,36,2.78
May,31,2023,St. Louis,MO,Passenger,1,0,1,47,48,2.08
May,31,2023,Adams,WA,Truck,2,0,2,5262,5264,0.04
May,31,2023,Charleston,SC,Passenger,1,2,3,49,52,5.77
May,31,2023,Garfield,WA,Truck,0,0,0,964,964,0
May,31,2023,Clark,NV,Passenger,4,2,6,361,367,1.63
May,31,2023,DeKalb,GA,Passenger,1,0,1,37,38,2.63
May,31,2023,Cumberland,NC,Passenger,1,2,3,280,283,1.06
May,31,2023,Anne Arundel,MD,Passenger,5,4,9,281,290,3.1
May,31,2023,Jackson,OK,Passenger,0,1,1,31,32,3.12
May,31,2023,Walla Walla,WA,Passenger,215,115,330,35196,35526,0.93
May,31,2023,San Bernardino,CA,Passenger,2,1,3,245,248,1.21
May,31,2023,Klickitat,WA,Truck,11,0,11,8198,8209,0.13
May,31,2023,Prince George's,MD,Passenger,2,1,3,100,103,2.91
May,31,2023,St. Clair,IL,Passenger,1,0,1,95,96,1.04
May,31,2023,Marin,CA,Passenger,0,1,1,27,28,3.57
May,31,2023,Wahkiakum,WA,Passenger,26,17,43,3018,3061,1.4
May,31,2023,District of Columbia,DC,Passenger,5,0,5,144,149,3.36
May,31,2023,Chelan,WA,Truck,29,0,29,22965,22994,0.13
May,31,2023,Yellowstone,MT,Passenger,0,1,1,16,17,5.88
May,31,2023,Beaufort,SC,Passenger,1,0,1,18,19,5.26
May,31,2023,Kitsap,WA,Truck,70,0,70,52120,52190,0.13
May,31,2023,Spokane,WA,Truck,39,0,39,101203,101242,0.04
May,31,2023,Fairfax,VA,Truck,1,0,1,84,85,1.18
May,31,2023,Arlington,VA,Passenger,1,0,1,96,97,1.03
May,31,2023,Stevens,WA,Passenger,110,64,174,29562,29736,0.59
May,31,2023,Kings,CA,Passenger,2,1,3,255,258,1.16
May,31,2023,San Juan,WA,Passenger,611,173,784,13720,14504,5.41
May,31,2023,El Paso,CO,Passenger,3,1,4,465,469,0.85
May,31,2023,Frederick,MD,Passenger,1,1,2,48,50,4
May,31,2023,Harrison,MS,Passenger,1,0,1,28,29,3.45
May,31,2023,Howard,MD,Passenger,0,1,1,40,41,2.44
May,31,2023,Wichita,TX,Passenger,2,0,2,29,31,6.45
May,31,2023,Asotin,WA,Passenger,34,20,54,12351,12405,0.44
May,31,2023,Carroll,MD,Passenger,0,1,1,16,17,5.88
May,31,2023,Calvert,MD,Passenger,1,1,2,69,71,2.82
May,31,2023,Whitman,WA,Truck,4,0,4,8547,8551,0.05
May,31,2023,Snohomish,WA,Passenger,12139,2974,15113,524703,539816,2.8
May,31,2023,Virginia Beach,VA,Passenger,2,0,2,409,411,0.49
May,31,2023,Onslow,NC,Passenger,0,1,1,133,134,0.75
May,31,2023,Chesapeake,VA,Passenger,2,3,5,263,268,1.87
May,31,2023,Sedgwick,KS,Passenger,1,0,1,52,53,1.89
May,31,2023,Mason,WA,Passenger,429,206,635,45953,46588,1.36
May,31,2023,Yavapai,AZ,Passenger,1,0,1,19,20,5
May,31,2023,Chelan,WA,Passenger,619,159,778,53890,54668,1.42
May,31,2023,Hudson,NJ,Passenger,1,0,1,15,16,6.25
May,31,2023,Clark,WA,Truck,90,0,90,80813,80903,0.11
May,31,2023,Portsmouth,VA,Passenger,0,1,1,57,58,1.72
May,31,2023,Pierce,WA,Passenger,7397,2707,10104,527950,538054,1.88
May,31,2023,Franklin,WA,Truck,4,0,4,20695,20699,0.02
May,31,2023,Kauai,HI,Passenger,1,1,2,13,15,13.33
May,31,2023,Whatcom,WA,Truck,57,0,57,42393,42450,0.13
May,31,2023,Randolph,NC,Passenger,1,0,1,3,4,25
May,31,2023,Berkeley,SC,Passenger,0,1,1,93,94,1.06
May,31,2023,Moore,NC,Passenger,0,1,1,99,100,1
May,31,2023,Cook,IL,Passenger,2,0,2,131,133,1.5
May,31,2023,Grant,WA,Passenger,275,122,397,66534,66931,0.59
May,31,2023,Alexandria,VA,Passenger,3,1,4,84,88,4.55
May,31,2023,Jefferson,WA,Passenger,549,260,809,24141,24950,3.24
May,31,2023,Whatcom,WA,Passenger,2374,867,3241,146794,150035,2.16
May,31,2023,,,Passenger,17,6,23,1218,1241,1.85
May,31,2023,Middlesex,MA,Passenger,2,1,3,57,60,5
May,31,2023,Allen,IN,Passenger,1,0,1,8,9,11.11
May,31,2023,Skagit,WA,Passenger,1081,403,1484,88295,89779,1.65
May,31,2023,Pend Oreille,WA,Truck,0,0,0,5568,5568,0
May,31,2023,Yakima,WA,Truck,12,0,12,60495,60507,0.02
May,31,2023,Washington,MD,Passenger,2,0,2,12,14,14.29
May,31,2023,Santa Cruz,CA,Passenger,1,0,1,12,13,7.69
May,31,2023,Platte,MO,Passenger,1,0,1,16,17,5.88
May,31,2023,Okanogan,WA,Truck,7,0,7,16336,16343,0.04
May,31,2023,Honolulu,HI,Passenger,2,3,5,233,238,2.1
May,31,2023,Benton,WA,Passenger,1120,555,1675,134506,136181,1.23
May,31,2023,Polk,OR,Passenger,0,1,1,14,15,6.67
May,31,2023,Skamania,WA,Truck,1,0,1,3802,3803,0.03
May,31,2023,St. Mary's,MD,Passenger,1,0,1,161,162,0.62
May,31,2023,Ferry,WA,Passenger,20,4,24,4292,4316,0.56
May,31,2023,New Haven,CT,Passenger,0,2,2,21,23,8.7
May,31,2023,Ray,MO,Passenger,0,1,1,0,1,100
May,31,2023,Galveston,TX,Passenger,0,1,1,15,16,6.25
May,31,2023,Spokane,WA,Passenger,2227,1062,3289,320686,323975,1.02
May,31,2023,Santa Barbara,CA,Passenger,1,0,1,60,61,1.64
May,31,2023,Whitman,WA,Passenger,144,76,220,21873,22093,1
May,31,2023,Fairfax,VA,Passenger,5,3,8,520,528,1.52
May,31,2023,Jefferson,WA,Truck,12,0,12,9267,9279,0.13
May,31,2023,Elmore,ID,Passenger,1,0,1,9,10,10
May,31,2023,Madison,IL,Passenger,1,0,1,14,15,6.67
May,31,2023,Mason,WA,Truck,10,0,10,20553,20563,0.05
May,31,2023,Newport News,VA,Passenger,1,0,1,89,90,1.11
May,31,2023,Lincoln,WA,Passenger,16,17,33,7646,7679,0.43
May,31,2023,Clallam,WA,Passenger,533,280,813,48629,49442,1.64
May,31,2023,Columbia,WA,Passenger,9,1,10,2407,2417,0.41
May,31,2023,Arapahoe,CO,Passenger,1,1,2,63,65,3.08
May,31,2023,St. Tammany,LA,Passenger,1,0,1,28,29,3.45
May,31,2023,Lewis,WA,Truck,7,0,7,25864,25871,0.03
May,31,2023,El Paso,TX,Passenger,2,0,2,248,250,0.8
May,31,2023,Monterey,CA,Passenger,1,0,1,104,105,0.95
May,31,2023,Dallas,TX,Passenger,1,0,1,70,71,1.41
May,31,2023,Grays Harbor,WA,Truck,6,0,6,20817,20823,0.03
May,31,2023,Collin,TX,Passenger,1,0,1,36,37,2.7
May,31,2023,Camden,NJ,Passenger,0,1,1,12,13,7.69
May,31,2023,Thurston,WA,Truck,57,0,57,53621,53678,0.11
May,31,2023,Kootenai,ID,Truck,1,0,1,25,26,3.85
May,31,2023,Escambia,FL,Passenger,0,1,1,103,104,0.96
May,31,2023,Nueces,TX,Passenger,0,1,1,49,50,2
May,31,2023,Sonoma,CA,Passenger,1,1,2,50,52,3.85
May,31,2023,Kent,DE,Passenger,1,0,1,43,44,2.27
May,31,2023,Pierce,WA,Truck,152,0,152,136292,136444,0.11
May,31,2023,Franklin,WA,Passenger,300,136,436,61492,61928,0.7
May,31,2023,Hidalgo,TX,Passenger,0,1,1,42,43,2.33
May,31,2023,Multnomah,OR,Passenger,0,2,2,398,400,0.5
May,31,2023,Garfield,WA,Passenger,1,3,4,1303,1307,0.31
May,31,2023,Los Angeles,CA,Passenger,4,4,8,565,573,1.4
May,31,2023,Island,WA,Truck,29,0,29,20927,20956,0.14
May,31,2023,Cowlitz,WA,Truck,8,0,8,28004,28012,0.03
May,31,2023,Plaquemines,LA,Passenger,1,1,2,12,14,14.29
May,31,2023,Burlington,NJ,Passenger,0,2,2,87,89,2.25
May,31,2023,Alameda,CA,Passenger,3,0,3,147,150,2
May,31,2023,Jefferson,NY,Passenger,1,1,2,169,171,1.17
May,31,2023,Okanogan,WA,Passenger,123,62,185,25949,26134,0.71
May,31,2023,Snohomish,WA,Truck,162,0,162,120661,120823,0.13
May,31,2023,Miami-Dade,FL,Passenger,1,0,1,53,54,1.85
May,31,2023,San Juan,WA,Truck,12,0,12,5866,5878,0.2
May,31,2023,Thurston,WA,Passenger,3033,1203,4236,189258,193494,2.19
May,31,2023,Charles,MD,Passenger,1,1,2,47,49,4.08
May,31,2023,Walla Walla,WA,Truck,5,0,5,13644,13649,0.04
May,31,2023,Montgomery,MD,Passenger,3,2,5,166,171,2.92
May,31,2023,Douglas,WA,Passenger,198,61,259,28577,28836,0.9
May,31,2023,Lee,AL,Passenger,1,0,1,11,12,8.33
May,31,2023,Adams,WA,Passenger,25,12,37,12934,12971,0.29
May,31,2023,Stevens,WA,Truck,1,0,1,18642,18643,0.01
May,31,2023,Sheridan,WY,Passenger,1,0,1,5,6,16.67
May,31,2023,Hawaii,HI,Passenger,1,0,1,23,24,4.17
May,31,2023,Hamilton,OH,Truck,1,0,1,2,3,33.33
May,31,2023,Rock Island,IL,Passenger,0,1,1,13,14,7.14
May,31,2023,Ferry,WA,Truck,0,0,0,3538,3538,0
May,31,2023,Columbia,WA,Truck,0,0,0,1546,1546,0
May,31,2023,Ulster,NY,Passenger,1,0,1,4,5,20
May,31,2023,Douglas,NE,Passenger,1,1,2,25,27,7.41
May,31,2023,Clallam,WA,Truck,20,0,20,21594,21614,0.09
May,31,2023,Nassau,NY,Passenger,1,0,1,21,22,4.55
May,31,2023,Stafford,VA,Passenger,3,1,4,71,75,5.33
May,31,2023,Bell,TX,Passenger,1,0,1,233,234,0.43
May,31,2023,Las Animas,CO,Passenger,1,0,1,0,1,100
May,31,2023,Pacific,WA,Passenger,76,90,166,15521,15687,1.06
May,31,2023,Champaign,IL,Passenger,1,0,1,7,8,12.5
May,31,2023,Ventura,CA,Passenger,2,1,3,190,193,1.55
May,31,2023,Douglas,CO,Passenger,0,1,1,49,50,2
May,31,2023,Douglas,WA,Truck,7,0,7,12885,12892,0.05
May,31,2023,Essex,NJ,Passenger,2,0,2,4,6,33.33
May,31,2023,Grays Harbor,WA,Passenger,290,181,471,48014,48485,0.97
May,31,2023,Benton,OR,Passenger,1,0,1,30,31,3.23
May,31,2023,Napa,CA,Passenger,0,1,1,10,11,9.09
May,31,2023,Norfolk,VA,Passenger,3,2,5,249,254,1.97
May,31,2023,Cowlitz,WA,Passenger,454,206,660,69496,70156,0.94
May,31,2023,Santa Clara,CA,Passenger,8,1,9,142,151,5.96
May,31,2023,Goochland,VA,Passenger,0,1,1,36,37,2.7
May,31,2023,Pend Oreille,WA,Passenger,30,11,41,8845,8886,0.46
May,31,2023,Placer,CA,Passenger,1,0,1,50,51,1.96
May,31,2023,King,WA,Passenger,55335,14137,69472,1316224,1385696,5.01
May,31,2023,Asotin,WA,Truck,0,0,0,6599,6599,0
May,31,2023,Skagit,WA,Truck,19,0,19,31695,31714,0.06
May,31,2023,Hillsborough,FL,Passenger,0,1,1,95,96,1.04
May,31,2023,Clark,WA,Passenger,5619,2279,7898,311557,319455,2.47
May,31,2023,Kittitas,WA,Truck,8,0,8,14448,14456,0.06
May,31,2023,Fairbanks North Star,AK,Passenger,0,1,1,45,46,2.17
May,31,2023,Williamson,TX,Passenger,0,1,1,46,47,2.13
May,31,2023,Rockdale,GA,Passenger,1,0,1,3,4,25
May,31,2023,Richmond,NY,Passenger,1,0,1,6,7,14.29
May,31,2023,Saratoga,NY,Passenger,1,1,2,27,29,6.9
May,31,2023,Pacific,WA,Truck,3,0,3,7785,7788,0.04
May,31,2023,Solano,CA,Passenger,5,0,5,132,137,3.65
May,31,2023,Geary,KS,Passenger,1,0,1,67,68,1.47
May,31,2023,Hoke,NC,Passenger,1,0,1,53,54,1.85
May,31,2023,Cumberland,PA,Passenger,1,0,1,30,31,3.23
May,31,2023,Kittitas,WA,Passenger,339,102,441,29165,29606,1.49
May,31,2023,Broward,FL,Passenger,1,0,1,53,54,1.85
May,31,2023,Sarasota,FL,Passenger,1,0,1,14,15,6.67
May,31,2023,Kitsap,WA,Passenger,3126,1246,4372,175192,179564,2.43
May,31,2023,Wahkiakum,WA,Truck,2,0,2,1753,1755,0.11
May,31,2023,Travis,TX,Passenger,1,0,1,75,76,1.32
May,31,2023,Coryell,TX,Passenger,1,0,1,70,71,1.41
May,31,2023,San Diego,CA,Passenger,16,9,25,1823,1848,1.35
May,31,2023,Leavenworth,KS,Passenger,0,1,1,89,90,1.11
May,31,2023,Houston,GA,Passenger,1,0,1,26,27,3.7
May,31,2023,Lincoln,OR,Passenger,0,1,1,12,13,7.69
May,31,2023,Skamania,WA,Passenger,101,58,159,7977,8136,1.95
May,31,2023,Hamilton,OH,Passenger,1,0,1,24,25,4
May,31,2023,Suffolk,VA,Passenger,1,0,1,101,102,0.98
May,31,2023,Cape May,NJ,Passenger,0,1,1,7,8,12.5
May,31,2023,Orange,CA,Passenger,6,2,8,260,268,2.99
May,31,2023,Lewis,WA,Passenger,309,203,512,58552,59064,0.87
May,31,2023,Yakima,WA,Passenger,484,249,733,164633,165366,0.44
May,31,2023,Hennepin,MN,Passenger,1,0,1,27,28,3.57
May,31,2023,Harnett,NC,Passenger,4,0,4,116,120,3.33
May,31,2023,Contra Costa,CA,Passenger,0,3,3,183,186,1.61
May,31,2023,Riverside,CA,Passenger,6,1,7,348,355,1.97
May,31,2023,Salt Lake,UT,Passenger,0,1,1,86,87,1.15
May,31,2023,Emmet,MI,Passenger,0,1,1,0,1,100
May,31,2023,Grant,WA,Truck,10,0,10,27771,27781,0.04
May,31,2023,Rockingham,NH,Passenger,1,0,1,11,12,8.33
May,31,2023,Sacramento,CA,Passenger,4,0,4,129,133,3.01
May,31,2023,Lincoln,WA,Truck,0,0,0,4844,4844,0
May,31,2023,Klickitat,WA,Passenger,145,63,208,15072,15280,1.36
May,31,2023,Adams,CO,Passenger,1,0,1,25,26,3.85
May,31,2023,Vernon,LA,Passenger,1,0,1,68,69,1.45
May,31,2023,Oldham,KY,Passenger,0,1,1,3,4,25
May,31,2023,Lane,OR,Passenger,0,1,1,60,61,1.64
May,31,2023,Benton,WA,Truck,22,0,22,42823,42845,0.05
May,31,2023,Island,WA,Passenger,1044,430,1474,60998,62472,2.36
May,31,2023,Lake,IL,Passenger,2,0,2,104,106,1.89
