,Month_ending,Year,County,State,Primary_use,Battery_BEVs,Hybrid_(PHEVs),EV_Total,Non-Electric_Total,Total_Veh,%_Electric,Proximity,State_Names
1,April,2017,Island,WA,Passenger,108,128,236,59768,60004,0.39,Washington,Washington
2,April,2017,Clark,WA,Truck,0,0,0,77561,77561,0.0,Washington,Washington
6,April,2017,Jefferson,WA,Passenger,98,56,154,23744,23898,0.64,Washington,Washington
10,April,2017,Yakima,WA,Truck,0,0,0,57219,57219,0.0,Washington,Washington
12,April,2017,Skamania,WA,Truck,0,0,0,3874,3874,0.0,Washington,Washington
13,April,2017,Whitman,WA,Passenger,9,19,28,21964,21992,0.13,Washington,Washington
15,April,2017,Clark,WA,Passenger,755,471,1226,298474,299700,0.41,Washington,Washington
16,April,2017,Adams,WA,Passenger,2,3,5,12128,12133,0.04,Washington,Washington
17,April,2017,Franklin,WA,Passenger,27,47,74,55348,55422,0.13,Washington,Washington
18,April,2017,Ferry,WA,Truck,0,0,0,3549,3549,0.0,Washington,Washington
19,April,2017,San Juan,WA,Truck,0,0,0,5551,5551,0.0,Washington,Washington
22,April,2017,Klickitat,WA,Passenger,22,23,45,14768,14813,0.3,Washington,Washington
25,April,2017,Skagit,WA,Truck,1,0,1,31395,31396,0.0,Washington,Washington
27,April,2017,San Juan,WA,Passenger,98,35,133,13479,13612,0.98,Washington,Washington
30,April,2017,Adams,WA,Truck,0,0,0,5072,5072,0.0,Washington,Washington
31,April,2017,Lewis,WA,Passenger,46,33,79,55192,55271,0.14,Washington,Washington
33,April,2017,Whatcom,WA,Truck,2,0,2,41449,41451,0.0,Washington,Washington
34,April,2017,Lincoln,WA,Truck,0,0,0,4464,4464,0.0,Washington,Washington
38,April,2017,Grays Harbor,WA,Truck,0,0,0,19850,19850,0.0,Washington,Washington
40,April,2017,Okanogan,WA,Passenger,3,16,19,25595,25614,0.07,Washington,Washington
42,April,2017,Kitsap,WA,Truck,1,0,1,52312,52313,0.0,Washington,Washington
45,April,2017,Garfield,WA,Truck,0,0,0,938,938,0.0,Washington,Washington
48,April,2017,Lewis,WA,Truck,0,0,0,24797,24797,0.0,Washington,Washington
49,April,2017,Asotin,WA,Passenger,6,2,8,12343,12351,0.06,Washington,Washington
53,April,2017,Thurston,WA,Passenger,385,319,704,185729,186433,0.38,Washington,Washington
56,April,2017,Walla Walla,WA,Passenger,22,24,46,34828,34874,0.13,Washington,Washington
57,April,2017,Stevens,WA,Passenger,8,22,30,31233,31263,0.1,Washington,Washington
58,April,2017,Okanogan,WA,Truck,0,0,0,16256,16256,0.0,Washington,Washington
59,April,2017,Pierce,WA,Truck,0,0,0,137818,137818,0.0,Washington,Washington
60,April,2017,Douglas,WA,Passenger,31,21,52,26603,26655,0.2,Washington,Washington
61,April,2017,Franklin,WA,Truck,0,0,0,17995,17995,0.0,Washington,Washington
71,April,2017,Spokane,WA,Truck,1,0,1,90266,90267,0.0,Washington,Washington
75,April,2017,King,WA,Truck,8,1,9,188938,188947,0.0,Washington,Washington
77,April,2017,Klickitat,WA,Truck,0,0,0,7954,7954,0.0,Washington,Washington
82,April,2017,Clallam,WA,Passenger,80,68,148,48127,48275,0.31,Washington,Washington
83,April,2017,Thurston,WA,Truck,0,0,0,53255,53255,0.0,Washington,Washington
86,April,2017,Pacific,WA,Truck,0,0,0,7464,7464,0.0,Washington,Washington
90,April,2017,Columbia,WA,Truck,0,0,0,1536,1536,0.0,Washington,Washington
92,April,2017,Lincoln,WA,Passenger,2,4,6,7481,7487,0.08,Washington,Washington
101,April,2017,Grant,WA,Truck,0,0,0,25091,25091,0.0,Washington,Washington
105,April,2017,Pacific,WA,Passenger,9,8,17,15082,15099,0.11,Washington,Washington
106,April,2017,Jefferson,WA,Truck,0,0,0,9442,9442,0.0,Washington,Washington
110,April,2017,Yakima,WA,Passenger,38,54,92,159283,159375,0.06,Washington,Washington
114,April,2017,Walla Walla,WA,Truck,0,0,0,13177,13177,0.0,Washington,Washington
115,April,2017,Chelan,WA,Truck,0,0,0,21208,21208,0.0,Washington,Washington
117,April,2017,Grant,WA,Passenger,18,21,39,60489,60528,0.06,Washington,Washington
118,April,2017,Whitman,WA,Truck,0,0,0,8380,8380,0.0,Washington,Washington
122,April,2017,Spokane,WA,Passenger,236,208,444,295746,296190,0.15,Washington,Washington
123,April,2017,Grays Harbor,WA,Passenger,29,30,59,44477,44536,0.13,Washington,Washington
125,April,2017,Wahkiakum,WA,Passenger,0,2,2,2848,2850,0.07,Washington,Washington
127,April,2017,Skamania,WA,Passenger,9,8,17,8521,8538,0.2,Washington,Washington
130,April,2017,Mason,WA,Truck,0,0,0,19242,19242,0.0,Washington,Washington
136,April,2017,King,WA,Passenger,9558,3882,13440,1378548,1391988,0.97,Washington,Washington
138,April,2017,Clallam,WA,Truck,0,0,0,20962,20962,0.0,Washington,Washington
140,April,2017,Pierce,WA,Passenger,917,807,1724,525754,527478,0.33,Washington,Washington
142,April,2017,Benton,WA,Passenger,143,140,283,128087,128370,0.22,Washington,Washington
143,April,2017,Island,WA,Truck,0,0,0,20526,20526,0.0,Washington,Washington
146,April,2017,Kittitas,WA,Truck,0,0,0,13478,13478,0.0,Washington,Washington
149,April,2017,Skagit,WA,Passenger,123,97,220,87597,87817,0.25,Washington,Washington
150,April,2017,Stevens,WA,Truck,0,0,0,18286,18286,0.0,Washington,Washington
151,April,2017,Cowlitz,WA,Truck,0,0,0,27856,27856,0.0,Washington,Washington
152,April,2017,Snohomish,WA,Passenger,1709,861,2570,512767,515337,0.5,Washington,Washington
158,April,2017,Ferry,WA,Passenger,2,1,3,4397,4400,0.07,Washington,Washington
159,April,2017,Kitsap,WA,Passenger,584,298,882,172672,173554,0.51,Washington,Washington
161,April,2017,Douglas,WA,Truck,0,0,0,11451,11451,0.0,Washington,Washington
162,April,2017,Wahkiakum,WA,Truck,0,0,0,1631,1631,0.0,Washington,Washington
165,April,2017,Chelan,WA,Passenger,55,31,86,51695,51781,0.17,Washington,Washington
166,April,2017,Mason,WA,Passenger,49,64,113,43002,43115,0.26,Washington,Washington
172,April,2017,Columbia,WA,Passenger,0,1,1,2358,2359,0.04,Washington,Washington
173,April,2017,Asotin,WA,Truck,0,0,0,6504,6504,0.0,Washington,Washington
175,April,2017,Whatcom,WA,Passenger,441,159,600,142459,143059,0.42,Washington,Washington
178,April,2017,Garfield,WA,Passenger,0,0,0,1283,1283,0.0,Washington,Washington
180,April,2017,Pend Oreille,WA,Truck,0,0,0,5586,5586,0.0,Washington,Washington
181,April,2017,Benton,WA,Truck,0,0,0,39892,39892,0.0,Washington,Washington
182,April,2017,Pend Oreille,WA,Passenger,1,4,5,9320,9325,0.05,Washington,Washington
183,April,2017,Cowlitz,WA,Passenger,52,48,100,69320,69420,0.14,Washington,Washington
184,April,2017,Kittitas,WA,Passenger,21,17,38,27202,27240,0.14,Washington,Washington
185,April,2017,Snohomish,WA,Truck,1,0,1,122009,122010,0.0,Washington,Washington
188,April,2018,Lincoln,WA,Truck,0,0,0,4532,4532,0.0,Washington,Washington
191,April,2018,Franklin,WA,Truck,0,0,0,18597,18597,0.0,Washington,Washington
194,April,2018,Grays Harbor,WA,Passenger,47,52,99,46287,46386,0.21,Washington,Washington
195,April,2018,Ferry,WA,Truck,0,0,0,3499,3499,0.0,Washington,Washington
197,April,2018,Spokane,WA,Truck,1,0,1,92061,92062,0.0,Washington,Washington
202,April,2018,Yakima,WA,Truck,0,0,0,58216,58216,0.0,Washington,Washington
205,April,2018,Benton,WA,Passenger,178,188,366,130946,131312,0.28,Washington,Washington
206,April,2018,Skamania,WA,Truck,0,0,0,3922,3922,0.0,Washington,Washington
207,April,2018,Thurston,WA,Truck,0,0,0,54065,54065,0.0,Washington,Washington
209,April,2018,Whatcom,WA,Truck,2,0,2,42122,42124,0.0,Washington,Washington
210,April,2018,Columbia,WA,Passenger,2,1,3,2414,2417,0.12,Washington,Washington
212,April,2018,Douglas,WA,Passenger,41,32,73,27438,27511,0.27,Washington,Washington
214,April,2018,Thurston,WA,Passenger,523,444,967,191803,192770,0.5,Washington,Washington
219,April,2018,Cowlitz,WA,Passenger,55,73,128,71356,71484,0.18,Washington,Washington
220,April,2018,San Juan,WA,Passenger,141,53,194,13961,14155,1.37,Washington,Washington
222,April,2018,Garfield,WA,Passenger,1,0,1,1330,1331,0.08,Washington,Washington
223,April,2018,Walla Walla,WA,Truck,0,0,0,13332,13332,0.0,Washington,Washington
225,April,2018,Cowlitz,WA,Truck,0,0,0,28292,28292,0.0,Washington,Washington
226,April,2018,Mason,WA,Passenger,71,87,158,45392,45550,0.35,Washington,Washington
227,April,2018,Pacific,WA,Passenger,14,19,33,15488,15521,0.21,Washington,Washington
236,April,2018,Snohomish,WA,Truck,1,0,1,121256,121257,0.0,Washington,Washington
238,April,2018,Yakima,WA,Passenger,62,84,146,163240,163386,0.09,Washington,Washington
243,April,2018,Skamania,WA,Passenger,12,8,20,8705,8725,0.23,Washington,Washington
244,April,2018,Chelan,WA,Passenger,98,45,143,53398,53541,0.27,Washington,Washington
245,April,2018,Skagit,WA,Passenger,182,155,337,90035,90372,0.37,Washington,Washington
246,April,2018,Wahkiakum,WA,Passenger,1,3,4,2887,2891,0.14,Washington,Washington
251,April,2018,Asotin,WA,Truck,0,0,0,6594,6594,0.0,Washington,Washington
252,April,2018,Grays Harbor,WA,Truck,0,0,0,20130,20130,0.0,Washington,Washington
253,April,2018,Stevens,WA,Truck,0,0,0,18512,18512,0.0,Washington,Washington
254,April,2018,Lewis,WA,Truck,0,0,0,25310,25310,0.0,Washington,Washington
255,April,2018,Snohomish,WA,Passenger,2189,1194,3383,518822,522205,0.65,Washington,Washington
257,April,2018,Columbia,WA,Truck,0,0,0,1523,1523,0.0,Washington,Washington
259,April,2018,Clark,WA,Passenger,943,657,1600,306447,308047,0.52,Washington,Washington
264,April,2018,Adams,WA,Passenger,5,4,9,12523,12532,0.07,Washington,Washington
265,April,2018,Lewis,WA,Passenger,78,51,129,57351,57480,0.22,Washington,Washington
269,April,2018,Pend Oreille,WA,Passenger,4,5,9,9474,9483,0.09,Washington,Washington
271,April,2018,Pierce,WA,Passenger,1154,1091,2245,529160,531405,0.42,Washington,Washington
277,April,2018,Clallam,WA,Passenger,117,105,222,49605,49827,0.45,Washington,Washington
279,April,2018,Douglas,WA,Truck,0,0,0,11882,11882,0.0,Washington,Washington
283,April,2018,Benton,WA,Truck,0,0,0,40852,40852,0.0,Washington,Washington
285,April,2018,Klickitat,WA,Truck,0,0,0,8070,8070,0.0,Washington,Washington
287,April,2018,Whatcom,WA,Passenger,593,269,862,146611,147473,0.58,Washington,Washington
290,April,2018,Walla Walla,WA,Passenger,34,40,74,35454,35528,0.21,Washington,Washington
291,April,2018,Spokane,WA,Passenger,318,288,606,301923,302529,0.2,Washington,Washington
292,April,2018,Adams,WA,Truck,0,0,0,5150,5150,0.0,Washington,Washington
294,April,2018,Pacific,WA,Truck,0,0,0,7596,7596,0.0,Washington,Washington
296,April,2018,Kitsap,WA,Passenger,742,441,1183,177372,178555,0.66,Washington,Washington
297,April,2018,Stevens,WA,Passenger,10,24,34,31585,31619,0.11,Washington,Washington
299,April,2018,San Juan,WA,Truck,0,0,0,5698,5698,0.0,Washington,Washington
302,April,2018,Kittitas,WA,Passenger,40,32,72,28774,28846,0.25,Washington,Washington
306,April,2018,Grant,WA,Passenger,31,42,73,62794,62867,0.12,Washington,Washington
307,April,2018,Kitsap,WA,Truck,1,0,1,52991,52992,0.0,Washington,Washington
308,April,2018,Clallam,WA,Truck,0,0,0,21359,21359,0.0,Washington,Washington
310,April,2018,Whitman,WA,Passenger,20,24,44,22555,22599,0.19,Washington,Washington
311,April,2018,Whitman,WA,Truck,0,0,0,8463,8463,0.0,Washington,Washington
312,April,2018,Island,WA,Truck,0,0,0,20845,20845,0.0,Washington,Washington
314,April,2018,Asotin,WA,Passenger,8,6,14,12640,12654,0.11,Washington,Washington
325,April,2018,Ferry,WA,Passenger,2,3,5,4414,4419,0.11,Washington,Washington
326,April,2018,Garfield,WA,Truck,0,0,0,950,950,0.0,Washington,Washington
329,April,2018,Wahkiakum,WA,Truck,0,0,0,1668,1668,0.0,Washington,Washington
330,April,2018,Pend Oreille,WA,Truck,0,0,0,5654,5654,0.0,Washington,Washington
336,April,2018,Franklin,WA,Passenger,37,59,96,57403,57499,0.17,Washington,Washington
341,April,2018,Mason,WA,Truck,0,0,0,19808,19808,0.0,Washington,Washington
349,April,2018,Klickitat,WA,Passenger,24,29,53,15050,15103,0.35,Washington,Washington
355,April,2018,King,WA,Truck,7,1,8,183356,183364,0.0,Washington,Washington
357,April,2018,King,WA,Passenger,12284,5290,17574,1368427,1386001,1.27,Washington,Washington
359,April,2018,Island,WA,Passenger,184,177,361,62281,62642,0.58,Washington,Washington
360,April,2018,Pierce,WA,Truck,0,0,0,137364,137364,0.0,Washington,Washington
361,April,2018,Jefferson,WA,Truck,0,0,0,9525,9525,0.0,Washington,Washington
363,April,2018,Kittitas,WA,Truck,0,0,0,13993,13993,0.0,Washington,Washington
366,April,2018,Skagit,WA,Truck,1,0,1,31980,31981,0.0,Washington,Washington
367,April,2018,Okanogan,WA,Passenger,8,19,27,25823,25850,0.1,Washington,Washington
369,April,2018,Lincoln,WA,Passenger,2,6,8,7613,7621,0.1,Washington,Washington
371,April,2018,Okanogan,WA,Truck,0,0,0,16350,16350,0.0,Washington,Washington
380,April,2018,Grant,WA,Truck,0,0,0,25855,25855,0.0,Washington,Washington
381,April,2018,Chelan,WA,Truck,0,0,0,21764,21764,0.0,Washington,Washington
385,April,2018,Clark,WA,Truck,0,0,0,78735,78735,0.0,Washington,Washington
387,April,2018,Jefferson,WA,Passenger,134,88,222,24353,24575,0.9,Washington,Washington
388,April,2019,Pierce,WA,Passenger,1692,1486,3178,540913,544091,0.58,Washington,Washington
390,April,2019,Clark,WA,Truck,0,0,0,80105,80105,0.0,Washington,Washington
391,April,2019,Grant,WA,Truck,0,0,0,26430,26430,0.0,Washington,Washington
393,April,2019,Wahkiakum,WA,Truck,0,0,0,1733,1733,0.0,Washington,Washington
396,April,2019,Wahkiakum,WA,Passenger,1,1,2,3014,3016,0.07,Washington,Washington
398,April,2019,Yakima,WA,Passenger,93,103,196,164616,164812,0.12,Washington,Washington
402,April,2019,Whitman,WA,Passenger,29,45,74,22711,22785,0.32,Washington,Washington
403,April,2019,Skamania,WA,Truck,0,0,0,4039,4039,0.0,Washington,Washington
405,April,2019,Benton,WA,Passenger,248,263,511,133307,133818,0.38,Washington,Washington
406,April,2019,Whitman,WA,Truck,0,0,0,8517,8517,0.0,Washington,Washington
410,April,2019,Jefferson,WA,Passenger,187,118,305,24901,25206,1.21,Washington,Washington
411,April,2019,Walla Walla,WA,Passenger,46,57,103,36137,36240,0.28,Washington,Washington
420,April,2019,Chelan,WA,Truck,0,0,0,22173,22173,0.0,Washington,Washington
422,April,2019,Pierce,WA,Truck,0,0,0,139350,139350,0.0,Washington,Washington
423,April,2019,Columbia,WA,Passenger,2,2,4,2441,2445,0.16,Washington,Washington
428,April,2019,Yakima,WA,Truck,0,0,0,58948,58948,0.0,Washington,Washington
429,April,2019,Skamania,WA,Passenger,21,16,37,8713,8750,0.42,Washington,Washington
435,April,2019,Okanogan,WA,Passenger,20,22,42,26020,26062,0.16,Washington,Washington
436,April,2019,Garfield,WA,Truck,0,0,0,958,958,0.0,Washington,Washington
438,April,2019,Clark,WA,Passenger,1414,896,2310,312581,314891,0.73,Washington,Washington
440,April,2019,Cowlitz,WA,Truck,0,0,0,28852,28852,0.0,Washington,Washington
460,April,2019,Asotin,WA,Passenger,12,8,20,12659,12679,0.16,Washington,Washington
462,April,2019,King,WA,Passenger,18277,6871,25148,1384099,1409247,1.78,Washington,Washington
463,April,2019,Whatcom,WA,Truck,2,0,2,42771,42773,0.0,Washington,Washington
464,April,2019,Whatcom,WA,Passenger,823,394,1217,150081,151298,0.8,Washington,Washington
470,April,2019,Douglas,WA,Truck,0,0,0,12176,12176,0.0,Washington,Washington
472,April,2019,Pacific,WA,Truck,0,0,0,7660,7660,0.0,Washington,Washington
473,April,2019,Chelan,WA,Passenger,147,66,213,54294,54507,0.39,Washington,Washington
474,April,2019,Pend Oreille,WA,Truck,0,0,0,5753,5753,0.0,Washington,Washington
476,April,2019,Grant,WA,Passenger,35,60,95,64382,64477,0.15,Washington,Washington
477,April,2019,Klickitat,WA,Passenger,33,33,66,15507,15573,0.42,Washington,Washington
480,April,2019,Walla Walla,WA,Truck,0,0,0,13603,13603,0.0,Washington,Washington
484,April,2019,Kitsap,WA,Passenger,1009,575,1584,180200,181784,0.87,Washington,Washington
490,April,2019,Kittitas,WA,Passenger,71,35,106,29489,29595,0.36,Washington,Washington
491,April,2019,Mason,WA,Truck,0,0,0,20326,20326,0.0,Washington,Washington
492,April,2019,Pend Oreille,WA,Passenger,4,5,9,9505,9514,0.09,Washington,Washington
495,April,2019,Thurston,WA,Passenger,821,613,1434,196770,198204,0.72,Washington,Washington
498,April,2019,Asotin,WA,Truck,0,0,0,6629,6629,0.0,Washington,Washington
500,April,2019,Spokane,WA,Truck,1,0,1,94382,94383,0.0,Washington,Washington
501,April,2019,Clallam,WA,Passenger,160,132,292,50458,50750,0.58,Washington,Washington
503,April,2019,King,WA,Truck,5,1,6,181820,181826,0.0,Washington,Washington
506,April,2019,Stevens,WA,Truck,0,0,0,18683,18683,0.0,Washington,Washington
509,April,2019,Thurston,WA,Truck,0,0,0,55024,55024,0.0,Washington,Washington
510,April,2019,Adams,WA,Passenger,5,6,11,12657,12668,0.09,Washington,Washington
511,April,2019,Ferry,WA,Passenger,4,2,6,4370,4376,0.14,Washington,Washington
521,April,2019,Benton,WA,Truck,0,0,0,41655,41655,0.0,Washington,Washington
522,April,2019,Lincoln,WA,Truck,0,0,0,4700,4700,0.0,Washington,Washington
529,April,2019,San Juan,WA,Truck,0,0,0,5834,5834,0.0,Washington,Washington
533,April,2019,Grays Harbor,WA,Truck,0,0,0,20395,20395,0.0,Washington,Washington
535,April,2019,Klickitat,WA,Truck,0,0,0,8222,8222,0.0,Washington,Washington
539,April,2019,Okanogan,WA,Truck,0,0,0,16478,16478,0.0,Washington,Washington
543,April,2019,Spokane,WA,Passenger,512,407,919,309575,310494,0.3,Washington,Washington
546,April,2019,Cowlitz,WA,Passenger,89,101,190,72747,72937,0.26,Washington,Washington
548,April,2019,Mason,WA,Passenger,117,118,235,46864,47099,0.5,Washington,Washington
549,April,2019,Stevens,WA,Passenger,19,27,46,31638,31684,0.15,Washington,Washington
551,April,2019,Snohomish,WA,Truck,1,0,1,122012,122013,0.0,Washington,Washington
552,April,2019,Grays Harbor,WA,Passenger,70,84,154,47665,47819,0.32,Washington,Washington
554,April,2019,Island,WA,Passenger,310,241,551,63255,63806,0.86,Washington,Washington
555,April,2019,Pacific,WA,Passenger,23,28,51,15922,15973,0.32,Washington,Washington
556,April,2019,Island,WA,Truck,0,0,0,21247,21247,0.0,Washington,Washington
558,April,2019,Lewis,WA,Truck,0,0,0,25826,25826,0.0,Washington,Washington
562,April,2019,Lincoln,WA,Passenger,3,6,9,7756,7765,0.12,Washington,Washington
564,April,2019,Franklin,WA,Truck,0,0,0,19218,19218,0.0,Washington,Washington
565,April,2019,Franklin,WA,Passenger,53,67,120,59469,59589,0.2,Washington,Washington
568,April,2019,San Juan,WA,Passenger,204,69,273,14332,14605,1.87,Washington,Washington
575,April,2019,Douglas,WA,Passenger,55,34,89,27972,28061,0.32,Washington,Washington
579,April,2019,Jefferson,WA,Truck,0,0,0,9652,9652,0.0,Washington,Washington
580,April,2019,Snohomish,WA,Passenger,3292,1539,4831,529161,533992,0.9,Washington,Washington
584,April,2019,Adams,WA,Truck,0,0,0,5104,5104,0.0,Washington,Washington
585,April,2019,Ferry,WA,Truck,0,0,0,3592,3592,0.0,Washington,Washington
586,April,2019,Skagit,WA,Passenger,292,197,489,91537,92026,0.53,Washington,Washington
588,April,2019,Clallam,WA,Truck,0,0,0,21681,21681,0.0,Washington,Washington
591,April,2019,Kitsap,WA,Truck,1,0,1,53874,53875,0.0,Washington,Washington
593,April,2019,Lewis,WA,Passenger,95,91,186,58821,59007,0.32,Washington,Washington
595,April,2019,Kittitas,WA,Truck,0,0,0,14296,14296,0.0,Washington,Washington
597,April,2019,Garfield,WA,Passenger,1,1,2,1298,1300,0.15,Washington,Washington
602,April,2019,Skagit,WA,Truck,1,0,1,32325,32326,0.0,Washington,Washington
605,April,2019,Columbia,WA,Truck,0,0,0,1531,1531,0.0,Washington,Washington
612,April,2020,King,WA,Passenger,24085,7696,31781,1386024,1417805,2.24,Washington,Washington
613,April,2020,Pend Oreille,WA,Truck,0,0,0,5739,5739,0.0,Washington,Washington
615,April,2020,Pierce,WA,Passenger,2347,1682,4029,548871,552900,0.73,Washington,Washington
616,April,2020,Garfield,WA,Truck,0,0,0,968,968,0.0,Washington,Washington
617,April,2020,Cowlitz,WA,Truck,0,0,0,28765,28765,0.0,Washington,Washington
625,April,2020,Adams,WA,Truck,0,0,0,5206,5206,0.0,Washington,Washington
631,April,2020,Yakima,WA,Passenger,129,115,244,165261,165505,0.15,Washington,Washington
635,April,2020,Ferry,WA,Passenger,5,3,8,4331,4339,0.18,Washington,Washington
640,April,2020,Mason,WA,Truck,0,0,0,20531,20531,0.0,Washington,Washington
645,April,2020,Klickitat,WA,Truck,0,0,0,8193,8193,0.0,Washington,Washington
650,April,2020,Whitman,WA,Passenger,44,48,92,22313,22405,0.41,Washington,Washington
652,April,2020,Asotin,WA,Truck,0,0,0,6617,6617,0.0,Washington,Washington
653,April,2020,Columbia,WA,Truck,0,0,0,1524,1524,0.0,Washington,Washington
656,April,2020,Kitsap,WA,Truck,1,0,1,53907,53908,0.0,Washington,Washington
658,April,2020,Wahkiakum,WA,Passenger,6,5,11,2973,2984,0.37,Washington,Washington
663,April,2020,Benton,WA,Passenger,348,321,669,134556,135225,0.49,Washington,Washington
667,April,2020,Spokane,WA,Passenger,711,473,1184,316298,317482,0.37,Washington,Washington
671,April,2020,Chelan,WA,Truck,0,0,0,22460,22460,0.0,Washington,Washington
674,April,2020,Clallam,WA,Passenger,219,166,385,50341,50726,0.76,Washington,Washington
677,April,2020,Clark,WA,Passenger,1992,1056,3048,318746,321794,0.95,Washington,Washington
679,April,2020,Cowlitz,WA,Passenger,136,115,251,72718,72969,0.34,Washington,Washington
680,April,2020,Skagit,WA,Truck,1,0,1,32387,32388,0.0,Washington,Washington
683,April,2020,Jefferson,WA,Passenger,234,142,376,24908,25284,1.49,Washington,Washington
687,April,2020,Skamania,WA,Passenger,29,17,46,8615,8661,0.53,Washington,Washington
688,April,2020,Stevens,WA,Truck,0,0,0,18611,18611,0.0,Washington,Washington
691,April,2020,Spokane,WA,Truck,1,0,1,97398,97399,0.0,Washington,Washington
692,April,2020,King,WA,Truck,5,1,6,181518,181524,0.0,Washington,Washington
695,April,2020,Garfield,WA,Passenger,0,1,1,1341,1342,0.07,Washington,Washington
698,April,2020,Pierce,WA,Truck,0,0,0,141140,141140,0.0,Washington,Washington
699,April,2020,Ferry,WA,Truck,0,0,0,3543,3543,0.0,Washington,Washington
705,April,2020,Walla Walla,WA,Passenger,69,63,132,36000,36132,0.37,Washington,Washington
709,April,2020,Thurston,WA,Truck,0,0,0,55499,55499,0.0,Washington,Washington
710,April,2020,San Juan,WA,Truck,0,0,0,5898,5898,0.0,Washington,Washington
713,April,2020,Grant,WA,Truck,0,0,0,26995,26995,0.0,Washington,Washington
715,April,2020,Okanogan,WA,Passenger,34,31,65,25891,25956,0.25,Washington,Washington
717,April,2020,Stevens,WA,Passenger,33,33,66,30969,31035,0.21,Washington,Washington
721,April,2020,Kittitas,WA,Passenger,101,49,150,29857,30007,0.5,Washington,Washington
726,April,2020,Island,WA,Truck,1,0,1,21149,21150,0.0,Washington,Washington
728,April,2020,Okanogan,WA,Truck,0,0,0,16384,16384,0.0,Washington,Washington
730,April,2020,Mason,WA,Passenger,155,135,290,47212,47502,0.61,Washington,Washington
733,April,2020,Pacific,WA,Passenger,30,34,64,15837,15901,0.4,Washington,Washington
744,April,2020,Chelan,WA,Passenger,224,80,304,54232,54536,0.56,Washington,Washington
747,April,2020,Benton,WA,Truck,0,0,0,42485,42485,0.0,Washington,Washington
750,April,2020,Lewis,WA,Passenger,99,106,205,58652,58857,0.35,Washington,Washington
751,April,2020,Pacific,WA,Truck,0,0,0,7665,7665,0.0,Washington,Washington
755,April,2020,Clallam,WA,Truck,1,0,1,21696,21697,0.0,Washington,Washington
759,April,2020,Island,WA,Passenger,405,270,675,62863,63538,1.06,Washington,Washington
760,April,2020,Franklin,WA,Truck,0,0,0,19844,19844,0.0,Washington,Washington
765,April,2020,Wahkiakum,WA,Truck,0,0,0,1760,1760,0.0,Washington,Washington
769,April,2020,Skamania,WA,Truck,0,0,0,4054,4054,0.0,Washington,Washington
770,April,2020,Grays Harbor,WA,Truck,0,0,0,20728,20728,0.0,Washington,Washington
776,April,2020,Whitman,WA,Truck,0,0,0,8532,8532,0.0,Washington,Washington
777,April,2020,Grant,WA,Passenger,59,71,130,65268,65398,0.2,Washington,Washington
784,April,2020,Thurston,WA,Passenger,1141,730,1871,197497,199368,0.94,Washington,Washington
785,April,2020,Lincoln,WA,Truck,0,0,0,4627,4627,0.0,Washington,Washington
787,April,2020,Kitsap,WA,Passenger,1312,676,1988,180568,182556,1.09,Washington,Washington
789,April,2020,Walla Walla,WA,Truck,0,0,0,13622,13622,0.0,Washington,Washington
790,April,2020,Douglas,WA,Truck,0,0,0,12271,12271,0.0,Washington,Washington
792,April,2020,Snohomish,WA,Truck,0,0,0,123316,123316,0.0,Washington,Washington
793,April,2020,Columbia,WA,Passenger,3,3,6,2407,2413,0.25,Washington,Washington
797,April,2020,Pend Oreille,WA,Passenger,8,6,14,9257,9271,0.15,Washington,Washington
798,April,2020,Franklin,WA,Passenger,58,76,134,60733,60867,0.22,Washington,Washington
803,April,2020,Asotin,WA,Passenger,16,12,28,12444,12472,0.22,Washington,Washington
804,April,2020,Douglas,WA,Passenger,69,40,109,28017,28126,0.39,Washington,Washington
808,April,2020,Jefferson,WA,Truck,0,0,0,9531,9531,0.0,Washington,Washington
814,April,2020,Adams,WA,Passenger,7,7,14,12756,12770,0.11,Washington,Washington
816,April,2020,Skagit,WA,Passenger,397,215,612,91480,92092,0.66,Washington,Washington
820,April,2020,Whatcom,WA,Passenger,1058,490,1548,150136,151684,1.02,Washington,Washington
825,April,2020,Kittitas,WA,Truck,0,0,0,14593,14593,0.0,Washington,Washington
830,April,2020,Lewis,WA,Truck,0,0,0,25979,25979,0.0,Washington,Washington
834,April,2020,Yakima,WA,Truck,0,0,0,59516,59516,0.0,Washington,Washington
838,April,2020,Clark,WA,Truck,0,0,0,81837,81837,0.0,Washington,Washington
839,April,2020,Snohomish,WA,Passenger,4400,1751,6151,535202,541353,1.14,Washington,Washington
842,April,2020,Grays Harbor,WA,Passenger,106,110,216,48072,48288,0.45,Washington,Washington
843,April,2020,Lincoln,WA,Passenger,4,12,16,7676,7692,0.21,Washington,Washington
844,April,2020,Klickitat,WA,Passenger,53,41,94,15425,15519,0.61,Washington,Washington
845,April,2020,Whatcom,WA,Truck,3,0,3,42832,42835,0.01,Washington,Washington
847,April,2020,San Juan,WA,Passenger,295,88,383,14157,14540,2.63,Washington,Washington
848,April,2021,Thurston,WA,Truck,0,0,0,56710,56710,0.0,Washington,Washington
849,April,2021,Snohomish,WA,Truck,1,0,1,126400,126401,0.0,Washington,Washington
850,April,2021,Skagit,WA,Truck,1,0,1,33024,33025,0.0,Washington,Washington
860,April,2021,Douglas,WA,Passenger,88,46,134,28472,28606,0.47,Washington,Washington
861,April,2021,Columbia,WA,Truck,0,0,0,1560,1560,0.0,Washington,Washington
863,April,2021,Walla Walla,WA,Passenger,108,71,179,36527,36706,0.49,Washington,Washington
867,April,2021,Pend Oreille,WA,Passenger,14,5,19,9302,9321,0.2,Washington,Washington
873,April,2021,Grays Harbor,WA,Truck,0,0,0,21415,21415,0.0,Washington,Washington
877,April,2021,Chelan,WA,Truck,0,0,0,23068,23068,0.0,Washington,Washington
880,April,2021,Island,WA,Truck,0,0,0,21561,21561,0.0,Washington,Washington
883,April,2021,Asotin,WA,Passenger,19,14,33,12659,12692,0.26,Washington,Washington
885,April,2021,Whatcom,WA,Truck,4,0,4,43870,43874,0.01,Washington,Washington
886,April,2021,Stevens,WA,Truck,0,0,0,18874,18874,0.0,Washington,Washington
889,April,2021,Lewis,WA,Truck,0,0,0,26910,26910,0.0,Washington,Washington
894,April,2021,Kittitas,WA,Passenger,153,58,211,29983,30194,0.7,Washington,Washington
895,April,2021,Whatcom,WA,Passenger,1355,582,1937,151158,153095,1.27,Washington,Washington
898,April,2021,Asotin,WA,Truck,0,0,0,6769,6769,0.0,Washington,Washington
903,April,2021,Thurston,WA,Passenger,1494,834,2328,198087,200415,1.16,Washington,Washington
921,April,2021,Pierce,WA,Passenger,3272,1903,5175,559851,565026,0.92,Washington,Washington
926,April,2021,Franklin,WA,Passenger,109,95,204,61946,62150,0.33,Washington,Washington
928,April,2021,Klickitat,WA,Truck,0,0,0,8248,8248,0.0,Washington,Washington
929,April,2021,Jefferson,WA,Truck,0,0,0,9623,9623,0.0,Washington,Washington
930,April,2021,Skagit,WA,Passenger,562,268,830,91975,92805,0.89,Washington,Washington
939,April,2021,Pend Oreille,WA,Truck,0,0,0,5738,5738,0.0,Washington,Washington
944,April,2021,Grays Harbor,WA,Passenger,156,134,290,49368,49658,0.58,Washington,Washington
945,April,2021,Okanogan,WA,Truck,0,0,0,16751,16751,0.0,Washington,Washington
953,April,2021,Garfield,WA,Passenger,0,2,2,1376,1378,0.15,Washington,Washington
957,April,2021,Walla Walla,WA,Truck,0,0,0,14047,14047,0.0,Washington,Washington
964,April,2021,Yakima,WA,Truck,0,0,0,61656,61656,0.0,Washington,Washington
966,April,2021,King,WA,Truck,6,1,7,184931,184938,0.0,Washington,Washington
970,April,2021,King,WA,Passenger,29460,8753,38213,1369496,1407709,2.71,Washington,Washington
971,April,2021,Benton,WA,Passenger,496,377,873,136100,136973,0.64,Washington,Washington
972,April,2021,Benton,WA,Truck,0,0,0,43685,43685,0.0,Washington,Washington
974,April,2021,Adams,WA,Truck,0,0,0,5406,5406,0.0,Washington,Washington
976,April,2021,Franklin,WA,Truck,0,0,0,20683,20683,0.0,Washington,Washington
977,April,2021,Yakima,WA,Passenger,206,139,345,169220,169565,0.2,Washington,Washington
978,April,2021,Jefferson,WA,Passenger,310,178,488,24904,25392,1.92,Washington,Washington
980,April,2021,San Juan,WA,Passenger,406,125,531,14147,14678,3.62,Washington,Washington
983,April,2021,Adams,WA,Passenger,11,9,20,13054,13074,0.15,Washington,Washington
987,April,2021,Ferry,WA,Passenger,10,3,13,4406,4419,0.29,Washington,Washington
993,April,2021,Island,WA,Passenger,582,308,890,63254,64144,1.39,Washington,Washington
998,April,2021,Cowlitz,WA,Passenger,211,134,345,72518,72863,0.47,Washington,Washington
1001,April,2021,Clallam,WA,Passenger,309,206,515,50403,50918,1.01,Washington,Washington
1002,April,2021,Mason,WA,Passenger,191,134,325,48096,48421,0.67,Washington,Washington
1005,April,2021,Klickitat,WA,Passenger,67,47,114,15186,15300,0.75,Washington,Washington
1008,April,2021,Columbia,WA,Passenger,5,4,9,2478,2487,0.36,Washington,Washington
1010,April,2021,Whitman,WA,Passenger,59,44,103,21991,22094,0.47,Washington,Washington
1013,April,2021,Wahkiakum,WA,Truck,0,0,0,1806,1806,0.0,Washington,Washington
1019,April,2021,Skamania,WA,Passenger,40,30,70,8366,8436,0.83,Washington,Washington
1021,April,2021,Douglas,WA,Truck,0,0,0,12625,12625,0.0,Washington,Washington
1023,April,2021,Cowlitz,WA,Truck,0,0,0,29173,29173,0.0,Washington,Washington
1024,April,2021,Kitsap,WA,Passenger,1733,814,2547,180539,183086,1.39,Washington,Washington
1026,April,2021,Grant,WA,Passenger,102,86,188,66806,66994,0.28,Washington,Washington
1028,April,2021,Lincoln,WA,Truck,0,0,0,4751,4751,0.0,Washington,Washington
1029,April,2021,Clallam,WA,Truck,1,0,1,21992,21993,0.0,Washington,Washington
1030,April,2021,Garfield,WA,Truck,0,0,0,1007,1007,0.0,Washington,Washington
1034,April,2021,Stevens,WA,Passenger,40,43,83,30581,30664,0.27,Washington,Washington
1037,April,2021,Pacific,WA,Truck,0,0,0,7919,7919,0.0,Washington,Washington
1040,April,2021,Pierce,WA,Truck,0,0,0,145966,145966,0.0,Washington,Washington
1041,April,2021,Spokane,WA,Truck,0,0,0,101932,101932,0.0,Washington,Washington
1044,April,2021,San Juan,WA,Truck,0,0,0,5911,5911,0.0,Washington,Washington
1045,April,2021,Lewis,WA,Passenger,146,135,281,59779,60060,0.47,Washington,Washington
1048,April,2021,Chelan,WA,Passenger,314,93,407,54673,55080,0.74,Washington,Washington
1049,April,2021,Kittitas,WA,Truck,0,0,0,14775,14775,0.0,Washington,Washington
1051,April,2021,Wahkiakum,WA,Passenger,11,6,17,3113,3130,0.54,Washington,Washington
1057,April,2021,Mason,WA,Truck,0,0,0,21291,21291,0.0,Washington,Washington
1058,April,2021,Skamania,WA,Truck,0,0,0,4022,4022,0.0,Washington,Washington
1062,April,2021,Pacific,WA,Passenger,41,41,82,16071,16153,0.51,Washington,Washington
1066,April,2021,Lincoln,WA,Passenger,5,13,18,7751,7769,0.23,Washington,Washington
1067,April,2021,Whitman,WA,Truck,0,0,0,8564,8564,0.0,Washington,Washington
1069,April,2021,Clark,WA,Passenger,2681,1330,4011,321630,325641,1.23,Washington,Washington
1072,April,2021,Okanogan,WA,Passenger,60,36,96,26414,26510,0.36,Washington,Washington
1083,April,2021,Clark,WA,Truck,0,0,0,84198,84198,0.0,Washington,Washington
1084,April,2021,Grant,WA,Truck,0,0,0,27879,27879,0.0,Washington,Washington
1085,April,2021,Spokane,WA,Passenger,1000,611,1611,324879,326490,0.49,Washington,Washington
1087,April,2021,Kitsap,WA,Truck,0,0,0,54575,54575,0.0,Washington,Washington
1091,April,2021,Ferry,WA,Truck,0,0,0,3649,3649,0.0,Washington,Washington
1095,April,2021,Snohomish,WA,Passenger,5588,1967,7555,540438,547993,1.38,Washington,Washington
1100,April,2022,Whitman,WA,Truck,0,0,0,8586,8586,0.0,Washington,Washington
1105,April,2022,Cowlitz,WA,Truck,0,1,1,28734,28735,0.0,Washington,Washington
1124,April,2022,Pierce,WA,Truck,3,0,3,143016,143019,0.0,Washington,Washington
1130,April,2022,Mason,WA,Passenger,294,178,472,47516,47988,0.98,Washington,Washington
1131,April,2022,Walla Walla,WA,Passenger,163,92,255,36040,36295,0.7,Washington,Washington
1132,April,2022,Columbia,WA,Truck,0,0,0,1588,1588,0.0,Washington,Washington
1134,April,2022,Wahkiakum,WA,Truck,0,0,0,1817,1817,0.0,Washington,Washington
1142,April,2022,Skamania,WA,Truck,0,0,0,3981,3981,0.0,Washington,Washington
1146,April,2022,Island,WA,Passenger,779,367,1146,62227,63373,1.81,Washington,Washington
1147,April,2022,Clark,WA,Truck,3,0,3,83236,83239,0.0,Washington,Washington
1152,April,2022,King,WA,Truck,26,1,27,181794,181821,0.01,Washington,Washington
1158,April,2022,Columbia,WA,Passenger,7,0,7,2446,2453,0.29,Washington,Washington
1161,April,2022,Yakima,WA,Truck,0,0,0,61533,61533,0.0,Washington,Washington
1162,April,2022,Thurston,WA,Passenger,2073,1015,3088,195014,198102,1.56,Washington,Washington
1163,April,2022,Pacific,WA,Truck,0,0,0,7978,7978,0.0,Washington,Washington
1165,April,2022,Ferry,WA,Truck,0,0,0,3568,3568,0.0,Washington,Washington
1167,April,2022,Benton,WA,Truck,1,0,1,43588,43589,0.0,Washington,Washington
1168,April,2022,Lewis,WA,Truck,0,0,0,26439,26439,0.0,Washington,Washington
1170,April,2022,Yakima,WA,Passenger,318,183,501,167415,167916,0.3,Washington,Washington
1171,April,2022,Chelan,WA,Truck,0,0,0,23067,23067,0.0,Washington,Washington
1173,April,2022,San Juan,WA,Passenger,494,155,649,14128,14777,4.39,Washington,Washington
1175,April,2022,Skagit,WA,Truck,1,0,1,32485,32486,0.0,Washington,Washington
1177,April,2022,Cowlitz,WA,Passenger,314,172,486,70917,71403,0.68,Washington,Washington
1179,April,2022,Stevens,WA,Truck,0,0,0,18994,18994,0.0,Washington,Washington
1182,April,2022,Walla Walla,WA,Truck,0,0,0,14018,14018,0.0,Washington,Washington
1188,April,2022,Kittitas,WA,Passenger,236,77,313,29746,30059,1.04,Washington,Washington
1192,April,2022,Douglas,WA,Passenger,126,57,183,28526,28709,0.64,Washington,Washington
1198,April,2022,Franklin,WA,Passenger,179,105,284,62000,62284,0.46,Washington,Washington
1201,April,2022,Grant,WA,Truck,0,0,0,28082,28082,0.0,Washington,Washington
1203,April,2022,Clallam,WA,Passenger,404,241,645,49821,50466,1.28,Washington,Washington
1204,April,2022,Adams,WA,Truck,0,0,0,5481,5481,0.0,Washington,Washington
1205,April,2022,Clallam,WA,Truck,1,0,1,21998,21999,0.0,Washington,Washington
1207,April,2022,Spokane,WA,Truck,0,0,0,102417,102417,0.0,Washington,Washington
1209,April,2022,Asotin,WA,Truck,0,0,0,6749,6749,0.0,Washington,Washington
1217,April,2022,Wahkiakum,WA,Passenger,20,11,31,3079,3110,1.0,Washington,Washington
1219,April,2022,Kittitas,WA,Truck,0,0,0,14715,14715,0.0,Washington,Washington
1222,April,2022,Whatcom,WA,Truck,4,0,4,43460,43464,0.01,Washington,Washington
1223,April,2022,Spokane,WA,Passenger,1511,810,2321,325760,328081,0.71,Washington,Washington
1228,April,2022,Thurston,WA,Truck,3,0,3,55595,55598,0.01,Washington,Washington
1234,April,2022,Lincoln,WA,Passenger,7,18,25,7670,7695,0.32,Washington,Washington
1236,April,2022,Lewis,WA,Passenger,232,171,403,59518,59921,0.67,Washington,Washington
1239,April,2022,Chelan,WA,Passenger,447,124,571,54522,55093,1.04,Washington,Washington
1241,April,2022,Kitsap,WA,Passenger,2325,1020,3345,179074,182419,1.83,Washington,Washington
1242,April,2022,Lincoln,WA,Truck,0,0,0,4851,4851,0.0,Washington,Washington
1244,April,2022,Skagit,WA,Passenger,752,328,1080,90318,91398,1.18,Washington,Washington
1245,April,2022,Jefferson,WA,Passenger,415,210,625,24734,25359,2.46,Washington,Washington
1253,April,2022,King,WA,Passenger,39326,10828,50154,1351160,1401314,3.58,Washington,Washington
1257,April,2022,Pend Oreille,WA,Passenger,16,10,26,9032,9058,0.29,Washington,Washington
1258,April,2022,Franklin,WA,Truck,0,0,0,20942,20942,0.0,Washington,Washington
1259,April,2022,Mason,WA,Truck,0,0,0,21131,21131,0.0,Washington,Washington
1264,April,2022,Clark,WA,Passenger,3864,1692,5556,317894,323450,1.72,Washington,Washington
1267,April,2022,Kitsap,WA,Truck,1,0,1,53850,53851,0.0,Washington,Washington
1272,April,2022,Whatcom,WA,Passenger,1775,717,2492,149078,151570,1.64,Washington,Washington
1274,April,2022,Okanogan,WA,Passenger,79,48,127,26465,26592,0.48,Washington,Washington
1277,April,2022,Whitman,WA,Passenger,83,56,139,22051,22190,0.63,Washington,Washington
1279,April,2022,Benton,WA,Passenger,715,446,1161,135499,136660,0.85,Washington,Washington
1286,April,2022,Pierce,WA,Passenger,4836,2264,7100,548921,556021,1.28,Washington,Washington
1289,April,2022,Grant,WA,Passenger,159,98,257,66893,67150,0.38,Washington,Washington
1292,April,2022,Klickitat,WA,Truck,0,0,0,8281,8281,0.0,Washington,Washington
1293,April,2022,Stevens,WA,Passenger,64,52,116,30125,30241,0.38,Washington,Washington
1306,April,2022,Okanogan,WA,Truck,0,0,0,16687,16687,0.0,Washington,Washington
1307,April,2022,Garfield,WA,Truck,0,0,0,990,990,0.0,Washington,Washington
1309,April,2022,Snohomish,WA,Passenger,7965,2418,10383,534060,544443,1.91,Washington,Washington
1311,April,2022,Skamania,WA,Passenger,67,46,113,8227,8340,1.35,Washington,Washington
1312,April,2022,Grays Harbor,WA,Passenger,200,158,358,49216,49574,0.72,Washington,Washington
1313,April,2022,Ferry,WA,Passenger,19,4,23,4406,4429,0.52,Washington,Washington
1323,April,2022,Grays Harbor,WA,Truck,0,0,0,21346,21346,0.0,Washington,Washington
1324,April,2022,Island,WA,Truck,1,0,1,21467,21468,0.0,Washington,Washington
1329,April,2022,Asotin,WA,Passenger,24,19,43,12707,12750,0.34,Washington,Washington
1333,April,2022,Douglas,WA,Truck,0,0,0,12748,12748,0.0,Washington,Washington
1334,April,2022,Pend Oreille,WA,Truck,0,0,0,5657,5657,0.0,Washington,Washington
1341,April,2022,Klickitat,WA,Passenger,100,55,155,15247,15402,1.01,Washington,Washington
1347,April,2022,Adams,WA,Passenger,16,10,26,12985,13011,0.2,Washington,Washington
1348,April,2022,Snohomish,WA,Truck,4,0,4,124628,124632,0.0,Washington,Washington
1349,April,2022,Pacific,WA,Passenger,60,68,128,15938,16066,0.8,Washington,Washington
1350,April,2022,Jefferson,WA,Truck,0,0,0,9522,9522,0.0,Washington,Washington
1353,April,2022,Garfield,WA,Passenger,0,3,3,1332,1335,0.22,Washington,Washington
1354,April,2022,San Juan,WA,Truck,1,0,1,5986,5987,0.02,Washington,Washington
1360,April,2023,Mason,WA,Passenger,417,204,621,46162,46783,1.33,Washington,Washington
1369,April,2023,Kittitas,WA,Passenger,328,95,423,29339,29762,1.42,Washington,Washington
1378,April,2023,Wahkiakum,WA,Passenger,27,16,43,3044,3087,1.39,Washington,Washington
1380,April,2023,King,WA,Passenger,53639,13733,67372,1318485,1385857,4.86,Washington,Washington
1383,April,2023,Asotin,WA,Passenger,33,21,54,12339,12393,0.44,Washington,Washington
1386,April,2023,Grays Harbor,WA,Truck,4,0,4,20911,20915,0.02,Washington,Washington
1395,April,2023,Walla Walla,WA,Truck,5,0,5,13674,13679,0.04,Washington,Washington
1399,April,2023,Klickitat,WA,Truck,8,0,8,8230,8238,0.1,Washington,Washington
1400,April,2023,Jefferson,WA,Truck,10,0,10,9292,9302,0.11,Washington,Washington
1401,April,2023,Thurston,WA,Truck,55,0,55,53886,53941,0.1,Washington,Washington
1406,April,2023,Douglas,WA,Truck,7,0,7,12882,12889,0.05,Washington,Washington
1408,April,2023,San Juan,WA,Truck,12,0,12,5895,5907,0.2,Washington,Washington
1409,April,2023,Cowlitz,WA,Passenger,433,203,636,69749,70385,0.9,Washington,Washington
1410,April,2023,Spokane,WA,Truck,34,0,34,101402,101436,0.03,Washington,Washington
1412,April,2023,Wahkiakum,WA,Truck,2,0,2,1779,1781,0.11,Washington,Washington
1414,April,2023,Douglas,WA,Passenger,189,61,250,28557,28807,0.87,Washington,Washington
1419,April,2023,Whatcom,WA,Passenger,2323,857,3180,147179,150359,2.11,Washington,Washington
1420,April,2023,Mason,WA,Truck,10,0,10,20712,20722,0.05,Washington,Washington
1425,April,2023,Yakima,WA,Passenger,468,242,710,165211,165921,0.43,Washington,Washington
1433,April,2023,Clark,WA,Passenger,5444,2212,7656,312447,320103,2.39,Washington,Washington
1442,April,2023,Snohomish,WA,Passenger,11666,2925,14591,526766,541357,2.7,Washington,Washington
1443,April,2023,Stevens,WA,Passenger,108,62,170,29693,29863,0.57,Washington,Washington
1444,April,2023,Okanogan,WA,Truck,3,0,3,16397,16400,0.02,Washington,Washington
1447,April,2023,Pacific,WA,Truck,3,0,3,7787,7790,0.04,Washington,Washington
1448,April,2023,Cowlitz,WA,Truck,8,0,8,28099,28107,0.03,Washington,Washington
1450,April,2023,Island,WA,Passenger,1012,423,1435,61224,62659,2.29,Washington,Washington
1451,April,2023,Adams,WA,Truck,2,0,2,5293,5295,0.04,Washington,Washington
1452,April,2023,Ferry,WA,Passenger,19,4,23,4330,4353,0.53,Washington,Washington
1455,April,2023,Walla Walla,WA,Passenger,213,115,328,35303,35631,0.92,Washington,Washington
1460,April,2023,Skamania,WA,Passenger,99,53,152,8037,8189,1.86,Washington,Washington
1464,April,2023,Chelan,WA,Passenger,605,154,759,54000,54759,1.39,Washington,Washington
1465,April,2023,Clark,WA,Truck,82,0,82,81044,81126,0.1,Washington,Washington
1476,April,2023,Ferry,WA,Truck,0,0,0,3556,3556,0.0,Washington,Washington
1477,April,2023,Skagit,WA,Passenger,1055,389,1444,88585,90029,1.6,Washington,Washington
1478,April,2023,Grant,WA,Truck,10,0,10,27865,27875,0.04,Washington,Washington
1479,April,2023,San Juan,WA,Passenger,605,173,778,13782,14560,5.34,Washington,Washington
1480,April,2023,Lincoln,WA,Passenger,18,16,34,7641,7675,0.44,Washington,Washington
1486,April,2023,Grant,WA,Passenger,265,114,379,66651,67030,0.57,Washington,Washington
1489,April,2023,Pend Oreille,WA,Passenger,31,13,44,8881,8925,0.49,Washington,Washington
1493,April,2023,Clallam,WA,Truck,18,0,18,21654,21672,0.08,Washington,Washington
1496,April,2023,Pacific,WA,Passenger,76,89,165,15580,15745,1.05,Washington,Washington
1498,April,2023,Skagit,WA,Truck,18,0,18,31863,31881,0.06,Washington,Washington
1500,April,2023,Pierce,WA,Truck,139,0,139,137180,137319,0.1,Washington,Washington
1506,April,2023,King,WA,Truck,634,2,636,175590,176226,0.36,Washington,Washington
1508,April,2023,Columbia,WA,Truck,0,0,0,1552,1552,0.0,Washington,Washington
1512,April,2023,Whatcom,WA,Truck,52,0,52,42622,42674,0.12,Washington,Washington
1513,April,2023,Pierce,WA,Passenger,7128,2668,9796,530958,540754,1.81,Washington,Washington
1514,April,2023,Clallam,WA,Passenger,518,278,796,48898,49694,1.6,Washington,Washington
1515,April,2023,Franklin,WA,Passenger,298,132,430,61650,62080,0.69,Washington,Washington
1519,April,2023,Whitman,WA,Truck,4,0,4,8571,8575,0.05,Washington,Washington
1522,April,2023,Lewis,WA,Truck,6,0,6,26003,26009,0.02,Washington,Washington
1524,April,2023,Lincoln,WA,Truck,0,0,0,4841,4841,0.0,Washington,Washington
1526,April,2023,Snohomish,WA,Truck,145,0,145,121227,121372,0.12,Washington,Washington
1527,April,2023,Chelan,WA,Truck,26,0,26,23050,23076,0.11,Washington,Washington
1529,April,2023,Grays Harbor,WA,Passenger,286,182,468,48238,48706,0.96,Washington,Washington
1531,April,2023,Stevens,WA,Truck,1,0,1,18709,18710,0.01,Washington,Washington
1535,April,2023,Kittitas,WA,Truck,8,0,8,14470,14478,0.06,Washington,Washington
1536,April,2023,Jefferson,WA,Passenger,531,253,784,24161,24945,3.14,Washington,Washington
1545,April,2023,Columbia,WA,Passenger,8,1,9,2407,2416,0.37,Washington,Washington
1548,April,2023,Whitman,WA,Passenger,138,73,211,21935,22146,0.95,Washington,Washington
1549,April,2023,Spokane,WA,Passenger,2159,1032,3191,321308,324499,0.98,Washington,Washington
1550,April,2023,Kitsap,WA,Passenger,3049,1231,4280,175820,180100,2.38,Washington,Washington
1551,April,2023,Yakima,WA,Truck,11,0,11,60803,60814,0.02,Washington,Washington
1553,April,2023,Klickitat,WA,Passenger,139,59,198,15114,15312,1.29,Washington,Washington
1554,April,2023,Island,WA,Truck,28,0,28,21017,21045,0.13,Washington,Washington
1555,April,2023,Garfield,WA,Truck,0,0,0,976,976,0.0,Washington,Washington
1557,April,2023,Adams,WA,Passenger,24,12,36,12970,13006,0.28,Washington,Washington
1560,April,2023,Pend Oreille,WA,Truck,0,0,0,5600,5600,0.0,Washington,Washington
1561,April,2023,Asotin,WA,Truck,0,0,0,6607,6607,0.0,Washington,Washington
1563,April,2023,Skamania,WA,Truck,1,0,1,3828,3829,0.03,Washington,Washington
1565,April,2023,Benton,WA,Passenger,1089,545,1634,135049,136683,1.2,Washington,Washington
1568,April,2023,Thurston,WA,Passenger,2918,1188,4106,190129,194235,2.11,Washington,Washington
1570,April,2023,Kitsap,WA,Truck,64,0,64,52364,52428,0.12,Washington,Washington
1572,April,2023,Lewis,WA,Passenger,302,195,497,58597,59094,0.84,Washington,Washington
1573,April,2023,Franklin,WA,Truck,4,0,4,20798,20802,0.02,Washington,Washington
1574,April,2023,Garfield,WA,Passenger,1,3,4,1316,1320,0.3,Washington,Washington
1575,April,2023,Okanogan,WA,Passenger,119,58,177,25969,26146,0.68,Washington,Washington
1579,April,2023,Benton,WA,Truck,19,0,19,43089,43108,0.04,Washington,Washington
1583,August,2017,Lincoln,WA,Passenger,1,5,6,7571,7577,0.08,Washington,Washington
1584,August,2017,Asotin,WA,Passenger,8,5,13,12444,12457,0.1,Washington,Washington
1585,August,2017,Thurston,WA,Truck,0,0,0,53429,53429,0.0,Washington,Washington
1588,August,2017,Kitsap,WA,Passenger,637,336,973,173831,174804,0.56,Washington,Washington
1590,August,2017,Walla Walla,WA,Truck,0,0,0,13188,13188,0.0,Washington,Washington
1596,August,2017,Lewis,WA,Truck,0,0,0,25013,25013,0.0,Washington,Washington
1599,August,2017,Franklin,WA,Truck,0,0,0,18234,18234,0.0,Washington,Washington
1600,August,2017,Ferry,WA,Truck,0,0,0,3532,3532,0.0,Washington,Washington
1601,August,2017,Asotin,WA,Truck,0,0,0,6515,6515,0.0,Washington,Washington
1605,August,2017,Grays Harbor,WA,Passenger,37,37,74,44965,45039,0.16,Washington,Washington
1606,August,2017,Snohomish,WA,Passenger,1847,942,2789,513730,516519,0.54,Washington,Washington
1607,August,2017,Wahkiakum,WA,Passenger,0,2,2,2834,2836,0.07,Washington,Washington
1609,August,2017,Skamania,WA,Passenger,10,7,17,8571,8588,0.2,Washington,Washington
1611,August,2017,Garfield,WA,Truck,0,0,0,932,932,0.0,Washington,Washington
1613,August,2017,Columbia,WA,Truck,0,0,0,1541,1541,0.0,Washington,Washington
1614,August,2017,Kittitas,WA,Passenger,27,21,48,27891,27939,0.17,Washington,Washington
1617,August,2017,Ferry,WA,Passenger,1,1,2,4396,4398,0.05,Washington,Washington
1619,August,2017,Chelan,WA,Passenger,72,36,108,52309,52417,0.21,Washington,Washington
1623,August,2017,Pierce,WA,Truck,0,0,0,137231,137231,0.0,Washington,Washington
1624,August,2017,Clark,WA,Passenger,794,528,1322,300774,302096,0.44,Washington,Washington
1626,August,2017,Skamania,WA,Truck,0,0,0,3876,3876,0.0,Washington,Washington
1627,August,2017,Whitman,WA,Truck,0,0,0,8451,8451,0.0,Washington,Washington
1632,August,2017,Jefferson,WA,Passenger,112,64,176,23954,24130,0.73,Washington,Washington
1633,August,2017,Pend Oreille,WA,Passenger,3,4,7,9358,9365,0.07,Washington,Washington
1634,August,2017,Franklin,WA,Passenger,27,48,75,55929,56004,0.13,Washington,Washington
1638,August,2017,Chelan,WA,Truck,0,0,0,21363,21363,0.0,Washington,Washington
1640,August,2017,Kitsap,WA,Truck,1,0,1,52562,52563,0.0,Washington,Washington
1645,August,2017,Grant,WA,Truck,0,0,0,25352,25352,0.0,Washington,Washington
1646,August,2017,Adams,WA,Passenger,3,3,6,12183,12189,0.05,Washington,Washington
1649,August,2017,Stevens,WA,Passenger,8,22,30,31514,31544,0.1,Washington,Washington
1655,August,2017,Lewis,WA,Passenger,55,38,93,55794,55887,0.17,Washington,Washington
1656,August,2017,Clark,WA,Truck,0,0,0,77898,77898,0.0,Washington,Washington
1657,August,2017,Pacific,WA,Passenger,10,9,19,15248,15267,0.12,Washington,Washington
1658,August,2017,Klickitat,WA,Truck,0,0,0,7970,7970,0.0,Washington,Washington
1663,August,2017,Cowlitz,WA,Truck,0,0,0,27992,27992,0.0,Washington,Washington
1664,August,2017,Pacific,WA,Truck,0,0,0,7515,7515,0.0,Washington,Washington
1666,August,2017,Benton,WA,Truck,0,0,0,40164,40164,0.0,Washington,Washington
1667,August,2017,Whatcom,WA,Passenger,481,182,663,143561,144224,0.46,Washington,Washington
1671,August,2017,Yakima,WA,Passenger,54,67,121,160149,160270,0.08,Washington,Washington
1673,August,2017,San Juan,WA,Passenger,113,39,152,13645,13797,1.1,Washington,Washington
1674,August,2017,Snohomish,WA,Truck,1,0,1,121668,121669,0.0,Washington,Washington
1679,August,2017,Wahkiakum,WA,Truck,0,0,0,1655,1655,0.0,Washington,Washington
1680,August,2017,Garfield,WA,Passenger,1,0,1,1302,1303,0.08,Washington,Washington
1685,August,2017,Thurston,WA,Passenger,421,359,780,187775,188555,0.41,Washington,Washington
1688,August,2017,Stevens,WA,Truck,0,0,0,18218,18218,0.0,Washington,Washington
1692,August,2017,Walla Walla,WA,Passenger,27,27,54,34981,35035,0.15,Washington,Washington
1693,August,2017,Jefferson,WA,Truck,0,0,0,9427,9427,0.0,Washington,Washington
1694,August,2017,Kittitas,WA,Truck,0,0,0,13610,13610,0.0,Washington,Washington
1695,August,2017,Pierce,WA,Passenger,999,866,1865,524926,526791,0.35,Washington,Washington
1696,August,2017,Spokane,WA,Passenger,268,220,488,297411,297899,0.16,Washington,Washington
1697,August,2017,Skagit,WA,Passenger,140,112,252,88466,88718,0.28,Washington,Washington
1701,August,2017,Benton,WA,Passenger,161,147,308,129043,129351,0.24,Washington,Washington
1702,August,2017,Adams,WA,Truck,0,0,0,5097,5097,0.0,Washington,Washington
1706,August,2017,King,WA,Truck,7,1,8,186770,186778,0.0,Washington,Washington
1708,August,2017,Pend Oreille,WA,Truck,0,0,0,5552,5552,0.0,Washington,Washington
1710,August,2017,Douglas,WA,Truck,0,0,0,11570,11570,0.0,Washington,Washington
1711,August,2017,Clallam,WA,Passenger,96,79,175,48546,48721,0.36,Washington,Washington
1715,August,2017,Whatcom,WA,Truck,2,0,2,41764,41766,0.0,Washington,Washington
1716,August,2017,Spokane,WA,Truck,1,0,1,90996,90997,0.0,Washington,Washington
1717,August,2017,Okanogan,WA,Passenger,4,18,22,25673,25695,0.09,Washington,Washington
1718,August,2017,Lincoln,WA,Truck,0,0,0,4457,4457,0.0,Washington,Washington
1720,August,2017,Okanogan,WA,Truck,0,0,0,16242,16242,0.0,Washington,Washington
1722,August,2017,Grant,WA,Passenger,19,32,51,61193,61244,0.08,Washington,Washington
1725,August,2017,Douglas,WA,Passenger,35,27,62,26835,26897,0.23,Washington,Washington
1726,August,2017,Cowlitz,WA,Passenger,50,62,112,70013,70125,0.16,Washington,Washington
1730,August,2017,Grays Harbor,WA,Truck,0,0,0,19935,19935,0.0,Washington,Washington
1731,August,2017,San Juan,WA,Truck,0,0,0,5549,5549,0.0,Washington,Washington
1732,August,2017,King,WA,Passenger,10441,4267,14708,1372396,1387104,1.06,Washington,Washington
1739,August,2017,Island,WA,Passenger,124,149,273,60582,60855,0.45,Washington,Washington
1741,August,2017,Mason,WA,Truck,0,0,0,19333,19333,0.0,Washington,Washington
1742,August,2017,Mason,WA,Passenger,59,73,132,43923,44055,0.3,Washington,Washington
1745,August,2017,Columbia,WA,Passenger,1,1,2,2352,2354,0.08,Washington,Washington
1754,August,2017,Island,WA,Truck,0,0,0,20519,20519,0.0,Washington,Washington
1755,August,2017,Clallam,WA,Truck,0,0,0,21059,21059,0.0,Washington,Washington
1756,August,2017,Yakima,WA,Truck,0,0,0,57643,57643,0.0,Washington,Washington
1758,August,2017,Skagit,WA,Truck,1,0,1,31515,31516,0.0,Washington,Washington
1760,August,2017,Klickitat,WA,Passenger,21,24,45,14782,14827,0.3,Washington,Washington
1763,August,2017,Whitman,WA,Passenger,11,22,33,22128,22161,0.15,Washington,Washington
1766,August,2018,Garfield,WA,Passenger,1,1,2,1318,1320,0.15,Washington,Washington
1767,August,2018,Whatcom,WA,Passenger,653,321,974,148265,149239,0.65,Washington,Washington
1772,August,2018,Snohomish,WA,Passenger,2471,1311,3782,523635,527417,0.72,Washington,Washington
1773,August,2018,Jefferson,WA,Truck,0,0,0,9623,9623,0.0,Washington,Washington
1776,August,2018,Douglas,WA,Passenger,45,31,76,27791,27867,0.27,Washington,Washington
1784,August,2018,Whitman,WA,Passenger,20,30,50,22680,22730,0.22,Washington,Washington
1788,August,2018,Benton,WA,Truck,0,0,0,41231,41231,0.0,Washington,Washington
1790,August,2018,Whitman,WA,Truck,0,0,0,8505,8505,0.0,Washington,Washington
1791,August,2018,Stevens,WA,Truck,0,0,0,18676,18676,0.0,Washington,Washington
1792,August,2018,Ferry,WA,Passenger,2,2,4,4420,4424,0.09,Washington,Washington
1794,August,2018,Columbia,WA,Truck,0,0,0,1535,1535,0.0,Washington,Washington
1795,August,2018,Wahkiakum,WA,Passenger,1,1,2,2961,2963,0.07,Washington,Washington
1796,August,2018,Garfield,WA,Truck,0,0,0,956,956,0.0,Washington,Washington
1798,August,2018,Okanogan,WA,Passenger,10,20,30,26065,26095,0.11,Washington,Washington
1799,August,2018,Clallam,WA,Passenger,128,115,243,50115,50358,0.48,Washington,Washington
1802,August,2018,Pacific,WA,Passenger,19,22,41,15677,15718,0.26,Washington,Washington
1805,August,2018,Lewis,WA,Truck,0,0,0,25605,25605,0.0,Washington,Washington
1806,August,2018,Franklin,WA,Truck,0,0,0,18794,18794,0.0,Washington,Washington
1810,August,2018,Yakima,WA,Truck,0,0,0,58619,58619,0.0,Washington,Washington
1817,August,2018,Kitsap,WA,Truck,1,0,1,53439,53440,0.0,Washington,Washington
1818,August,2018,Kittitas,WA,Truck,0,0,0,14113,14113,0.0,Washington,Washington
1821,August,2018,Cowlitz,WA,Passenger,62,81,143,71989,72132,0.2,Washington,Washington
1823,August,2018,Clark,WA,Truck,0,0,0,79303,79303,0.0,Washington,Washington
1826,August,2018,Skagit,WA,Truck,1,0,1,32229,32230,0.0,Washington,Washington
1831,August,2018,Spokane,WA,Passenger,360,336,696,304743,305439,0.23,Washington,Washington
1833,August,2018,Walla Walla,WA,Truck,0,0,0,13497,13497,0.0,Washington,Washington
1840,August,2018,Pierce,WA,Truck,0,0,0,138304,138304,0.0,Washington,Washington
1843,August,2018,King,WA,Passenger,13801,5938,19739,1373749,1393488,1.42,Washington,Washington
1845,August,2018,Wahkiakum,WA,Truck,0,0,0,1691,1691,0.0,Washington,Washington
1846,August,2018,Kitsap,WA,Passenger,828,488,1316,179328,180644,0.73,Washington,Washington
1847,August,2018,Cowlitz,WA,Truck,0,0,0,28606,28606,0.0,Washington,Washington
1848,August,2018,Jefferson,WA,Passenger,152,101,253,24679,24932,1.01,Washington,Washington
1855,August,2018,San Juan,WA,Truck,0,0,0,5755,5755,0.0,Washington,Washington
1857,August,2018,Clark,WA,Passenger,1069,765,1834,309220,311054,0.59,Washington,Washington
1858,August,2018,Pacific,WA,Truck,0,0,0,7624,7624,0.0,Washington,Washington
1860,August,2018,Whatcom,WA,Truck,2,0,2,42393,42395,0.0,Washington,Washington
1865,August,2018,Pierce,WA,Passenger,1303,1224,2527,534848,537375,0.47,Washington,Washington
1869,August,2018,Thurston,WA,Passenger,603,517,1120,194254,195374,0.57,Washington,Washington
1870,August,2018,Thurston,WA,Truck,0,0,0,54562,54562,0.0,Washington,Washington
1874,August,2018,Columbia,WA,Passenger,2,2,4,2415,2419,0.17,Washington,Washington
1877,August,2018,Mason,WA,Truck,0,0,0,20084,20084,0.0,Washington,Washington
1880,August,2018,Grant,WA,Truck,0,0,0,26008,26008,0.0,Washington,Washington
1881,August,2018,Lincoln,WA,Passenger,3,6,9,7748,7757,0.12,Washington,Washington
1882,August,2018,Chelan,WA,Passenger,114,55,169,53723,53892,0.31,Washington,Washington
1883,August,2018,Pend Oreille,WA,Truck,0,0,0,5718,5718,0.0,Washington,Washington
1885,August,2018,Benton,WA,Passenger,189,198,387,132209,132596,0.29,Washington,Washington
1887,August,2018,Island,WA,Passenger,216,204,420,62724,63144,0.67,Washington,Washington
1889,August,2018,Asotin,WA,Truck,0,0,0,6649,6649,0.0,Washington,Washington
1892,August,2018,Adams,WA,Passenger,5,5,10,12682,12692,0.08,Washington,Washington
1897,August,2018,Asotin,WA,Passenger,11,8,19,12663,12682,0.15,Washington,Washington
1898,August,2018,Klickitat,WA,Passenger,24,32,56,15283,15339,0.37,Washington,Washington
1899,August,2018,Skagit,WA,Passenger,220,169,389,90837,91226,0.43,Washington,Washington
1903,August,2018,Skamania,WA,Truck,0,0,0,3948,3948,0.0,Washington,Washington
1905,August,2018,Skamania,WA,Passenger,14,10,24,8670,8694,0.28,Washington,Washington
1906,August,2018,Grays Harbor,WA,Passenger,54,65,119,46989,47108,0.25,Washington,Washington
1908,August,2018,Snohomish,WA,Truck,1,0,1,121713,121714,0.0,Washington,Washington
1910,August,2018,Douglas,WA,Truck,0,0,0,12028,12028,0.0,Washington,Washington
1913,August,2018,Yakima,WA,Passenger,67,92,159,164210,164369,0.1,Washington,Washington
1914,August,2018,Chelan,WA,Truck,0,0,0,21983,21983,0.0,Washington,Washington
1917,August,2018,Grant,WA,Passenger,34,49,83,63544,63627,0.13,Washington,Washington
1918,August,2018,Pend Oreille,WA,Passenger,5,5,10,9583,9593,0.1,Washington,Washington
1926,August,2018,Adams,WA,Truck,0,0,0,5174,5174,0.0,Washington,Washington
1928,August,2018,Mason,WA,Passenger,92,97,189,46050,46239,0.41,Washington,Washington
1931,August,2018,Klickitat,WA,Truck,0,0,0,8158,8158,0.0,Washington,Washington
1932,August,2018,Okanogan,WA,Truck,0,0,0,16469,16469,0.0,Washington,Washington
1935,August,2018,Franklin,WA,Passenger,36,65,101,58372,58473,0.17,Washington,Washington
1939,August,2018,Kittitas,WA,Passenger,51,34,85,29121,29206,0.29,Washington,Washington
1941,August,2018,Lincoln,WA,Truck,0,0,0,4572,4572,0.0,Washington,Washington
1943,August,2018,Ferry,WA,Truck,0,0,0,3550,3550,0.0,Washington,Washington
1948,August,2018,Lewis,WA,Passenger,83,62,145,57867,58012,0.25,Washington,Washington
1953,August,2018,Clallam,WA,Truck,0,0,0,21476,21476,0.0,Washington,Washington
1959,August,2018,Island,WA,Truck,0,0,0,21052,21052,0.0,Washington,Washington
1963,August,2018,Stevens,WA,Passenger,12,26,38,31687,31725,0.12,Washington,Washington
1964,August,2018,San Juan,WA,Passenger,152,66,218,14152,14370,1.52,Washington,Washington
1967,August,2018,King,WA,Truck,7,1,8,182994,183002,0.0,Washington,Washington
1972,August,2018,Grays Harbor,WA,Truck,0,0,0,20309,20309,0.0,Washington,Washington
1974,August,2018,Spokane,WA,Truck,1,0,1,93029,93030,0.0,Washington,Washington
1976,August,2018,Walla Walla,WA,Passenger,34,48,82,35872,35954,0.23,Washington,Washington
1977,August,2019,Grays Harbor,WA,Truck,0,0,0,20570,20570,0.0,Washington,Washington
1978,August,2019,Mason,WA,Passenger,130,127,257,47429,47686,0.54,Washington,Washington
1979,August,2019,Stevens,WA,Passenger,22,29,51,31707,31758,0.16,Washington,Washington
1986,August,2019,Franklin,WA,Truck,0,0,0,19494,19494,0.0,Washington,Washington
1993,August,2019,Chelan,WA,Passenger,165,70,235,54453,54688,0.43,Washington,Washington
1994,August,2019,San Juan,WA,Passenger,225,73,298,14441,14739,2.02,Washington,Washington
1997,August,2019,Whitman,WA,Truck,0,0,0,8627,8627,0.0,Washington,Washington
1998,August,2019,Ferry,WA,Truck,0,0,0,3579,3579,0.0,Washington,Washington
2000,August,2019,Garfield,WA,Passenger,0,1,1,1306,1307,0.08,Washington,Washington
2001,August,2019,Whatcom,WA,Passenger,902,450,1352,151212,152564,0.89,Washington,Washington
2004,August,2019,Adams,WA,Truck,0,0,0,5138,5138,0.0,Washington,Washington
2006,August,2019,Adams,WA,Passenger,5,5,10,12843,12853,0.08,Washington,Washington
2014,August,2019,Pend Oreille,WA,Passenger,5,6,11,9495,9506,0.12,Washington,Washington
2017,August,2019,Thurston,WA,Passenger,927,661,1588,198371,199959,0.79,Washington,Washington
2021,August,2019,Lincoln,WA,Truck,0,0,0,4683,4683,0.0,Washington,Washington
2025,August,2019,Lewis,WA,Truck,0,0,0,25986,25986,0.0,Washington,Washington
2034,August,2019,Okanogan,WA,Truck,0,0,0,16479,16479,0.0,Washington,Washington
2035,August,2019,Asotin,WA,Truck,0,0,0,6684,6684,0.0,Washington,Washington
2037,August,2019,Snohomish,WA,Truck,0,0,0,122863,122863,0.0,Washington,Washington
2040,August,2019,Yakima,WA,Truck,0,0,0,59390,59390,0.0,Washington,Washington
2042,August,2019,Benton,WA,Passenger,280,291,571,134343,134914,0.42,Washington,Washington
2044,August,2019,Pacific,WA,Passenger,23,29,52,16045,16097,0.32,Washington,Washington
2048,August,2019,Grant,WA,Passenger,45,61,106,65169,65275,0.16,Washington,Washington
2051,August,2019,Kitsap,WA,Truck,1,0,1,54161,54162,0.0,Washington,Washington
2053,August,2019,Spokane,WA,Truck,1,0,1,95528,95529,0.0,Washington,Washington
2055,August,2019,Skamania,WA,Passenger,25,18,43,8755,8798,0.49,Washington,Washington
2061,August,2019,Franklin,WA,Passenger,51,72,123,60233,60356,0.2,Washington,Washington
2064,August,2019,Spokane,WA,Passenger,575,439,1014,313142,314156,0.32,Washington,Washington
2066,August,2019,Walla Walla,WA,Truck,0,0,0,13652,13652,0.0,Washington,Washington
2068,August,2019,Grant,WA,Truck,0,0,0,26739,26739,0.0,Washington,Washington
2069,August,2019,Kittitas,WA,Truck,0,0,0,14523,14523,0.0,Washington,Washington
2073,August,2019,Asotin,WA,Passenger,12,7,19,12642,12661,0.15,Washington,Washington
2080,August,2019,Yakima,WA,Passenger,112,108,220,165635,165855,0.13,Washington,Washington
2088,August,2019,Cowlitz,WA,Passenger,107,108,215,73286,73501,0.29,Washington,Washington
2092,August,2019,Snohomish,WA,Passenger,3641,1640,5281,533107,538388,0.98,Washington,Washington
2094,August,2019,Douglas,WA,Passenger,61,36,97,28181,28278,0.34,Washington,Washington
2095,August,2019,Garfield,WA,Truck,0,0,0,959,959,0.0,Washington,Washington
2099,August,2019,Kittitas,WA,Passenger,79,44,123,29744,29867,0.41,Washington,Washington
2102,August,2019,Pacific,WA,Truck,0,0,0,7681,7681,0.0,Washington,Washington
2105,August,2019,Clallam,WA,Truck,1,0,1,21824,21825,0.0,Washington,Washington
2106,August,2019,Island,WA,Truck,0,0,0,21275,21275,0.0,Washington,Washington
2118,August,2019,Island,WA,Passenger,335,244,579,63461,64040,0.9,Washington,Washington
2122,August,2019,Clallam,WA,Passenger,184,148,332,50729,51061,0.65,Washington,Washington
2126,August,2019,Walla Walla,WA,Passenger,56,63,119,36230,36349,0.33,Washington,Washington
2127,August,2019,Columbia,WA,Passenger,2,2,4,2455,2459,0.16,Washington,Washington
2128,August,2019,Kitsap,WA,Passenger,1114,633,1747,181513,183260,0.95,Washington,Washington
2129,August,2019,Stevens,WA,Truck,0,0,0,18717,18717,0.0,Washington,Washington
2134,August,2019,Skagit,WA,Passenger,310,209,519,92306,92825,0.56,Washington,Washington
2136,August,2019,Lincoln,WA,Passenger,2,10,12,7786,7798,0.15,Washington,Washington
2137,August,2019,Cowlitz,WA,Truck,0,0,0,28900,28900,0.0,Washington,Washington
2142,August,2019,Whitman,WA,Passenger,34,44,78,22711,22789,0.34,Washington,Washington
2143,August,2019,Wahkiakum,WA,Truck,0,0,0,1763,1763,0.0,Washington,Washington
2144,August,2019,Pierce,WA,Truck,0,0,0,140335,140335,0.0,Washington,Washington
2145,August,2019,Skagit,WA,Truck,1,0,1,32553,32554,0.0,Washington,Washington
2147,August,2019,Okanogan,WA,Passenger,25,26,51,26190,26241,0.19,Washington,Washington
2150,August,2019,San Juan,WA,Truck,0,0,0,5891,5891,0.0,Washington,Washington
2151,August,2019,Klickitat,WA,Passenger,37,35,72,15624,15696,0.46,Washington,Washington
2153,August,2019,Chelan,WA,Truck,0,0,0,22366,22366,0.0,Washington,Washington
2156,August,2019,King,WA,Passenger,20005,7202,27207,1393126,1420333,1.92,Washington,Washington
2159,August,2019,Clark,WA,Truck,0,0,0,80861,80861,0.0,Washington,Washington
2160,August,2019,Pend Oreille,WA,Truck,0,0,0,5721,5721,0.0,Washington,Washington
2161,August,2019,Whatcom,WA,Truck,2,0,2,42997,42999,0.0,Washington,Washington
2163,August,2019,Grays Harbor,WA,Passenger,88,85,173,48116,48289,0.36,Washington,Washington
2164,August,2019,Wahkiakum,WA,Passenger,2,2,4,3026,3030,0.13,Washington,Washington
2173,August,2019,Columbia,WA,Truck,0,0,0,1531,1531,0.0,Washington,Washington
2177,August,2019,King,WA,Truck,6,1,7,182265,182272,0.0,Washington,Washington
2179,August,2019,Thurston,WA,Truck,0,0,0,55440,55440,0.0,Washington,Washington
2181,August,2019,Skamania,WA,Truck,0,0,0,4075,4075,0.0,Washington,Washington
2184,August,2019,Ferry,WA,Passenger,5,2,7,4414,4421,0.16,Washington,Washington
2185,August,2019,Jefferson,WA,Truck,0,0,0,9675,9675,0.0,Washington,Washington
2186,August,2019,Pierce,WA,Passenger,1930,1584,3514,544791,548305,0.64,Washington,Washington
2188,August,2019,Lewis,WA,Passenger,105,96,201,59363,59564,0.34,Washington,Washington
2189,August,2019,Mason,WA,Truck,0,0,0,20413,20413,0.0,Washington,Washington
2193,August,2019,Douglas,WA,Truck,0,0,0,12264,12264,0.0,Washington,Washington
2194,August,2019,Jefferson,WA,Passenger,205,122,327,25074,25401,1.29,Washington,Washington
2198,August,2019,Benton,WA,Truck,0,0,0,42177,42177,0.0,Washington,Washington
2200,August,2019,Klickitat,WA,Truck,0,0,0,8292,8292,0.0,Washington,Washington
2203,August,2019,Clark,WA,Passenger,1647,959,2606,315547,318153,0.82,Washington,Washington
2212,August,2020,Klickitat,WA,Truck,0,0,0,8105,8105,0.0,Washington,Washington
2215,August,2020,Pacific,WA,Truck,0,0,0,7724,7724,0.0,Washington,Washington
2218,August,2020,King,WA,Truck,5,1,6,183316,183322,0.0,Washington,Washington
2220,August,2020,Yakima,WA,Passenger,146,122,268,166128,166396,0.16,Washington,Washington
2237,August,2020,Skamania,WA,Passenger,31,22,53,8376,8429,0.63,Washington,Washington
2240,August,2020,Grant,WA,Passenger,66,75,141,65404,65545,0.22,Washington,Washington
2242,August,2020,Spokane,WA,Truck,1,0,1,99446,99447,0.0,Washington,Washington
2249,August,2020,Columbia,WA,Truck,0,0,0,1526,1526,0.0,Washington,Washington
2253,August,2020,Lincoln,WA,Passenger,5,11,16,7625,7641,0.21,Washington,Washington
2258,August,2020,Cowlitz,WA,Passenger,152,120,272,72131,72403,0.38,Washington,Washington
2259,August,2020,Lincoln,WA,Truck,0,0,0,4652,4652,0.0,Washington,Washington
2261,August,2020,Whatcom,WA,Passenger,1111,512,1623,149201,150824,1.08,Washington,Washington
2262,August,2020,Whatcom,WA,Truck,3,0,3,43278,43281,0.01,Washington,Washington
2263,August,2020,Adams,WA,Truck,0,0,0,5303,5303,0.0,Washington,Washington
2266,August,2020,Pierce,WA,Truck,0,0,0,143398,143398,0.0,Washington,Washington
2267,August,2020,San Juan,WA,Passenger,320,100,420,13928,14348,2.93,Washington,Washington
2271,August,2020,Franklin,WA,Truck,0,0,0,20187,20187,0.0,Washington,Washington
2272,August,2020,Columbia,WA,Passenger,3,3,6,2423,2429,0.25,Washington,Washington
2275,August,2020,Grays Harbor,WA,Passenger,111,116,227,48357,48584,0.47,Washington,Washington
2276,August,2020,Jefferson,WA,Truck,0,0,0,9539,9539,0.0,Washington,Washington
2277,August,2020,Kittitas,WA,Passenger,110,47,157,29764,29921,0.52,Washington,Washington
2287,August,2020,Okanogan,WA,Passenger,40,34,74,25977,26051,0.28,Washington,Washington
2297,August,2020,Garfield,WA,Truck,0,0,0,994,994,0.0,Washington,Washington
2299,August,2020,Mason,WA,Passenger,162,133,295,47407,47702,0.62,Washington,Washington
2303,August,2020,Adams,WA,Passenger,9,7,16,12868,12884,0.12,Washington,Washington
2310,August,2020,Asotin,WA,Truck,0,0,0,6667,6667,0.0,Washington,Washington
2314,August,2020,Thurston,WA,Passenger,1194,752,1946,197105,199051,0.98,Washington,Washington
2317,August,2020,Grays Harbor,WA,Truck,0,0,0,21033,21033,0.0,Washington,Washington
2318,August,2020,Chelan,WA,Truck,0,0,0,22677,22677,0.0,Washington,Washington
2324,August,2020,King,WA,Passenger,25173,7814,32987,1370893,1403880,2.35,Washington,Washington
2329,August,2020,Benton,WA,Truck,0,0,0,43024,43024,0.0,Washington,Washington
2331,August,2020,Pend Oreille,WA,Truck,0,0,0,5746,5746,0.0,Washington,Washington
2334,August,2020,Okanogan,WA,Truck,0,0,0,16543,16543,0.0,Washington,Washington
2335,August,2020,Lewis,WA,Truck,0,0,0,26362,26362,0.0,Washington,Washington
2338,August,2020,San Juan,WA,Truck,0,0,0,5838,5838,0.0,Washington,Washington
2343,August,2020,Franklin,WA,Passenger,66,77,143,60794,60937,0.23,Washington,Washington
2346,August,2020,Spokane,WA,Passenger,781,505,1286,317481,318767,0.4,Washington,Washington
2349,August,2020,Snohomish,WA,Truck,0,0,0,124595,124595,0.0,Washington,Washington
2351,August,2020,Grant,WA,Truck,0,0,0,27237,27237,0.0,Washington,Washington
2354,August,2020,Asotin,WA,Passenger,17,14,31,12356,12387,0.25,Washington,Washington
2357,August,2020,Pacific,WA,Passenger,32,33,65,15709,15774,0.41,Washington,Washington
2359,August,2020,Benton,WA,Passenger,380,322,702,134321,135023,0.52,Washington,Washington
2364,August,2020,Stevens,WA,Truck,0,0,0,18653,18653,0.0,Washington,Washington
2366,August,2020,Thurston,WA,Truck,0,0,0,55974,55974,0.0,Washington,Washington
2369,August,2020,Klickitat,WA,Passenger,57,42,99,15043,15142,0.65,Washington,Washington
2370,August,2020,Kitsap,WA,Truck,0,0,0,54174,54174,0.0,Washington,Washington
2371,August,2020,Kittitas,WA,Truck,0,0,0,14559,14559,0.0,Washington,Washington
2372,August,2020,Whitman,WA,Truck,0,0,0,8480,8480,0.0,Washington,Washington
2374,August,2020,Skagit,WA,Truck,1,0,1,32634,32635,0.0,Washington,Washington
2375,August,2020,Clark,WA,Passenger,2135,1076,3211,318235,321446,1.0,Washington,Washington
2376,August,2020,Clallam,WA,Passenger,239,171,410,49948,50358,0.81,Washington,Washington
2379,August,2020,Lewis,WA,Passenger,112,117,229,58206,58435,0.39,Washington,Washington
2381,August,2020,Skamania,WA,Truck,0,0,0,4023,4023,0.0,Washington,Washington
2382,August,2020,Douglas,WA,Truck,0,0,0,12339,12339,0.0,Washington,Washington
2386,August,2020,Jefferson,WA,Passenger,249,144,393,24652,25045,1.57,Washington,Washington
2390,August,2020,Chelan,WA,Passenger,248,80,328,54176,54504,0.6,Washington,Washington
2392,August,2020,Stevens,WA,Passenger,35,36,71,30494,30565,0.23,Washington,Washington
2393,August,2020,Pierce,WA,Passenger,2519,1704,4223,552476,556699,0.76,Washington,Washington
2400,August,2020,Island,WA,Passenger,434,273,707,62809,63516,1.11,Washington,Washington
2402,August,2020,Kitsap,WA,Passenger,1400,699,2099,179638,181737,1.15,Washington,Washington
2403,August,2020,Mason,WA,Truck,0,0,0,20779,20779,0.0,Washington,Washington
2405,August,2020,Walla Walla,WA,Truck,0,0,0,13750,13750,0.0,Washington,Washington
2411,August,2020,Garfield,WA,Passenger,0,1,1,1350,1351,0.07,Washington,Washington
2412,August,2020,Whitman,WA,Passenger,46,48,94,22021,22115,0.43,Washington,Washington
2415,August,2020,Ferry,WA,Passenger,7,3,10,4309,4319,0.23,Washington,Washington
2416,August,2020,Island,WA,Truck,1,0,1,21228,21229,0.0,Washington,Washington
2417,August,2020,Pend Oreille,WA,Passenger,8,5,13,9230,9243,0.14,Washington,Washington
2418,August,2020,Yakima,WA,Truck,0,0,0,60420,60420,0.0,Washington,Washington
2419,August,2020,Skagit,WA,Passenger,432,222,654,91256,91910,0.71,Washington,Washington
2421,August,2020,Clark,WA,Truck,0,0,0,82716,82716,0.0,Washington,Washington
2423,August,2020,Wahkiakum,WA,Passenger,6,6,12,3028,3040,0.39,Washington,Washington
2424,August,2020,Ferry,WA,Truck,0,0,0,3582,3582,0.0,Washington,Washington
2427,August,2020,Snohomish,WA,Passenger,4645,1782,6427,536082,542509,1.18,Washington,Washington
2429,August,2020,Clallam,WA,Truck,1,0,1,21704,21705,0.0,Washington,Washington
2441,August,2020,Cowlitz,WA,Truck,0,0,0,28911,28911,0.0,Washington,Washington
2444,August,2020,Douglas,WA,Passenger,77,41,118,28010,28128,0.42,Washington,Washington
2445,August,2020,Walla Walla,WA,Passenger,81,65,146,35891,36037,0.41,Washington,Washington
2451,August,2020,Wahkiakum,WA,Truck,0,0,0,1745,1745,0.0,Washington,Washington
2463,August,2021,Island,WA,Truck,0,0,0,21590,21590,0.0,Washington,Washington
2464,August,2021,Columbia,WA,Truck,0,0,0,1539,1539,0.0,Washington,Washington
2469,August,2021,Snohomish,WA,Passenger,6310,2137,8447,539419,547866,1.54,Washington,Washington
2475,August,2021,Chelan,WA,Passenger,364,102,466,54718,55184,0.84,Washington,Washington
2477,August,2021,Lewis,WA,Passenger,181,151,332,59647,59979,0.55,Washington,Washington
2482,August,2021,Thurston,WA,Truck,0,0,0,56421,56421,0.0,Washington,Washington
2486,August,2021,Skamania,WA,Passenger,52,38,90,8389,8479,1.06,Washington,Washington
2493,August,2021,Wahkiakum,WA,Passenger,16,8,24,3079,3103,0.77,Washington,Washington
2494,August,2021,Garfield,WA,Truck,0,0,0,1003,1003,0.0,Washington,Washington
2496,August,2021,Pierce,WA,Truck,0,0,0,145668,145668,0.0,Washington,Washington
2497,August,2021,Walla Walla,WA,Truck,0,0,0,14079,14079,0.0,Washington,Washington
2503,August,2021,Grant,WA,Truck,0,0,0,27997,27997,0.0,Washington,Washington
2506,August,2021,Wahkiakum,WA,Truck,0,0,0,1801,1801,0.0,Washington,Washington
2508,August,2021,Cowlitz,WA,Passenger,237,152,389,72118,72507,0.54,Washington,Washington
2509,August,2021,Klickitat,WA,Truck,0,0,0,8331,8331,0.0,Washington,Washington
2513,August,2021,Whatcom,WA,Truck,4,0,4,43867,43871,0.01,Washington,Washington
2514,August,2021,King,WA,Truck,5,1,6,184053,184059,0.0,Washington,Washington
2516,August,2021,Whitman,WA,Passenger,63,52,115,21930,22045,0.52,Washington,Washington
2520,August,2021,San Juan,WA,Truck,0,0,0,5976,5976,0.0,Washington,Washington
2523,August,2021,Garfield,WA,Passenger,0,3,3,1369,1372,0.22,Washington,Washington
2524,August,2021,Snohomish,WA,Truck,1,0,1,126015,126016,0.0,Washington,Washington
2530,August,2021,Clallam,WA,Truck,1,0,1,22024,22025,0.0,Washington,Washington
2532,August,2021,Whatcom,WA,Passenger,1520,628,2148,150496,152644,1.41,Washington,Washington
2535,August,2021,Spokane,WA,Truck,0,0,0,102463,102463,0.0,Washington,Washington
2537,August,2021,Skagit,WA,Passenger,620,287,907,91723,92630,0.98,Washington,Washington
2541,August,2021,Spokane,WA,Passenger,1158,684,1842,326045,327887,0.56,Washington,Washington
2542,August,2021,Franklin,WA,Truck,0,0,0,20720,20720,0.0,Washington,Washington
2544,August,2021,Pacific,WA,Truck,0,0,0,7973,7973,0.0,Washington,Washington
2545,August,2021,Yakima,WA,Truck,0,0,0,61772,61772,0.0,Washington,Washington
2550,August,2021,Kittitas,WA,Truck,0,0,0,14782,14782,0.0,Washington,Washington
2551,August,2021,Walla Walla,WA,Passenger,121,82,203,36479,36682,0.55,Washington,Washington
2553,August,2021,Mason,WA,Passenger,227,147,374,48071,48445,0.77,Washington,Washington
2556,August,2021,Clallam,WA,Passenger,350,220,570,50504,51074,1.12,Washington,Washington
2562,August,2021,Okanogan,WA,Passenger,66,45,111,26473,26584,0.42,Washington,Washington
2575,August,2021,Kitsap,WA,Passenger,1952,888,2840,180672,183512,1.55,Washington,Washington
2576,August,2021,Adams,WA,Passenger,16,14,30,13041,13071,0.23,Washington,Washington
2577,August,2021,Skamania,WA,Truck,0,0,0,4036,4036,0.0,Washington,Washington
2579,August,2021,Grays Harbor,WA,Passenger,177,147,324,49506,49830,0.65,Washington,Washington
2580,August,2021,Stevens,WA,Passenger,48,44,92,30285,30377,0.3,Washington,Washington
2584,August,2021,Pend Oreille,WA,Truck,0,0,0,5726,5726,0.0,Washington,Washington
2586,August,2021,Klickitat,WA,Passenger,82,51,133,15361,15494,0.86,Washington,Washington
2588,August,2021,Chelan,WA,Truck,0,0,0,23088,23088,0.0,Washington,Washington
2597,August,2021,King,WA,Passenger,32289,9551,41840,1365924,1407764,2.97,Washington,Washington
2598,August,2021,Yakima,WA,Passenger,248,163,411,168910,169321,0.24,Washington,Washington
2602,August,2021,Skagit,WA,Truck,1,0,1,32973,32974,0.0,Washington,Washington
2608,August,2021,Ferry,WA,Passenger,9,3,12,4389,4401,0.27,Washington,Washington
2609,August,2021,Thurston,WA,Passenger,1715,906,2621,197780,200401,1.31,Washington,Washington
2611,August,2021,Grant,WA,Passenger,123,96,219,66857,67076,0.33,Washington,Washington
2612,August,2021,San Juan,WA,Passenger,452,141,593,14207,14800,4.01,Washington,Washington
2615,August,2021,Clark,WA,Truck,0,0,0,84180,84180,0.0,Washington,Washington
2618,August,2021,Lewis,WA,Truck,0,0,0,26748,26748,0.0,Washington,Washington
2621,August,2021,Island,WA,Passenger,645,318,963,63236,64199,1.5,Washington,Washington
2622,August,2021,Pierce,WA,Passenger,3774,2031,5805,559092,564897,1.03,Washington,Washington
2631,August,2021,Columbia,WA,Passenger,7,2,9,2458,2467,0.36,Washington,Washington
2634,August,2021,Stevens,WA,Truck,0,0,0,18913,18913,0.0,Washington,Washington
2635,August,2021,Jefferson,WA,Truck,0,0,0,9611,9611,0.0,Washington,Washington
2637,August,2021,Clark,WA,Passenger,3072,1473,4545,322091,326636,1.39,Washington,Washington
2639,August,2021,Whitman,WA,Truck,0,0,0,8572,8572,0.0,Washington,Washington
2640,August,2021,Asotin,WA,Passenger,21,17,38,12728,12766,0.3,Washington,Washington
2641,August,2021,Douglas,WA,Truck,0,0,0,12682,12682,0.0,Washington,Washington
2642,August,2021,Kittitas,WA,Passenger,173,72,245,29872,30117,0.81,Washington,Washington
2651,August,2021,Lincoln,WA,Truck,0,0,0,4773,4773,0.0,Washington,Washington
2654,August,2021,Cowlitz,WA,Truck,0,1,1,29085,29086,0.0,Washington,Washington
2655,August,2021,Lincoln,WA,Passenger,7,15,22,7695,7717,0.29,Washington,Washington
2659,August,2021,Ferry,WA,Truck,0,0,0,3632,3632,0.0,Washington,Washington
2666,August,2021,Pend Oreille,WA,Passenger,16,7,23,9243,9266,0.25,Washington,Washington
2682,August,2021,Franklin,WA,Passenger,139,99,238,61954,62192,0.38,Washington,Washington
2683,August,2021,Adams,WA,Truck,0,0,0,5413,5413,0.0,Washington,Washington
2687,August,2021,Asotin,WA,Truck,0,0,0,6755,6755,0.0,Washington,Washington
2689,August,2021,Kitsap,WA,Truck,0,0,0,54394,54394,0.0,Washington,Washington
2693,August,2021,Douglas,WA,Passenger,103,51,154,28575,28729,0.54,Washington,Washington
2694,August,2021,Grays Harbor,WA,Truck,0,0,0,21395,21395,0.0,Washington,Washington
2698,August,2021,Jefferson,WA,Passenger,350,183,533,24858,25391,2.1,Washington,Washington
2702,August,2021,Mason,WA,Truck,0,0,0,21324,21324,0.0,Washington,Washington
2704,August,2021,Benton,WA,Passenger,567,409,976,136208,137184,0.71,Washington,Washington
2705,August,2021,Okanogan,WA,Truck,0,0,0,16752,16752,0.0,Washington,Washington
2708,August,2021,Pacific,WA,Passenger,48,54,102,16069,16171,0.63,Washington,Washington
2711,August,2021,Benton,WA,Truck,0,0,0,43605,43605,0.0,Washington,Washington
2714,August,2022,Pierce,WA,Truck,34,0,34,140861,140895,0.02,Washington,Washington
2719,August,2022,Thurston,WA,Truck,17,0,17,55162,55179,0.03,Washington,Washington
2727,August,2022,Yakima,WA,Truck,1,0,1,61393,61394,0.0,Washington,Washington
2734,August,2022,Ferry,WA,Truck,0,0,0,3585,3585,0.0,Washington,Washington
2739,August,2022,Spokane,WA,Truck,10,0,10,102018,102028,0.01,Washington,Washington
2741,August,2022,Lewis,WA,Truck,0,0,0,26330,26330,0.0,Washington,Washington
2742,August,2022,Snohomish,WA,Passenger,8928,2595,11523,531276,542799,2.12,Washington,Washington
2743,August,2022,Okanogan,WA,Passenger,88,48,136,26317,26453,0.51,Washington,Washington
2745,August,2022,Douglas,WA,Passenger,141,60,201,28384,28585,0.7,Washington,Washington
2746,August,2022,Pend Oreille,WA,Truck,0,0,0,5635,5635,0.0,Washington,Washington
2749,August,2022,Garfield,WA,Passenger,1,3,4,1322,1326,0.3,Washington,Washington
2752,August,2022,Garfield,WA,Truck,0,0,0,977,977,0.0,Washington,Washington
2756,August,2022,Walla Walla,WA,Passenger,179,104,283,35818,36101,0.78,Washington,Washington
2760,August,2022,Island,WA,Truck,9,0,9,21330,21339,0.04,Washington,Washington
2761,August,2022,Pacific,WA,Passenger,70,72,142,15797,15939,0.89,Washington,Washington
2765,August,2022,Ferry,WA,Passenger,20,4,24,4399,4423,0.54,Washington,Washington
2769,August,2022,Asotin,WA,Truck,0,0,0,6695,6695,0.0,Washington,Washington
2772,August,2022,Kittitas,WA,Passenger,284,88,372,29610,29982,1.24,Washington,Washington
2776,August,2022,Columbia,WA,Truck,0,0,0,1574,1574,0.0,Washington,Washington
2782,August,2022,Benton,WA,Passenger,815,471,1286,135382,136668,0.94,Washington,Washington
2783,August,2022,Kitsap,WA,Passenger,2523,1093,3616,177977,181593,1.99,Washington,Washington
2786,August,2022,Douglas,WA,Truck,1,0,1,12758,12759,0.01,Washington,Washington
2788,August,2022,Jefferson,WA,Passenger,453,223,676,24508,25184,2.68,Washington,Washington
2789,August,2022,Spokane,WA,Passenger,1743,881,2624,324740,327364,0.8,Washington,Washington
2790,August,2022,Jefferson,WA,Truck,3,0,3,9424,9427,0.03,Washington,Washington
2792,August,2022,Adams,WA,Truck,1,0,1,5434,5435,0.02,Washington,Washington
2795,August,2022,Island,WA,Passenger,858,380,1238,61876,63114,1.96,Washington,Washington
2796,August,2022,Columbia,WA,Passenger,8,0,8,2437,2445,0.33,Washington,Washington
2798,August,2022,Lincoln,WA,Truck,0,0,0,4846,4846,0.0,Washington,Washington
2799,August,2022,King,WA,Passenger,42950,11640,54590,1346237,1400827,3.9,Washington,Washington
2809,August,2022,Klickitat,WA,Passenger,106,54,160,15196,15356,1.04,Washington,Washington
2810,August,2022,San Juan,WA,Passenger,530,162,692,13993,14685,4.71,Washington,Washington
2812,August,2022,Grays Harbor,WA,Passenger,218,163,381,48843,49224,0.77,Washington,Washington
2821,August,2022,Kittitas,WA,Truck,3,0,3,14621,14624,0.02,Washington,Washington
2822,August,2022,Pierce,WA,Passenger,5429,2399,7828,542983,550811,1.42,Washington,Washington
2824,August,2022,Adams,WA,Passenger,21,9,30,12974,13004,0.23,Washington,Washington
2825,August,2022,Grant,WA,Passenger,198,106,304,66772,67076,0.45,Washington,Washington
2833,August,2022,Wahkiakum,WA,Truck,1,0,1,1802,1803,0.06,Washington,Washington
2837,August,2022,Klickitat,WA,Truck,2,0,2,8267,8269,0.02,Washington,Washington
2838,August,2022,Okanogan,WA,Truck,1,0,1,16543,16544,0.01,Washington,Washington
2841,August,2022,Clark,WA,Truck,17,0,17,82407,82424,0.02,Washington,Washington
2842,August,2022,Franklin,WA,Passenger,224,113,337,61955,62292,0.54,Washington,Washington
2843,August,2022,Lewis,WA,Passenger,243,177,420,59723,60143,0.7,Washington,Washington
2847,August,2022,Stevens,WA,Passenger,76,56,132,30060,30192,0.44,Washington,Washington
2848,August,2022,San Juan,WA,Truck,5,0,5,5953,5958,0.08,Washington,Washington
2849,August,2022,King,WA,Truck,204,2,206,180057,180263,0.11,Washington,Washington
2852,August,2022,Wahkiakum,WA,Passenger,24,12,36,3080,3116,1.16,Washington,Washington
2854,August,2022,Skagit,WA,Passenger,855,348,1203,89814,91017,1.32,Washington,Washington
2859,August,2022,Asotin,WA,Passenger,24,18,42,12617,12659,0.33,Washington,Washington
2864,August,2022,Clallam,WA,Truck,4,0,4,21879,21883,0.02,Washington,Washington
2866,August,2022,Franklin,WA,Truck,2,0,2,20905,20907,0.01,Washington,Washington
2868,August,2022,Skamania,WA,Truck,0,0,0,3906,3906,0.0,Washington,Washington
2871,August,2022,Cowlitz,WA,Passenger,353,172,525,70460,70985,0.74,Washington,Washington
2872,August,2022,Mason,WA,Passenger,330,177,507,47021,47528,1.07,Washington,Washington
2873,August,2022,Thurston,WA,Passenger,2326,1086,3412,193178,196590,1.74,Washington,Washington
2877,August,2022,Grays Harbor,WA,Truck,2,0,2,21214,21216,0.01,Washington,Washington
2879,August,2022,Pacific,WA,Truck,0,0,0,7860,7860,0.0,Washington,Washington
2884,August,2022,Stevens,WA,Truck,1,0,1,18926,18927,0.01,Washington,Washington
2886,August,2022,Whatcom,WA,Truck,13,0,13,43149,43162,0.03,Washington,Washington
2890,August,2022,Chelan,WA,Truck,5,0,5,23065,23070,0.02,Washington,Washington
2892,August,2022,Pend Oreille,WA,Passenger,18,12,30,9031,9061,0.33,Washington,Washington
2898,August,2022,Whitman,WA,Truck,2,0,2,8568,8570,0.02,Washington,Washington
2903,August,2022,Cowlitz,WA,Truck,2,0,2,28458,28460,0.01,Washington,Washington
2908,August,2022,Snohomish,WA,Truck,45,0,45,123227,123272,0.04,Washington,Washington
2912,August,2022,Whitman,WA,Passenger,94,62,156,22009,22165,0.7,Washington,Washington
2919,August,2022,Lincoln,WA,Passenger,9,16,25,7697,7722,0.32,Washington,Washington
2924,August,2022,Whatcom,WA,Passenger,1915,766,2681,148907,151588,1.77,Washington,Washington
2934,August,2022,Walla Walla,WA,Truck,2,0,2,13914,13916,0.01,Washington,Washington
2935,August,2022,Clark,WA,Passenger,4348,1852,6200,315595,321795,1.93,Washington,Washington
2938,August,2022,Chelan,WA,Passenger,487,134,621,54190,54811,1.13,Washington,Washington
2941,August,2022,Skagit,WA,Truck,5,0,5,32237,32242,0.02,Washington,Washington
2942,August,2022,Skamania,WA,Passenger,82,50,132,8155,8287,1.59,Washington,Washington
2944,August,2022,Grant,WA,Truck,1,0,1,27998,27999,0.0,Washington,Washington
2946,August,2022,Yakima,WA,Passenger,364,204,568,166544,167112,0.34,Washington,Washington
2947,August,2022,Kitsap,WA,Truck,19,0,19,53291,53310,0.04,Washington,Washington
2950,August,2022,Mason,WA,Truck,4,0,4,20986,20990,0.02,Washington,Washington
2952,August,2022,Clallam,WA,Passenger,435,247,682,49540,50222,1.36,Washington,Washington
2955,August,2022,Benton,WA,Truck,5,0,5,43422,43427,0.01,Washington,Washington
2956,December,2017,Wahkiakum,WA,Passenger,0,2,2,2860,2862,0.07,Washington,Washington
2958,December,2017,Franklin,WA,Truck,0,0,0,18492,18492,0.0,Washington,Washington
2959,December,2017,San Juan,WA,Passenger,132,43,175,13853,14028,1.25,Washington,Washington
2960,December,2017,Jefferson,WA,Truck,0,0,0,9475,9475,0.0,Washington,Washington
2962,December,2017,Lincoln,WA,Passenger,2,5,7,7569,7576,0.09,Washington,Washington
2964,December,2017,Okanogan,WA,Passenger,7,18,25,25740,25765,0.1,Washington,Washington
2969,December,2017,Whitman,WA,Passenger,17,20,37,22426,22463,0.16,Washington,Washington
2970,December,2017,Kittitas,WA,Passenger,35,26,61,28449,28510,0.21,Washington,Washington
2973,December,2017,Stevens,WA,Truck,0,0,0,18379,18379,0.0,Washington,Washington
2978,December,2017,Lewis,WA,Passenger,54,40,94,56571,56665,0.17,Washington,Washington
2979,December,2017,Yakima,WA,Passenger,59,75,134,162075,162209,0.08,Washington,Washington
2980,December,2017,Stevens,WA,Passenger,10,21,31,31533,31564,0.1,Washington,Washington
2982,December,2017,Columbia,WA,Truck,0,0,0,1540,1540,0.0,Washington,Washington
2983,December,2017,King,WA,Truck,8,1,9,185056,185065,0.0,Washington,Washington
2985,December,2017,Pend Oreille,WA,Truck,0,0,0,5618,5618,0.0,Washington,Washington
2988,December,2017,Asotin,WA,Truck,0,0,0,6543,6543,0.0,Washington,Washington
2992,December,2017,Clallam,WA,Passenger,99,91,190,49056,49246,0.39,Washington,Washington
2993,December,2017,Columbia,WA,Passenger,2,1,3,2403,2406,0.12,Washington,Washington
2994,December,2017,Garfield,WA,Truck,0,0,0,943,943,0.0,Washington,Washington
2995,December,2017,Kitsap,WA,Truck,1,0,1,52687,52688,0.0,Washington,Washington
2996,December,2017,Klickitat,WA,Truck,0,0,0,8003,8003,0.0,Washington,Washington
2998,December,2017,Snohomish,WA,Passenger,2016,1051,3067,516915,519982,0.59,Washington,Washington
3000,December,2017,Pacific,WA,Truck,0,0,0,7545,7545,0.0,Washington,Washington
3001,December,2017,Whatcom,WA,Passenger,532,227,759,145194,145953,0.52,Washington,Washington
3002,December,2017,Clark,WA,Truck,0,0,0,78388,78388,0.0,Washington,Washington
3008,December,2017,Grays Harbor,WA,Truck,0,0,0,20064,20064,0.0,Washington,Washington
3015,December,2017,Benton,WA,Passenger,172,168,340,130229,130569,0.26,Washington,Washington
3017,December,2017,Douglas,WA,Truck,0,0,0,11757,11757,0.0,Washington,Washington
3018,December,2017,Douglas,WA,Passenger,38,33,71,27171,27242,0.26,Washington,Washington
3021,December,2017,Jefferson,WA,Passenger,121,74,195,24283,24478,0.8,Washington,Washington
3022,December,2017,Spokane,WA,Truck,1,0,1,91580,91581,0.0,Washington,Washington
3023,December,2017,Grant,WA,Passenger,26,35,61,62097,62158,0.1,Washington,Washington
3027,December,2017,Pierce,WA,Truck,0,0,0,137028,137028,0.0,Washington,Washington
3029,December,2017,Whatcom,WA,Truck,1,0,1,42016,42017,0.0,Washington,Washington
3033,December,2017,Thurston,WA,Passenger,470,391,861,190046,190907,0.45,Washington,Washington
3034,December,2017,Cowlitz,WA,Truck,0,0,0,28150,28150,0.0,Washington,Washington
3036,December,2017,Skagit,WA,Passenger,167,138,305,89553,89858,0.34,Washington,Washington
3037,December,2017,Pierce,WA,Passenger,1071,963,2034,526446,528480,0.38,Washington,Washington
3038,December,2017,Mason,WA,Truck,0,0,0,19593,19593,0.0,Washington,Washington
3042,December,2017,Island,WA,Truck,0,0,0,20753,20753,0.0,Washington,Washington
3043,December,2017,Okanogan,WA,Truck,0,0,0,16269,16269,0.0,Washington,Washington
3045,December,2017,Skamania,WA,Passenger,10,7,17,8589,8606,0.2,Washington,Washington
3047,December,2017,Kittitas,WA,Truck,0,0,0,13805,13805,0.0,Washington,Washington
3050,December,2017,Walla Walla,WA,Truck,0,0,0,13292,13292,0.0,Washington,Washington
3051,December,2017,Yakima,WA,Truck,0,0,0,58011,58011,0.0,Washington,Washington
3053,December,2017,Garfield,WA,Passenger,1,0,1,1321,1322,0.08,Washington,Washington
3060,December,2017,Wahkiakum,WA,Truck,0,0,0,1670,1670,0.0,Washington,Washington
3061,December,2017,Spokane,WA,Passenger,297,240,537,300106,300643,0.18,Washington,Washington
3063,December,2017,Island,WA,Passenger,155,165,320,61576,61896,0.52,Washington,Washington
3065,December,2017,Snohomish,WA,Truck,1,0,1,121405,121406,0.0,Washington,Washington
3066,December,2017,Cowlitz,WA,Passenger,54,67,121,70747,70868,0.17,Washington,Washington
3067,December,2017,Kitsap,WA,Passenger,693,377,1070,175868,176938,0.6,Washington,Washington
3072,December,2017,Asotin,WA,Passenger,8,5,13,12519,12532,0.1,Washington,Washington
3075,December,2017,Adams,WA,Passenger,4,5,9,12408,12417,0.07,Washington,Washington
3076,December,2017,Benton,WA,Truck,0,0,0,40573,40573,0.0,Washington,Washington
3080,December,2017,Clark,WA,Passenger,851,573,1424,304270,305694,0.47,Washington,Washington
3082,December,2017,Adams,WA,Truck,0,0,0,5128,5128,0.0,Washington,Washington
3087,December,2017,Ferry,WA,Truck,0,0,0,3523,3523,0.0,Washington,Washington
3088,December,2017,San Juan,WA,Truck,0,0,0,5604,5604,0.0,Washington,Washington
3089,December,2017,Thurston,WA,Truck,0,0,0,53761,53761,0.0,Washington,Washington
3094,December,2017,King,WA,Passenger,11277,4684,15961,1370800,1386761,1.15,Washington,Washington
3101,December,2017,Pend Oreille,WA,Passenger,3,4,7,9440,9447,0.07,Washington,Washington
3103,December,2017,Ferry,WA,Passenger,1,3,4,4402,4406,0.09,Washington,Washington
3105,December,2017,Grant,WA,Truck,0,0,0,25587,25587,0.0,Washington,Washington
3106,December,2017,Chelan,WA,Truck,0,0,0,21619,21619,0.0,Washington,Washington
3109,December,2017,Pacific,WA,Passenger,15,13,28,15404,15432,0.18,Washington,Washington
3111,December,2017,Skamania,WA,Truck,0,0,0,3896,3896,0.0,Washington,Washington
3112,December,2017,Lewis,WA,Truck,0,0,0,25311,25311,0.0,Washington,Washington
3116,December,2017,Whitman,WA,Truck,0,0,0,8450,8450,0.0,Washington,Washington
3118,December,2017,Klickitat,WA,Passenger,23,26,49,14902,14951,0.33,Washington,Washington
3121,December,2017,Walla Walla,WA,Passenger,29,32,61,35287,35348,0.17,Washington,Washington
3122,December,2017,Mason,WA,Passenger,66,75,141,44844,44985,0.31,Washington,Washington
3125,December,2017,Grays Harbor,WA,Passenger,42,41,83,45821,45904,0.18,Washington,Washington
3127,December,2017,Lincoln,WA,Truck,0,0,0,4493,4493,0.0,Washington,Washington
3128,December,2017,Chelan,WA,Passenger,86,38,124,53028,53152,0.23,Washington,Washington
3129,December,2017,Clallam,WA,Truck,0,0,0,21218,21218,0.0,Washington,Washington
3137,December,2017,Franklin,WA,Passenger,30,50,80,56860,56940,0.14,Washington,Washington
3142,December,2017,Skagit,WA,Truck,1,0,1,31731,31732,0.0,Washington,Washington
3144,December,2018,Franklin,WA,Truck,0,0,0,19057,19057,0.0,Washington,Washington
3148,December,2018,Snohomish,WA,Truck,1,0,1,121967,121968,0.0,Washington,Washington
3149,December,2018,Skamania,WA,Passenger,16,13,29,8731,8760,0.33,Washington,Washington
3150,December,2018,Wahkiakum,WA,Passenger,1,1,2,2979,2981,0.07,Washington,Washington
3151,December,2018,Kitsap,WA,Passenger,946,544,1490,179830,181320,0.82,Washington,Washington
3152,December,2018,Pacific,WA,Passenger,21,25,46,15834,15880,0.29,Washington,Washington
3153,December,2018,Grays Harbor,WA,Passenger,62,72,134,47465,47599,0.28,Washington,Washington
3155,December,2018,Asotin,WA,Passenger,12,9,21,12724,12745,0.16,Washington,Washington
3157,December,2018,Chelan,WA,Passenger,140,61,201,54138,54339,0.37,Washington,Washington
3159,December,2018,Cowlitz,WA,Passenger,72,94,166,72436,72602,0.23,Washington,Washington
3160,December,2018,Walla Walla,WA,Passenger,41,52,93,36097,36190,0.26,Washington,Washington
3161,December,2018,Pacific,WA,Truck,0,0,0,7614,7614,0.0,Washington,Washington
3171,December,2018,Jefferson,WA,Passenger,168,106,274,24838,25112,1.09,Washington,Washington
3174,December,2018,Pend Oreille,WA,Truck,0,0,0,5738,5738,0.0,Washington,Washington
3175,December,2018,Jefferson,WA,Truck,0,0,0,9606,9606,0.0,Washington,Washington
3178,December,2018,Snohomish,WA,Passenger,2915,1437,4352,527237,531589,0.82,Washington,Washington
3179,December,2018,Chelan,WA,Truck,0,0,0,22052,22052,0.0,Washington,Washington
3187,December,2018,Grant,WA,Passenger,32,52,84,64196,64280,0.13,Washington,Washington
3191,December,2018,Cowlitz,WA,Truck,0,0,0,28739,28739,0.0,Washington,Washington
3194,December,2018,Klickitat,WA,Passenger,28,32,60,15431,15491,0.39,Washington,Washington
3195,December,2018,Franklin,WA,Passenger,45,66,111,59124,59235,0.19,Washington,Washington
3196,December,2018,Grays Harbor,WA,Truck,0,0,0,20356,20356,0.0,Washington,Washington
3197,December,2018,Kittitas,WA,Passenger,66,37,103,29339,29442,0.35,Washington,Washington
3198,December,2018,Skagit,WA,Truck,1,0,1,32318,32319,0.0,Washington,Washington
3202,December,2018,Lincoln,WA,Truck,0,0,0,4639,4639,0.0,Washington,Washington
3205,December,2018,Ferry,WA,Truck,0,0,0,3585,3585,0.0,Washington,Washington
3206,December,2018,Skamania,WA,Truck,0,0,0,4008,4008,0.0,Washington,Washington
3207,December,2018,Garfield,WA,Passenger,1,1,2,1329,1331,0.15,Washington,Washington
3211,December,2018,Clallam,WA,Passenger,150,124,274,50353,50627,0.54,Washington,Washington
3213,December,2018,Yakima,WA,Truck,0,0,0,58848,58848,0.0,Washington,Washington
3214,December,2018,Clallam,WA,Truck,0,0,0,21642,21642,0.0,Washington,Washington
3215,December,2018,Douglas,WA,Truck,0,0,0,12160,12160,0.0,Washington,Washington
3219,December,2018,Columbia,WA,Truck,0,0,0,1517,1517,0.0,Washington,Washington
3222,December,2018,Benton,WA,Passenger,227,235,462,132930,133392,0.35,Washington,Washington
3224,December,2018,San Juan,WA,Truck,0,0,0,5818,5818,0.0,Washington,Washington
3225,December,2018,Thurston,WA,Passenger,739,572,1311,195602,196913,0.67,Washington,Washington
3234,December,2018,Kittitas,WA,Truck,0,0,0,14196,14196,0.0,Washington,Washington
3238,December,2018,San Juan,WA,Passenger,183,69,252,14224,14476,1.74,Washington,Washington
3241,December,2018,Adams,WA,Truck,0,0,0,5149,5149,0.0,Washington,Washington
3245,December,2018,Whatcom,WA,Truck,2,0,2,42664,42666,0.0,Washington,Washington
3250,December,2018,Lewis,WA,Passenger,93,77,170,58326,58496,0.29,Washington,Washington
3252,December,2018,Whatcom,WA,Passenger,757,371,1128,149448,150576,0.75,Washington,Washington
3255,December,2018,Mason,WA,Passenger,107,110,217,46462,46679,0.46,Washington,Washington
3256,December,2018,Mason,WA,Truck,0,0,0,20192,20192,0.0,Washington,Washington
3262,December,2018,Thurston,WA,Truck,0,0,0,54873,54873,0.0,Washington,Washington
3264,December,2018,Island,WA,Truck,0,0,0,21185,21185,0.0,Washington,Washington
3265,December,2018,Garfield,WA,Truck,0,0,0,965,965,0.0,Washington,Washington
3267,December,2018,Lewis,WA,Truck,0,0,0,25634,25634,0.0,Washington,Washington
3268,December,2018,Yakima,WA,Passenger,82,99,181,164762,164943,0.11,Washington,Washington
3271,December,2018,Benton,WA,Truck,0,0,0,41561,41561,0.0,Washington,Washington
3276,December,2018,Pierce,WA,Truck,0,0,0,139122,139122,0.0,Washington,Washington
3283,December,2018,Grant,WA,Truck,0,0,0,26258,26258,0.0,Washington,Washington
3286,December,2018,Ferry,WA,Passenger,3,2,5,4383,4388,0.11,Washington,Washington
3292,December,2018,Spokane,WA,Truck,1,0,1,93762,93763,0.0,Washington,Washington
3294,December,2018,Asotin,WA,Truck,0,0,0,6635,6635,0.0,Washington,Washington
3299,December,2018,Adams,WA,Passenger,5,6,11,12744,12755,0.09,Washington,Washington
3302,December,2018,King,WA,Truck,6,1,7,182653,182660,0.0,Washington,Washington
3306,December,2018,Clark,WA,Passenger,1246,841,2087,311394,313481,0.67,Washington,Washington
3308,December,2018,Kitsap,WA,Truck,1,0,1,53636,53637,0.0,Washington,Washington
3309,December,2018,Douglas,WA,Passenger,50,34,84,28009,28093,0.3,Washington,Washington
3313,December,2018,Island,WA,Passenger,276,225,501,63178,63679,0.79,Washington,Washington
3319,December,2018,Skagit,WA,Passenger,259,187,446,91196,91642,0.49,Washington,Washington
3326,December,2018,Klickitat,WA,Truck,0,0,0,8209,8209,0.0,Washington,Washington
3327,December,2018,Lincoln,WA,Passenger,2,5,7,7780,7787,0.09,Washington,Washington
3329,December,2018,Pierce,WA,Passenger,1509,1373,2882,538890,541772,0.53,Washington,Washington
3330,December,2018,Walla Walla,WA,Truck,0,0,0,13523,13523,0.0,Washington,Washington
3334,December,2018,Spokane,WA,Passenger,439,373,812,307178,307990,0.26,Washington,Washington
3336,December,2018,Stevens,WA,Truck,0,0,0,18764,18764,0.0,Washington,Washington
3340,December,2018,Clark,WA,Truck,0,0,0,79840,79840,0.0,Washington,Washington
3343,December,2018,Okanogan,WA,Truck,0,0,0,16487,16487,0.0,Washington,Washington
3344,December,2018,King,WA,Passenger,16280,6530,22810,1378186,1400996,1.63,Washington,Washington
3346,December,2018,Okanogan,WA,Passenger,16,22,38,26070,26108,0.15,Washington,Washington
3348,December,2018,Pend Oreille,WA,Passenger,5,5,10,9533,9543,0.1,Washington,Washington
3349,December,2018,Columbia,WA,Passenger,2,2,4,2421,2425,0.16,Washington,Washington
3355,December,2018,Whitman,WA,Passenger,24,38,62,22811,22873,0.27,Washington,Washington
3357,December,2018,Stevens,WA,Passenger,16,27,43,31786,31829,0.14,Washington,Washington
3358,December,2018,Wahkiakum,WA,Truck,0,0,0,1722,1722,0.0,Washington,Washington
3360,December,2018,Whitman,WA,Truck,0,0,0,8542,8542,0.0,Washington,Washington
3363,December,2019,Asotin,WA,Passenger,14,9,23,12679,12702,0.18,Washington,Washington
3365,December,2019,Jefferson,WA,Truck,0,0,0,9647,9647,0.0,Washington,Washington
3367,December,2019,Clallam,WA,Passenger,196,157,353,50869,51222,0.69,Washington,Washington
3369,December,2019,Grant,WA,Truck,0,0,0,27002,27002,0.0,Washington,Washington
3372,December,2019,Douglas,WA,Passenger,67,38,105,28299,28404,0.37,Washington,Washington
3375,December,2019,Whitman,WA,Truck,0,0,0,8579,8579,0.0,Washington,Washington
3377,December,2019,Columbia,WA,Passenger,3,3,6,2449,2455,0.24,Washington,Washington
3382,December,2019,Clark,WA,Passenger,1843,1043,2886,317733,320619,0.9,Washington,Washington
3383,December,2019,Cowlitz,WA,Passenger,118,107,225,73644,73869,0.3,Washington,Washington
3387,December,2019,Wahkiakum,WA,Passenger,4,3,7,3041,3048,0.23,Washington,Washington
3388,December,2019,Klickitat,WA,Passenger,46,38,84,15674,15758,0.53,Washington,Washington
3389,December,2019,Wahkiakum,WA,Truck,0,0,0,1754,1754,0.0,Washington,Washington
3390,December,2019,San Juan,WA,Truck,0,0,0,5935,5935,0.0,Washington,Washington
3395,December,2019,Columbia,WA,Truck,0,0,0,1537,1537,0.0,Washington,Washington
3400,December,2019,Pend Oreille,WA,Truck,0,0,0,5771,5771,0.0,Washington,Washington
3402,December,2019,Cowlitz,WA,Truck,0,0,0,29035,29035,0.0,Washington,Washington
3403,December,2019,Skagit,WA,Passenger,363,213,576,92637,93213,0.62,Washington,Washington
3405,December,2019,Lewis,WA,Passenger,106,102,208,59556,59764,0.35,Washington,Washington
3409,December,2019,Clark,WA,Truck,0,0,0,81316,81316,0.0,Washington,Washington
3412,December,2019,Garfield,WA,Passenger,0,1,1,1306,1307,0.08,Washington,Washington
3413,December,2019,Thurston,WA,Passenger,1052,701,1753,199236,200989,0.87,Washington,Washington
3415,December,2019,Okanogan,WA,Truck,0,0,0,16550,16550,0.0,Washington,Washington
3416,December,2019,Chelan,WA,Passenger,201,78,279,54622,54901,0.51,Washington,Washington
3417,December,2019,Whatcom,WA,Truck,2,0,2,43188,43190,0.0,Washington,Washington
3419,December,2019,Ferry,WA,Passenger,5,2,7,4398,4405,0.16,Washington,Washington
3425,December,2019,King,WA,Truck,6,1,7,182216,182223,0.0,Washington,Washington
3429,December,2019,Lewis,WA,Truck,0,0,0,26087,26087,0.0,Washington,Washington
3435,December,2019,Kitsap,WA,Passenger,1199,652,1851,182349,184200,1.0,Washington,Washington
3438,December,2019,Asotin,WA,Truck,0,0,0,6709,6709,0.0,Washington,Washington
3440,December,2019,Walla Walla,WA,Truck,0,0,0,13663,13663,0.0,Washington,Washington
3442,December,2019,Island,WA,Truck,1,0,1,21356,21357,0.0,Washington,Washington
3444,December,2019,Clallam,WA,Truck,1,0,1,21871,21872,0.0,Washington,Washington
3445,December,2019,Pacific,WA,Truck,0,0,0,7721,7721,0.0,Washington,Washington
3448,December,2019,Spokane,WA,Passenger,643,471,1114,315064,316178,0.35,Washington,Washington
3450,December,2019,Pierce,WA,Passenger,2127,1651,3778,547907,551685,0.68,Washington,Washington
3452,December,2019,Pacific,WA,Passenger,30,30,60,16120,16180,0.37,Washington,Washington
3454,December,2019,Pierce,WA,Truck,0,0,0,140864,140864,0.0,Washington,Washington
3457,December,2019,Stevens,WA,Passenger,31,31,62,31609,31671,0.2,Washington,Washington
3458,December,2019,Yakima,WA,Truck,0,0,0,59618,59618,0.0,Washington,Washington
3464,December,2019,Skagit,WA,Truck,1,0,1,32566,32567,0.0,Washington,Washington
3466,December,2019,Snohomish,WA,Passenger,4021,1709,5730,536109,541839,1.06,Washington,Washington
3470,December,2019,Island,WA,Passenger,375,253,628,63608,64236,0.98,Washington,Washington
3483,December,2019,Jefferson,WA,Passenger,217,134,351,25187,25538,1.37,Washington,Washington
3484,December,2019,Adams,WA,Passenger,6,7,13,12936,12949,0.1,Washington,Washington
3486,December,2019,Douglas,WA,Truck,0,0,0,12308,12308,0.0,Washington,Washington
3488,December,2019,Okanogan,WA,Passenger,30,30,60,26236,26296,0.23,Washington,Washington
3492,December,2019,Skamania,WA,Truck,0,0,0,4099,4099,0.0,Washington,Washington
3498,December,2019,Grays Harbor,WA,Passenger,105,100,205,48394,48599,0.42,Washington,Washington
3500,December,2019,Yakima,WA,Passenger,116,114,230,166298,166528,0.14,Washington,Washington
3502,December,2019,Klickitat,WA,Truck,0,0,0,8318,8318,0.0,Washington,Washington
3505,December,2019,Snohomish,WA,Truck,0,0,0,123277,123277,0.0,Washington,Washington
3507,December,2019,Thurston,WA,Truck,0,0,0,55729,55729,0.0,Washington,Washington
3513,December,2019,Benton,WA,Truck,0,0,0,42486,42486,0.0,Washington,Washington
3514,December,2019,Ferry,WA,Truck,0,0,0,3580,3580,0.0,Washington,Washington
3516,December,2019,Lincoln,WA,Truck,0,0,0,4683,4683,0.0,Washington,Washington
3517,December,2019,Kittitas,WA,Passenger,90,46,136,30054,30190,0.45,Washington,Washington
3524,December,2019,Garfield,WA,Truck,0,0,0,969,969,0.0,Washington,Washington
3527,December,2019,Adams,WA,Truck,0,0,0,5198,5198,0.0,Washington,Washington
3532,December,2019,Spokane,WA,Truck,1,0,1,96378,96379,0.0,Washington,Washington
3534,December,2019,Grant,WA,Passenger,55,68,123,65625,65748,0.19,Washington,Washington
3535,December,2019,King,WA,Passenger,21951,7543,29494,1394823,1424317,2.07,Washington,Washington
3536,December,2019,Mason,WA,Truck,0,0,0,20527,20527,0.0,Washington,Washington
3538,December,2019,Franklin,WA,Passenger,54,76,130,60982,61112,0.21,Washington,Washington
3543,December,2019,Kittitas,WA,Truck,0,0,0,14624,14624,0.0,Washington,Washington
3549,December,2019,Mason,WA,Passenger,142,135,277,47637,47914,0.58,Washington,Washington
3550,December,2019,San Juan,WA,Passenger,253,79,332,14407,14739,2.25,Washington,Washington
3553,December,2019,Benton,WA,Passenger,315,308,623,135242,135865,0.46,Washington,Washington
3555,December,2019,Walla Walla,WA,Passenger,63,60,123,36306,36429,0.34,Washington,Washington
3566,December,2019,Lincoln,WA,Passenger,1,11,12,7804,7816,0.15,Washington,Washington
3570,December,2019,Whatcom,WA,Passenger,987,477,1464,151703,153167,0.96,Washington,Washington
3573,December,2019,Whitman,WA,Passenger,42,46,88,22678,22766,0.39,Washington,Washington
3575,December,2019,Pend Oreille,WA,Passenger,7,7,14,9514,9528,0.15,Washington,Washington
3581,December,2019,Kitsap,WA,Truck,1,0,1,54446,54447,0.0,Washington,Washington
3582,December,2019,Stevens,WA,Truck,0,0,0,18761,18761,0.0,Washington,Washington
3583,December,2019,Skamania,WA,Passenger,26,19,45,8767,8812,0.51,Washington,Washington
3590,December,2019,Franklin,WA,Truck,0,0,0,19779,19779,0.0,Washington,Washington
3591,December,2019,Grays Harbor,WA,Truck,0,0,0,20770,20770,0.0,Washington,Washington
3592,December,2019,Chelan,WA,Truck,0,0,0,22549,22549,0.0,Washington,Washington
3595,December,2020,Lincoln,WA,Truck,0,0,0,4673,4673,0.0,Washington,Washington
3596,December,2020,Clallam,WA,Truck,1,0,1,21831,21832,0.0,Washington,Washington
3597,December,2020,Columbia,WA,Truck,0,0,0,1543,1543,0.0,Washington,Washington
3599,December,2020,Benton,WA,Truck,0,0,0,43207,43207,0.0,Washington,Washington
3600,December,2020,Chelan,WA,Passenger,278,88,366,54504,54870,0.67,Washington,Washington
3605,December,2020,Whitman,WA,Truck,0,0,0,8508,8508,0.0,Washington,Washington
3611,December,2020,Whitman,WA,Passenger,51,44,95,21905,22000,0.43,Washington,Washington
3612,December,2020,Pierce,WA,Truck,0,0,0,144789,144789,0.0,Washington,Washington
3615,December,2020,Douglas,WA,Truck,0,0,0,12494,12494,0.0,Washington,Washington
3617,December,2020,Kitsap,WA,Passenger,1556,756,2312,179832,182144,1.27,Washington,Washington
3619,December,2020,Franklin,WA,Passenger,85,83,168,61368,61536,0.27,Washington,Washington
3623,December,2020,Klickitat,WA,Truck,0,0,0,8088,8088,0.0,Washington,Washington
3624,December,2020,Stevens,WA,Truck,0,0,0,18716,18716,0.0,Washington,Washington
3629,December,2020,Skagit,WA,Passenger,497,238,735,91428,92163,0.8,Washington,Washington
3632,December,2020,Kitsap,WA,Truck,0,0,0,54371,54371,0.0,Washington,Washington
3634,December,2020,Lewis,WA,Passenger,123,122,245,58843,59088,0.41,Washington,Washington
3637,December,2020,Columbia,WA,Passenger,5,3,8,2441,2449,0.33,Washington,Washington
3638,December,2020,Grant,WA,Truck,0,0,0,27505,27505,0.0,Washington,Washington
3640,December,2020,Lewis,WA,Truck,0,0,0,26622,26622,0.0,Washington,Washington
3644,December,2020,Lincoln,WA,Passenger,5,12,17,7644,7661,0.22,Washington,Washington
3649,December,2020,Mason,WA,Truck,0,0,0,20948,20948,0.0,Washington,Washington
3650,December,2020,Clark,WA,Passenger,2356,1180,3536,319513,323049,1.09,Washington,Washington
3654,December,2020,Wahkiakum,WA,Passenger,6,7,13,3036,3049,0.43,Washington,Washington
3657,December,2020,Garfield,WA,Passenger,0,2,2,1367,1369,0.15,Washington,Washington
3658,December,2020,Yakima,WA,Passenger,170,128,298,167294,167592,0.18,Washington,Washington
3661,December,2020,Kittitas,WA,Truck,0,0,0,14646,14646,0.0,Washington,Washington
3664,December,2020,Thurston,WA,Truck,0,0,0,56389,56389,0.0,Washington,Washington
3666,December,2020,San Juan,WA,Passenger,365,111,476,14021,14497,3.28,Washington,Washington
3669,December,2020,Walla Walla,WA,Truck,0,0,0,13871,13871,0.0,Washington,Washington
3677,December,2020,Ferry,WA,Passenger,9,3,12,4361,4373,0.27,Washington,Washington
3679,December,2020,Jefferson,WA,Passenger,285,155,440,24813,25253,1.74,Washington,Washington
3682,December,2020,Kittitas,WA,Passenger,127,51,178,29824,30002,0.59,Washington,Washington
3684,December,2020,Okanogan,WA,Passenger,55,36,91,26069,26160,0.35,Washington,Washington
3687,December,2020,Asotin,WA,Passenger,16,13,29,12413,12442,0.23,Washington,Washington
3688,December,2020,Skamania,WA,Passenger,33,22,55,8352,8407,0.65,Washington,Washington
3689,December,2020,Grays Harbor,WA,Truck,0,0,0,21205,21205,0.0,Washington,Washington
3690,December,2020,King,WA,Passenger,26917,8171,35088,1370135,1405223,2.5,Washington,Washington
3693,December,2020,Thurston,WA,Passenger,1321,780,2101,197406,199507,1.05,Washington,Washington
3696,December,2020,Cowlitz,WA,Passenger,177,127,304,72118,72422,0.42,Washington,Washington
3698,December,2020,Okanogan,WA,Truck,0,0,0,16607,16607,0.0,Washington,Washington
3707,December,2020,Jefferson,WA,Truck,0,0,0,9588,9588,0.0,Washington,Washington
3711,December,2020,Clark,WA,Truck,0,0,0,83498,83498,0.0,Washington,Washington
3715,December,2020,Snohomish,WA,Truck,0,0,0,125700,125700,0.0,Washington,Washington
3719,December,2020,Stevens,WA,Passenger,36,40,76,30234,30310,0.25,Washington,Washington
3722,December,2020,Grays Harbor,WA,Passenger,127,122,249,48651,48900,0.51,Washington,Washington
3724,December,2020,Pacific,WA,Truck,0,0,0,7792,7792,0.0,Washington,Washington
3725,December,2020,Spokane,WA,Truck,0,0,0,100712,100712,0.0,Washington,Washington
3728,December,2020,Whatcom,WA,Passenger,1218,550,1768,150033,151801,1.16,Washington,Washington
3729,December,2020,Adams,WA,Truck,0,0,0,5337,5337,0.0,Washington,Washington
3735,December,2020,Yakima,WA,Truck,0,0,0,60982,60982,0.0,Washington,Washington
3736,December,2020,Pierce,WA,Passenger,2825,1771,4596,555647,560243,0.82,Washington,Washington
3745,December,2020,Garfield,WA,Truck,0,0,0,996,996,0.0,Washington,Washington
3746,December,2020,Skagit,WA,Truck,1,0,1,32781,32782,0.0,Washington,Washington
3750,December,2020,Snohomish,WA,Passenger,5036,1848,6884,538610,545494,1.26,Washington,Washington
3758,December,2020,Island,WA,Truck,0,0,0,21369,21369,0.0,Washington,Washington
3759,December,2020,Cowlitz,WA,Truck,0,0,0,28933,28933,0.0,Washington,Washington
3760,December,2020,Pacific,WA,Passenger,34,35,69,15727,15796,0.44,Washington,Washington
3765,December,2020,San Juan,WA,Truck,0,0,0,5874,5874,0.0,Washington,Washington
3767,December,2020,Klickitat,WA,Passenger,62,43,105,14980,15085,0.7,Washington,Washington
3782,December,2020,Island,WA,Passenger,507,289,796,63011,63807,1.25,Washington,Washington
3783,December,2020,Asotin,WA,Truck,0,0,0,6675,6675,0.0,Washington,Washington
3786,December,2020,Ferry,WA,Truck,0,0,0,3607,3607,0.0,Washington,Washington
3789,December,2020,Whatcom,WA,Truck,3,0,3,43545,43548,0.01,Washington,Washington
3798,December,2020,Mason,WA,Passenger,173,133,306,47648,47954,0.64,Washington,Washington
3801,December,2020,Grant,WA,Passenger,80,81,161,65927,66088,0.24,Washington,Washington
3802,December,2020,Douglas,WA,Passenger,86,44,130,28191,28321,0.46,Washington,Washington
3804,December,2020,Clallam,WA,Passenger,273,185,458,49921,50379,0.91,Washington,Washington
3806,December,2020,Walla Walla,WA,Passenger,98,67,165,36134,36299,0.45,Washington,Washington
3807,December,2020,Pend Oreille,WA,Truck,0,0,0,5715,5715,0.0,Washington,Washington
3808,December,2020,Benton,WA,Passenger,440,355,795,134989,135784,0.59,Washington,Washington
3809,December,2020,Skamania,WA,Truck,0,0,0,4004,4004,0.0,Washington,Washington
3811,December,2020,Chelan,WA,Truck,0,0,0,22804,22804,0.0,Washington,Washington
3816,December,2020,Pend Oreille,WA,Passenger,12,4,16,9171,9187,0.17,Washington,Washington
3822,December,2020,Wahkiakum,WA,Truck,0,0,0,1770,1770,0.0,Washington,Washington
3827,December,2020,Franklin,WA,Truck,0,0,0,20434,20434,0.0,Washington,Washington
3828,December,2020,Adams,WA,Passenger,10,7,17,12960,12977,0.13,Washington,Washington
3830,December,2020,King,WA,Truck,6,1,7,184370,184377,0.0,Washington,Washington
3841,December,2020,Spokane,WA,Passenger,886,547,1433,321109,322542,0.44,Washington,Washington
3844,December,2021,Benton,WA,Truck,0,0,0,43707,43707,0.0,Washington,Washington
3846,December,2021,Lewis,WA,Passenger,206,164,370,59615,59985,0.62,Washington,Washington
3848,December,2021,Pend Oreille,WA,Truck,0,0,0,5703,5703,0.0,Washington,Washington
3856,December,2021,Lincoln,WA,Truck,0,0,0,4823,4823,0.0,Washington,Washington
3858,December,2021,Benton,WA,Passenger,639,445,1084,136113,137197,0.79,Washington,Washington
3859,December,2021,Grant,WA,Truck,0,0,0,27999,27999,0.0,Washington,Washington
3864,December,2021,Clallam,WA,Truck,1,0,1,22124,22125,0.0,Washington,Washington
3865,December,2021,Wahkiakum,WA,Passenger,17,10,27,3082,3109,0.87,Washington,Washington
3866,December,2021,Spokane,WA,Truck,0,0,0,102792,102792,0.0,Washington,Washington
3867,December,2021,Asotin,WA,Truck,0,0,0,6755,6755,0.0,Washington,Washington
3869,December,2021,Grant,WA,Passenger,137,98,235,66973,67208,0.35,Washington,Washington
3871,December,2021,Adams,WA,Truck,0,0,0,5419,5419,0.0,Washington,Washington
3876,December,2021,Stevens,WA,Truck,0,0,0,18940,18940,0.0,Washington,Washington
3877,December,2021,Asotin,WA,Passenger,22,17,39,12718,12757,0.31,Washington,Washington
3879,December,2021,Island,WA,Passenger,714,340,1054,62768,63822,1.65,Washington,Washington
3883,December,2021,Adams,WA,Passenger,17,14,31,13083,13114,0.24,Washington,Washington
3884,December,2021,Whatcom,WA,Truck,4,0,4,43696,43700,0.01,Washington,Washington
3887,December,2021,Pend Oreille,WA,Passenger,18,9,27,9129,9156,0.29,Washington,Washington
3888,December,2021,Jefferson,WA,Truck,0,0,0,9599,9599,0.0,Washington,Washington
3891,December,2021,Jefferson,WA,Passenger,382,194,576,24756,25332,2.27,Washington,Washington
3892,December,2021,Ferry,WA,Passenger,14,3,17,4442,4459,0.38,Washington,Washington
3893,December,2021,Thurston,WA,Truck,0,0,0,56065,56065,0.0,Washington,Washington
3897,December,2021,Kittitas,WA,Truck,0,0,0,14794,14794,0.0,Washington,Washington
3899,December,2021,Whitman,WA,Passenger,67,59,126,21978,22104,0.57,Washington,Washington
3903,December,2021,Clallam,WA,Passenger,383,239,622,50384,51006,1.22,Washington,Washington
3904,December,2021,Klickitat,WA,Passenger,89,53,142,15347,15489,0.92,Washington,Washington
3906,December,2021,Wahkiakum,WA,Truck,0,0,0,1824,1824,0.0,Washington,Washington
3908,December,2021,Franklin,WA,Passenger,162,104,266,62306,62572,0.43,Washington,Washington
3909,December,2021,Pacific,WA,Passenger,51,64,115,16068,16183,0.71,Washington,Washington
3910,December,2021,Clark,WA,Truck,1,0,1,83996,83997,0.0,Washington,Washington
3916,December,2021,King,WA,Passenger,35480,10222,45702,1359266,1404968,3.25,Washington,Washington
3917,December,2021,Grays Harbor,WA,Truck,0,0,0,21388,21388,0.0,Washington,Washington
3921,December,2021,Yakima,WA,Truck,0,0,0,61785,61785,0.0,Washington,Washington
3925,December,2021,Lincoln,WA,Passenger,7,16,23,7719,7742,0.3,Washington,Washington
3926,December,2021,Klickitat,WA,Truck,0,0,0,8333,8333,0.0,Washington,Washington
3927,December,2021,Island,WA,Truck,0,0,0,21524,21524,0.0,Washington,Washington
3932,December,2021,San Juan,WA,Passenger,478,149,627,14189,14816,4.23,Washington,Washington
3937,December,2021,Snohomish,WA,Passenger,7024,2235,9259,537474,546733,1.69,Washington,Washington
3938,December,2021,Cowlitz,WA,Truck,0,1,1,28998,28999,0.0,Washington,Washington
3940,December,2021,Douglas,WA,Truck,0,0,0,12700,12700,0.0,Washington,Washington
3946,December,2021,Mason,WA,Passenger,266,158,424,47764,48188,0.88,Washington,Washington
3953,December,2021,Lewis,WA,Truck,0,0,0,26677,26677,0.0,Washington,Washington
3956,December,2021,Columbia,WA,Passenger,6,2,8,2452,2460,0.33,Washington,Washington
3961,December,2021,Clark,WA,Passenger,3474,1562,5036,320347,325383,1.55,Washington,Washington
3972,December,2021,Okanogan,WA,Truck,0,0,0,16688,16688,0.0,Washington,Washington
3973,December,2021,Whitman,WA,Truck,0,0,0,8559,8559,0.0,Washington,Washington
3976,December,2021,Cowlitz,WA,Passenger,274,163,437,71563,72000,0.61,Washington,Washington
3980,December,2021,Whatcom,WA,Passenger,1643,673,2316,149995,152311,1.52,Washington,Washington
3982,December,2021,Yakima,WA,Passenger,286,173,459,168770,169229,0.27,Washington,Washington
3988,December,2021,Columbia,WA,Truck,0,0,0,1555,1555,0.0,Washington,Washington
3993,December,2021,Skamania,WA,Passenger,60,42,102,8323,8425,1.21,Washington,Washington
3998,December,2021,Kitsap,WA,Truck,0,0,0,54199,54199,0.0,Washington,Washington
4006,December,2021,Grays Harbor,WA,Passenger,192,157,349,49447,49796,0.7,Washington,Washington
4008,December,2021,Garfield,WA,Truck,0,0,0,1001,1001,0.0,Washington,Washington
4014,December,2021,Snohomish,WA,Truck,2,0,2,125446,125448,0.0,Washington,Washington
4017,December,2021,San Juan,WA,Truck,0,0,0,6002,6002,0.0,Washington,Washington
4024,December,2021,Garfield,WA,Passenger,0,3,3,1350,1353,0.22,Washington,Washington
4027,December,2021,Walla Walla,WA,Truck,0,0,0,14090,14090,0.0,Washington,Washington
4029,December,2021,Mason,WA,Truck,0,0,0,21219,21219,0.0,Washington,Washington
4036,December,2021,Pierce,WA,Passenger,4236,2127,6363,555764,562127,1.13,Washington,Washington
4041,December,2021,Chelan,WA,Truck,0,0,0,23108,23108,0.0,Washington,Washington
4042,December,2021,Douglas,WA,Passenger,116,56,172,28610,28782,0.6,Washington,Washington
4043,December,2021,Walla Walla,WA,Passenger,143,87,230,36378,36608,0.63,Washington,Washington
4047,December,2021,Okanogan,WA,Passenger,69,45,114,26600,26714,0.43,Washington,Washington
4048,December,2021,Skagit,WA,Passenger,695,302,997,91135,92132,1.08,Washington,Washington
4051,December,2021,Ferry,WA,Truck,0,0,0,3596,3596,0.0,Washington,Washington
4052,December,2021,Skamania,WA,Truck,0,0,0,4002,4002,0.0,Washington,Washington
4054,December,2021,Stevens,WA,Passenger,55,44,99,30290,30389,0.33,Washington,Washington
4057,December,2021,Pacific,WA,Truck,0,0,0,8019,8019,0.0,Washington,Washington
4061,December,2021,Kittitas,WA,Passenger,207,75,282,29844,30126,0.94,Washington,Washington
4065,December,2021,King,WA,Truck,6,1,7,183027,183034,0.0,Washington,Washington
4071,December,2021,Franklin,WA,Truck,0,0,0,20851,20851,0.0,Washington,Washington
4075,December,2021,Thurston,WA,Passenger,1867,964,2831,196824,199655,1.42,Washington,Washington
4081,December,2021,Spokane,WA,Passenger,1310,758,2068,327386,329454,0.63,Washington,Washington
4082,December,2021,Pierce,WA,Truck,0,0,0,144818,144818,0.0,Washington,Washington
4084,December,2021,Kitsap,WA,Passenger,2129,958,3087,180142,183229,1.68,Washington,Washington
4098,December,2021,Chelan,WA,Passenger,408,114,522,54685,55207,0.95,Washington,Washington
4099,December,2021,Skagit,WA,Truck,1,0,1,32702,32703,0.0,Washington,Washington
4101,December,2022,Stevens,WA,Truck,2,0,2,18846,18848,0.01,Washington,Washington
4102,December,2022,Snohomish,WA,Passenger,10174,2763,12937,530310,543247,2.38,Washington,Washington
4103,December,2022,Lewis,WA,Truck,1,0,1,26311,26312,0.0,Washington,Washington
4104,December,2022,Stevens,WA,Passenger,90,56,146,30021,30167,0.48,Washington,Washington
4107,December,2022,Pacific,WA,Passenger,74,80,154,15740,15894,0.97,Washington,Washington
4110,December,2022,Wahkiakum,WA,Passenger,26,13,39,3037,3076,1.27,Washington,Washington
4112,December,2022,Ferry,WA,Passenger,24,4,28,4344,4372,0.64,Washington,Washington
4120,December,2022,Columbia,WA,Truck,0,0,0,1587,1587,0.0,Washington,Washington
4121,December,2022,Garfield,WA,Passenger,1,3,4,1313,1317,0.3,Washington,Washington
4125,December,2022,Skamania,WA,Passenger,89,52,141,8114,8255,1.71,Washington,Washington
4130,December,2022,Cowlitz,WA,Passenger,405,190,595,70330,70925,0.84,Washington,Washington
4133,December,2022,Columbia,WA,Passenger,7,1,8,2441,2449,0.33,Washington,Washington
4135,December,2022,San Juan,WA,Passenger,561,170,731,13907,14638,4.99,Washington,Washington
4137,December,2022,Skamania,WA,Truck,0,0,0,3884,3884,0.0,Washington,Washington
4138,December,2022,Island,WA,Passenger,930,398,1328,61576,62904,2.11,Washington,Washington
4140,December,2022,Mason,WA,Truck,6,0,6,20861,20867,0.03,Washington,Washington
4142,December,2022,Adams,WA,Passenger,23,11,34,13019,13053,0.26,Washington,Washington
4143,December,2022,Walla Walla,WA,Passenger,201,106,307,35691,35998,0.85,Washington,Washington
4149,December,2022,Pierce,WA,Truck,82,0,82,139604,139686,0.06,Washington,Washington
4155,December,2022,Spokane,WA,Truck,20,0,20,101929,101949,0.02,Washington,Washington
4157,December,2022,Spokane,WA,Passenger,1943,932,2875,324633,327508,0.88,Washington,Washington
4161,December,2022,Pend Oreille,WA,Passenger,21,13,34,8969,9003,0.38,Washington,Washington
4162,December,2022,Whatcom,WA,Passenger,2110,809,2919,148844,151763,1.92,Washington,Washington
4165,December,2022,Whatcom,WA,Truck,26,0,26,43084,43110,0.06,Washington,Washington
4170,December,2022,Garfield,WA,Truck,0,0,0,976,976,0.0,Washington,Washington
4177,December,2022,Kittitas,WA,Truck,5,0,5,14570,14575,0.03,Washington,Washington
4178,December,2022,Walla Walla,WA,Truck,3,0,3,13871,13874,0.02,Washington,Washington
4182,December,2022,Grays Harbor,WA,Truck,2,0,2,21093,21095,0.01,Washington,Washington
4184,December,2022,Jefferson,WA,Passenger,480,230,710,24301,25011,2.84,Washington,Washington
4185,December,2022,Klickitat,WA,Truck,4,0,4,8233,8237,0.05,Washington,Washington
4186,December,2022,Douglas,WA,Truck,3,0,3,12825,12828,0.02,Washington,Washington
4188,December,2022,Clark,WA,Passenger,4917,2031,6948,314946,321894,2.16,Washington,Washington
4189,December,2022,Okanogan,WA,Truck,2,0,2,16442,16444,0.01,Washington,Washington
4199,December,2022,King,WA,Truck,386,2,388,178383,178771,0.22,Washington,Washington
4202,December,2022,Clark,WA,Truck,51,0,51,81917,81968,0.06,Washington,Washington
4203,December,2022,Lincoln,WA,Truck,0,0,0,4848,4848,0.0,Washington,Washington
4206,December,2022,Skagit,WA,Passenger,924,355,1279,89464,90743,1.41,Washington,Washington
4208,December,2022,Clallam,WA,Truck,8,0,8,21879,21887,0.04,Washington,Washington
4209,December,2022,Benton,WA,Passenger,933,500,1433,135784,137217,1.04,Washington,Washington
4210,December,2022,Lincoln,WA,Passenger,12,18,30,7769,7799,0.38,Washington,Washington
4211,December,2022,Ferry,WA,Truck,0,0,0,3548,3548,0.0,Washington,Washington
4218,December,2022,Pend Oreille,WA,Truck,0,0,0,5582,5582,0.0,Washington,Washington
4220,December,2022,Skagit,WA,Truck,11,0,11,32151,32162,0.03,Washington,Washington
4221,December,2022,Wahkiakum,WA,Truck,1,0,1,1790,1791,0.06,Washington,Washington
4222,December,2022,Okanogan,WA,Passenger,97,52,149,26171,26320,0.57,Washington,Washington
4225,December,2022,Thurston,WA,Truck,38,0,38,54686,54724,0.07,Washington,Washington
4230,December,2022,Asotin,WA,Passenger,29,20,49,12492,12541,0.39,Washington,Washington
4232,December,2022,King,WA,Passenger,48110,12252,60362,1337864,1398226,4.32,Washington,Washington
4237,December,2022,Benton,WA,Truck,10,0,10,43344,43354,0.02,Washington,Washington
4238,December,2022,Adams,WA,Truck,1,0,1,5387,5388,0.02,Washington,Washington
4242,December,2022,San Juan,WA,Truck,8,0,8,5913,5921,0.14,Washington,Washington
4247,December,2022,Lewis,WA,Passenger,268,182,450,59910,60360,0.75,Washington,Washington
4249,December,2022,Yakima,WA,Truck,6,0,6,61209,61215,0.01,Washington,Washington
4254,December,2022,Jefferson,WA,Truck,6,0,6,9367,9373,0.06,Washington,Washington
4256,December,2022,Grays Harbor,WA,Passenger,246,160,406,48674,49080,0.83,Washington,Washington
4258,December,2022,Snohomish,WA,Truck,92,0,92,122549,122641,0.08,Washington,Washington
4260,December,2022,Grant,WA,Truck,4,0,4,28064,28068,0.01,Washington,Washington
4269,December,2022,Cowlitz,WA,Truck,4,0,4,28376,28380,0.01,Washington,Washington
4270,December,2022,Whitman,WA,Passenger,110,67,177,21969,22146,0.8,Washington,Washington
4272,December,2022,Island,WA,Truck,17,0,17,21235,21252,0.08,Washington,Washington
4273,December,2022,Douglas,WA,Passenger,169,59,228,28513,28741,0.79,Washington,Washington
4274,December,2022,Whitman,WA,Truck,3,0,3,8661,8664,0.03,Washington,Washington
4278,December,2022,Franklin,WA,Truck,4,0,4,20986,20990,0.02,Washington,Washington
4282,December,2022,Kittitas,WA,Passenger,301,93,394,29550,29944,1.32,Washington,Washington
4284,December,2022,Chelan,WA,Passenger,536,143,679,54270,54949,1.24,Washington,Washington
4285,December,2022,Thurston,WA,Passenger,2627,1134,3761,192301,196062,1.92,Washington,Washington
4286,December,2022,Asotin,WA,Truck,0,0,0,6686,6686,0.0,Washington,Washington
4287,December,2022,Mason,WA,Passenger,370,191,561,46879,47440,1.18,Washington,Washington
4289,December,2022,Franklin,WA,Passenger,252,120,372,61769,62141,0.6,Washington,Washington
4292,December,2022,Klickitat,WA,Passenger,123,51,174,15155,15329,1.14,Washington,Washington
4298,December,2022,Kitsap,WA,Passenger,2765,1146,3911,177328,181239,2.16,Washington,Washington
4299,December,2022,Yakima,WA,Passenger,425,218,643,166458,167101,0.38,Washington,Washington
4302,December,2022,Grant,WA,Passenger,230,112,342,66890,67232,0.51,Washington,Washington
4305,December,2022,Pacific,WA,Truck,2,0,2,7838,7840,0.03,Washington,Washington
4311,December,2022,Clallam,WA,Passenger,482,262,744,49422,50166,1.48,Washington,Washington
4319,December,2022,Pierce,WA,Passenger,6159,2513,8672,539032,547704,1.58,Washington,Washington
4329,December,2022,Chelan,WA,Truck,13,0,13,23093,23106,0.06,Washington,Washington
4332,December,2022,Kitsap,WA,Truck,34,0,34,52973,53007,0.06,Washington,Washington
4339,February,2017,Columbia,WA,Passenger,0,1,1,2337,2338,0.04,Washington,Washington
4341,February,2017,Pacific,WA,Passenger,5,6,11,14997,15008,0.07,Washington,Washington
4342,February,2017,Island,WA,Passenger,100,122,222,59448,59670,0.37,Washington,Washington
4346,February,2017,Clark,WA,Truck,0,0,0,77521,77521,0.0,Washington,Washington
4348,February,2017,Cowlitz,WA,Passenger,50,46,96,69052,69148,0.14,Washington,Washington
4356,February,2017,Skagit,WA,Truck,1,0,1,31404,31405,0.0,Washington,Washington
4357,February,2017,Clark,WA,Passenger,695,434,1129,297935,299064,0.38,Washington,Washington
4362,February,2017,Adams,WA,Truck,0,0,0,5071,5071,0.0,Washington,Washington
4363,February,2017,Benton,WA,Passenger,134,133,267,127653,127920,0.21,Washington,Washington
4364,February,2017,Mason,WA,Truck,0,0,0,19196,19196,0.0,Washington,Washington
4367,February,2017,Douglas,WA,Passenger,30,19,49,26547,26596,0.18,Washington,Washington
4369,February,2017,Franklin,WA,Truck,0,0,0,17907,17907,0.0,Washington,Washington
4372,February,2017,Ferry,WA,Truck,0,0,0,3562,3562,0.0,Washington,Washington
4374,February,2017,Kittitas,WA,Truck,0,0,0,13383,13383,0.0,Washington,Washington
4376,February,2017,Franklin,WA,Passenger,26,42,68,55221,55289,0.12,Washington,Washington
4383,February,2017,Lincoln,WA,Passenger,2,4,6,7509,7515,0.08,Washington,Washington
4384,February,2017,Island,WA,Truck,0,0,0,20499,20499,0.0,Washington,Washington
4386,February,2017,Cowlitz,WA,Truck,0,0,0,27871,27871,0.0,Washington,Washington
4387,February,2017,Spokane,WA,Passenger,226,196,422,295023,295445,0.14,Washington,Washington
4390,February,2017,Jefferson,WA,Passenger,89,55,144,23601,23745,0.61,Washington,Washington
4392,February,2017,Clallam,WA,Passenger,75,64,139,47981,48120,0.29,Washington,Washington
4393,February,2017,Okanogan,WA,Truck,0,0,0,16300,16300,0.0,Washington,Washington
4394,February,2017,Wahkiakum,WA,Passenger,0,1,1,2843,2844,0.04,Washington,Washington
4397,February,2017,Grant,WA,Truck,0,0,0,24996,24996,0.0,Washington,Washington
4399,February,2017,Benton,WA,Truck,0,0,0,39743,39743,0.0,Washington,Washington
4401,February,2017,Lewis,WA,Passenger,45,31,76,54970,55046,0.14,Washington,Washington
4402,February,2017,Grant,WA,Passenger,16,21,37,60193,60230,0.06,Washington,Washington
4404,February,2017,King,WA,Passenger,9098,3713,12811,1385263,1398074,0.92,Washington,Washington
4405,February,2017,Whatcom,WA,Passenger,401,146,547,141888,142435,0.38,Washington,Washington
4406,February,2017,Stevens,WA,Truck,0,0,0,18333,18333,0.0,Washington,Washington
4407,February,2017,Whitman,WA,Passenger,8,18,26,21938,21964,0.12,Washington,Washington
4408,February,2017,San Juan,WA,Passenger,88,31,119,13403,13522,0.88,Washington,Washington
4411,February,2017,Walla Walla,WA,Passenger,17,21,38,34781,34819,0.11,Washington,Washington
4416,February,2017,Grays Harbor,WA,Passenger,27,24,51,44252,44303,0.12,Washington,Washington
4417,February,2017,Klickitat,WA,Truck,0,0,0,7937,7937,0.0,Washington,Washington
4420,February,2017,Klickitat,WA,Passenger,20,22,42,14768,14810,0.28,Washington,Washington
4421,February,2017,Asotin,WA,Truck,0,0,0,6475,6475,0.0,Washington,Washington
4422,February,2017,King,WA,Truck,8,1,9,190501,190510,0.0,Washington,Washington
4424,February,2017,Ferry,WA,Passenger,2,1,3,4391,4394,0.07,Washington,Washington
4426,February,2017,Pend Oreille,WA,Truck,0,0,0,5573,5573,0.0,Washington,Washington
4429,February,2017,Whatcom,WA,Truck,2,0,2,41327,41329,0.0,Washington,Washington
4433,February,2017,Walla Walla,WA,Truck,0,0,0,13161,13161,0.0,Washington,Washington
4436,February,2017,Pend Oreille,WA,Passenger,1,4,5,9300,9305,0.05,Washington,Washington
4437,February,2017,Douglas,WA,Truck,0,0,0,11387,11387,0.0,Washington,Washington
4439,February,2017,Okanogan,WA,Passenger,3,15,18,25674,25692,0.07,Washington,Washington
4444,February,2017,Snohomish,WA,Passenger,1604,824,2428,514072,516500,0.47,Washington,Washington
4445,February,2017,Chelan,WA,Passenger,55,29,84,51755,51839,0.16,Washington,Washington
4446,February,2017,Lewis,WA,Truck,0,0,0,24783,24783,0.0,Washington,Washington
4451,February,2017,Garfield,WA,Truck,0,0,0,934,934,0.0,Washington,Washington
4452,February,2017,Columbia,WA,Truck,0,0,0,1528,1528,0.0,Washington,Washington
4455,February,2017,Pierce,WA,Truck,0,0,0,138554,138554,0.0,Washington,Washington
4457,February,2017,Snohomish,WA,Truck,1,0,1,122505,122506,0.0,Washington,Washington
4461,February,2017,Lincoln,WA,Truck,0,0,0,4463,4463,0.0,Washington,Washington
4462,February,2017,Thurston,WA,Truck,0,0,0,53345,53345,0.0,Washington,Washington
4464,February,2017,Thurston,WA,Passenger,351,309,660,184902,185562,0.36,Washington,Washington
4468,February,2017,Whitman,WA,Truck,0,0,0,8399,8399,0.0,Washington,Washington
4469,February,2017,Clallam,WA,Truck,0,0,0,21029,21029,0.0,Washington,Washington
4474,February,2017,Skamania,WA,Truck,0,0,0,3889,3889,0.0,Washington,Washington
4475,February,2017,Yakima,WA,Passenger,36,50,86,159126,159212,0.05,Washington,Washington
4480,February,2017,Stevens,WA,Passenger,6,21,27,31317,31344,0.09,Washington,Washington
4485,February,2017,Pacific,WA,Truck,0,0,0,7486,7486,0.0,Washington,Washington
4486,February,2017,Skamania,WA,Passenger,7,7,14,8543,8557,0.16,Washington,Washington
4489,February,2017,Yakima,WA,Truck,0,0,0,57223,57223,0.0,Washington,Washington
4493,February,2017,Spokane,WA,Truck,1,0,1,90241,90242,0.0,Washington,Washington
4500,February,2017,Garfield,WA,Passenger,0,0,0,1290,1290,0.0,Washington,Washington
4501,February,2017,Kittitas,WA,Passenger,15,15,30,27062,27092,0.11,Washington,Washington
4505,February,2017,Skagit,WA,Passenger,113,86,199,87262,87461,0.23,Washington,Washington
4507,February,2017,Jefferson,WA,Truck,0,0,0,9472,9472,0.0,Washington,Washington
4508,February,2017,Pierce,WA,Passenger,862,778,1640,526771,528411,0.31,Washington,Washington
4511,February,2017,Grays Harbor,WA,Truck,0,0,0,19819,19819,0.0,Washington,Washington
4512,February,2017,Adams,WA,Passenger,2,2,4,12126,12130,0.03,Washington,Washington
4513,February,2017,Kitsap,WA,Truck,1,0,1,52347,52348,0.0,Washington,Washington
4514,February,2017,Asotin,WA,Passenger,4,3,7,12324,12331,0.06,Washington,Washington
4517,February,2017,San Juan,WA,Truck,0,0,0,5573,5573,0.0,Washington,Washington
4521,February,2017,Mason,WA,Passenger,47,63,110,42778,42888,0.26,Washington,Washington
4522,February,2017,Kitsap,WA,Passenger,561,280,841,172111,172952,0.49,Washington,Washington
4523,February,2017,Chelan,WA,Truck,0,0,0,21250,21250,0.0,Washington,Washington
4524,February,2017,Wahkiakum,WA,Truck,0,0,0,1625,1625,0.0,Washington,Washington
4526,February,2018,Mason,WA,Truck,0,0,0,19725,19725,0.0,Washington,Washington
4527,February,2018,Grant,WA,Passenger,31,38,69,62313,62382,0.11,Washington,Washington
4528,February,2018,Pacific,WA,Passenger,15,17,32,15463,15495,0.21,Washington,Washington
4529,February,2018,Wahkiakum,WA,Truck,0,0,0,1673,1673,0.0,Washington,Washington
4530,February,2018,Island,WA,Truck,0,0,0,20828,20828,0.0,Washington,Washington
4532,February,2018,Skagit,WA,Truck,1,0,1,31814,31815,0.0,Washington,Washington
4533,February,2018,Asotin,WA,Passenger,8,5,13,12588,12601,0.1,Washington,Washington
4535,February,2018,Garfield,WA,Truck,0,0,0,942,942,0.0,Washington,Washington
4536,February,2018,Walla Walla,WA,Passenger,31,35,66,35386,35452,0.19,Washington,Washington
4541,February,2018,Whitman,WA,Passenger,18,21,39,22530,22569,0.17,Washington,Washington
4542,February,2018,Yakima,WA,Truck,0,0,0,58125,58125,0.0,Washington,Washington
4544,February,2018,Grays Harbor,WA,Truck,0,0,0,20115,20115,0.0,Washington,Washington
4545,February,2018,Jefferson,WA,Truck,0,0,0,9511,9511,0.0,Washington,Washington
4546,February,2018,Garfield,WA,Passenger,1,0,1,1323,1324,0.08,Washington,Washington
4547,February,2018,Adams,WA,Truck,0,0,0,5139,5139,0.0,Washington,Washington
4550,February,2018,Adams,WA,Passenger,5,4,9,12458,12467,0.07,Washington,Washington
4556,February,2018,Clallam,WA,Passenger,109,101,210,49356,49566,0.42,Washington,Washington
4559,February,2018,Columbia,WA,Truck,0,0,0,1535,1535,0.0,Washington,Washington
4562,February,2018,Cowlitz,WA,Truck,0,0,0,28183,28183,0.0,Washington,Washington
4564,February,2018,Yakima,WA,Passenger,61,79,140,162333,162473,0.09,Washington,Washington
4567,February,2018,Ferry,WA,Truck,0,0,0,3527,3527,0.0,Washington,Washington
4568,February,2018,Whatcom,WA,Truck,1,0,1,42039,42040,0.0,Washington,Washington
4570,February,2018,Franklin,WA,Passenger,32,51,83,57008,57091,0.15,Washington,Washington
4572,February,2018,Pend Oreille,WA,Truck,0,0,0,5631,5631,0.0,Washington,Washington
4577,February,2018,Lincoln,WA,Passenger,2,5,7,7594,7601,0.09,Washington,Washington
4585,February,2018,Skagit,WA,Passenger,172,145,317,89751,90068,0.35,Washington,Washington
4586,February,2018,Thurston,WA,Passenger,492,414,906,190758,191664,0.47,Washington,Washington
4587,February,2018,Benton,WA,Passenger,175,179,354,130454,130808,0.27,Washington,Washington
4592,February,2018,Kitsap,WA,Passenger,716,418,1134,176380,177514,0.64,Washington,Washington
4594,February,2018,Clark,WA,Passenger,888,616,1504,305306,306810,0.49,Washington,Washington
4599,February,2018,Jefferson,WA,Passenger,127,80,207,24312,24519,0.84,Washington,Washington
4600,February,2018,Chelan,WA,Passenger,94,39,133,53238,53371,0.25,Washington,Washington
4605,February,2018,Franklin,WA,Truck,0,0,0,18577,18577,0.0,Washington,Washington
4607,February,2018,Pierce,WA,Truck,0,0,0,137016,137016,0.0,Washington,Washington
4612,February,2018,Spokane,WA,Passenger,306,263,569,300527,301096,0.19,Washington,Washington
4613,February,2018,Columbia,WA,Passenger,2,1,3,2407,2410,0.12,Washington,Washington
4618,February,2018,Lewis,WA,Truck,0,0,0,25269,25269,0.0,Washington,Washington
4619,February,2018,Snohomish,WA,Passenger,2088,1119,3207,517277,520484,0.62,Washington,Washington
4622,February,2018,Spokane,WA,Truck,1,0,1,91721,91722,0.0,Washington,Washington
4623,February,2018,Whitman,WA,Truck,0,0,0,8453,8453,0.0,Washington,Washington
4630,February,2018,Chelan,WA,Truck,0,0,0,21668,21668,0.0,Washington,Washington
4636,February,2018,Grant,WA,Truck,0,0,0,25680,25680,0.0,Washington,Washington
4637,February,2018,Pacific,WA,Truck,0,0,0,7561,7561,0.0,Washington,Washington
4639,February,2018,Cowlitz,WA,Passenger,54,70,124,70938,71062,0.17,Washington,Washington
4642,February,2018,Clark,WA,Truck,0,0,0,78570,78570,0.0,Washington,Washington
4643,February,2018,Klickitat,WA,Passenger,24,27,51,14944,14995,0.34,Washington,Washington
4644,February,2018,Douglas,WA,Passenger,43,33,76,27316,27392,0.28,Washington,Washington
4645,February,2018,Mason,WA,Passenger,64,80,144,45049,45193,0.32,Washington,Washington
4649,February,2018,Benton,WA,Truck,0,0,0,40752,40752,0.0,Washington,Washington
4654,February,2018,Okanogan,WA,Truck,0,0,0,16305,16305,0.0,Washington,Washington
4656,February,2018,Thurston,WA,Truck,0,0,0,53921,53921,0.0,Washington,Washington
4658,February,2018,Whatcom,WA,Passenger,556,249,805,145579,146384,0.55,Washington,Washington
4659,February,2018,Pend Oreille,WA,Passenger,4,3,7,9418,9425,0.07,Washington,Washington
4661,February,2018,Wahkiakum,WA,Passenger,0,2,2,2860,2862,0.07,Washington,Washington
4662,February,2018,Ferry,WA,Passenger,1,3,4,4396,4400,0.09,Washington,Washington
4666,February,2018,Lincoln,WA,Truck,0,0,0,4511,4511,0.0,Washington,Washington
4667,February,2018,Douglas,WA,Truck,0,0,0,11812,11812,0.0,Washington,Washington
4669,February,2018,Island,WA,Passenger,165,171,336,61877,62213,0.54,Washington,Washington
4670,February,2018,Stevens,WA,Truck,0,0,0,18404,18404,0.0,Washington,Washington
4676,February,2018,Pierce,WA,Passenger,1116,1028,2144,526413,528557,0.41,Washington,Washington
4677,February,2018,Okanogan,WA,Passenger,7,19,26,25665,25691,0.1,Washington,Washington
4679,February,2018,San Juan,WA,Truck,0,0,0,5641,5641,0.0,Washington,Washington
4681,February,2018,Kitsap,WA,Truck,1,0,1,52833,52834,0.0,Washington,Washington
4684,February,2018,Lewis,WA,Passenger,52,45,97,56859,56956,0.17,Washington,Washington
4689,February,2018,Snohomish,WA,Truck,1,0,1,121335,121336,0.0,Washington,Washington
4690,February,2018,King,WA,Truck,8,1,9,184086,184095,0.0,Washington,Washington
4691,February,2018,Walla Walla,WA,Truck,0,0,0,13323,13323,0.0,Washington,Washington
4692,February,2018,San Juan,WA,Passenger,140,48,188,13922,14110,1.33,Washington,Washington
4695,February,2018,Stevens,WA,Passenger,10,21,31,31515,31546,0.1,Washington,Washington
4700,February,2018,King,WA,Passenger,11758,5019,16777,1368249,1385026,1.21,Washington,Washington
4701,February,2018,Skamania,WA,Truck,0,0,0,3920,3920,0.0,Washington,Washington
4702,February,2018,Asotin,WA,Truck,0,0,0,6580,6580,0.0,Washington,Washington
4703,February,2018,Skamania,WA,Passenger,11,8,19,8624,8643,0.22,Washington,Washington
4704,February,2018,Kittitas,WA,Truck,0,0,0,13948,13948,0.0,Washington,Washington
4705,February,2018,Grays Harbor,WA,Passenger,42,44,86,45889,45975,0.19,Washington,Washington
4708,February,2018,Clallam,WA,Truck,0,0,0,21289,21289,0.0,Washington,Washington
4714,February,2018,Klickitat,WA,Truck,0,0,0,8038,8038,0.0,Washington,Washington
4715,February,2018,Kittitas,WA,Passenger,36,27,63,28690,28753,0.22,Washington,Washington
4716,February,2019,Grays Harbor,WA,Truck,0,0,0,20318,20318,0.0,Washington,Washington
4717,February,2019,Garfield,WA,Truck,0,0,0,961,961,0.0,Washington,Washington
4719,February,2019,Benton,WA,Passenger,233,245,478,132999,133477,0.36,Washington,Washington
4720,February,2019,Whatcom,WA,Passenger,785,380,1165,149641,150806,0.77,Washington,Washington
4728,February,2019,Benton,WA,Truck,0,0,0,41547,41547,0.0,Washington,Washington
4731,February,2019,Island,WA,Truck,0,0,0,21171,21171,0.0,Washington,Washington
4732,February,2019,Douglas,WA,Truck,0,0,0,12166,12166,0.0,Washington,Washington
4735,February,2019,Okanogan,WA,Truck,0,0,0,16468,16468,0.0,Washington,Washington
4737,February,2019,Grant,WA,Truck,0,0,0,26315,26315,0.0,Washington,Washington
4738,February,2019,Whitman,WA,Passenger,25,40,65,22756,22821,0.28,Washington,Washington
4744,February,2019,Pierce,WA,Truck,0,0,0,138931,138931,0.0,Washington,Washington
4751,February,2019,Yakima,WA,Truck,0,0,0,58797,58797,0.0,Washington,Washington
4753,February,2019,Island,WA,Passenger,294,231,525,63179,63704,0.82,Washington,Washington
4755,February,2019,Kittitas,WA,Passenger,73,37,110,29446,29556,0.37,Washington,Washington
4757,February,2019,Lewis,WA,Truck,0,0,0,25698,25698,0.0,Washington,Washington
4761,February,2019,Pend Oreille,WA,Passenger,5,5,10,9483,9493,0.11,Washington,Washington
4762,February,2019,Asotin,WA,Passenger,12,9,21,12682,12703,0.17,Washington,Washington
4766,February,2019,Lincoln,WA,Truck,0,0,0,4667,4667,0.0,Washington,Washington
4767,February,2019,Jefferson,WA,Passenger,179,113,292,24863,25155,1.16,Washington,Washington
4772,February,2019,Skamania,WA,Passenger,20,15,35,8715,8750,0.4,Washington,Washington
4775,February,2019,Wahkiakum,WA,Passenger,1,1,2,3020,3022,0.07,Washington,Washington
4779,February,2019,Cowlitz,WA,Truck,0,0,0,28726,28726,0.0,Washington,Washington
4780,February,2019,Skagit,WA,Passenger,278,187,465,91208,91673,0.51,Washington,Washington
4788,February,2019,Yakima,WA,Passenger,86,101,187,164464,164651,0.11,Washington,Washington
4790,February,2019,Snohomish,WA,Passenger,3146,1498,4644,527664,532308,0.87,Washington,Washington
4791,February,2019,Stevens,WA,Passenger,18,28,46,31733,31779,0.14,Washington,Washington
4795,February,2019,Franklin,WA,Truck,0,0,0,19115,19115,0.0,Washington,Washington
4796,February,2019,Ferry,WA,Truck,0,0,0,3592,3592,0.0,Washington,Washington
4801,February,2019,Garfield,WA,Passenger,1,1,2,1324,1326,0.15,Washington,Washington
4802,February,2019,Mason,WA,Passenger,109,117,226,46675,46901,0.48,Washington,Washington
4807,February,2019,King,WA,Passenger,17528,6762,24290,1379846,1404136,1.73,Washington,Washington
4808,February,2019,Ferry,WA,Passenger,3,2,5,4377,4382,0.11,Washington,Washington
4812,February,2019,Thurston,WA,Truck,0,0,0,54906,54906,0.0,Washington,Washington
4813,February,2019,Clallam,WA,Truck,0,0,0,21577,21577,0.0,Washington,Washington
4817,February,2019,Skamania,WA,Truck,0,0,0,3990,3990,0.0,Washington,Washington
4824,February,2019,Franklin,WA,Passenger,50,70,120,59299,59419,0.2,Washington,Washington
4825,February,2019,Spokane,WA,Truck,1,0,1,93888,93889,0.0,Washington,Washington
4826,February,2019,Snohomish,WA,Truck,1,0,1,121877,121878,0.0,Washington,Washington
4830,February,2019,Wahkiakum,WA,Truck,0,0,0,1720,1720,0.0,Washington,Washington
4831,February,2019,Klickitat,WA,Passenger,30,32,62,15450,15512,0.4,Washington,Washington
4839,February,2019,Columbia,WA,Truck,0,0,0,1525,1525,0.0,Washington,Washington
4840,February,2019,Clallam,WA,Passenger,153,127,280,50344,50624,0.55,Washington,Washington
4842,February,2019,Klickitat,WA,Truck,0,0,0,8221,8221,0.0,Washington,Washington
4847,February,2019,Thurston,WA,Passenger,782,594,1376,195890,197266,0.7,Washington,Washington
4851,February,2019,Walla Walla,WA,Truck,0,0,0,13543,13543,0.0,Washington,Washington
4854,February,2019,Clark,WA,Truck,0,0,0,79977,79977,0.0,Washington,Washington
4855,February,2019,Walla Walla,WA,Passenger,43,54,97,36066,36163,0.27,Washington,Washington
4858,February,2019,San Juan,WA,Truck,0,0,0,5799,5799,0.0,Washington,Washington
4859,February,2019,Pacific,WA,Truck,0,0,0,7634,7634,0.0,Washington,Washington
4861,February,2019,Kitsap,WA,Truck,1,0,1,53701,53702,0.0,Washington,Washington
4862,February,2019,Jefferson,WA,Truck,0,0,0,9623,9623,0.0,Washington,Washington
4866,February,2019,Pend Oreille,WA,Truck,0,0,0,5738,5738,0.0,Washington,Washington
4868,February,2019,King,WA,Truck,6,1,7,182021,182028,0.0,Washington,Washington
4872,February,2019,San Juan,WA,Passenger,193,69,262,14274,14536,1.8,Washington,Washington
4873,February,2019,Whitman,WA,Truck,0,0,0,8490,8490,0.0,Washington,Washington
4875,February,2019,Kittitas,WA,Truck,0,0,0,14260,14260,0.0,Washington,Washington
4876,February,2019,Pierce,WA,Passenger,1611,1428,3039,538910,541949,0.56,Washington,Washington
4877,February,2019,Adams,WA,Passenger,4,6,10,12671,12681,0.08,Washington,Washington
4878,February,2019,Skagit,WA,Truck,1,0,1,32291,32292,0.0,Washington,Washington
4880,February,2019,Cowlitz,WA,Passenger,82,100,182,72440,72622,0.25,Washington,Washington
4881,February,2019,Clark,WA,Passenger,1337,866,2203,311844,314047,0.7,Washington,Washington
4884,February,2019,Kitsap,WA,Passenger,988,571,1559,179782,181341,0.86,Washington,Washington
4887,February,2019,Asotin,WA,Truck,0,0,0,6644,6644,0.0,Washington,Washington
4889,February,2019,Lincoln,WA,Passenger,3,5,8,7735,7743,0.1,Washington,Washington
4890,February,2019,Pacific,WA,Passenger,22,26,48,15864,15912,0.3,Washington,Washington
4893,February,2019,Mason,WA,Truck,0,0,0,20229,20229,0.0,Washington,Washington
4902,February,2019,Chelan,WA,Passenger,145,66,211,54157,54368,0.39,Washington,Washington
4903,February,2019,Grant,WA,Passenger,33,55,88,64279,64367,0.14,Washington,Washington
4904,February,2019,Stevens,WA,Truck,0,0,0,18757,18757,0.0,Washington,Washington
4912,February,2019,Douglas,WA,Passenger,52,35,87,27939,28026,0.31,Washington,Washington
4914,February,2019,Lewis,WA,Passenger,96,84,180,58309,58489,0.31,Washington,Washington
4916,February,2019,Okanogan,WA,Passenger,19,21,40,25964,26004,0.15,Washington,Washington
4917,February,2019,Spokane,WA,Passenger,481,386,867,307236,308103,0.28,Washington,Washington
4922,February,2019,Adams,WA,Truck,0,0,0,5109,5109,0.0,Washington,Washington
4927,February,2019,Columbia,WA,Passenger,2,2,4,2430,2434,0.16,Washington,Washington
4929,February,2019,Whatcom,WA,Truck,2,0,2,42708,42710,0.0,Washington,Washington
4934,February,2019,Chelan,WA,Truck,0,0,0,22097,22097,0.0,Washington,Washington
4935,February,2019,Grays Harbor,WA,Passenger,66,79,145,47455,47600,0.3,Washington,Washington
4946,February,2021,Island,WA,Passenger,546,296,842,62878,63720,1.32,Washington,Washington
4949,February,2021,Spokane,WA,Passenger,923,560,1483,321417,322900,0.46,Washington,Washington
4954,February,2021,Wahkiakum,WA,Passenger,8,6,14,3045,3059,0.46,Washington,Washington
4958,February,2021,Wahkiakum,WA,Truck,0,0,0,1782,1782,0.0,Washington,Washington
4966,February,2021,Thurston,WA,Truck,0,0,0,56448,56448,0.0,Washington,Washington
4968,February,2021,Franklin,WA,Truck,0,0,0,20510,20510,0.0,Washington,Washington
4969,February,2021,King,WA,Truck,6,1,7,184321,184328,0.0,Washington,Washington
4972,February,2021,Grant,WA,Passenger,90,86,176,66076,66252,0.27,Washington,Washington
4978,February,2021,Columbia,WA,Truck,0,0,0,1543,1543,0.0,Washington,Washington
4980,February,2021,Kittitas,WA,Passenger,142,53,195,29825,30020,0.65,Washington,Washington
4984,February,2021,Lewis,WA,Truck,0,0,0,26704,26704,0.0,Washington,Washington
4986,February,2021,Pacific,WA,Passenger,37,38,75,15822,15897,0.47,Washington,Washington
4988,February,2021,Okanogan,WA,Passenger,56,35,91,26131,26222,0.35,Washington,Washington
4991,February,2021,Walla Walla,WA,Truck,0,0,0,13907,13907,0.0,Washington,Washington
4992,February,2021,Grays Harbor,WA,Passenger,142,130,272,48797,49069,0.55,Washington,Washington
4997,February,2021,Douglas,WA,Passenger,86,46,132,28249,28381,0.47,Washington,Washington
5000,February,2021,Okanogan,WA,Truck,0,0,0,16631,16631,0.0,Washington,Washington
5001,February,2021,Stevens,WA,Truck,0,0,0,18720,18720,0.0,Washington,Washington
5007,February,2021,Kitsap,WA,Passenger,1642,777,2419,179346,181765,1.33,Washington,Washington
5013,February,2021,Whatcom,WA,Passenger,1277,572,1849,150039,151888,1.22,Washington,Washington
5017,February,2021,Island,WA,Truck,0,0,0,21432,21432,0.0,Washington,Washington
5020,February,2021,Klickitat,WA,Passenger,65,45,110,14999,15109,0.73,Washington,Washington
5021,February,2021,Yakima,WA,Truck,0,0,0,61147,61147,0.0,Washington,Washington
5022,February,2021,Jefferson,WA,Truck,0,0,0,9576,9576,0.0,Washington,Washington
5024,February,2021,San Juan,WA,Passenger,383,118,501,14058,14559,3.44,Washington,Washington
5027,February,2021,Skamania,WA,Passenger,37,24,61,8292,8353,0.73,Washington,Washington
5029,February,2021,Chelan,WA,Truck,0,0,0,22878,22878,0.0,Washington,Washington
5032,February,2021,Walla Walla,WA,Passenger,105,69,174,36134,36308,0.48,Washington,Washington
5033,February,2021,Whitman,WA,Passenger,53,46,99,21854,21953,0.45,Washington,Washington
5036,February,2021,Thurston,WA,Passenger,1383,811,2194,197237,199431,1.1,Washington,Washington
5052,February,2021,Clallam,WA,Truck,1,0,1,21901,21902,0.0,Washington,Washington
5053,February,2021,Skagit,WA,Passenger,535,247,782,91350,92132,0.85,Washington,Washington
5057,February,2021,Yakima,WA,Passenger,184,135,319,167503,167822,0.19,Washington,Washington
5062,February,2021,Whatcom,WA,Truck,3,0,3,43636,43639,0.01,Washington,Washington
5064,February,2021,Whitman,WA,Truck,0,0,0,8514,8514,0.0,Washington,Washington
5071,February,2021,Snohomish,WA,Truck,1,0,1,125733,125734,0.0,Washington,Washington
5073,February,2021,Adams,WA,Truck,0,0,0,5344,5344,0.0,Washington,Washington
5074,February,2021,Kitsap,WA,Truck,0,0,0,54278,54278,0.0,Washington,Washington
5079,February,2021,Kittitas,WA,Truck,0,0,0,14694,14694,0.0,Washington,Washington
5080,February,2021,Stevens,WA,Passenger,38,42,80,30228,30308,0.26,Washington,Washington
5082,February,2021,Pacific,WA,Truck,0,0,0,7828,7828,0.0,Washington,Washington
5083,February,2021,Skagit,WA,Truck,1,0,1,32853,32854,0.0,Washington,Washington
5091,February,2021,Clallam,WA,Passenger,282,195,477,49992,50469,0.95,Washington,Washington
5095,February,2021,Spokane,WA,Truck,0,0,0,101004,101004,0.0,Washington,Washington
5096,February,2021,Asotin,WA,Passenger,17,14,31,12486,12517,0.25,Washington,Washington
5098,February,2021,Lincoln,WA,Passenger,6,13,19,7648,7667,0.25,Washington,Washington
5101,February,2021,Pend Oreille,WA,Truck,0,0,0,5722,5722,0.0,Washington,Washington
5106,February,2021,Columbia,WA,Passenger,5,4,9,2453,2462,0.37,Washington,Washington
5111,February,2021,Clark,WA,Truck,0,0,0,83537,83537,0.0,Washington,Washington
5112,February,2021,Chelan,WA,Passenger,301,88,389,54492,54881,0.71,Washington,Washington
5113,February,2021,Adams,WA,Passenger,10,6,16,12975,12991,0.12,Washington,Washington
5116,February,2021,Klickitat,WA,Truck,0,0,0,8118,8118,0.0,Washington,Washington
5118,February,2021,Asotin,WA,Truck,0,0,0,6696,6696,0.0,Washington,Washington
5121,February,2021,Skamania,WA,Truck,0,0,0,4030,4030,0.0,Washington,Washington
5123,February,2021,Snohomish,WA,Passenger,5270,1894,7164,538252,545416,1.31,Washington,Washington
5126,February,2021,Mason,WA,Passenger,177,135,312,47649,47961,0.65,Washington,Washington
5127,February,2021,Pend Oreille,WA,Passenger,12,4,16,9194,9210,0.17,Washington,Washington
5130,February,2021,Ferry,WA,Truck,0,0,0,3625,3625,0.0,Washington,Washington
5131,February,2021,Cowlitz,WA,Passenger,194,130,324,71935,72259,0.45,Washington,Washington
5135,February,2021,Grays Harbor,WA,Truck,0,0,0,21251,21251,0.0,Washington,Washington
5137,February,2021,San Juan,WA,Truck,0,0,0,5867,5867,0.0,Washington,Washington
5138,February,2021,Pierce,WA,Truck,0,0,0,145031,145031,0.0,Washington,Washington
5149,February,2021,Cowlitz,WA,Truck,0,0,0,28976,28976,0.0,Washington,Washington
5152,February,2021,Douglas,WA,Truck,0,0,0,12517,12517,0.0,Washington,Washington
5154,February,2021,Garfield,WA,Passenger,0,2,2,1356,1358,0.15,Washington,Washington
5157,February,2021,Mason,WA,Truck,0,0,0,21053,21053,0.0,Washington,Washington
5162,February,2021,Garfield,WA,Truck,0,0,0,1006,1006,0.0,Washington,Washington
5164,February,2021,Pierce,WA,Passenger,3029,1810,4839,555482,560321,0.86,Washington,Washington
5165,February,2021,Benton,WA,Passenger,460,362,822,135084,135906,0.6,Washington,Washington
5167,February,2021,Franklin,WA,Passenger,92,87,179,61606,61785,0.29,Washington,Washington
5171,February,2021,Lincoln,WA,Truck,0,0,0,4689,4689,0.0,Washington,Washington
5175,February,2021,Clark,WA,Passenger,2505,1245,3750,318957,322707,1.16,Washington,Washington
5178,February,2021,Benton,WA,Truck,0,0,0,43381,43381,0.0,Washington,Washington
5179,February,2021,Jefferson,WA,Passenger,295,168,463,24790,25253,1.83,Washington,Washington
5181,February,2021,King,WA,Passenger,28230,8448,36678,1364916,1401594,2.62,Washington,Washington
5185,February,2021,Lewis,WA,Passenger,127,132,259,58860,59119,0.44,Washington,Washington
5186,February,2021,Grant,WA,Truck,0,0,0,27662,27662,0.0,Washington,Washington
5187,February,2021,Ferry,WA,Passenger,10,3,13,4332,4345,0.3,Washington,Washington
5189,February,2022,Pacific,WA,Passenger,58,65,123,16024,16147,0.76,Washington,Washington
5191,February,2022,Whatcom,WA,Passenger,1690,685,2375,149351,151726,1.57,Washington,Washington
5197,February,2022,Clallam,WA,Passenger,393,243,636,50137,50773,1.25,Washington,Washington
5198,February,2022,Mason,WA,Truck,0,0,0,21184,21184,0.0,Washington,Washington
5201,February,2022,Stevens,WA,Truck,0,0,0,18976,18976,0.0,Washington,Washington
5208,February,2022,San Juan,WA,Truck,1,0,1,6017,6018,0.02,Washington,Washington
5213,February,2022,Benton,WA,Passenger,664,451,1115,135846,136961,0.81,Washington,Washington
5219,February,2022,Skagit,WA,Passenger,716,316,1032,90675,91707,1.13,Washington,Washington
5221,February,2022,Thurston,WA,Passenger,1970,990,2960,196039,198999,1.49,Washington,Washington
5229,February,2022,Grays Harbor,WA,Truck,0,0,0,21340,21340,0.0,Washington,Washington
5237,February,2022,Spokane,WA,Passenger,1392,784,2176,326237,328413,0.66,Washington,Washington
5240,February,2022,Clark,WA,Passenger,3627,1600,5227,319148,324375,1.61,Washington,Washington
5241,February,2022,Garfield,WA,Passenger,0,3,3,1353,1356,0.22,Washington,Washington
5243,February,2022,Lincoln,WA,Truck,0,0,0,4845,4845,0.0,Washington,Washington
5244,February,2022,Kitsap,WA,Passenger,2230,982,3212,179653,182865,1.76,Washington,Washington
5246,February,2022,Benton,WA,Truck,0,0,0,43644,43644,0.0,Washington,Washington
5247,February,2022,Clallam,WA,Truck,1,0,1,22104,22105,0.0,Washington,Washington
5250,February,2022,Lewis,WA,Truck,0,0,0,26607,26607,0.0,Washington,Washington
5259,February,2022,Columbia,WA,Passenger,6,1,7,2457,2464,0.28,Washington,Washington
5260,February,2022,San Juan,WA,Passenger,485,152,637,14178,14815,4.3,Washington,Washington
5261,February,2022,Kittitas,WA,Truck,0,0,0,14753,14753,0.0,Washington,Washington
5265,February,2022,Jefferson,WA,Truck,0,0,0,9576,9576,0.0,Washington,Washington
5267,February,2022,Pierce,WA,Passenger,4484,2176,6660,552620,559280,1.19,Washington,Washington
5268,February,2022,Adams,WA,Passenger,17,14,31,13020,13051,0.24,Washington,Washington
5271,February,2022,Wahkiakum,WA,Truck,0,0,0,1815,1815,0.0,Washington,Washington
5272,February,2022,Asotin,WA,Truck,0,0,0,6741,6741,0.0,Washington,Washington
5274,February,2022,Garfield,WA,Truck,0,0,0,998,998,0.0,Washington,Washington
5277,February,2022,Klickitat,WA,Truck,0,0,0,8332,8332,0.0,Washington,Washington
5280,February,2022,Pend Oreille,WA,Truck,0,0,0,5718,5718,0.0,Washington,Washington
5285,February,2022,Island,WA,Passenger,745,351,1096,62408,63504,1.73,Washington,Washington
5288,February,2022,Thurston,WA,Truck,3,0,3,55853,55856,0.01,Washington,Washington
5289,February,2022,Grant,WA,Truck,0,0,0,28009,28009,0.0,Washington,Washington
5296,February,2022,Chelan,WA,Truck,0,0,0,23075,23075,0.0,Washington,Washington
5299,February,2022,Snohomish,WA,Truck,3,0,3,125152,125155,0.0,Washington,Washington
5311,February,2022,Yakima,WA,Passenger,301,178,479,168019,168498,0.28,Washington,Washington
5313,February,2022,Grant,WA,Passenger,142,99,241,66798,67039,0.36,Washington,Washington
5317,February,2022,Walla Walla,WA,Truck,0,0,0,14072,14072,0.0,Washington,Washington
5323,February,2022,Kittitas,WA,Passenger,218,72,290,29778,30068,0.96,Washington,Washington
5337,February,2022,Pierce,WA,Truck,2,0,2,144061,144063,0.0,Washington,Washington
5339,February,2022,Okanogan,WA,Passenger,74,47,121,26474,26595,0.45,Washington,Washington
5342,February,2022,Franklin,WA,Truck,0,0,0,20925,20925,0.0,Washington,Washington
5343,February,2022,Jefferson,WA,Passenger,394,202,596,24685,25281,2.36,Washington,Washington
5344,February,2022,Ferry,WA,Passenger,15,3,18,4443,4461,0.4,Washington,Washington
5345,February,2022,Whitman,WA,Truck,0,0,0,8578,8578,0.0,Washington,Washington
5346,February,2022,Whitman,WA,Passenger,70,56,126,22020,22146,0.57,Washington,Washington
5355,February,2022,Stevens,WA,Passenger,58,47,105,30105,30210,0.35,Washington,Washington
5357,February,2022,Skagit,WA,Truck,1,0,1,32638,32639,0.0,Washington,Washington
5360,February,2022,Island,WA,Truck,1,0,1,21490,21491,0.0,Washington,Washington
5363,February,2022,Skamania,WA,Truck,0,0,0,4001,4001,0.0,Washington,Washington
5364,February,2022,Kitsap,WA,Truck,0,0,0,54096,54096,0.0,Washington,Washington
5367,February,2022,Lincoln,WA,Passenger,7,17,24,7685,7709,0.31,Washington,Washington
5368,February,2022,Pacific,WA,Truck,0,0,0,8006,8006,0.0,Washington,Washington
5369,February,2022,Walla Walla,WA,Passenger,152,91,243,36233,36476,0.67,Washington,Washington
5370,February,2022,Whatcom,WA,Truck,4,0,4,43608,43612,0.01,Washington,Washington
5378,February,2022,Wahkiakum,WA,Passenger,17,11,28,3096,3124,0.9,Washington,Washington
5382,February,2022,Asotin,WA,Passenger,22,18,40,12641,12681,0.32,Washington,Washington
5386,February,2022,Douglas,WA,Truck,0,0,0,12686,12686,0.0,Washington,Washington
5394,February,2022,King,WA,Passenger,37216,10526,47742,1354857,1402599,3.4,Washington,Washington
5396,February,2022,Adams,WA,Truck,0,0,0,5459,5459,0.0,Washington,Washington
5400,February,2022,Cowlitz,WA,Passenger,280,168,448,71262,71710,0.62,Washington,Washington
5403,February,2022,Snohomish,WA,Passenger,7454,2311,9765,535946,545711,1.79,Washington,Washington
5405,February,2022,Okanogan,WA,Truck,0,0,0,16714,16714,0.0,Washington,Washington
5409,February,2022,Chelan,WA,Passenger,429,121,550,54566,55116,1.0,Washington,Washington
5410,February,2022,Lewis,WA,Passenger,221,166,387,59453,59840,0.65,Washington,Washington
5418,February,2022,Spokane,WA,Truck,0,0,0,102602,102602,0.0,Washington,Washington
5420,February,2022,Yakima,WA,Truck,0,0,0,61654,61654,0.0,Washington,Washington
5422,February,2022,Cowlitz,WA,Truck,0,1,1,28908,28909,0.0,Washington,Washington
5427,February,2022,Clark,WA,Truck,2,0,2,83758,83760,0.0,Washington,Washington
5428,February,2022,King,WA,Truck,22,1,23,182492,182515,0.01,Washington,Washington
5430,February,2022,Skamania,WA,Passenger,59,45,104,8311,8415,1.24,Washington,Washington
5431,February,2022,Klickitat,WA,Passenger,92,53,145,15306,15451,0.94,Washington,Washington
5432,February,2022,Pend Oreille,WA,Passenger,17,9,26,9075,9101,0.29,Washington,Washington
5437,February,2022,Mason,WA,Passenger,280,166,446,47722,48168,0.93,Washington,Washington
5440,February,2022,Grays Harbor,WA,Passenger,202,157,359,49318,49677,0.72,Washington,Washington
5441,February,2022,Ferry,WA,Truck,0,0,0,3567,3567,0.0,Washington,Washington
5442,February,2022,Columbia,WA,Truck,0,0,0,1571,1571,0.0,Washington,Washington
5446,February,2022,Douglas,WA,Passenger,122,55,177,28558,28735,0.62,Washington,Washington
5448,February,2022,Franklin,WA,Passenger,175,102,277,62074,62351,0.44,Washington,Washington
5455,February,2023,Skagit,WA,Passenger,987,377,1364,89175,90539,1.51,Washington,Washington
5458,February,2023,Cowlitz,WA,Passenger,424,193,617,70210,70827,0.87,Washington,Washington
5459,February,2023,Benton,WA,Truck,15,0,15,43323,43338,0.03,Washington,Washington
5464,February,2023,Ferry,WA,Truck,0,0,0,3565,3565,0.0,Washington,Washington
5467,February,2023,Lewis,WA,Truck,4,0,4,26200,26204,0.02,Washington,Washington
5470,February,2023,Clark,WA,Passenger,5174,2109,7283,313862,321145,2.27,Washington,Washington
5472,February,2023,Whitman,WA,Truck,4,0,4,8658,8662,0.05,Washington,Washington
5477,February,2023,Columbia,WA,Truck,0,0,0,1574,1574,0.0,Washington,Washington
5478,February,2023,Klickitat,WA,Truck,4,0,4,8261,8265,0.05,Washington,Washington
5480,February,2023,Spokane,WA,Passenger,2041,983,3024,323909,326933,0.92,Washington,Washington
5482,February,2023,Clallam,WA,Passenger,504,272,776,49281,50057,1.55,Washington,Washington
5484,February,2023,San Juan,WA,Passenger,580,172,752,13878,14630,5.14,Washington,Washington
5487,February,2023,Island,WA,Truck,20,0,20,21105,21125,0.09,Washington,Washington
5488,February,2023,Yakima,WA,Passenger,445,240,685,166120,166805,0.41,Washington,Washington
5489,February,2023,Kitsap,WA,Passenger,2890,1171,4061,176810,180871,2.25,Washington,Washington
5497,February,2023,Snohomish,WA,Truck,122,0,122,122092,122214,0.1,Washington,Washington
5498,February,2023,Stevens,WA,Truck,2,0,2,18777,18779,0.01,Washington,Washington
5500,February,2023,Adams,WA,Passenger,21,11,32,13008,13040,0.25,Washington,Washington
5501,February,2023,Garfield,WA,Truck,0,0,0,979,979,0.0,Washington,Washington
5503,February,2023,Whitman,WA,Passenger,124,71,195,22018,22213,0.88,Washington,Washington
5507,February,2023,San Juan,WA,Truck,10,0,10,5886,5896,0.17,Washington,Washington
5509,February,2023,Wahkiakum,WA,Truck,1,0,1,1793,1794,0.06,Washington,Washington
5511,February,2023,Douglas,WA,Truck,6,0,6,12882,12888,0.05,Washington,Washington
5512,February,2023,Lincoln,WA,Truck,0,0,0,4846,4846,0.0,Washington,Washington
5516,February,2023,Klickitat,WA,Passenger,127,57,184,15144,15328,1.2,Washington,Washington
5519,February,2023,Walla Walla,WA,Passenger,206,108,314,35642,35956,0.87,Washington,Washington
5525,February,2023,Chelan,WA,Truck,19,0,19,23120,23139,0.08,Washington,Washington
5528,February,2023,Kittitas,WA,Truck,6,0,6,14560,14566,0.04,Washington,Washington
5530,February,2023,Grays Harbor,WA,Truck,2,0,2,21049,21051,0.01,Washington,Washington
5532,February,2023,Skamania,WA,Passenger,93,53,146,8095,8241,1.77,Washington,Washington
5533,February,2023,Island,WA,Passenger,977,411,1388,61460,62848,2.21,Washington,Washington
5538,February,2023,Lewis,WA,Passenger,292,186,478,59690,60168,0.79,Washington,Washington
5546,February,2023,Pierce,WA,Passenger,6593,2579,9172,535692,544864,1.68,Washington,Washington
5547,February,2023,King,WA,Truck,495,2,497,177291,177788,0.28,Washington,Washington
5548,February,2023,Whatcom,WA,Truck,44,0,44,42882,42926,0.1,Washington,Washington
5551,February,2023,Spokane,WA,Truck,26,0,26,101868,101894,0.03,Washington,Washington
5552,February,2023,Ferry,WA,Passenger,21,4,25,4341,4366,0.57,Washington,Washington
5560,February,2023,Grays Harbor,WA,Passenger,272,171,443,48597,49040,0.9,Washington,Washington
5563,February,2023,Douglas,WA,Passenger,180,59,239,28618,28857,0.83,Washington,Washington
5565,February,2023,Thurston,WA,Truck,49,0,49,54485,54534,0.09,Washington,Washington
5566,February,2023,Skagit,WA,Truck,13,0,13,32041,32054,0.04,Washington,Washington
5570,February,2023,Asotin,WA,Passenger,30,20,50,12475,12525,0.4,Washington,Washington
5576,February,2023,King,WA,Passenger,50928,12806,63734,1330234,1393968,4.57,Washington,Washington
5581,February,2023,Okanogan,WA,Truck,2,0,2,16449,16451,0.01,Washington,Washington
5587,February,2023,Jefferson,WA,Truck,9,0,9,9332,9341,0.1,Washington,Washington
5595,February,2023,Jefferson,WA,Passenger,508,242,750,24237,24987,3.0,Washington,Washington
5598,February,2023,Pend Oreille,WA,Truck,0,0,0,5573,5573,0.0,Washington,Washington
5599,February,2023,Walla Walla,WA,Truck,3,0,3,13814,13817,0.02,Washington,Washington
5601,February,2023,Mason,WA,Truck,9,0,9,20863,20872,0.04,Washington,Washington
5603,February,2023,Clallam,WA,Truck,12,0,12,21812,21824,0.05,Washington,Washington
5604,February,2023,Benton,WA,Passenger,989,517,1506,135708,137214,1.1,Washington,Washington
5607,February,2023,Grant,WA,Truck,7,0,7,28056,28063,0.02,Washington,Washington
5608,February,2023,Lincoln,WA,Passenger,16,17,33,7744,7777,0.42,Washington,Washington
5614,February,2023,Snohomish,WA,Passenger,10921,2841,13762,529463,543225,2.53,Washington,Washington
5615,February,2023,Stevens,WA,Passenger,99,58,157,29968,30125,0.52,Washington,Washington
5620,February,2023,Clark,WA,Truck,70,0,70,81540,81610,0.09,Washington,Washington
5621,February,2023,Chelan,WA,Passenger,566,151,717,54278,54995,1.3,Washington,Washington
5623,February,2023,Pacific,WA,Passenger,71,82,153,15680,15833,0.97,Washington,Washington
5629,February,2023,Adams,WA,Truck,2,0,2,5362,5364,0.04,Washington,Washington
5633,February,2023,Wahkiakum,WA,Passenger,26,15,41,3046,3087,1.33,Washington,Washington
5636,February,2023,Yakima,WA,Truck,9,0,9,61121,61130,0.01,Washington,Washington
5637,February,2023,Kitsap,WA,Truck,49,0,49,52804,52853,0.09,Washington,Washington
5638,February,2023,Okanogan,WA,Passenger,107,56,163,26100,26263,0.62,Washington,Washington
5639,February,2023,Garfield,WA,Passenger,1,3,4,1315,1319,0.3,Washington,Washington
5648,February,2023,Thurston,WA,Passenger,2773,1153,3926,191440,195366,2.01,Washington,Washington
5651,February,2023,Columbia,WA,Passenger,8,1,9,2424,2433,0.37,Washington,Washington
5652,February,2023,Franklin,WA,Passenger,275,128,403,61808,62211,0.65,Washington,Washington
5654,February,2023,Franklin,WA,Truck,4,0,4,20960,20964,0.02,Washington,Washington
5656,February,2023,Pierce,WA,Truck,111,0,111,138554,138665,0.08,Washington,Washington
5658,February,2023,Pacific,WA,Truck,2,0,2,7825,7827,0.03,Washington,Washington
5661,February,2023,Asotin,WA,Truck,0,0,0,6661,6661,0.0,Washington,Washington
5664,February,2023,Cowlitz,WA,Truck,7,0,7,28319,28326,0.02,Washington,Washington
5669,February,2023,Grant,WA,Passenger,241,114,355,66906,67261,0.53,Washington,Washington
5672,February,2023,Mason,WA,Passenger,394,199,593,46628,47221,1.26,Washington,Washington
5673,February,2023,Whatcom,WA,Passenger,2212,826,3038,148577,151615,2.0,Washington,Washington
5675,February,2023,Pend Oreille,WA,Passenger,26,13,39,8936,8975,0.43,Washington,Washington
5678,February,2023,Kittitas,WA,Passenger,322,92,414,29510,29924,1.38,Washington,Washington
5679,February,2023,Skamania,WA,Truck,1,0,1,3860,3861,0.03,Washington,Washington
5704,February,2020,Franklin,WA,Truck,0,0,0,19897,19897,0.0,Washington,Washington
5705,February,2020,Skamania,WA,Truck,0,0,0,4102,4102,0.0,Washington,Washington
5706,February,2020,Garfield,WA,Passenger,0,1,1,1349,1350,0.07,Washington,Washington
5711,February,2020,Jefferson,WA,Passenger,230,139,369,25171,25540,1.44,Washington,Washington
5712,February,2020,Whitman,WA,Truck,0,0,0,8555,8555,0.0,Washington,Washington
5714,February,2020,Skagit,WA,Truck,1,0,1,32559,32560,0.0,Washington,Washington
5716,February,2020,Okanogan,WA,Passenger,34,31,65,26121,26186,0.25,Washington,Washington
5717,February,2020,Okanogan,WA,Truck,0,0,0,16498,16498,0.0,Washington,Washington
5722,February,2020,Pierce,WA,Passenger,2253,1684,3937,551186,555123,0.71,Washington,Washington
5733,February,2020,Clark,WA,Passenger,1970,1058,3028,320541,323569,0.94,Washington,Washington
5739,February,2020,Cowlitz,WA,Passenger,128,111,239,73460,73699,0.32,Washington,Washington
5742,February,2020,Asotin,WA,Truck,0,0,0,6695,6695,0.0,Washington,Washington
5746,February,2020,Lincoln,WA,Passenger,1,12,13,7781,7794,0.17,Washington,Washington
5747,February,2020,Grays Harbor,WA,Truck,0,0,0,20809,20809,0.0,Washington,Washington
5748,February,2020,Mason,WA,Passenger,150,135,285,47595,47880,0.6,Washington,Washington
5755,February,2020,Garfield,WA,Truck,0,0,0,965,965,0.0,Washington,Washington
5758,February,2020,Spokane,WA,Passenger,696,469,1165,317560,318725,0.37,Washington,Washington
5762,February,2020,Klickitat,WA,Truck,0,0,0,8301,8301,0.0,Washington,Washington
5763,February,2020,Lewis,WA,Passenger,108,105,213,59582,59795,0.36,Washington,Washington
5766,February,2020,Kitsap,WA,Truck,1,0,1,54392,54393,0.0,Washington,Washington
5768,February,2020,Clark,WA,Truck,0,0,0,81980,81980,0.0,Washington,Washington
5772,February,2020,Grant,WA,Truck,0,0,0,27065,27065,0.0,Washington,Washington
5773,February,2020,Cowlitz,WA,Truck,0,0,0,28994,28994,0.0,Washington,Washington
5774,February,2020,Skagit,WA,Passenger,379,215,594,92466,93060,0.64,Washington,Washington
5778,February,2020,Pend Oreille,WA,Passenger,8,7,15,9454,9469,0.16,Washington,Washington
5782,February,2020,Douglas,WA,Passenger,69,40,109,28271,28380,0.38,Washington,Washington
5783,February,2020,Grant,WA,Passenger,58,70,128,65569,65697,0.19,Washington,Washington
5787,February,2020,Spokane,WA,Truck,1,0,1,97160,97161,0.0,Washington,Washington
5788,February,2020,Wahkiakum,WA,Truck,0,0,0,1762,1762,0.0,Washington,Washington
5792,February,2020,Grays Harbor,WA,Passenger,109,108,217,48374,48591,0.45,Washington,Washington
5794,February,2020,Yakima,WA,Passenger,122,116,238,165956,166194,0.14,Washington,Washington
5795,February,2020,Lewis,WA,Truck,0,0,0,26101,26101,0.0,Washington,Washington
5796,February,2020,Pierce,WA,Truck,0,0,0,141517,141517,0.0,Washington,Washington
5800,February,2020,Ferry,WA,Truck,0,0,0,3582,3582,0.0,Washington,Washington
5803,February,2020,Walla Walla,WA,Truck,0,0,0,13701,13701,0.0,Washington,Washington
5807,February,2020,San Juan,WA,Passenger,279,82,361,14330,14691,2.46,Washington,Washington
5810,February,2020,Clallam,WA,Truck,1,0,1,21839,21840,0.0,Washington,Washington
5811,February,2020,Klickitat,WA,Passenger,49,41,90,15686,15776,0.57,Washington,Washington
5812,February,2020,King,WA,Truck,6,1,7,182612,182619,0.0,Washington,Washington
5815,February,2020,King,WA,Passenger,23446,7675,31121,1400298,1431419,2.17,Washington,Washington
5819,February,2020,Pacific,WA,Passenger,30,32,62,16071,16133,0.38,Washington,Washington
5821,February,2020,Stevens,WA,Truck,0,0,0,18756,18756,0.0,Washington,Washington
5822,February,2020,Island,WA,Passenger,401,263,664,63475,64139,1.04,Washington,Washington
5824,February,2020,Mason,WA,Truck,0,0,0,20602,20602,0.0,Washington,Washington
5826,February,2020,Lincoln,WA,Truck,0,0,0,4658,4658,0.0,Washington,Washington
5827,February,2020,Whatcom,WA,Truck,3,0,3,43146,43149,0.01,Washington,Washington
5831,February,2020,Adams,WA,Truck,0,0,0,5221,5221,0.0,Washington,Washington
5834,February,2020,Thurston,WA,Truck,0,0,0,55720,55720,0.0,Washington,Washington
5835,February,2020,Kittitas,WA,Passenger,94,49,143,30014,30157,0.47,Washington,Washington
5838,February,2020,Wahkiakum,WA,Passenger,5,5,10,3017,3027,0.33,Washington,Washington
5839,February,2020,Pend Oreille,WA,Truck,0,0,0,5763,5763,0.0,Washington,Washington
5841,February,2020,Ferry,WA,Passenger,5,2,7,4373,4380,0.16,Washington,Washington
5844,February,2020,Yakima,WA,Truck,0,0,0,59625,59625,0.0,Washington,Washington
5850,February,2020,San Juan,WA,Truck,0,0,0,5925,5925,0.0,Washington,Washington
5851,February,2020,Whitman,WA,Passenger,42,48,90,22621,22711,0.4,Washington,Washington
5852,February,2020,Columbia,WA,Passenger,3,3,6,2433,2439,0.25,Washington,Washington
5854,February,2020,Adams,WA,Passenger,7,7,14,12913,12927,0.11,Washington,Washington
5855,February,2020,Island,WA,Truck,1,0,1,21333,21334,0.0,Washington,Washington
5856,February,2020,Benton,WA,Passenger,338,320,658,135315,135973,0.48,Washington,Washington
5859,February,2020,Stevens,WA,Passenger,33,33,66,31445,31511,0.21,Washington,Washington
5861,February,2020,Douglas,WA,Truck,0,0,0,12320,12320,0.0,Washington,Washington
5865,February,2020,Columbia,WA,Truck,0,0,0,1535,1535,0.0,Washington,Washington
5866,February,2020,Thurston,WA,Passenger,1109,725,1834,198984,200818,0.91,Washington,Washington
5867,February,2020,Snohomish,WA,Truck,0,0,0,123728,123728,0.0,Washington,Washington
5870,February,2020,Chelan,WA,Truck,0,0,0,22573,22573,0.0,Washington,Washington
5872,February,2020,Benton,WA,Truck,0,0,0,42572,42572,0.0,Washington,Washington
5882,February,2020,Walla Walla,WA,Passenger,68,62,130,36314,36444,0.36,Washington,Washington
5888,February,2020,Pacific,WA,Truck,0,0,0,7745,7745,0.0,Washington,Washington
5892,February,2020,Whatcom,WA,Passenger,1042,486,1528,151612,153140,1.0,Washington,Washington
5893,February,2020,Kitsap,WA,Passenger,1273,661,1934,182316,184250,1.05,Washington,Washington
5896,February,2020,Franklin,WA,Passenger,58,76,134,61129,61263,0.22,Washington,Washington
5902,February,2020,Asotin,WA,Passenger,16,11,27,12671,12698,0.21,Washington,Washington
5908,February,2020,Chelan,WA,Passenger,216,78,294,54606,54900,0.54,Washington,Washington
5909,February,2020,Snohomish,WA,Passenger,4302,1729,6031,538151,544182,1.11,Washington,Washington
5910,February,2020,Jefferson,WA,Truck,0,0,0,9642,9642,0.0,Washington,Washington
5913,February,2020,Clallam,WA,Passenger,206,163,369,50804,51173,0.72,Washington,Washington
5917,February,2020,Kittitas,WA,Truck,0,0,0,14649,14649,0.0,Washington,Washington
5920,February,2020,Skamania,WA,Passenger,28,19,47,8773,8820,0.53,Washington,Washington
5924,January,2017,Garfield,WA,Truck,0,0,0,941,941,0.0,Washington,Washington
5927,January,2017,Skagit,WA,Truck,1,0,1,31404,31405,0.0,Washington,Washington
5931,January,2017,Adams,WA,Passenger,1,1,2,12175,12177,0.02,Washington,Washington
5932,January,2017,Skamania,WA,Truck,0,0,0,3908,3908,0.0,Washington,Washington
5933,January,2017,Kitsap,WA,Passenger,556,262,818,172401,173219,0.47,Washington,Washington
5937,January,2017,Thurston,WA,Truck,0,0,0,53340,53340,0.0,Washington,Washington
5938,January,2017,Yakima,WA,Passenger,36,49,85,159930,160015,0.05,Washington,Washington
5939,January,2017,Pend Oreille,WA,Truck,0,0,0,5595,5595,0.0,Washington,Washington
5941,January,2017,Kitsap,WA,Truck,1,0,1,52380,52381,0.0,Washington,Washington
5942,January,2017,Cowlitz,WA,Passenger,51,44,95,69109,69204,0.14,Washington,Washington
5943,January,2017,Grant,WA,Truck,0,0,0,25039,25039,0.0,Washington,Washington
5945,January,2017,Whitman,WA,Passenger,8,19,27,21936,21963,0.12,Washington,Washington
5947,January,2017,Douglas,WA,Truck,0,0,0,11426,11426,0.0,Washington,Washington
5950,January,2017,Columbia,WA,Passenger,0,1,1,2331,2332,0.04,Washington,Washington
5953,January,2017,Yakima,WA,Truck,0,0,0,57337,57337,0.0,Washington,Washington
5954,January,2017,Stevens,WA,Truck,0,0,0,18341,18341,0.0,Washington,Washington
5955,January,2017,Clark,WA,Truck,0,0,0,77522,77522,0.0,Washington,Washington
5957,January,2017,Clark,WA,Passenger,673,426,1099,297819,298918,0.37,Washington,Washington
5960,January,2017,Chelan,WA,Passenger,54,28,82,51898,51980,0.16,Washington,Washington
5961,January,2017,Pend Oreille,WA,Passenger,1,4,5,9345,9350,0.05,Washington,Washington
5964,January,2017,Lincoln,WA,Truck,0,0,0,4462,4462,0.0,Washington,Washington
5965,January,2017,Skamania,WA,Passenger,7,7,14,8549,8563,0.16,Washington,Washington
5966,January,2017,Mason,WA,Passenger,48,60,108,42807,42915,0.25,Washington,Washington
5967,January,2017,Lincoln,WA,Passenger,2,4,6,7543,7549,0.08,Washington,Washington
5968,January,2017,Clallam,WA,Truck,0,0,0,21044,21044,0.0,Washington,Washington
5970,January,2017,Ferry,WA,Passenger,2,1,3,4386,4389,0.07,Washington,Washington
5973,January,2017,Cowlitz,WA,Truck,0,0,0,27949,27949,0.0,Washington,Washington
5977,January,2017,Walla Walla,WA,Passenger,16,21,37,34864,34901,0.11,Washington,Washington
5978,January,2017,Benton,WA,Passenger,129,129,258,127860,128118,0.2,Washington,Washington
5980,January,2017,Lewis,WA,Truck,0,0,0,24791,24791,0.0,Washington,Washington
5981,January,2017,Klickitat,WA,Truck,0,0,0,7945,7945,0.0,Washington,Washington
5985,January,2017,Asotin,WA,Passenger,4,3,7,12319,12326,0.06,Washington,Washington
5988,January,2017,Douglas,WA,Passenger,29,19,48,26580,26628,0.18,Washington,Washington
5997,January,2017,Pierce,WA,Passenger,822,751,1573,528314,529887,0.3,Washington,Washington
5998,January,2017,Okanogan,WA,Passenger,3,15,18,25814,25832,0.07,Washington,Washington
6000,January,2017,Thurston,WA,Passenger,336,299,635,184964,185599,0.34,Washington,Washington
6004,January,2017,King,WA,Truck,8,1,9,191085,191094,0.0,Washington,Washington
6005,January,2017,Spokane,WA,Truck,1,0,1,90429,90430,0.0,Washington,Washington
6007,January,2017,Walla Walla,WA,Truck,0,0,0,13168,13168,0.0,Washington,Washington
6009,January,2017,Jefferson,WA,Truck,0,0,0,9469,9469,0.0,Washington,Washington
6010,January,2017,Pacific,WA,Passenger,5,6,11,15034,15045,0.07,Washington,Washington
6017,January,2017,Franklin,WA,Passenger,27,42,69,55402,55471,0.12,Washington,Washington
6018,January,2017,Adams,WA,Truck,0,0,0,5077,5077,0.0,Washington,Washington
6019,January,2017,Spokane,WA,Passenger,221,196,417,296020,296437,0.14,Washington,Washington
6020,January,2017,Grant,WA,Passenger,16,21,37,60386,60423,0.06,Washington,Washington
6023,January,2017,Snohomish,WA,Truck,1,0,1,122825,122826,0.0,Washington,Washington
6024,January,2017,Stevens,WA,Passenger,6,21,27,31528,31555,0.09,Washington,Washington
6026,January,2017,Skagit,WA,Passenger,106,81,187,87447,87634,0.21,Washington,Washington
6027,January,2017,Ferry,WA,Truck,0,0,0,3581,3581,0.0,Washington,Washington
6030,January,2017,San Juan,WA,Truck,0,0,0,5594,5594,0.0,Washington,Washington
6034,January,2017,Kittitas,WA,Passenger,15,16,31,27158,27189,0.11,Washington,Washington
6037,January,2017,Asotin,WA,Truck,0,0,0,6487,6487,0.0,Washington,Washington
6040,January,2017,Pacific,WA,Truck,0,0,0,7509,7509,0.0,Washington,Washington
6051,January,2017,Pierce,WA,Truck,0,0,0,138768,138768,0.0,Washington,Washington
6054,January,2017,Klickitat,WA,Passenger,20,22,42,14793,14835,0.28,Washington,Washington
6056,January,2017,King,WA,Passenger,8804,3621,12425,1387384,1399809,0.89,Washington,Washington
6057,January,2017,Clallam,WA,Passenger,73,64,137,48005,48142,0.28,Washington,Washington
6058,January,2017,Grays Harbor,WA,Passenger,27,24,51,44315,44366,0.11,Washington,Washington
6060,January,2017,Columbia,WA,Truck,0,0,0,1543,1543,0.0,Washington,Washington
6065,January,2017,Whitman,WA,Truck,0,0,0,8403,8403,0.0,Washington,Washington
6067,January,2017,Island,WA,Truck,1,0,1,20520,20521,0.0,Washington,Washington
6069,January,2017,Whatcom,WA,Passenger,383,141,524,141886,142410,0.37,Washington,Washington
6071,January,2017,Whatcom,WA,Truck,2,0,2,41337,41339,0.0,Washington,Washington
6072,January,2017,Island,WA,Passenger,103,119,222,59416,59638,0.37,Washington,Washington
6074,January,2017,Mason,WA,Truck,0,0,0,19187,19187,0.0,Washington,Washington
6076,January,2017,Kittitas,WA,Truck,0,0,0,13412,13412,0.0,Washington,Washington
6079,January,2017,Garfield,WA,Passenger,0,0,0,1285,1285,0.0,Washington,Washington
6080,January,2017,Chelan,WA,Truck,0,0,0,21262,21262,0.0,Washington,Washington
6082,January,2017,Benton,WA,Truck,0,0,0,39813,39813,0.0,Washington,Washington
6087,January,2017,Lewis,WA,Passenger,43,30,73,54960,55033,0.13,Washington,Washington
6090,January,2017,Okanogan,WA,Truck,0,0,0,16374,16374,0.0,Washington,Washington
6098,January,2017,Jefferson,WA,Passenger,87,53,140,23606,23746,0.59,Washington,Washington
6100,January,2017,Grays Harbor,WA,Truck,0,0,0,19862,19862,0.0,Washington,Washington
6105,January,2017,San Juan,WA,Passenger,84,31,115,13348,13463,0.85,Washington,Washington
6106,January,2017,Franklin,WA,Truck,0,0,0,17912,17912,0.0,Washington,Washington
6108,January,2017,Wahkiakum,WA,Passenger,0,1,1,2861,2862,0.03,Washington,Washington
6109,January,2017,Snohomish,WA,Passenger,1549,803,2352,514965,517317,0.45,Washington,Washington
6110,January,2017,Wahkiakum,WA,Truck,0,0,0,1624,1624,0.0,Washington,Washington
6115,January,2018,Garfield,WA,Truck,0,0,0,945,945,0.0,Washington,Washington
6116,January,2018,Walla Walla,WA,Truck,0,0,0,13323,13323,0.0,Washington,Washington
6117,January,2018,Klickitat,WA,Truck,0,0,0,8000,8000,0.0,Washington,Washington
6123,January,2018,Spokane,WA,Passenger,300,255,555,300795,301350,0.18,Washington,Washington
6124,January,2018,Clark,WA,Truck,0,0,0,78578,78578,0.0,Washington,Washington
6125,January,2018,Cowlitz,WA,Passenger,54,69,123,70972,71095,0.17,Washington,Washington
6126,January,2018,Franklin,WA,Passenger,31,51,82,57013,57095,0.14,Washington,Washington
6127,January,2018,Benton,WA,Passenger,175,179,354,130623,130977,0.27,Washington,Washington
6130,January,2018,Skamania,WA,Passenger,11,8,19,8608,8627,0.22,Washington,Washington
6134,January,2018,King,WA,Passenger,11619,4878,16497,1370831,1387328,1.19,Washington,Washington
6136,January,2018,Grant,WA,Truck,0,0,0,25641,25641,0.0,Washington,Washington
6137,January,2018,Pend Oreille,WA,Passenger,4,4,8,9441,9449,0.08,Washington,Washington
6138,January,2018,Mason,WA,Truck,0,0,0,19646,19646,0.0,Washington,Washington
6141,January,2018,Garfield,WA,Passenger,1,0,1,1329,1330,0.08,Washington,Washington
6142,January,2018,Snohomish,WA,Passenger,2073,1094,3167,518066,521233,0.61,Washington,Washington
6143,January,2018,Kittitas,WA,Passenger,36,27,63,28637,28700,0.22,Washington,Washington
6146,January,2018,Pierce,WA,Passenger,1095,996,2091,527421,529512,0.39,Washington,Washington
6147,January,2018,Lewis,WA,Passenger,52,43,95,56805,56900,0.17,Washington,Washington
6158,January,2018,Kitsap,WA,Truck,1,0,1,52751,52752,0.0,Washington,Washington
6161,January,2018,Spokane,WA,Truck,1,0,1,91739,91740,0.0,Washington,Washington
6162,January,2018,Pacific,WA,Passenger,15,13,28,15453,15481,0.18,Washington,Washington
6165,January,2018,Whatcom,WA,Truck,1,0,1,42070,42071,0.0,Washington,Washington
6168,January,2018,Wahkiakum,WA,Passenger,0,2,2,2844,2846,0.07,Washington,Washington
6170,January,2018,Chelan,WA,Truck,0,0,0,21676,21676,0.0,Washington,Washington
6172,January,2018,Jefferson,WA,Passenger,124,80,204,24352,24556,0.83,Washington,Washington
6176,January,2018,Benton,WA,Truck,0,0,0,40708,40708,0.0,Washington,Washington
6178,January,2018,Skamania,WA,Truck,0,0,0,3900,3900,0.0,Washington,Washington
6182,January,2018,Klickitat,WA,Passenger,23,26,49,14933,14982,0.33,Washington,Washington
6184,January,2018,Asotin,WA,Passenger,8,5,13,12548,12561,0.1,Washington,Washington
6187,January,2018,Jefferson,WA,Truck,0,0,0,9485,9485,0.0,Washington,Washington
6190,January,2018,Lincoln,WA,Truck,0,0,0,4504,4504,0.0,Washington,Washington
6191,January,2018,Stevens,WA,Truck,0,0,0,18391,18391,0.0,Washington,Washington
6192,January,2018,Stevens,WA,Passenger,10,22,32,31598,31630,0.1,Washington,Washington
6197,January,2018,Okanogan,WA,Passenger,7,19,26,25706,25732,0.1,Washington,Washington
6199,January,2018,Asotin,WA,Truck,0,0,0,6559,6559,0.0,Washington,Washington
6204,January,2018,Thurston,WA,Passenger,487,407,894,190668,191562,0.47,Washington,Washington
6207,January,2018,Adams,WA,Truck,0,0,0,5148,5148,0.0,Washington,Washington
6211,January,2018,Okanogan,WA,Truck,0,0,0,16333,16333,0.0,Washington,Washington
6212,January,2018,Wahkiakum,WA,Truck,0,0,0,1681,1681,0.0,Washington,Washington
6213,January,2018,Ferry,WA,Truck,0,0,0,3544,3544,0.0,Washington,Washington
6214,January,2018,Skagit,WA,Truck,1,0,1,31840,31841,0.0,Washington,Washington
6215,January,2018,Thurston,WA,Truck,0,0,0,53893,53893,0.0,Washington,Washington
6216,January,2018,Grays Harbor,WA,Truck,0,0,0,20089,20089,0.0,Washington,Washington
6220,January,2018,Kittitas,WA,Truck,0,0,0,13876,13876,0.0,Washington,Washington
6221,January,2018,Lewis,WA,Truck,0,0,0,25325,25325,0.0,Washington,Washington
6222,January,2018,Ferry,WA,Passenger,1,3,4,4408,4412,0.09,Washington,Washington
6228,January,2018,King,WA,Truck,8,1,9,184806,184815,0.0,Washington,Washington
6231,January,2018,Clark,WA,Passenger,873,599,1472,305301,306773,0.48,Washington,Washington
6234,January,2018,Adams,WA,Passenger,4,4,8,12443,12451,0.06,Washington,Washington
6236,January,2018,Pend Oreille,WA,Truck,0,0,0,5618,5618,0.0,Washington,Washington
6239,January,2018,Grant,WA,Passenger,29,37,66,62283,62349,0.11,Washington,Washington
6241,January,2018,Skagit,WA,Passenger,170,140,310,89781,90091,0.34,Washington,Washington
6242,January,2018,Cowlitz,WA,Truck,0,0,0,28201,28201,0.0,Washington,Washington
6243,January,2018,Whitman,WA,Passenger,18,20,38,22475,22513,0.17,Washington,Washington
6244,January,2018,Walla Walla,WA,Passenger,30,33,63,35373,35436,0.18,Washington,Washington
6250,January,2018,Island,WA,Truck,0,0,0,20786,20786,0.0,Washington,Washington
6252,January,2018,Yakima,WA,Passenger,60,76,136,162512,162648,0.08,Washington,Washington
6254,January,2018,Mason,WA,Passenger,65,77,142,44977,45119,0.31,Washington,Washington
6256,January,2018,Douglas,WA,Truck,0,0,0,11790,11790,0.0,Washington,Washington
6260,January,2018,Yakima,WA,Truck,0,0,0,58106,58106,0.0,Washington,Washington
6264,January,2018,Pierce,WA,Truck,0,0,0,137147,137147,0.0,Washington,Washington
6265,January,2018,Lincoln,WA,Passenger,2,5,7,7587,7594,0.09,Washington,Washington
6266,January,2018,Kitsap,WA,Passenger,706,402,1108,176404,177512,0.62,Washington,Washington
6267,January,2018,Snohomish,WA,Truck,1,0,1,121550,121551,0.0,Washington,Washington
6268,January,2018,Columbia,WA,Truck,0,0,0,1545,1545,0.0,Washington,Washington
6269,January,2018,Grays Harbor,WA,Passenger,42,42,84,45972,46056,0.18,Washington,Washington
6270,January,2018,San Juan,WA,Passenger,137,46,183,13927,14110,1.3,Washington,Washington
6277,January,2018,Whitman,WA,Truck,0,0,0,8472,8472,0.0,Washington,Washington
6278,January,2018,Clallam,WA,Passenger,106,95,201,49281,49482,0.41,Washington,Washington
6280,January,2018,Whatcom,WA,Passenger,548,238,786,145510,146296,0.54,Washington,Washington
6282,January,2018,Chelan,WA,Passenger,94,38,132,53236,53368,0.25,Washington,Washington
6283,January,2018,Douglas,WA,Passenger,43,33,76,27223,27299,0.28,Washington,Washington
6288,January,2018,Clallam,WA,Truck,0,0,0,21280,21280,0.0,Washington,Washington
6291,January,2018,Pacific,WA,Truck,0,0,0,7534,7534,0.0,Washington,Washington
6294,January,2018,Island,WA,Passenger,159,167,326,61838,62164,0.52,Washington,Washington
6296,January,2018,Columbia,WA,Passenger,2,1,3,2401,2404,0.12,Washington,Washington
6297,January,2018,San Juan,WA,Truck,0,0,0,5644,5644,0.0,Washington,Washington
6301,January,2018,Franklin,WA,Truck,0,0,0,18563,18563,0.0,Washington,Washington
6304,January,2019,San Juan,WA,Truck,0,0,0,5802,5802,0.0,Washington,Washington
6305,January,2019,Ferry,WA,Passenger,3,2,5,4388,4393,0.11,Washington,Washington
6306,January,2019,Okanogan,WA,Truck,0,0,0,16477,16477,0.0,Washington,Washington
6308,January,2019,Stevens,WA,Truck,0,0,0,18768,18768,0.0,Washington,Washington
6309,January,2019,Island,WA,Truck,0,0,0,21211,21211,0.0,Washington,Washington
6315,January,2019,Adams,WA,Truck,0,0,0,5142,5142,0.0,Washington,Washington
6316,January,2019,King,WA,Truck,6,1,7,182396,182403,0.0,Washington,Washington
6317,January,2019,Cowlitz,WA,Truck,0,0,0,28728,28728,0.0,Washington,Washington
6321,January,2019,Pacific,WA,Truck,0,0,0,7615,7615,0.0,Washington,Washington
6324,January,2019,Asotin,WA,Truck,0,0,0,6645,6645,0.0,Washington,Washington
6328,January,2019,Grant,WA,Passenger,33,53,86,64365,64451,0.13,Washington,Washington
6329,January,2019,Cowlitz,WA,Passenger,79,96,175,72557,72732,0.24,Washington,Washington
6330,January,2019,Adams,WA,Passenger,5,6,11,12742,12753,0.09,Washington,Washington
6331,January,2019,Clark,WA,Passenger,1313,868,2181,312092,314273,0.69,Washington,Washington
6333,January,2019,Franklin,WA,Passenger,49,68,117,59324,59441,0.2,Washington,Washington
6335,January,2019,Wahkiakum,WA,Passenger,1,1,2,3006,3008,0.07,Washington,Washington
6337,January,2019,Franklin,WA,Truck,0,0,0,19128,19128,0.0,Washington,Washington
6341,January,2019,Benton,WA,Passenger,232,243,475,133224,133699,0.36,Washington,Washington
6343,January,2019,Pend Oreille,WA,Passenger,5,5,10,9538,9548,0.1,Washington,Washington
6344,January,2019,Columbia,WA,Passenger,2,2,4,2423,2427,0.16,Washington,Washington
6345,January,2019,Asotin,WA,Passenger,12,9,21,12729,12750,0.16,Washington,Washington
6348,January,2019,Walla Walla,WA,Passenger,42,54,96,36138,36234,0.26,Washington,Washington
6353,January,2019,Snohomish,WA,Passenger,3075,1488,4563,528288,532851,0.86,Washington,Washington
6354,January,2019,Clallam,WA,Truck,0,0,0,21632,21632,0.0,Washington,Washington
6357,January,2019,Kittitas,WA,Passenger,69,36,105,29465,29570,0.36,Washington,Washington
6360,January,2019,Clark,WA,Truck,0,0,0,79967,79967,0.0,Washington,Washington
6361,January,2019,Whitman,WA,Passenger,24,40,64,22845,22909,0.28,Washington,Washington
6362,January,2019,Pend Oreille,WA,Truck,0,0,0,5743,5743,0.0,Washington,Washington
6366,January,2019,Clallam,WA,Passenger,152,128,280,50402,50682,0.55,Washington,Washington
6367,January,2019,Klickitat,WA,Truck,0,0,0,8228,8228,0.0,Washington,Washington
6372,January,2019,Grays Harbor,WA,Truck,0,0,0,20319,20319,0.0,Washington,Washington
6374,January,2019,Grant,WA,Truck,0,0,0,26324,26324,0.0,Washington,Washington
6376,January,2019,Benton,WA,Truck,0,0,0,41617,41617,0.0,Washington,Washington
6377,January,2019,Yakima,WA,Passenger,84,100,184,164930,165114,0.11,Washington,Washington
6378,January,2019,Klickitat,WA,Passenger,29,32,61,15485,15546,0.39,Washington,Washington
6380,January,2019,Chelan,WA,Truck,0,0,0,22107,22107,0.0,Washington,Washington
6382,January,2019,Mason,WA,Truck,0,0,0,20224,20224,0.0,Washington,Washington
6383,January,2019,Snohomish,WA,Truck,1,0,1,122005,122006,0.0,Washington,Washington
6391,January,2019,Island,WA,Passenger,288,229,517,63253,63770,0.81,Washington,Washington
6392,January,2019,Lewis,WA,Truck,0,0,0,25661,25661,0.0,Washington,Washington
6399,January,2019,Walla Walla,WA,Truck,0,0,0,13535,13535,0.0,Washington,Washington
6400,January,2019,Jefferson,WA,Truck,0,0,0,9619,9619,0.0,Washington,Washington
6404,January,2019,Kittitas,WA,Truck,0,0,0,14237,14237,0.0,Washington,Washington
6405,January,2019,Skagit,WA,Truck,1,0,1,32319,32320,0.0,Washington,Washington
6407,January,2019,Okanogan,WA,Passenger,18,21,39,26053,26092,0.15,Washington,Washington
6422,January,2019,Whatcom,WA,Truck,2,0,2,42739,42741,0.0,Washington,Washington
6426,January,2019,Skamania,WA,Passenger,18,15,33,8741,8774,0.38,Washington,Washington
6429,January,2019,Jefferson,WA,Passenger,175,112,287,24852,25139,1.14,Washington,Washington
6430,January,2019,Kitsap,WA,Passenger,981,556,1537,179937,181474,0.85,Washington,Washington
6435,January,2019,Thurston,WA,Passenger,771,590,1361,196046,197407,0.69,Washington,Washington
6438,January,2019,Whatcom,WA,Passenger,778,375,1153,149711,150864,0.76,Washington,Washington
6439,January,2019,Garfield,WA,Passenger,1,1,2,1332,1334,0.15,Washington,Washington
6440,January,2019,Columbia,WA,Truck,0,0,0,1529,1529,0.0,Washington,Washington
6443,January,2019,Pierce,WA,Truck,0,0,0,139124,139124,0.0,Washington,Washington
6452,January,2019,Douglas,WA,Passenger,51,35,86,28011,28097,0.31,Washington,Washington
6453,January,2019,Skamania,WA,Truck,0,0,0,4008,4008,0.0,Washington,Washington
6454,January,2019,Thurston,WA,Truck,0,0,0,54922,54922,0.0,Washington,Washington
6464,January,2019,Mason,WA,Passenger,108,115,223,46659,46882,0.48,Washington,Washington
6467,January,2019,Chelan,WA,Passenger,140,64,204,54205,54409,0.37,Washington,Washington
6469,January,2019,Pierce,WA,Passenger,1581,1423,3004,539770,542774,0.55,Washington,Washington
6471,January,2019,Douglas,WA,Truck,0,0,0,12172,12172,0.0,Washington,Washington
6477,January,2019,Wahkiakum,WA,Truck,0,0,0,1711,1711,0.0,Washington,Washington
6479,January,2019,Stevens,WA,Passenger,18,28,46,31816,31862,0.14,Washington,Washington
6480,January,2019,Skagit,WA,Passenger,270,186,456,91360,91816,0.5,Washington,Washington
6482,January,2019,Lincoln,WA,Passenger,2,5,7,7755,7762,0.09,Washington,Washington
6484,January,2019,Spokane,WA,Passenger,471,380,851,307611,308462,0.28,Washington,Washington
6485,January,2019,Whitman,WA,Truck,0,0,0,8512,8512,0.0,Washington,Washington
6486,January,2019,Garfield,WA,Truck,0,0,0,962,962,0.0,Washington,Washington
6488,January,2019,Ferry,WA,Truck,0,0,0,3590,3590,0.0,Washington,Washington
6490,January,2019,Spokane,WA,Truck,1,0,1,93943,93944,0.0,Washington,Washington
6492,January,2019,Kitsap,WA,Truck,1,0,1,53730,53731,0.0,Washington,Washington
6500,January,2019,Lincoln,WA,Truck,0,0,0,4666,4666,0.0,Washington,Washington
6501,January,2019,Pacific,WA,Passenger,22,26,48,15882,15930,0.3,Washington,Washington
6502,January,2019,San Juan,WA,Passenger,190,68,258,14255,14513,1.78,Washington,Washington
6503,January,2019,Lewis,WA,Passenger,95,82,177,58367,58544,0.3,Washington,Washington
6504,January,2019,King,WA,Passenger,17167,6678,23845,1381057,1404902,1.7,Washington,Washington
6506,January,2019,Yakima,WA,Truck,0,0,0,58929,58929,0.0,Washington,Washington
6511,January,2019,Grays Harbor,WA,Passenger,67,76,143,47449,47592,0.3,Washington,Washington
6533,January,2020,Snohomish,WA,Truck,0,0,0,123641,123641,0.0,Washington,Washington
6535,January,2020,Whitman,WA,Passenger,42,48,90,22664,22754,0.4,Washington,Washington
6536,January,2020,Okanogan,WA,Passenger,32,30,62,26220,26282,0.24,Washington,Washington
6543,January,2020,Grays Harbor,WA,Passenger,105,105,210,48505,48715,0.43,Washington,Washington
6547,January,2020,Whatcom,WA,Passenger,1032,486,1518,151794,153312,0.99,Washington,Washington
6548,January,2020,Walla Walla,WA,Truck,0,0,0,13710,13710,0.0,Washington,Washington
6553,January,2020,Chelan,WA,Truck,0,0,0,22573,22573,0.0,Washington,Washington
6559,January,2020,Stevens,WA,Truck,0,0,0,18790,18790,0.0,Washington,Washington
6561,January,2020,Garfield,WA,Passenger,0,1,1,1321,1322,0.08,Washington,Washington
6564,January,2020,Chelan,WA,Passenger,213,77,290,54617,54907,0.53,Washington,Washington
6565,January,2020,Wahkiakum,WA,Passenger,4,5,9,3034,3043,0.3,Washington,Washington
6566,January,2020,Benton,WA,Passenger,337,315,652,135323,135975,0.48,Washington,Washington
6568,January,2020,Pend Oreille,WA,Passenger,8,7,15,9470,9485,0.16,Washington,Washington
6569,January,2020,King,WA,Passenger,23196,7620,30816,1399178,1429994,2.15,Washington,Washington
6575,January,2020,Island,WA,Truck,1,0,1,21354,21355,0.0,Washington,Washington
6578,January,2020,Mason,WA,Passenger,150,135,285,47624,47909,0.59,Washington,Washington
6579,January,2020,Douglas,WA,Passenger,69,39,108,28367,28475,0.38,Washington,Washington
6588,January,2020,Klickitat,WA,Passenger,48,39,87,15683,15770,0.55,Washington,Washington
6589,January,2020,Pacific,WA,Truck,0,0,0,7748,7748,0.0,Washington,Washington
6591,January,2020,Skagit,WA,Passenger,378,215,593,92622,93215,0.64,Washington,Washington
6596,January,2020,Columbia,WA,Truck,0,0,0,1534,1534,0.0,Washington,Washington
6598,January,2020,Skagit,WA,Truck,1,0,1,32593,32594,0.0,Washington,Washington
6599,January,2020,Spokane,WA,Truck,1,0,1,96899,96900,0.0,Washington,Washington
6606,January,2020,Thurston,WA,Truck,0,0,0,55762,55762,0.0,Washington,Washington
6607,January,2020,Clark,WA,Passenger,1940,1054,2994,319981,322975,0.93,Washington,Washington
6614,January,2020,Clallam,WA,Truck,1,0,1,21855,21856,0.0,Washington,Washington
6615,January,2020,Grant,WA,Passenger,58,71,129,65624,65753,0.2,Washington,Washington
6617,January,2020,Lincoln,WA,Passenger,1,11,12,7787,7799,0.15,Washington,Washington
6619,January,2020,King,WA,Truck,6,1,7,182654,182661,0.0,Washington,Washington
6620,January,2020,Yakima,WA,Passenger,120,115,235,166247,166482,0.14,Washington,Washington
6622,January,2020,Whatcom,WA,Truck,3,0,3,43229,43232,0.01,Washington,Washington
6623,January,2020,Pend Oreille,WA,Truck,0,0,0,5778,5778,0.0,Washington,Washington
6624,January,2020,Kittitas,WA,Passenger,93,47,140,30081,30221,0.46,Washington,Washington
6625,January,2020,Grays Harbor,WA,Truck,0,0,0,20827,20827,0.0,Washington,Washington
6639,January,2020,Pierce,WA,Passenger,2229,1679,3908,550655,554563,0.7,Washington,Washington
6641,January,2020,Kitsap,WA,Passenger,1258,656,1914,182446,184360,1.04,Washington,Washington
6643,January,2020,Thurston,WA,Passenger,1093,719,1812,199295,201107,0.9,Washington,Washington
6644,January,2020,Columbia,WA,Passenger,3,3,6,2447,2453,0.24,Washington,Washington
6648,January,2020,Asotin,WA,Passenger,17,11,28,12723,12751,0.22,Washington,Washington
6649,January,2020,Garfield,WA,Truck,0,0,0,969,969,0.0,Washington,Washington
6651,January,2020,Island,WA,Passenger,392,257,649,63598,64247,1.01,Washington,Washington
6652,January,2020,Pacific,WA,Passenger,30,31,61,16096,16157,0.38,Washington,Washington
6657,January,2020,Franklin,WA,Passenger,57,76,133,61093,61226,0.22,Washington,Washington
6659,January,2020,Yakima,WA,Truck,0,0,0,59638,59638,0.0,Washington,Washington
6660,January,2020,Ferry,WA,Passenger,5,2,7,4381,4388,0.16,Washington,Washington
6661,January,2020,Clallam,WA,Passenger,203,163,366,50913,51279,0.71,Washington,Washington
6663,January,2020,San Juan,WA,Truck,0,0,0,5928,5928,0.0,Washington,Washington
6667,January,2020,Skamania,WA,Truck,0,0,0,4106,4106,0.0,Washington,Washington
6671,January,2020,Pierce,WA,Truck,0,0,0,141347,141347,0.0,Washington,Washington
6673,January,2020,Benton,WA,Truck,0,0,0,42555,42555,0.0,Washington,Washington
6675,January,2020,Lewis,WA,Passenger,109,104,213,59601,59814,0.36,Washington,Washington
6682,January,2020,Klickitat,WA,Truck,0,0,0,8299,8299,0.0,Washington,Washington
6683,January,2020,Kittitas,WA,Truck,0,0,0,14666,14666,0.0,Washington,Washington
6685,January,2020,Spokane,WA,Passenger,684,467,1151,316758,317909,0.36,Washington,Washington
6686,January,2020,Franklin,WA,Truck,0,0,0,19851,19851,0.0,Washington,Washington
6687,January,2020,Stevens,WA,Passenger,33,32,65,31499,31564,0.21,Washington,Washington
6688,January,2020,Lewis,WA,Truck,0,0,0,26097,26097,0.0,Washington,Washington
6690,January,2020,Jefferson,WA,Truck,0,0,0,9661,9661,0.0,Washington,Washington
6692,January,2020,Adams,WA,Passenger,7,7,14,12913,12927,0.11,Washington,Washington
6693,January,2020,Adams,WA,Truck,0,0,0,5211,5211,0.0,Washington,Washington
6698,January,2020,Skamania,WA,Passenger,29,19,48,8769,8817,0.54,Washington,Washington
6702,January,2020,Wahkiakum,WA,Truck,0,0,0,1759,1759,0.0,Washington,Washington
6703,January,2020,Lincoln,WA,Truck,0,0,0,4671,4671,0.0,Washington,Washington
6705,January,2020,Jefferson,WA,Passenger,224,139,363,25209,25572,1.42,Washington,Washington
6707,January,2020,Whitman,WA,Truck,0,0,0,8567,8567,0.0,Washington,Washington
6710,January,2020,Walla Walla,WA,Passenger,65,61,126,36352,36478,0.35,Washington,Washington
6716,January,2020,Ferry,WA,Truck,0,0,0,3586,3586,0.0,Washington,Washington
6724,January,2020,Cowlitz,WA,Passenger,127,111,238,73602,73840,0.32,Washington,Washington
6726,January,2020,Clark,WA,Truck,0,0,0,81767,81767,0.0,Washington,Washington
6732,January,2020,Cowlitz,WA,Truck,0,0,0,29028,29028,0.0,Washington,Washington
6735,January,2020,Mason,WA,Truck,0,0,0,20563,20563,0.0,Washington,Washington
6736,January,2020,Grant,WA,Truck,0,0,0,27036,27036,0.0,Washington,Washington
6738,January,2020,Kitsap,WA,Truck,1,0,1,54484,54485,0.0,Washington,Washington
6741,January,2020,Douglas,WA,Truck,0,0,0,12312,12312,0.0,Washington,Washington
6745,January,2020,Snohomish,WA,Passenger,4244,1718,5962,537912,543874,1.1,Washington,Washington
6749,January,2020,Okanogan,WA,Truck,0,0,0,16557,16557,0.0,Washington,Washington
6751,January,2020,San Juan,WA,Passenger,265,83,348,14402,14750,2.36,Washington,Washington
6753,January,2020,Asotin,WA,Truck,0,0,0,6720,6720,0.0,Washington,Washington
6759,January,2021,Asotin,WA,Truck,0,0,0,6690,6690,0.0,Washington,Washington
6760,January,2021,Mason,WA,Passenger,179,137,316,47690,48006,0.66,Washington,Washington
6761,January,2021,Whitman,WA,Truck,0,0,0,8512,8512,0.0,Washington,Washington
6762,January,2021,Adams,WA,Truck,0,0,0,5347,5347,0.0,Washington,Washington
6766,January,2021,San Juan,WA,Passenger,377,113,490,14023,14513,3.38,Washington,Washington
6771,January,2021,Skamania,WA,Passenger,34,23,57,8339,8396,0.68,Washington,Washington
6773,January,2021,Grays Harbor,WA,Passenger,133,126,259,48779,49038,0.53,Washington,Washington
6776,January,2021,Pierce,WA,Passenger,2963,1790,4753,555715,560468,0.85,Washington,Washington
6779,January,2021,Yakima,WA,Passenger,178,129,307,167569,167876,0.18,Washington,Washington
6786,January,2021,Wahkiakum,WA,Truck,0,0,0,1769,1769,0.0,Washington,Washington
6787,January,2021,Grant,WA,Truck,0,0,0,27594,27594,0.0,Washington,Washington
6791,January,2021,Snohomish,WA,Passenger,5177,1876,7053,538376,545429,1.29,Washington,Washington
6793,January,2021,Adams,WA,Passenger,10,6,16,12971,12987,0.12,Washington,Washington
6798,January,2021,Grays Harbor,WA,Truck,0,0,0,21244,21244,0.0,Washington,Washington
6800,January,2021,Cowlitz,WA,Truck,0,0,0,28973,28973,0.0,Washington,Washington
6808,January,2021,Cowlitz,WA,Passenger,188,129,317,72162,72479,0.44,Washington,Washington
6810,January,2021,Garfield,WA,Truck,0,0,0,1003,1003,0.0,Washington,Washington
6814,January,2021,Okanogan,WA,Truck,0,0,0,16594,16594,0.0,Washington,Washington
6815,January,2021,Jefferson,WA,Truck,0,0,0,9597,9597,0.0,Washington,Washington
6825,January,2021,Stevens,WA,Truck,0,0,0,18751,18751,0.0,Washington,Washington
6827,January,2021,King,WA,Truck,6,1,7,184346,184353,0.0,Washington,Washington
6828,January,2021,Lewis,WA,Truck,0,0,0,26714,26714,0.0,Washington,Washington
6832,January,2021,Klickitat,WA,Passenger,63,43,106,14989,15095,0.7,Washington,Washington
6837,January,2021,Clallam,WA,Passenger,281,190,471,49972,50443,0.93,Washington,Washington
6838,January,2021,Thurston,WA,Truck,0,0,0,56449,56449,0.0,Washington,Washington
6844,January,2021,Walla Walla,WA,Truck,0,0,0,13897,13897,0.0,Washington,Washington
6847,January,2021,Clallam,WA,Truck,1,0,1,21869,21870,0.0,Washington,Washington
6848,January,2021,Pacific,WA,Truck,0,0,0,7802,7802,0.0,Washington,Washington
6851,January,2021,Mason,WA,Truck,0,0,0,21024,21024,0.0,Washington,Washington
6853,January,2021,Lewis,WA,Passenger,126,131,257,58904,59161,0.43,Washington,Washington
6856,January,2021,Whatcom,WA,Truck,3,0,3,43603,43606,0.01,Washington,Washington
6857,January,2021,Whitman,WA,Passenger,51,46,97,21847,21944,0.44,Washington,Washington
6859,January,2021,Ferry,WA,Truck,0,0,0,3606,3606,0.0,Washington,Washington
6861,January,2021,Island,WA,Passenger,527,294,821,62983,63804,1.29,Washington,Washington
6863,January,2021,Pend Oreille,WA,Passenger,12,3,15,9181,9196,0.16,Washington,Washington
6865,January,2021,Asotin,WA,Passenger,16,13,29,12441,12470,0.23,Washington,Washington
6867,January,2021,Okanogan,WA,Passenger,56,36,92,26138,26230,0.35,Washington,Washington
6874,January,2021,Columbia,WA,Passenger,5,3,8,2452,2460,0.33,Washington,Washington
6877,January,2021,Spokane,WA,Passenger,910,551,1461,320997,322458,0.45,Washington,Washington
6879,January,2021,Lincoln,WA,Truck,0,0,0,4693,4693,0.0,Washington,Washington
6885,January,2021,Garfield,WA,Passenger,0,2,2,1362,1364,0.15,Washington,Washington
6886,January,2021,Douglas,WA,Truck,0,0,0,12505,12505,0.0,Washington,Washington
6889,January,2021,Stevens,WA,Passenger,37,40,77,30273,30350,0.25,Washington,Washington
6891,January,2021,Grant,WA,Passenger,87,84,171,66105,66276,0.26,Washington,Washington
6892,January,2021,San Juan,WA,Truck,0,0,0,5867,5867,0.0,Washington,Washington
6893,January,2021,Skagit,WA,Passenger,517,243,760,91439,92199,0.82,Washington,Washington
6897,January,2021,Clark,WA,Passenger,2459,1211,3670,319410,323080,1.14,Washington,Washington
6899,January,2021,Pend Oreille,WA,Truck,0,0,0,5717,5717,0.0,Washington,Washington
6900,January,2021,Benton,WA,Passenger,453,358,811,135157,135968,0.6,Washington,Washington
6901,January,2021,Kittitas,WA,Truck,0,0,0,14675,14675,0.0,Washington,Washington
6904,January,2021,Thurston,WA,Passenger,1350,796,2146,197459,199605,1.08,Washington,Washington
6907,January,2021,Yakima,WA,Truck,0,0,0,61081,61081,0.0,Washington,Washington
6908,January,2021,Pierce,WA,Truck,0,0,0,144891,144891,0.0,Washington,Washington
6916,January,2021,Benton,WA,Truck,0,0,0,43331,43331,0.0,Washington,Washington
6919,January,2021,Franklin,WA,Truck,0,0,0,20491,20491,0.0,Washington,Washington
6925,January,2021,Kitsap,WA,Passenger,1607,765,2372,179318,181690,1.31,Washington,Washington
6926,January,2021,Lincoln,WA,Passenger,6,12,18,7632,7650,0.24,Washington,Washington
6928,January,2021,Whatcom,WA,Passenger,1253,564,1817,150089,151906,1.2,Washington,Washington
6929,January,2021,Klickitat,WA,Truck,0,0,0,8117,8117,0.0,Washington,Washington
6933,January,2021,Chelan,WA,Truck,0,0,0,22844,22844,0.0,Washington,Washington
6940,January,2021,Skamania,WA,Truck,0,0,0,4017,4017,0.0,Washington,Washington
6942,January,2021,Franklin,WA,Passenger,89,85,174,61500,61674,0.28,Washington,Washington
6943,January,2021,Walla Walla,WA,Passenger,103,68,171,36164,36335,0.47,Washington,Washington
6946,January,2021,Clark,WA,Truck,0,0,0,83564,83564,0.0,Washington,Washington
6949,January,2021,Skagit,WA,Truck,1,0,1,32861,32862,0.0,Washington,Washington
6952,January,2021,Snohomish,WA,Truck,1,0,1,125692,125693,0.0,Washington,Washington
6959,January,2021,Chelan,WA,Passenger,294,87,381,54481,54862,0.69,Washington,Washington
6960,January,2021,Jefferson,WA,Passenger,290,166,456,24802,25258,1.81,Washington,Washington
6967,January,2021,Pacific,WA,Passenger,35,37,72,15798,15870,0.45,Washington,Washington
6969,January,2021,Douglas,WA,Passenger,84,46,130,28199,28329,0.46,Washington,Washington
6974,January,2021,Kitsap,WA,Truck,0,0,0,54300,54300,0.0,Washington,Washington
6975,January,2021,Kittitas,WA,Passenger,134,52,186,29834,30020,0.62,Washington,Washington
6987,January,2021,Ferry,WA,Passenger,9,3,12,4341,4353,0.28,Washington,Washington
6988,January,2021,Wahkiakum,WA,Passenger,7,6,13,3040,3053,0.43,Washington,Washington
6999,January,2021,Island,WA,Truck,0,0,0,21409,21409,0.0,Washington,Washington
7001,January,2021,Columbia,WA,Truck,0,0,0,1547,1547,0.0,Washington,Washington
7002,January,2021,Spokane,WA,Truck,0,0,0,100880,100880,0.0,Washington,Washington
7008,January,2021,King,WA,Passenger,27793,8324,36117,1367229,1403346,2.57,Washington,Washington
7012,January,2022,Douglas,WA,Passenger,118,56,174,28586,28760,0.61,Washington,Washington
7018,January,2022,Whatcom,WA,Truck,3,0,3,43614,43617,0.01,Washington,Washington
7019,January,2022,Asotin,WA,Truck,0,0,0,6736,6736,0.0,Washington,Washington
7022,January,2022,Garfield,WA,Truck,0,0,0,995,995,0.0,Washington,Washington
7026,January,2022,Whatcom,WA,Passenger,1665,673,2338,149528,151866,1.54,Washington,Washington
7027,January,2022,King,WA,Passenger,36353,10406,46759,1356535,1403294,3.33,Washington,Washington
7028,January,2022,Walla Walla,WA,Passenger,146,89,235,36290,36525,0.64,Washington,Washington
7029,January,2022,Stevens,WA,Passenger,58,47,105,30190,30295,0.35,Washington,Washington
7030,January,2022,Clark,WA,Passenger,3541,1572,5113,319486,324599,1.58,Washington,Washington
7034,January,2022,San Juan,WA,Passenger,482,151,633,14173,14806,4.28,Washington,Washington
7036,January,2022,King,WA,Truck,14,1,15,182672,182687,0.01,Washington,Washington
7039,January,2022,Chelan,WA,Truck,0,0,0,23062,23062,0.0,Washington,Washington
7041,January,2022,Cowlitz,WA,Truck,0,1,1,28923,28924,0.0,Washington,Washington
7043,January,2022,Snohomish,WA,Truck,3,0,3,125304,125307,0.0,Washington,Washington
7045,January,2022,Lewis,WA,Passenger,213,165,378,59516,59894,0.63,Washington,Washington
7050,January,2022,Okanogan,WA,Passenger,70,47,117,26533,26650,0.44,Washington,Washington
7054,January,2022,Spokane,WA,Truck,0,0,0,102647,102647,0.0,Washington,Washington
7059,January,2022,Yakima,WA,Passenger,294,177,471,168293,168764,0.28,Washington,Washington
7065,January,2022,Skamania,WA,Passenger,60,43,103,8316,8419,1.22,Washington,Washington
7068,January,2022,Jefferson,WA,Passenger,385,197,582,24693,25275,2.3,Washington,Washington
7069,January,2022,Walla Walla,WA,Truck,0,0,0,14104,14104,0.0,Washington,Washington
7076,January,2022,Island,WA,Passenger,734,344,1078,62598,63676,1.69,Washington,Washington
7077,January,2022,Kitsap,WA,Truck,0,0,0,54155,54155,0.0,Washington,Washington
7079,January,2022,Benton,WA,Passenger,654,453,1107,135958,137065,0.81,Washington,Washington
7080,January,2022,Thurston,WA,Truck,3,0,3,55934,55937,0.01,Washington,Washington
7088,January,2022,Mason,WA,Truck,0,0,0,21187,21187,0.0,Washington,Washington
7094,January,2022,Kitsap,WA,Passenger,2191,970,3161,179910,183071,1.73,Washington,Washington
7097,January,2022,Benton,WA,Truck,0,0,0,43600,43600,0.0,Washington,Washington
7098,January,2022,Pierce,WA,Passenger,4367,2153,6520,554116,560636,1.16,Washington,Washington
7100,January,2022,Pierce,WA,Truck,0,0,0,144454,144454,0.0,Washington,Washington
7108,January,2022,Kittitas,WA,Truck,0,0,0,14768,14768,0.0,Washington,Washington
7112,January,2022,Pacific,WA,Passenger,55,63,118,16055,16173,0.73,Washington,Washington
7115,January,2022,Grant,WA,Truck,0,0,0,27996,27996,0.0,Washington,Washington
7117,January,2022,Clallam,WA,Passenger,391,241,632,50236,50868,1.24,Washington,Washington
7123,January,2022,Garfield,WA,Passenger,0,3,3,1356,1359,0.22,Washington,Washington
7127,January,2022,Franklin,WA,Truck,0,0,0,20891,20891,0.0,Washington,Washington
7128,January,2022,Ferry,WA,Passenger,14,3,17,4436,4453,0.38,Washington,Washington
7130,January,2022,San Juan,WA,Truck,1,0,1,6022,6023,0.02,Washington,Washington
7132,January,2022,Chelan,WA,Passenger,421,117,538,54587,55125,0.98,Washington,Washington
7133,January,2022,Thurston,WA,Passenger,1920,973,2893,196481,199374,1.45,Washington,Washington
7135,January,2022,Klickitat,WA,Passenger,90,54,144,15313,15457,0.93,Washington,Washington
7136,January,2022,Kittitas,WA,Passenger,216,71,287,29812,30099,0.95,Washington,Washington
7137,January,2022,Clark,WA,Truck,2,0,2,83892,83894,0.0,Washington,Washington
7139,January,2022,Grays Harbor,WA,Passenger,197,158,355,49346,49701,0.71,Washington,Washington
7142,January,2022,Adams,WA,Truck,0,0,0,5434,5434,0.0,Washington,Washington
7147,January,2022,Yakima,WA,Truck,0,0,0,61615,61615,0.0,Washington,Washington
7149,January,2022,Skagit,WA,Passenger,701,307,1008,90876,91884,1.1,Washington,Washington
7150,January,2022,Clallam,WA,Truck,1,0,1,22143,22144,0.0,Washington,Washington
7164,January,2022,Lewis,WA,Truck,0,0,0,26654,26654,0.0,Washington,Washington
7168,January,2022,Adams,WA,Passenger,17,14,31,13041,13072,0.24,Washington,Washington
7173,January,2022,Jefferson,WA,Truck,0,0,0,9571,9571,0.0,Washington,Washington
7175,January,2022,Pend Oreille,WA,Passenger,17,9,26,9118,9144,0.28,Washington,Washington
7180,January,2022,Cowlitz,WA,Passenger,273,164,437,71316,71753,0.61,Washington,Washington
7182,January,2022,Franklin,WA,Passenger,169,101,270,62152,62422,0.43,Washington,Washington
7184,January,2022,Columbia,WA,Truck,0,0,0,1557,1557,0.0,Washington,Washington
7188,January,2022,Stevens,WA,Truck,0,0,0,18938,18938,0.0,Washington,Washington
7190,January,2022,Lincoln,WA,Truck,0,0,0,4835,4835,0.0,Washington,Washington
7194,January,2022,Wahkiakum,WA,Truck,0,0,0,1816,1816,0.0,Washington,Washington
7197,January,2022,Okanogan,WA,Truck,0,0,0,16692,16692,0.0,Washington,Washington
7198,January,2022,Island,WA,Truck,1,0,1,21481,21482,0.0,Washington,Washington
7201,January,2022,Pend Oreille,WA,Truck,0,0,0,5731,5731,0.0,Washington,Washington
7203,January,2022,Columbia,WA,Passenger,6,2,8,2452,2460,0.33,Washington,Washington
7205,January,2022,Snohomish,WA,Passenger,7221,2278,9499,536658,546157,1.74,Washington,Washington
7206,January,2022,Ferry,WA,Truck,0,0,0,3582,3582,0.0,Washington,Washington
7207,January,2022,Spokane,WA,Passenger,1350,766,2116,326674,328790,0.64,Washington,Washington
7212,January,2022,Skagit,WA,Truck,1,0,1,32658,32659,0.0,Washington,Washington
7220,January,2022,Whitman,WA,Truck,0,0,0,8565,8565,0.0,Washington,Washington
7222,January,2022,Wahkiakum,WA,Passenger,17,11,28,3075,3103,0.9,Washington,Washington
7228,January,2022,Grays Harbor,WA,Truck,0,0,0,21347,21347,0.0,Washington,Washington
7230,January,2022,Lincoln,WA,Passenger,6,17,23,7738,7761,0.3,Washington,Washington
7234,January,2022,Asotin,WA,Passenger,23,17,40,12668,12708,0.31,Washington,Washington
7241,January,2022,Douglas,WA,Truck,0,0,0,12682,12682,0.0,Washington,Washington
7245,January,2022,Grant,WA,Passenger,140,100,240,66811,67051,0.36,Washington,Washington
7250,January,2022,Mason,WA,Passenger,272,161,433,47766,48199,0.9,Washington,Washington
7254,January,2022,Pacific,WA,Truck,0,0,0,8024,8024,0.0,Washington,Washington
7260,January,2022,Skamania,WA,Truck,0,0,0,3990,3990,0.0,Washington,Washington
7264,January,2022,Whitman,WA,Passenger,69,58,127,21971,22098,0.57,Washington,Washington
7267,January,2022,Klickitat,WA,Truck,0,0,0,8335,8335,0.0,Washington,Washington
7271,January,2023,Chelan,WA,Truck,15,0,15,23105,23120,0.06,Washington,Washington
7276,January,2023,Clark,WA,Passenger,5070,2078,7148,314583,321731,2.22,Washington,Washington
7277,January,2023,Island,WA,Passenger,955,401,1356,61553,62909,2.16,Washington,Washington
7291,January,2023,San Juan,WA,Truck,9,0,9,5904,5913,0.15,Washington,Washington
7292,January,2023,Skamania,WA,Passenger,93,53,146,8110,8256,1.77,Washington,Washington
7293,January,2023,Whatcom,WA,Truck,37,0,37,42986,43023,0.09,Washington,Washington
7296,January,2023,Whitman,WA,Passenger,120,70,190,22014,22204,0.86,Washington,Washington
7303,January,2023,Grays Harbor,WA,Passenger,260,164,424,48595,49019,0.86,Washington,Washington
7304,January,2023,Cowlitz,WA,Truck,7,0,7,28344,28351,0.02,Washington,Washington
7307,January,2023,Wahkiakum,WA,Truck,1,0,1,1794,1795,0.06,Washington,Washington
7311,January,2023,King,WA,Truck,461,2,463,177951,178414,0.26,Washington,Washington
7314,January,2023,Stevens,WA,Passenger,96,57,153,29986,30139,0.51,Washington,Washington
7316,January,2023,Lewis,WA,Passenger,281,185,466,59747,60213,0.77,Washington,Washington
7319,January,2023,Asotin,WA,Passenger,30,20,50,12490,12540,0.4,Washington,Washington
7320,January,2023,Douglas,WA,Passenger,172,58,230,28592,28822,0.8,Washington,Washington
7322,January,2023,Kittitas,WA,Truck,5,0,5,14551,14556,0.03,Washington,Washington
7328,January,2023,Jefferson,WA,Truck,6,0,6,9368,9374,0.06,Washington,Washington
7333,January,2023,Thurston,WA,Truck,42,0,42,54598,54640,0.08,Washington,Washington
7336,January,2023,Adams,WA,Passenger,22,11,33,13010,13043,0.25,Washington,Washington
7338,January,2023,Skagit,WA,Passenger,958,364,1322,89336,90658,1.46,Washington,Washington
7341,January,2023,Grant,WA,Truck,5,0,5,28035,28040,0.02,Washington,Washington
7344,January,2023,Ferry,WA,Truck,0,0,0,3552,3552,0.0,Washington,Washington
7349,January,2023,Chelan,WA,Passenger,556,147,703,54338,55041,1.28,Washington,Washington
7350,January,2023,Douglas,WA,Truck,5,0,5,12874,12879,0.04,Washington,Washington
7351,January,2023,Klickitat,WA,Truck,4,0,4,8231,8235,0.05,Washington,Washington
7354,January,2023,Island,WA,Truck,20,0,20,21176,21196,0.09,Washington,Washington
7355,January,2023,Clark,WA,Truck,62,0,62,81807,81869,0.08,Washington,Washington
7361,January,2023,Pacific,WA,Passenger,72,81,153,15730,15883,0.96,Washington,Washington
7362,January,2023,Walla Walla,WA,Passenger,203,107,310,35733,36043,0.86,Washington,Washington
7372,January,2023,Kitsap,WA,Passenger,2835,1163,3998,177157,181155,2.21,Washington,Washington
7375,January,2023,Yakima,WA,Passenger,435,228,663,166438,167101,0.4,Washington,Washington
7378,January,2023,Garfield,WA,Passenger,1,3,4,1319,1323,0.3,Washington,Washington
7381,January,2023,Snohomish,WA,Truck,113,0,113,122400,122513,0.09,Washington,Washington
7387,January,2023,Lincoln,WA,Truck,0,0,0,4853,4853,0.0,Washington,Washington
7391,January,2023,Thurston,WA,Passenger,2703,1144,3847,191970,195817,1.96,Washington,Washington
7395,January,2023,Kittitas,WA,Passenger,312,94,406,29546,29952,1.36,Washington,Washington
7404,January,2023,Whitman,WA,Truck,3,0,3,8648,8651,0.03,Washington,Washington
7406,January,2023,Okanogan,WA,Passenger,105,53,158,26127,26285,0.6,Washington,Washington
7408,January,2023,Okanogan,WA,Truck,2,0,2,16435,16437,0.01,Washington,Washington
7409,January,2023,Grays Harbor,WA,Truck,2,0,2,21070,21072,0.01,Washington,Washington
7411,January,2023,Snohomish,WA,Passenger,10586,2793,13379,530262,543641,2.46,Washington,Washington
7414,January,2023,Mason,WA,Passenger,380,192,572,46777,47349,1.21,Washington,Washington
7415,January,2023,Garfield,WA,Truck,0,0,0,976,976,0.0,Washington,Washington
7417,January,2023,Clallam,WA,Truck,9,0,9,21848,21857,0.04,Washington,Washington
7418,January,2023,Franklin,WA,Passenger,262,124,386,61842,62228,0.62,Washington,Washington
7420,January,2023,Spokane,WA,Truck,22,0,22,101916,101938,0.02,Washington,Washington
7422,January,2023,Cowlitz,WA,Passenger,417,193,610,70247,70857,0.86,Washington,Washington
7424,January,2023,Grant,WA,Passenger,230,113,343,66923,67266,0.51,Washington,Washington
7431,January,2023,Columbia,WA,Truck,0,0,0,1579,1579,0.0,Washington,Washington
7436,January,2023,King,WA,Passenger,49761,12517,62278,1334257,1396535,4.46,Washington,Washington
7438,January,2023,Mason,WA,Truck,8,0,8,20880,20888,0.04,Washington,Washington
7443,January,2023,Clallam,WA,Passenger,499,267,766,49348,50114,1.53,Washington,Washington
7447,January,2023,Kitsap,WA,Truck,41,0,41,52943,52984,0.08,Washington,Washington
7448,January,2023,Pend Oreille,WA,Truck,0,0,0,5572,5572,0.0,Washington,Washington
7449,January,2023,Lincoln,WA,Passenger,14,19,33,7764,7797,0.42,Washington,Washington
7450,January,2023,Skagit,WA,Truck,11,0,11,32085,32096,0.03,Washington,Washington
7455,January,2023,Spokane,WA,Passenger,1998,953,2951,324493,327444,0.9,Washington,Washington
7457,January,2023,Pierce,WA,Passenger,6394,2548,8942,537638,546580,1.64,Washington,Washington
7461,January,2023,Asotin,WA,Truck,0,0,0,6681,6681,0.0,Washington,Washington
7462,January,2023,Klickitat,WA,Passenger,127,53,180,15178,15358,1.17,Washington,Washington
7465,January,2023,Adams,WA,Truck,1,0,1,5377,5378,0.02,Washington,Washington
7466,January,2023,Yakima,WA,Truck,8,0,8,61183,61191,0.01,Washington,Washington
7469,January,2023,Franklin,WA,Truck,4,0,4,20981,20985,0.02,Washington,Washington
7471,January,2023,San Juan,WA,Passenger,572,173,745,13878,14623,5.09,Washington,Washington
7472,January,2023,Columbia,WA,Passenger,8,1,9,2438,2447,0.37,Washington,Washington
7477,January,2023,Ferry,WA,Passenger,24,4,28,4346,4374,0.64,Washington,Washington
7478,January,2023,Lewis,WA,Truck,2,0,2,26285,26287,0.01,Washington,Washington
7480,January,2023,Pacific,WA,Truck,2,0,2,7831,7833,0.03,Washington,Washington
7481,January,2023,Pend Oreille,WA,Passenger,23,14,37,8954,8991,0.41,Washington,Washington
7483,January,2023,Stevens,WA,Truck,2,0,2,18772,18774,0.01,Washington,Washington
7487,January,2023,Whatcom,WA,Passenger,2153,822,2975,148714,151689,1.96,Washington,Washington
7489,January,2023,Walla Walla,WA,Truck,3,0,3,13863,13866,0.02,Washington,Washington
7494,January,2023,Benton,WA,Passenger,961,512,1473,135906,137379,1.07,Washington,Washington
7495,January,2023,Pierce,WA,Truck,97,0,97,139157,139254,0.07,Washington,Washington
7500,January,2023,Jefferson,WA,Passenger,495,236,731,24276,25007,2.92,Washington,Washington
7502,January,2023,Wahkiakum,WA,Passenger,25,15,40,3050,3090,1.29,Washington,Washington
7503,January,2023,Skamania,WA,Truck,1,0,1,3877,3878,0.03,Washington,Washington
7506,January,2023,Benton,WA,Truck,13,0,13,43322,43335,0.03,Washington,Washington
7507,July,2017,Pierce,WA,Passenger,986,856,1842,524592,526434,0.35,Washington,Washington
7515,July,2017,Walla Walla,WA,Truck,0,0,0,13177,13177,0.0,Washington,Washington
7518,July,2017,Franklin,WA,Passenger,26,47,73,55735,55808,0.13,Washington,Washington
7519,July,2017,Clark,WA,Truck,0,0,0,77737,77737,0.0,Washington,Washington
7521,July,2017,Ferry,WA,Truck,0,0,0,3526,3526,0.0,Washington,Washington
7523,July,2017,Clallam,WA,Truck,0,0,0,21043,21043,0.0,Washington,Washington
7526,July,2017,Garfield,WA,Passenger,0,0,0,1296,1296,0.0,Washington,Washington
7527,July,2017,Yakima,WA,Truck,0,0,0,57469,57469,0.0,Washington,Washington
7528,July,2017,Island,WA,Truck,0,0,0,20500,20500,0.0,Washington,Washington
7530,July,2017,Kittitas,WA,Truck,0,0,0,13581,13581,0.0,Washington,Washington
7532,July,2017,King,WA,Passenger,10255,4174,14429,1373311,1387740,1.04,Washington,Washington
7534,July,2017,Kitsap,WA,Passenger,622,324,946,173384,174330,0.54,Washington,Washington
7536,July,2017,Whitman,WA,Passenger,12,19,31,22108,22139,0.14,Washington,Washington
7540,July,2017,Mason,WA,Truck,0,0,0,19261,19261,0.0,Washington,Washington
7543,July,2017,Pend Oreille,WA,Truck,0,0,0,5582,5582,0.0,Washington,Washington
7545,July,2017,Grant,WA,Passenger,19,30,49,61004,61053,0.08,Washington,Washington
7548,July,2017,Jefferson,WA,Truck,0,0,0,9414,9414,0.0,Washington,Washington
7549,July,2017,Douglas,WA,Passenger,35,26,61,26756,26817,0.23,Washington,Washington
7553,July,2017,Grays Harbor,WA,Truck,0,0,0,19894,19894,0.0,Washington,Washington
7554,July,2017,Asotin,WA,Passenger,8,4,12,12439,12451,0.1,Washington,Washington
7556,July,2017,Garfield,WA,Truck,0,0,0,926,926,0.0,Washington,Washington
7558,July,2017,Lincoln,WA,Truck,0,0,0,4445,4445,0.0,Washington,Washington
7559,July,2017,Clark,WA,Passenger,795,517,1312,299957,301269,0.44,Washington,Washington
7562,July,2017,San Juan,WA,Truck,0,0,0,5547,5547,0.0,Washington,Washington
7563,July,2017,Lewis,WA,Truck,0,0,0,24914,24914,0.0,Washington,Washington
7565,July,2017,Skagit,WA,Passenger,141,104,245,88182,88427,0.28,Washington,Washington
7568,July,2017,Skamania,WA,Passenger,9,7,16,8552,8568,0.19,Washington,Washington
7574,July,2017,Thurston,WA,Passenger,418,350,768,187062,187830,0.41,Washington,Washington
7575,July,2017,Kittitas,WA,Passenger,24,19,43,27678,27721,0.16,Washington,Washington
7576,July,2017,Snohomish,WA,Passenger,1818,920,2738,513286,516024,0.53,Washington,Washington
7577,July,2017,Lincoln,WA,Passenger,2,5,7,7519,7526,0.09,Washington,Washington
7579,July,2017,Pierce,WA,Truck,0,0,0,137369,137369,0.0,Washington,Washington
7580,July,2017,Clallam,WA,Passenger,93,77,170,48417,48587,0.35,Washington,Washington
7588,July,2017,Chelan,WA,Passenger,68,35,103,52135,52238,0.2,Washington,Washington
7591,July,2017,Franklin,WA,Truck,0,0,0,18175,18175,0.0,Washington,Washington
7592,July,2017,Cowlitz,WA,Truck,0,0,0,27954,27954,0.0,Washington,Washington
7596,July,2017,Stevens,WA,Truck,0,0,0,18211,18211,0.0,Washington,Washington
7598,July,2017,Chelan,WA,Truck,0,0,0,21329,21329,0.0,Washington,Washington
7600,July,2017,Pacific,WA,Passenger,10,9,19,15197,15216,0.12,Washington,Washington
7606,July,2017,Grant,WA,Truck,0,0,0,25271,25271,0.0,Washington,Washington
7609,July,2017,Skagit,WA,Truck,1,0,1,31485,31486,0.0,Washington,Washington
7610,July,2017,Okanogan,WA,Passenger,4,18,22,25634,25656,0.09,Washington,Washington
7612,July,2017,Jefferson,WA,Passenger,107,61,168,23895,24063,0.7,Washington,Washington
7614,July,2017,Columbia,WA,Truck,0,0,0,1533,1533,0.0,Washington,Washington
7616,July,2017,Wahkiakum,WA,Passenger,0,2,2,2836,2838,0.07,Washington,Washington
7617,July,2017,Benton,WA,Passenger,155,148,303,128671,128974,0.23,Washington,Washington
7619,July,2017,Spokane,WA,Truck,1,0,1,90744,90745,0.0,Washington,Washington
7626,July,2017,Wahkiakum,WA,Truck,0,0,0,1659,1659,0.0,Washington,Washington
7630,July,2017,Okanogan,WA,Truck,0,0,0,16226,16226,0.0,Washington,Washington
7631,July,2017,Island,WA,Passenger,121,141,262,60273,60535,0.43,Washington,Washington
7632,July,2017,Yakima,WA,Passenger,49,62,111,159655,159766,0.07,Washington,Washington
7634,July,2017,Grays Harbor,WA,Passenger,36,35,71,44850,44921,0.16,Washington,Washington
7635,July,2017,Kitsap,WA,Truck,1,0,1,52511,52512,0.0,Washington,Washington
7636,July,2017,Columbia,WA,Passenger,1,1,2,2350,2352,0.09,Washington,Washington
7637,July,2017,Stevens,WA,Passenger,8,23,31,31395,31426,0.1,Washington,Washington
7638,July,2017,Klickitat,WA,Truck,0,0,0,7953,7953,0.0,Washington,Washington
7639,July,2017,Asotin,WA,Truck,0,0,0,6532,6532,0.0,Washington,Washington
7642,July,2017,Walla Walla,WA,Passenger,27,26,53,34886,34939,0.15,Washington,Washington
7643,July,2017,Adams,WA,Truck,0,0,0,5123,5123,0.0,Washington,Washington
7644,July,2017,Pacific,WA,Truck,0,0,0,7495,7495,0.0,Washington,Washington
7645,July,2017,Pend Oreille,WA,Passenger,3,4,7,9321,9328,0.08,Washington,Washington
7646,July,2017,Spokane,WA,Passenger,262,213,475,296652,297127,0.16,Washington,Washington
7647,July,2017,Whatcom,WA,Truck,2,0,2,41660,41662,0.0,Washington,Washington
7650,July,2017,Benton,WA,Truck,0,0,0,40129,40129,0.0,Washington,Washington
7657,July,2017,San Juan,WA,Passenger,112,39,151,13563,13714,1.1,Washington,Washington
7658,July,2017,Ferry,WA,Passenger,1,1,2,4400,4402,0.05,Washington,Washington
7662,July,2017,Snohomish,WA,Truck,1,0,1,121771,121772,0.0,Washington,Washington
7663,July,2017,Klickitat,WA,Passenger,22,24,46,14803,14849,0.31,Washington,Washington
7664,July,2017,Adams,WA,Passenger,3,3,6,12184,12190,0.05,Washington,Washington
7665,July,2017,Thurston,WA,Truck,0,0,0,53297,53297,0.0,Washington,Washington
7667,July,2017,Douglas,WA,Truck,0,0,0,11515,11515,0.0,Washington,Washington
7671,July,2017,Skamania,WA,Truck,0,0,0,3873,3873,0.0,Washington,Washington
7672,July,2017,Mason,WA,Passenger,57,71,128,43631,43759,0.29,Washington,Washington
7674,July,2017,Whitman,WA,Truck,0,0,0,8425,8425,0.0,Washington,Washington
7675,July,2017,Lewis,WA,Passenger,52,36,88,55557,55645,0.16,Washington,Washington
7677,July,2017,Whatcom,WA,Passenger,474,179,653,143186,143839,0.45,Washington,Washington
7679,July,2017,King,WA,Truck,8,1,9,187250,187259,0.0,Washington,Washington
7685,July,2017,Cowlitz,WA,Passenger,52,61,113,69775,69888,0.16,Washington,Washington
7688,July,2018,Whatcom,WA,Truck,2,0,2,42313,42315,0.0,Washington,Washington
7690,July,2018,Whatcom,WA,Passenger,637,318,955,147985,148940,0.64,Washington,Washington
7691,July,2018,Skagit,WA,Truck,1,0,1,32118,32119,0.0,Washington,Washington
7692,July,2018,Grays Harbor,WA,Truck,0,0,0,20227,20227,0.0,Washington,Washington
7694,July,2018,Pacific,WA,Truck,0,0,0,7611,7611,0.0,Washington,Washington
7696,July,2018,Okanogan,WA,Truck,0,0,0,16423,16423,0.0,Washington,Washington
7697,July,2018,Stevens,WA,Passenger,11,25,36,31650,31686,0.11,Washington,Washington
7702,July,2018,Lewis,WA,Truck,0,0,0,25583,25583,0.0,Washington,Washington
7708,July,2018,Island,WA,Truck,0,0,0,20994,20994,0.0,Washington,Washington
7709,July,2018,Cowlitz,WA,Truck,0,0,0,28560,28560,0.0,Washington,Washington
7711,July,2018,Benton,WA,Passenger,193,197,390,131733,132123,0.3,Washington,Washington
7713,July,2018,Spokane,WA,Truck,1,0,1,92869,92870,0.0,Washington,Washington
7715,July,2018,Garfield,WA,Passenger,1,1,2,1320,1322,0.15,Washington,Washington
7718,July,2018,Lewis,WA,Passenger,83,59,142,57814,57956,0.25,Washington,Washington
7721,July,2018,Grant,WA,Truck,0,0,0,25943,25943,0.0,Washington,Washington
7723,July,2018,Cowlitz,WA,Passenger,57,77,134,71871,72005,0.19,Washington,Washington
7724,July,2018,Grant,WA,Passenger,33,47,80,63265,63345,0.13,Washington,Washington
7725,July,2018,Columbia,WA,Truck,0,0,0,1530,1530,0.0,Washington,Washington
7730,July,2018,Pierce,WA,Truck,0,0,0,138077,138077,0.0,Washington,Washington
7732,July,2018,Wahkiakum,WA,Truck,0,0,0,1681,1681,0.0,Washington,Washington
7735,July,2018,Klickitat,WA,Truck,0,0,0,8126,8126,0.0,Washington,Washington
7736,July,2018,Jefferson,WA,Passenger,147,99,246,24581,24827,0.99,Washington,Washington
7737,July,2018,Grays Harbor,WA,Passenger,54,62,116,46760,46876,0.25,Washington,Washington
7738,July,2018,Yakima,WA,Passenger,65,93,158,163968,164126,0.1,Washington,Washington
7739,July,2018,Skamania,WA,Truck,0,0,0,3960,3960,0.0,Washington,Washington
7741,July,2018,Clark,WA,Passenger,1042,744,1786,308652,310438,0.58,Washington,Washington
7744,July,2018,Lincoln,WA,Passenger,3,6,9,7748,7757,0.12,Washington,Washington
7755,July,2018,King,WA,Passenger,13479,5802,19281,1372470,1391751,1.39,Washington,Washington
7757,July,2018,Adams,WA,Passenger,5,5,10,12641,12651,0.08,Washington,Washington
7760,July,2018,Thurston,WA,Truck,0,0,0,54414,54414,0.0,Washington,Washington
7761,July,2018,Jefferson,WA,Truck,0,0,0,9588,9588,0.0,Washington,Washington
7764,July,2018,Franklin,WA,Passenger,38,66,104,58177,58281,0.18,Washington,Washington
7766,July,2018,Whitman,WA,Truck,0,0,0,8496,8496,0.0,Washington,Washington
7769,July,2018,Island,WA,Passenger,206,194,400,62580,62980,0.64,Washington,Washington
7770,July,2018,Ferry,WA,Truck,0,0,0,3535,3535,0.0,Washington,Washington
7781,July,2018,Franklin,WA,Truck,0,0,0,18741,18741,0.0,Washington,Washington
7784,July,2018,Chelan,WA,Truck,0,0,0,21950,21950,0.0,Washington,Washington
7785,July,2018,Skagit,WA,Passenger,215,171,386,90712,91098,0.42,Washington,Washington
7787,July,2018,Thurston,WA,Passenger,577,497,1074,193753,194827,0.55,Washington,Washington
7788,July,2018,San Juan,WA,Passenger,149,62,211,14115,14326,1.47,Washington,Washington
7790,July,2018,Douglas,WA,Passenger,43,32,75,27719,27794,0.27,Washington,Washington
7795,July,2018,Skamania,WA,Passenger,13,9,22,8635,8657,0.25,Washington,Washington
7797,July,2018,Pend Oreille,WA,Passenger,5,5,10,9578,9588,0.1,Washington,Washington
7800,July,2018,Mason,WA,Truck,0,0,0,20051,20051,0.0,Washington,Washington
7802,July,2018,Mason,WA,Passenger,87,93,180,45864,46044,0.39,Washington,Washington
7809,July,2018,Stevens,WA,Truck,0,0,0,18650,18650,0.0,Washington,Washington
7811,July,2018,Klickitat,WA,Passenger,24,31,55,15220,15275,0.36,Washington,Washington
7813,July,2018,San Juan,WA,Truck,0,0,0,5730,5730,0.0,Washington,Washington
7814,July,2018,Kitsap,WA,Truck,1,0,1,53372,53373,0.0,Washington,Washington
7816,July,2018,Pierce,WA,Passenger,1262,1194,2456,533502,535958,0.46,Washington,Washington
7817,July,2018,Lincoln,WA,Truck,0,0,0,4557,4557,0.0,Washington,Washington
7818,July,2018,Snohomish,WA,Passenger,2404,1295,3699,522666,526365,0.7,Washington,Washington
7820,July,2018,Asotin,WA,Passenger,11,8,19,12637,12656,0.15,Washington,Washington
7822,July,2018,Kitsap,WA,Passenger,809,473,1282,178849,180131,0.71,Washington,Washington
7823,July,2018,King,WA,Truck,7,1,8,182983,182991,0.0,Washington,Washington
7825,July,2018,Asotin,WA,Truck,0,0,0,6628,6628,0.0,Washington,Washington
7827,July,2018,Pend Oreille,WA,Truck,0,0,0,5699,5699,0.0,Washington,Washington
7828,July,2018,Pacific,WA,Passenger,19,21,40,15621,15661,0.26,Washington,Washington
7830,July,2018,Walla Walla,WA,Passenger,34,44,78,35739,35817,0.22,Washington,Washington
7831,July,2018,Benton,WA,Truck,0,0,0,41093,41093,0.0,Washington,Washington
7838,July,2018,Snohomish,WA,Truck,1,0,1,121679,121680,0.0,Washington,Washington
7840,July,2018,Walla Walla,WA,Truck,0,0,0,13467,13467,0.0,Washington,Washington
7845,July,2018,Wahkiakum,WA,Passenger,1,1,2,2938,2940,0.07,Washington,Washington
7847,July,2018,Clallam,WA,Truck,0,0,0,21477,21477,0.0,Washington,Washington
7850,July,2018,Chelan,WA,Passenger,112,52,164,53574,53738,0.31,Washington,Washington
7856,July,2018,Spokane,WA,Passenger,347,320,667,304017,304684,0.22,Washington,Washington
7857,July,2018,Columbia,WA,Passenger,2,2,4,2419,2423,0.17,Washington,Washington
7858,July,2018,Clark,WA,Truck,0,0,0,79240,79240,0.0,Washington,Washington
7875,July,2018,Garfield,WA,Truck,0,0,0,956,956,0.0,Washington,Washington
7878,July,2018,Yakima,WA,Truck,0,0,0,58542,58542,0.0,Washington,Washington
7880,July,2018,Ferry,WA,Passenger,3,3,6,4424,4430,0.14,Washington,Washington
7881,July,2018,Clallam,WA,Passenger,127,111,238,49977,50215,0.47,Washington,Washington
7882,July,2018,Kittitas,WA,Truck,0,0,0,14053,14053,0.0,Washington,Washington
7884,July,2018,Adams,WA,Truck,0,0,0,5161,5161,0.0,Washington,Washington
7885,July,2018,Kittitas,WA,Passenger,48,32,80,28990,29070,0.28,Washington,Washington
7887,July,2018,Douglas,WA,Truck,0,0,0,11970,11970,0.0,Washington,Washington
7890,July,2018,Okanogan,WA,Passenger,9,20,29,26029,26058,0.11,Washington,Washington
7891,July,2018,Whitman,WA,Passenger,19,28,47,22658,22705,0.21,Washington,Washington
7897,July,2019,Whatcom,WA,Truck,2,0,2,42929,42931,0.0,Washington,Washington
7899,July,2019,Pend Oreille,WA,Truck,0,0,0,5730,5730,0.0,Washington,Washington
7904,July,2019,Walla Walla,WA,Passenger,52,61,113,36208,36321,0.31,Washington,Washington
7909,July,2019,Walla Walla,WA,Truck,0,0,0,13617,13617,0.0,Washington,Washington
7912,July,2019,Columbia,WA,Passenger,2,2,4,2454,2458,0.16,Washington,Washington
7919,July,2019,Kittitas,WA,Passenger,79,41,120,29679,29799,0.4,Washington,Washington
7922,July,2019,Thurston,WA,Truck,0,0,0,55259,55259,0.0,Washington,Washington
7927,July,2019,Columbia,WA,Truck,0,0,0,1529,1529,0.0,Washington,Washington
7928,July,2019,Garfield,WA,Passenger,1,1,2,1298,1300,0.15,Washington,Washington
7930,July,2019,Yakima,WA,Passenger,109,107,216,165397,165613,0.13,Washington,Washington
7931,July,2019,San Juan,WA,Passenger,220,72,292,14446,14738,1.98,Washington,Washington
7932,July,2019,Lewis,WA,Truck,0,0,0,25966,25966,0.0,Washington,Washington
7937,July,2019,Skamania,WA,Passenger,25,18,43,8739,8782,0.49,Washington,Washington
7939,July,2019,Pierce,WA,Truck,0,0,0,140021,140021,0.0,Washington,Washington
7940,July,2019,Cowlitz,WA,Passenger,106,107,213,73140,73353,0.29,Washington,Washington
7941,July,2019,Thurston,WA,Passenger,905,652,1557,198166,199723,0.78,Washington,Washington
7945,July,2019,Skagit,WA,Truck,1,0,1,32524,32525,0.0,Washington,Washington
7952,July,2019,Clark,WA,Passenger,1588,944,2532,314921,317453,0.8,Washington,Washington
7953,July,2019,Lincoln,WA,Truck,0,0,0,4684,4684,0.0,Washington,Washington
7955,July,2019,Cowlitz,WA,Truck,0,0,0,28867,28867,0.0,Washington,Washington
7958,July,2019,Skagit,WA,Passenger,307,210,517,92211,92728,0.56,Washington,Washington
7965,July,2019,Clark,WA,Truck,0,0,0,80613,80613,0.0,Washington,Washington
7969,July,2019,Klickitat,WA,Truck,0,0,0,8255,8255,0.0,Washington,Washington
7970,July,2019,King,WA,Truck,5,1,6,182265,182271,0.0,Washington,Washington
7971,July,2019,Asotin,WA,Truck,0,0,0,6660,6660,0.0,Washington,Washington
7973,July,2019,Benton,WA,Passenger,270,289,559,134166,134725,0.41,Washington,Washington
7979,July,2019,Jefferson,WA,Truck,0,0,0,9683,9683,0.0,Washington,Washington
7984,July,2019,Skamania,WA,Truck,0,0,0,4063,4063,0.0,Washington,Washington
7985,July,2019,Mason,WA,Passenger,127,126,253,47316,47569,0.53,Washington,Washington
7992,July,2019,Clallam,WA,Truck,1,0,1,21812,21813,0.0,Washington,Washington
7993,July,2019,Jefferson,WA,Passenger,202,118,320,25065,25385,1.26,Washington,Washington
7996,July,2019,Ferry,WA,Truck,0,0,0,3580,3580,0.0,Washington,Washington
8005,July,2019,Snohomish,WA,Truck,0,0,0,122619,122619,0.0,Washington,Washington
8009,July,2019,Asotin,WA,Passenger,12,8,20,12658,12678,0.16,Washington,Washington
8013,July,2019,Benton,WA,Truck,0,0,0,42072,42072,0.0,Washington,Washington
8020,July,2019,Chelan,WA,Truck,0,0,0,22349,22349,0.0,Washington,Washington
8025,July,2019,Snohomish,WA,Passenger,3556,1617,5173,532742,537915,0.96,Washington,Washington
8026,July,2019,Island,WA,Truck,0,0,0,21312,21312,0.0,Washington,Washington
8027,July,2019,Franklin,WA,Passenger,53,71,124,60145,60269,0.21,Washington,Washington
8033,July,2019,Kitsap,WA,Truck,1,0,1,54128,54129,0.0,Washington,Washington
8034,July,2019,Lewis,WA,Passenger,100,96,196,59368,59564,0.33,Washington,Washington
8038,July,2019,Grant,WA,Truck,0,0,0,26703,26703,0.0,Washington,Washington
8039,July,2019,Franklin,WA,Truck,0,0,0,19368,19368,0.0,Washington,Washington
8043,July,2019,Adams,WA,Passenger,5,6,11,12835,12846,0.09,Washington,Washington
8046,July,2019,Spokane,WA,Passenger,557,435,992,312718,313710,0.32,Washington,Washington
8047,July,2019,Wahkiakum,WA,Passenger,2,2,4,3007,3011,0.13,Washington,Washington
8049,July,2019,Yakima,WA,Truck,0,0,0,59260,59260,0.0,Washington,Washington
8052,July,2019,Grant,WA,Passenger,43,61,104,65017,65121,0.16,Washington,Washington
8053,July,2019,Klickitat,WA,Passenger,35,33,68,15579,15647,0.43,Washington,Washington
8055,July,2019,San Juan,WA,Truck,0,0,0,5890,5890,0.0,Washington,Washington
8057,July,2019,Stevens,WA,Passenger,19,30,49,31721,31770,0.15,Washington,Washington
8059,July,2019,Pend Oreille,WA,Passenger,4,6,10,9537,9547,0.1,Washington,Washington
8065,July,2019,Adams,WA,Truck,0,0,0,5132,5132,0.0,Washington,Washington
8070,July,2019,Grays Harbor,WA,Truck,0,0,0,20535,20535,0.0,Washington,Washington
8073,July,2019,Spokane,WA,Truck,1,0,1,95241,95242,0.0,Washington,Washington
8075,July,2019,Grays Harbor,WA,Passenger,82,85,167,47997,48164,0.35,Washington,Washington
8076,July,2019,Ferry,WA,Passenger,5,2,7,4399,4406,0.16,Washington,Washington
8079,July,2019,Kittitas,WA,Truck,0,0,0,14488,14488,0.0,Washington,Washington
8081,July,2019,Wahkiakum,WA,Truck,0,0,0,1761,1761,0.0,Washington,Washington
8086,July,2019,Mason,WA,Truck,0,0,0,20412,20412,0.0,Washington,Washington
8089,July,2019,Okanogan,WA,Truck,0,0,0,16490,16490,0.0,Washington,Washington
8091,July,2019,Island,WA,Passenger,328,243,571,63488,64059,0.89,Washington,Washington
8092,July,2019,Stevens,WA,Truck,0,0,0,18704,18704,0.0,Washington,Washington
8093,July,2019,Pacific,WA,Passenger,24,30,54,16029,16083,0.34,Washington,Washington
8095,July,2019,Garfield,WA,Truck,0,0,0,961,961,0.0,Washington,Washington
8096,July,2019,Lincoln,WA,Passenger,2,10,12,7793,7805,0.15,Washington,Washington
8098,July,2019,Okanogan,WA,Passenger,23,26,49,26123,26172,0.19,Washington,Washington
8101,July,2019,Pierce,WA,Passenger,1877,1570,3447,544359,547806,0.63,Washington,Washington
8102,July,2019,Clallam,WA,Passenger,177,144,321,50640,50961,0.63,Washington,Washington
8109,July,2019,Douglas,WA,Passenger,60,37,97,28078,28175,0.34,Washington,Washington
8110,July,2019,Douglas,WA,Truck,0,0,0,12221,12221,0.0,Washington,Washington
8116,July,2019,Whitman,WA,Truck,0,0,0,8629,8629,0.0,Washington,Washington
8118,July,2019,Whatcom,WA,Passenger,883,436,1319,151115,152434,0.87,Washington,Washington
8119,July,2019,Kitsap,WA,Passenger,1093,625,1718,181246,182964,0.94,Washington,Washington
8120,July,2019,King,WA,Passenger,19627,7112,26739,1391293,1418032,1.89,Washington,Washington
8121,July,2019,Pacific,WA,Truck,0,0,0,7669,7669,0.0,Washington,Washington
8122,July,2019,Chelan,WA,Passenger,161,68,229,54431,54660,0.42,Washington,Washington
8127,July,2019,Whitman,WA,Passenger,33,45,78,22702,22780,0.34,Washington,Washington
8129,July,2020,Snohomish,WA,Passenger,4583,1775,6358,535609,541967,1.17,Washington,Washington
8130,July,2020,Pacific,WA,Passenger,33,33,66,15766,15832,0.42,Washington,Washington
8133,July,2020,Skamania,WA,Truck,0,0,0,4032,4032,0.0,Washington,Washington
8136,July,2020,Whitman,WA,Passenger,45,49,94,22124,22218,0.42,Washington,Washington
8140,July,2020,Snohomish,WA,Truck,0,0,0,124342,124342,0.0,Washington,Washington
8141,July,2020,Pierce,WA,Passenger,2467,1697,4164,551463,555627,0.75,Washington,Washington
8142,July,2020,Whitman,WA,Truck,0,0,0,8507,8507,0.0,Washington,Washington
8145,July,2020,King,WA,Truck,7,1,8,182955,182963,0.0,Washington,Washington
8148,July,2020,Klickitat,WA,Truck,0,0,0,8117,8117,0.0,Washington,Washington
8161,July,2020,Skagit,WA,Passenger,423,223,646,91309,91955,0.7,Washington,Washington
8162,July,2020,Cowlitz,WA,Truck,0,0,0,28879,28879,0.0,Washington,Washington
8163,July,2020,Pacific,WA,Truck,0,0,0,7714,7714,0.0,Washington,Washington
8165,July,2020,Chelan,WA,Truck,0,0,0,22628,22628,0.0,Washington,Washington
8167,July,2020,Walla Walla,WA,Passenger,77,65,142,35905,36047,0.39,Washington,Washington
8168,July,2020,Thurston,WA,Truck,0,0,0,55895,55895,0.0,Washington,Washington
8170,July,2020,Mason,WA,Truck,0,0,0,20714,20714,0.0,Washington,Washington
8174,July,2020,Lincoln,WA,Truck,0,0,0,4661,4661,0.0,Washington,Washington
8184,July,2020,Grays Harbor,WA,Passenger,109,112,221,48286,48507,0.46,Washington,Washington
8190,July,2020,Okanogan,WA,Truck,0,0,0,16492,16492,0.0,Washington,Washington
8193,July,2020,Franklin,WA,Passenger,65,79,144,60778,60922,0.24,Washington,Washington
8194,July,2020,Lewis,WA,Passenger,107,115,222,58138,58360,0.38,Washington,Washington
8195,July,2020,Wahkiakum,WA,Truck,0,0,0,1742,1742,0.0,Washington,Washington
8196,July,2020,Island,WA,Passenger,430,272,702,62871,63573,1.1,Washington,Washington
8199,July,2020,Lewis,WA,Truck,0,0,0,26284,26284,0.0,Washington,Washington
8201,July,2020,Douglas,WA,Truck,0,0,0,12352,12352,0.0,Washington,Washington
8206,July,2020,Clallam,WA,Passenger,237,169,406,50056,50462,0.8,Washington,Washington
8211,July,2020,Ferry,WA,Passenger,7,3,10,4330,4340,0.23,Washington,Washington
8212,July,2020,Pierce,WA,Truck,0,0,0,142931,142931,0.0,Washington,Washington
8213,July,2020,Columbia,WA,Truck,0,0,0,1541,1541,0.0,Washington,Washington
8218,July,2020,Whatcom,WA,Passenger,1091,499,1590,149332,150922,1.05,Washington,Washington
8220,July,2020,Skagit,WA,Truck,1,0,1,32590,32591,0.0,Washington,Washington
8223,July,2020,Jefferson,WA,Passenger,249,142,391,24737,25128,1.56,Washington,Washington
8224,July,2020,Asotin,WA,Truck,0,0,0,6653,6653,0.0,Washington,Washington
8225,July,2020,Clark,WA,Truck,0,0,0,82429,82429,0.0,Washington,Washington
8230,July,2020,Grays Harbor,WA,Truck,0,0,0,20981,20981,0.0,Washington,Washington
8231,July,2020,Grant,WA,Truck,0,0,0,27176,27176,0.0,Washington,Washington
8232,July,2020,Stevens,WA,Passenger,37,35,72,30627,30699,0.23,Washington,Washington
8238,July,2020,Asotin,WA,Passenger,16,12,28,12378,12406,0.23,Washington,Washington
8242,July,2020,Pend Oreille,WA,Passenger,7,5,12,9246,9258,0.13,Washington,Washington
8243,July,2020,Kittitas,WA,Truck,0,0,0,14564,14564,0.0,Washington,Washington
8245,July,2020,Garfield,WA,Truck,0,0,0,988,988,0.0,Washington,Washington
8246,July,2020,Cowlitz,WA,Passenger,146,117,263,72232,72495,0.36,Washington,Washington
8250,July,2020,Jefferson,WA,Truck,0,0,0,9542,9542,0.0,Washington,Washington
8252,July,2020,King,WA,Passenger,24904,7756,32660,1371156,1403816,2.33,Washington,Washington
8253,July,2020,San Juan,WA,Truck,0,0,0,5844,5844,0.0,Washington,Washington
8258,July,2020,Kitsap,WA,Truck,0,0,0,54144,54144,0.0,Washington,Washington
8259,July,2020,Clark,WA,Passenger,2097,1066,3163,317956,321119,0.98,Washington,Washington
8264,July,2020,Spokane,WA,Passenger,753,491,1244,316437,317681,0.39,Washington,Washington
8267,July,2020,Skamania,WA,Passenger,31,20,51,8428,8479,0.6,Washington,Washington
8270,July,2020,Island,WA,Truck,1,0,1,21235,21236,0.0,Washington,Washington
8271,July,2020,Franklin,WA,Truck,0,0,0,20096,20096,0.0,Washington,Washington
8280,July,2020,Stevens,WA,Truck,0,0,0,18672,18672,0.0,Washington,Washington
8285,July,2020,Garfield,WA,Passenger,0,1,1,1350,1351,0.07,Washington,Washington
8286,July,2020,Okanogan,WA,Passenger,37,34,71,25923,25994,0.27,Washington,Washington
8291,July,2020,Walla Walla,WA,Truck,0,0,0,13755,13755,0.0,Washington,Washington
8292,July,2020,Kittitas,WA,Passenger,104,47,151,29761,29912,0.5,Washington,Washington
8294,July,2020,Yakima,WA,Passenger,139,119,258,165771,166029,0.16,Washington,Washington
8296,July,2020,Whatcom,WA,Truck,3,0,3,43156,43159,0.01,Washington,Washington
8297,July,2020,Yakima,WA,Truck,0,0,0,60200,60200,0.0,Washington,Washington
8300,July,2020,Benton,WA,Truck,0,0,0,42882,42882,0.0,Washington,Washington
8302,July,2020,Mason,WA,Passenger,160,134,294,47372,47666,0.62,Washington,Washington
8304,July,2020,Chelan,WA,Passenger,240,82,322,54232,54554,0.59,Washington,Washington
8313,July,2020,San Juan,WA,Passenger,311,94,405,13959,14364,2.82,Washington,Washington
8314,July,2020,Clallam,WA,Truck,1,0,1,21697,21698,0.0,Washington,Washington
8315,July,2020,Kitsap,WA,Passenger,1377,696,2073,179884,181957,1.14,Washington,Washington
8316,July,2020,Adams,WA,Passenger,9,7,16,12866,12882,0.12,Washington,Washington
8331,July,2020,Pend Oreille,WA,Truck,0,0,0,5762,5762,0.0,Washington,Washington
8334,July,2020,Columbia,WA,Passenger,4,3,7,2418,2425,0.29,Washington,Washington
8337,July,2020,Wahkiakum,WA,Passenger,6,6,12,3001,3013,0.4,Washington,Washington
8340,July,2020,Benton,WA,Passenger,373,321,694,134304,134998,0.51,Washington,Washington
8343,July,2020,Ferry,WA,Truck,0,0,0,3568,3568,0.0,Washington,Washington
8348,July,2020,Klickitat,WA,Passenger,56,43,99,15115,15214,0.65,Washington,Washington
8354,July,2020,Adams,WA,Truck,0,0,0,5283,5283,0.0,Washington,Washington
8363,July,2020,Lincoln,WA,Passenger,5,11,16,7648,7664,0.21,Washington,Washington
8365,July,2020,Douglas,WA,Passenger,75,41,116,28050,28166,0.41,Washington,Washington
8366,July,2020,Spokane,WA,Truck,1,0,1,98982,98983,0.0,Washington,Washington
8367,July,2020,Grant,WA,Passenger,61,75,136,65284,65420,0.21,Washington,Washington
8369,July,2020,Thurston,WA,Passenger,1175,744,1919,197158,199077,0.96,Washington,Washington
8374,July,2021,San Juan,WA,Passenger,443,139,582,14241,14823,3.93,Washington,Washington
8376,July,2021,Okanogan,WA,Truck,0,0,0,16751,16751,0.0,Washington,Washington
8378,July,2021,Benton,WA,Truck,0,0,0,43648,43648,0.0,Washington,Washington
8381,July,2021,Jefferson,WA,Truck,0,0,0,9618,9618,0.0,Washington,Washington
8382,July,2021,Snohomish,WA,Passenger,6126,2100,8226,539757,547983,1.5,Washington,Washington
8383,July,2021,Mason,WA,Passenger,216,139,355,48095,48450,0.73,Washington,Washington
8389,July,2021,Clallam,WA,Passenger,341,220,561,50460,51021,1.1,Washington,Washington
8390,July,2021,Lincoln,WA,Truck,0,0,0,4759,4759,0.0,Washington,Washington
8395,July,2021,Douglas,WA,Passenger,100,51,151,28504,28655,0.53,Washington,Washington
8400,July,2021,San Juan,WA,Truck,0,0,0,5955,5955,0.0,Washington,Washington
8404,July,2021,Adams,WA,Truck,0,0,0,5392,5392,0.0,Washington,Washington
8405,July,2021,Wahkiakum,WA,Passenger,15,8,23,3091,3114,0.74,Washington,Washington
8406,July,2021,Yakima,WA,Passenger,236,161,397,169309,169706,0.23,Washington,Washington
8411,July,2021,Chelan,WA,Passenger,350,101,451,54716,55167,0.82,Washington,Washington
8413,July,2021,Stevens,WA,Truck,0,0,0,18921,18921,0.0,Washington,Washington
8418,July,2021,Whitman,WA,Truck,0,0,0,8590,8590,0.0,Washington,Washington
8421,July,2021,Stevens,WA,Passenger,49,46,95,30404,30499,0.31,Washington,Washington
8427,July,2021,Mason,WA,Truck,0,0,0,21344,21344,0.0,Washington,Washington
8428,July,2021,Grant,WA,Passenger,120,90,210,66913,67123,0.31,Washington,Washington
8430,July,2021,Lewis,WA,Passenger,165,144,309,59658,59967,0.52,Washington,Washington
8432,July,2021,Clark,WA,Truck,0,0,0,84269,84269,0.0,Washington,Washington
8439,July,2021,Okanogan,WA,Passenger,65,43,108,26539,26647,0.41,Washington,Washington
8441,July,2021,Wahkiakum,WA,Truck,0,0,0,1793,1793,0.0,Washington,Washington
8451,July,2021,Pacific,WA,Passenger,46,53,99,16030,16129,0.61,Washington,Washington
8452,July,2021,Klickitat,WA,Truck,0,0,0,8313,8313,0.0,Washington,Washington
8453,July,2021,Lewis,WA,Truck,0,0,0,26765,26765,0.0,Washington,Washington
8454,July,2021,Kitsap,WA,Truck,0,0,0,54423,54423,0.0,Washington,Washington
8457,July,2021,Thurston,WA,Truck,0,0,0,56500,56500,0.0,Washington,Washington
8458,July,2021,Lincoln,WA,Passenger,6,15,21,7722,7743,0.27,Washington,Washington
8461,July,2021,Adams,WA,Passenger,16,12,28,13038,13066,0.21,Washington,Washington
8462,July,2021,Grays Harbor,WA,Truck,0,0,0,21418,21418,0.0,Washington,Washington
8465,July,2021,Ferry,WA,Passenger,9,3,12,4379,4391,0.27,Washington,Washington
8473,July,2021,Asotin,WA,Passenger,21,17,38,12708,12746,0.3,Washington,Washington
8474,July,2021,Skamania,WA,Truck,0,0,0,4027,4027,0.0,Washington,Washington
8475,July,2021,Thurston,WA,Passenger,1660,892,2552,197867,200419,1.27,Washington,Washington
8476,July,2021,Kitsap,WA,Passenger,1911,871,2782,180648,183430,1.52,Washington,Washington
8477,July,2021,Cowlitz,WA,Truck,0,0,0,29116,29116,0.0,Washington,Washington
8478,July,2021,Grant,WA,Truck,0,0,0,27936,27936,0.0,Washington,Washington
8480,July,2021,Skagit,WA,Passenger,608,281,889,91879,92768,0.96,Washington,Washington
8484,July,2021,Douglas,WA,Truck,0,0,0,12696,12696,0.0,Washington,Washington
8485,July,2021,Pierce,WA,Passenger,3637,2018,5655,559608,565263,1.0,Washington,Washington
8486,July,2021,Island,WA,Passenger,625,316,941,63232,64173,1.47,Washington,Washington
8493,July,2021,Franklin,WA,Truck,0,0,0,20725,20725,0.0,Washington,Washington
8494,July,2021,Chelan,WA,Truck,0,0,0,23102,23102,0.0,Washington,Washington
8495,July,2021,Benton,WA,Passenger,540,397,937,136282,137219,0.68,Washington,Washington
8496,July,2021,Snohomish,WA,Truck,1,0,1,126198,126199,0.0,Washington,Washington
8500,July,2021,Pierce,WA,Truck,0,0,0,145859,145859,0.0,Washington,Washington
8502,July,2021,Whatcom,WA,Truck,4,0,4,43871,43875,0.01,Washington,Washington
8505,July,2021,Columbia,WA,Truck,0,0,0,1555,1555,0.0,Washington,Washington
8511,July,2021,Skamania,WA,Passenger,51,36,87,8410,8497,1.02,Washington,Washington
8521,July,2021,King,WA,Truck,5,1,6,184354,184360,0.0,Washington,Washington
8524,July,2021,Garfield,WA,Passenger,0,3,3,1375,1378,0.22,Washington,Washington
8527,July,2021,Clallam,WA,Truck,1,0,1,22036,22037,0.0,Washington,Washington
8528,July,2021,Kittitas,WA,Passenger,166,68,234,29980,30214,0.77,Washington,Washington
8538,July,2021,Asotin,WA,Truck,0,0,0,6768,6768,0.0,Washington,Washington
8539,July,2021,Yakima,WA,Truck,0,0,0,61720,61720,0.0,Washington,Washington
8543,July,2021,King,WA,Passenger,31555,9349,40904,1366948,1407852,2.91,Washington,Washington
8544,July,2021,Columbia,WA,Passenger,6,2,8,2472,2480,0.32,Washington,Washington
8546,July,2021,Pacific,WA,Truck,0,0,0,7961,7961,0.0,Washington,Washington
8559,July,2021,Clark,WA,Passenger,2977,1459,4436,322390,326826,1.36,Washington,Washington
8560,July,2021,Pend Oreille,WA,Truck,0,0,0,5747,5747,0.0,Washington,Washington
8567,July,2021,Whatcom,WA,Passenger,1475,618,2093,150663,152756,1.37,Washington,Washington
8570,July,2021,Grays Harbor,WA,Passenger,176,146,322,49519,49841,0.65,Washington,Washington
8571,July,2021,Ferry,WA,Truck,0,0,0,3646,3646,0.0,Washington,Washington
8586,July,2021,Whitman,WA,Passenger,61,49,110,21944,22054,0.5,Washington,Washington
8588,July,2021,Klickitat,WA,Passenger,77,50,127,15342,15469,0.82,Washington,Washington
8589,July,2021,Cowlitz,WA,Passenger,229,146,375,72247,72622,0.52,Washington,Washington
8591,July,2021,Walla Walla,WA,Truck,0,0,0,14055,14055,0.0,Washington,Washington
8593,July,2021,Island,WA,Truck,0,0,0,21573,21573,0.0,Washington,Washington
8596,July,2021,Garfield,WA,Truck,0,0,0,1004,1004,0.0,Washington,Washington
8604,July,2021,Spokane,WA,Truck,0,0,0,102316,102316,0.0,Washington,Washington
8609,July,2021,Skagit,WA,Truck,1,0,1,33023,33024,0.0,Washington,Washington
8611,July,2021,Kittitas,WA,Truck,0,0,0,14792,14792,0.0,Washington,Washington
8613,July,2021,Spokane,WA,Passenger,1119,653,1772,326073,327845,0.54,Washington,Washington
8614,July,2021,Pend Oreille,WA,Passenger,15,7,22,9264,9286,0.24,Washington,Washington
8617,July,2021,Franklin,WA,Passenger,134,97,231,62058,62289,0.37,Washington,Washington
8618,July,2021,Walla Walla,WA,Passenger,115,76,191,36567,36758,0.52,Washington,Washington
8624,July,2021,Jefferson,WA,Passenger,339,183,522,24889,25411,2.05,Washington,Washington
8626,July,2022,Pacific,WA,Truck,0,0,0,7881,7881,0.0,Washington,Washington
8631,July,2022,Clark,WA,Passenger,4229,1806,6035,315632,321667,1.88,Washington,Washington
8634,July,2022,Cowlitz,WA,Truck,2,0,2,28483,28485,0.01,Washington,Washington
8635,July,2022,Grays Harbor,WA,Passenger,214,162,376,48927,49303,0.76,Washington,Washington
8639,July,2022,Pend Oreille,WA,Passenger,18,12,30,9043,9073,0.33,Washington,Washington
8642,July,2022,Benton,WA,Passenger,780,462,1242,135328,136570,0.91,Washington,Washington
8646,July,2022,Skamania,WA,Passenger,76,47,123,8163,8286,1.48,Washington,Washington
8651,July,2022,Clark,WA,Truck,9,0,9,82552,82561,0.01,Washington,Washington
8652,July,2022,Skagit,WA,Truck,5,0,5,32300,32305,0.02,Washington,Washington
8655,July,2022,Spokane,WA,Truck,8,0,8,102044,102052,0.01,Washington,Washington
8659,July,2022,Thurston,WA,Passenger,2242,1065,3307,193613,196920,1.68,Washington,Washington
8661,July,2022,Spokane,WA,Passenger,1676,864,2540,324816,327356,0.78,Washington,Washington
8663,July,2022,Clallam,WA,Passenger,432,246,678,49651,50329,1.35,Washington,Washington
8665,July,2022,Asotin,WA,Passenger,24,19,43,12650,12693,0.34,Washington,Washington
8671,July,2022,Whitman,WA,Truck,2,0,2,8570,8572,0.02,Washington,Washington
8673,July,2022,Ferry,WA,Truck,0,0,0,3566,3566,0.0,Washington,Washington
8679,July,2022,Columbia,WA,Truck,0,0,0,1577,1577,0.0,Washington,Washington
8682,July,2022,Walla Walla,WA,Passenger,175,99,274,35828,36102,0.76,Washington,Washington
8686,July,2022,Stevens,WA,Truck,1,0,1,18912,18913,0.01,Washington,Washington
8690,July,2022,Lewis,WA,Truck,0,0,0,26347,26347,0.0,Washington,Washington
8693,July,2022,Jefferson,WA,Passenger,442,219,661,24548,25209,2.62,Washington,Washington
8694,July,2022,Kitsap,WA,Truck,13,0,13,53416,53429,0.02,Washington,Washington
8695,July,2022,Walla Walla,WA,Truck,1,0,1,13918,13919,0.01,Washington,Washington
8701,July,2022,Snohomish,WA,Truck,27,0,27,123535,123562,0.02,Washington,Washington
8706,July,2022,Stevens,WA,Passenger,72,54,126,30084,30210,0.42,Washington,Washington
8707,July,2022,Whitman,WA,Passenger,88,60,148,21969,22117,0.67,Washington,Washington
8709,July,2022,Pierce,WA,Passenger,5245,2337,7582,543947,551529,1.37,Washington,Washington
8714,July,2022,San Juan,WA,Truck,4,0,4,5948,5952,0.07,Washington,Washington
8715,July,2022,Okanogan,WA,Truck,1,0,1,16589,16590,0.01,Washington,Washington
8718,July,2022,Wahkiakum,WA,Truck,0,0,0,1801,1801,0.0,Washington,Washington
8724,July,2022,Whatcom,WA,Passenger,1864,754,2618,148809,151427,1.73,Washington,Washington
8725,July,2022,Lincoln,WA,Passenger,9,16,25,7715,7740,0.32,Washington,Washington
8732,July,2022,Franklin,WA,Passenger,203,110,313,61860,62173,0.5,Washington,Washington
8734,July,2022,Ferry,WA,Passenger,21,4,25,4378,4403,0.57,Washington,Washington
8740,July,2022,Wahkiakum,WA,Passenger,24,12,36,3071,3107,1.16,Washington,Washington
8741,July,2022,Franklin,WA,Truck,1,0,1,20873,20874,0.0,Washington,Washington
8742,July,2022,Garfield,WA,Passenger,1,3,4,1326,1330,0.3,Washington,Washington
8743,July,2022,Grays Harbor,WA,Truck,2,0,2,21240,21242,0.01,Washington,Washington
8750,July,2022,Kittitas,WA,Passenger,278,86,364,29692,30056,1.21,Washington,Washington
8751,July,2022,Lincoln,WA,Truck,0,0,0,4833,4833,0.0,Washington,Washington
8753,July,2022,Skagit,WA,Passenger,813,345,1158,89848,91006,1.27,Washington,Washington
8754,July,2022,Lewis,WA,Passenger,246,177,423,59694,60117,0.7,Washington,Washington
8756,July,2022,Garfield,WA,Truck,0,0,0,976,976,0.0,Washington,Washington
8761,July,2022,Benton,WA,Truck,3,0,3,43487,43490,0.01,Washington,Washington
8763,July,2022,Pierce,WA,Truck,20,0,20,141272,141292,0.01,Washington,Washington
8764,July,2022,Grant,WA,Passenger,183,100,283,66683,66966,0.42,Washington,Washington
8767,July,2022,Chelan,WA,Passenger,478,125,603,54238,54841,1.1,Washington,Washington
8771,July,2022,San Juan,WA,Passenger,521,160,681,14025,14706,4.63,Washington,Washington
8772,July,2022,Kittitas,WA,Truck,1,0,1,14616,14617,0.01,Washington,Washington
8782,July,2022,Thurston,WA,Truck,8,0,8,55356,55364,0.01,Washington,Washington
8783,July,2022,Columbia,WA,Passenger,7,0,7,2430,2437,0.29,Washington,Washington
8786,July,2022,Pacific,WA,Passenger,64,71,135,15841,15976,0.85,Washington,Washington
8788,July,2022,Okanogan,WA,Passenger,88,49,137,26298,26435,0.52,Washington,Washington
8789,July,2022,Cowlitz,WA,Passenger,349,171,520,70574,71094,0.73,Washington,Washington
8791,July,2022,Douglas,WA,Truck,1,0,1,12747,12748,0.01,Washington,Washington
8792,July,2022,Yakima,WA,Passenger,353,198,551,166690,167241,0.33,Washington,Washington
8797,July,2022,Douglas,WA,Passenger,138,60,198,28404,28602,0.69,Washington,Washington
8801,July,2022,Klickitat,WA,Truck,0,0,0,8286,8286,0.0,Washington,Washington
8802,July,2022,Island,WA,Truck,6,0,6,21337,21343,0.03,Washington,Washington
8810,July,2022,King,WA,Passenger,41908,11450,53358,1347349,1400707,3.81,Washington,Washington
8812,July,2022,Adams,WA,Truck,1,0,1,5458,5459,0.02,Washington,Washington
8814,July,2022,Klickitat,WA,Passenger,106,56,162,15204,15366,1.05,Washington,Washington
8816,July,2022,Skamania,WA,Truck,0,0,0,3948,3948,0.0,Washington,Washington
8818,July,2022,Chelan,WA,Truck,4,0,4,23054,23058,0.02,Washington,Washington
8820,July,2022,Mason,WA,Truck,4,0,4,20985,20989,0.02,Washington,Washington
8822,July,2022,Clallam,WA,Truck,3,0,3,21895,21898,0.01,Washington,Washington
8823,July,2022,Whatcom,WA,Truck,11,0,11,43223,43234,0.03,Washington,Washington
8828,July,2022,Mason,WA,Passenger,320,176,496,47125,47621,1.04,Washington,Washington
8830,July,2022,Adams,WA,Passenger,19,10,29,12942,12971,0.22,Washington,Washington
8834,July,2022,Pend Oreille,WA,Truck,0,0,0,5648,5648,0.0,Washington,Washington
8839,July,2022,Asotin,WA,Truck,0,0,0,6688,6688,0.0,Washington,Washington
8845,July,2022,Island,WA,Passenger,835,380,1215,61863,63078,1.93,Washington,Washington
8852,July,2022,Grant,WA,Truck,0,0,0,27963,27963,0.0,Washington,Washington
8856,July,2022,Yakima,WA,Truck,1,0,1,61344,61345,0.0,Washington,Washington
8857,July,2022,Kitsap,WA,Passenger,2463,1074,3537,178200,181737,1.95,Washington,Washington
8859,July,2022,King,WA,Truck,123,2,125,180390,180515,0.07,Washington,Washington
8861,July,2022,Jefferson,WA,Truck,3,0,3,9457,9460,0.03,Washington,Washington
8865,July,2022,Snohomish,WA,Passenger,8662,2565,11227,531561,542788,2.07,Washington,Washington
8875,July,2023,Skagit,WA,Passenger,1139,417,1556,86446,88002,1.77,Washington,Washington
8876,July,2023,Grays Harbor,WA,Passenger,311,192,503,47081,47584,1.06,Washington,Washington
8877,July,2023,Chelan,WA,Truck,31,0,31,22570,22601,0.14,Washington,Washington
8878,July,2023,Yakima,WA,Truck,13,0,13,58999,59012,0.02,Washington,Washington
8879,July,2023,King,WA,Passenger,58610,14725,73335,1297605,1370940,5.35,Washington,Washington
8881,July,2023,Yakima,WA,Passenger,511,253,764,161420,162184,0.47,Washington,Washington
8883,July,2023,Stevens,WA,Truck,2,0,2,18253,18255,0.01,Washington,Washington
8884,July,2023,Pend Oreille,WA,Passenger,30,15,45,8645,8690,0.52,Washington,Washington
8889,July,2023,Pierce,WA,Passenger,7775,2805,10580,516969,527549,2.01,Washington,Washington
8890,July,2023,Wahkiakum,WA,Passenger,27,17,44,2972,3016,1.46,Washington,Washington
8895,July,2023,Jefferson,WA,Truck,12,0,12,9094,9106,0.13,Washington,Washington
8896,July,2023,Whitman,WA,Truck,5,0,5,8455,8460,0.06,Washington,Washington
8897,July,2023,Wahkiakum,WA,Truck,3,0,3,1728,1731,0.17,Washington,Washington
8900,July,2023,Columbia,WA,Passenger,10,1,11,2365,2376,0.46,Washington,Washington
8903,July,2023,San Juan,WA,Passenger,622,165,787,13491,14278,5.51,Washington,Washington
8904,July,2023,Jefferson,WA,Passenger,571,261,832,23782,24614,3.38,Washington,Washington
8905,July,2023,Franklin,WA,Truck,6,0,6,20274,20280,0.03,Washington,Washington
8907,July,2023,Lincoln,WA,Passenger,18,19,37,7476,7513,0.49,Washington,Washington
8910,July,2023,King,WA,Truck,780,2,782,170537,171319,0.46,Washington,Washington
8916,July,2023,Columbia,WA,Truck,0,0,0,1509,1509,0.0,Washington,Washington
8918,July,2023,Okanogan,WA,Passenger,128,62,190,25306,25496,0.75,Washington,Washington
8925,July,2023,Snohomish,WA,Truck,187,0,187,117767,117954,0.16,Washington,Washington
8929,July,2023,Clallam,WA,Passenger,563,289,852,47919,48771,1.75,Washington,Washington
8934,July,2023,Asotin,WA,Passenger,35,23,58,12154,12212,0.47,Washington,Washington
8936,July,2023,Asotin,WA,Truck,0,0,0,6500,6500,0.0,Washington,Washington
8937,July,2023,Whitman,WA,Passenger,159,77,236,21502,21738,1.09,Washington,Washington
8943,July,2023,Kitsap,WA,Passenger,3267,1302,4569,172227,176796,2.58,Washington,Washington
8947,July,2023,Cowlitz,WA,Passenger,477,222,699,68070,68769,1.02,Washington,Washington
8951,July,2023,Kittitas,WA,Passenger,358,104,462,28484,28946,1.6,Washington,Washington
8952,July,2023,Pend Oreille,WA,Truck,0,0,0,5446,5446,0.0,Washington,Washington
8954,July,2023,Cowlitz,WA,Truck,10,0,10,27395,27405,0.04,Washington,Washington
8956,July,2023,Mason,WA,Truck,11,0,11,19979,19990,0.06,Washington,Washington
8959,July,2023,Adams,WA,Truck,3,0,3,5136,5139,0.06,Washington,Washington
8960,July,2023,Douglas,WA,Passenger,213,65,278,28117,28395,0.98,Washington,Washington
8961,July,2023,Benton,WA,Truck,25,0,25,41955,41980,0.06,Washington,Washington
8963,July,2023,Skamania,WA,Passenger,105,56,161,7814,7975,2.02,Washington,Washington
8969,July,2023,Chelan,WA,Passenger,641,165,806,52924,53730,1.5,Washington,Washington
8971,July,2023,Okanogan,WA,Truck,7,0,7,15946,15953,0.04,Washington,Washington
8972,July,2023,San Juan,WA,Truck,16,0,16,5767,5783,0.28,Washington,Washington
8974,July,2023,Ferry,WA,Truck,0,0,0,3476,3476,0.0,Washington,Washington
8976,July,2023,Clark,WA,Passenger,5943,2342,8285,305963,314248,2.64,Washington,Washington
8978,July,2023,Lewis,WA,Truck,7,0,7,25247,25254,0.03,Washington,Washington
8983,July,2023,Thurston,WA,Passenger,3153,1230,4383,185812,190195,2.3,Washington,Washington
8984,July,2023,Garfield,WA,Passenger,0,3,3,1282,1285,0.23,Washington,Washington
8985,July,2023,Lewis,WA,Passenger,328,217,545,57742,58287,0.94,Washington,Washington
8987,July,2023,Klickitat,WA,Truck,11,0,11,8015,8026,0.14,Washington,Washington
8989,July,2023,Snohomish,WA,Passenger,13023,3087,16110,515187,531297,3.03,Washington,Washington
8990,July,2023,Spokane,WA,Passenger,2340,1124,3464,315617,319081,1.09,Washington,Washington
8991,July,2023,Island,WA,Truck,33,0,33,20607,20640,0.16,Washington,Washington
8993,July,2023,Benton,WA,Passenger,1158,568,1726,131666,133392,1.29,Washington,Washington
9000,July,2023,Mason,WA,Passenger,462,212,674,45044,45718,1.47,Washington,Washington
9002,July,2023,Garfield,WA,Truck,0,0,0,950,950,0.0,Washington,Washington
9010,July,2023,Pacific,WA,Truck,4,0,4,7654,7658,0.05,Washington,Washington
9012,July,2023,Clallam,WA,Truck,19,0,19,21216,21235,0.09,Washington,Washington
9013,July,2023,Island,WA,Passenger,1106,442,1548,59897,61445,2.52,Washington,Washington
9014,July,2023,Walla Walla,WA,Truck,5,0,5,13311,13316,0.04,Washington,Washington
9015,July,2023,Grant,WA,Truck,12,0,12,27240,27252,0.04,Washington,Washington
9018,July,2023,Clark,WA,Truck,102,0,102,79248,79350,0.13,Washington,Washington
9020,July,2023,Klickitat,WA,Passenger,156,65,221,14764,14985,1.47,Washington,Washington
9026,July,2023,Ferry,WA,Passenger,21,4,25,4197,4222,0.59,Washington,Washington
9031,July,2023,Spokane,WA,Truck,42,0,42,99373,99415,0.04,Washington,Washington
9032,July,2023,Grant,WA,Passenger,287,131,418,65201,65619,0.64,Washington,Washington
9033,July,2023,Douglas,WA,Truck,5,0,5,12696,12701,0.04,Washington,Washington
9036,July,2023,Pacific,WA,Passenger,78,88,166,15312,15478,1.07,Washington,Washington
9037,July,2023,Kittitas,WA,Truck,10,0,10,14172,14182,0.07,Washington,Washington
9039,July,2023,Thurston,WA,Truck,64,0,64,52520,52584,0.12,Washington,Washington
9044,July,2023,Skamania,WA,Truck,1,0,1,3727,3728,0.03,Washington,Washington
9045,July,2023,Whatcom,WA,Passenger,2522,891,3413,144372,147785,2.31,Washington,Washington
9049,July,2023,Franklin,WA,Passenger,315,141,456,60118,60574,0.75,Washington,Washington
9053,July,2023,Whatcom,WA,Truck,63,0,63,41534,41597,0.15,Washington,Washington
9059,July,2023,Lincoln,WA,Truck,0,0,0,4756,4756,0.0,Washington,Washington
9060,July,2023,Grays Harbor,WA,Truck,9,0,9,20411,20420,0.04,Washington,Washington
9065,July,2023,Kitsap,WA,Truck,80,0,80,51022,51102,0.16,Washington,Washington
9066,July,2023,Adams,WA,Passenger,24,12,36,12621,12657,0.28,Washington,Washington
9067,July,2023,Walla Walla,WA,Passenger,223,113,336,34442,34778,0.97,Washington,Washington
9071,July,2023,Stevens,WA,Passenger,117,69,186,28933,29119,0.64,Washington,Washington
9077,July,2023,Pierce,WA,Truck,166,0,166,132850,133016,0.12,Washington,Washington
9085,July,2023,Skagit,WA,Truck,23,0,23,30998,31021,0.07,Washington,Washington
9093,June,2017,Ferry,WA,Truck,0,0,0,3537,3537,0.0,Washington,Washington
9098,June,2017,Grays Harbor,WA,Passenger,35,31,66,44778,44844,0.15,Washington,Washington
9102,June,2017,Kitsap,WA,Truck,1,0,1,52519,52520,0.0,Washington,Washington
9103,June,2017,Garfield,WA,Truck,0,0,0,940,940,0.0,Washington,Washington
9105,June,2017,Douglas,WA,Truck,0,0,0,11527,11527,0.0,Washington,Washington
9106,June,2017,Snohomish,WA,Passenger,1793,903,2696,513181,515877,0.52,Washington,Washington
9107,June,2017,Douglas,WA,Passenger,34,26,60,26716,26776,0.22,Washington,Washington
9108,June,2017,Chelan,WA,Passenger,67,37,104,52044,52148,0.2,Washington,Washington
9113,June,2017,Whitman,WA,Truck,0,0,0,8429,8429,0.0,Washington,Washington
9114,June,2017,Clallam,WA,Truck,0,0,0,21016,21016,0.0,Washington,Washington
9115,June,2017,Franklin,WA,Truck,0,0,0,18122,18122,0.0,Washington,Washington
9118,June,2017,Snohomish,WA,Truck,1,0,1,121886,121887,0.0,Washington,Washington
9121,June,2017,Walla Walla,WA,Truck,0,0,0,13205,13205,0.0,Washington,Washington
9124,June,2017,San Juan,WA,Passenger,107,40,147,13551,13698,1.07,Washington,Washington
9125,June,2017,Kitsap,WA,Passenger,605,319,924,173378,174302,0.53,Washington,Washington
9132,June,2017,Pacific,WA,Truck,0,0,0,7471,7471,0.0,Washington,Washington
9133,June,2017,Wahkiakum,WA,Passenger,0,2,2,2832,2834,0.07,Washington,Washington
9135,June,2017,Kittitas,WA,Truck,0,0,0,13560,13560,0.0,Washington,Washington
9137,June,2017,Stevens,WA,Passenger,8,23,31,31384,31415,0.1,Washington,Washington
9138,June,2017,Skamania,WA,Truck,0,0,0,3892,3892,0.0,Washington,Washington
9144,June,2017,Grays Harbor,WA,Truck,0,0,0,19888,19888,0.0,Washington,Washington
9146,June,2017,Okanogan,WA,Truck,0,0,0,16204,16204,0.0,Washington,Washington
9149,June,2017,Lewis,WA,Truck,0,0,0,24838,24838,0.0,Washington,Washington
9150,June,2017,Klickitat,WA,Truck,0,0,0,7971,7971,0.0,Washington,Washington
9153,June,2017,Asotin,WA,Truck,0,0,0,6502,6502,0.0,Washington,Washington
9156,June,2017,Skagit,WA,Passenger,140,103,243,88070,88313,0.28,Washington,Washington
9158,June,2017,Spokane,WA,Passenger,253,208,461,296812,297273,0.16,Washington,Washington
9159,June,2017,Cowlitz,WA,Truck,0,0,0,27913,27913,0.0,Washington,Washington
9160,June,2017,Whatcom,WA,Passenger,462,175,637,143061,143698,0.44,Washington,Washington
9162,June,2017,Whatcom,WA,Truck,2,0,2,41620,41622,0.0,Washington,Washington
9165,June,2017,Franklin,WA,Passenger,26,45,71,55615,55686,0.13,Washington,Washington
9168,June,2017,Walla Walla,WA,Passenger,25,26,51,34843,34894,0.15,Washington,Washington
9172,June,2017,Ferry,WA,Passenger,1,1,2,4394,4396,0.05,Washington,Washington
9173,June,2017,Jefferson,WA,Passenger,104,61,165,23850,24015,0.69,Washington,Washington
9175,June,2017,Mason,WA,Truck,0,0,0,19273,19273,0.0,Washington,Washington
9177,June,2017,Pierce,WA,Truck,0,0,0,137535,137535,0.0,Washington,Washington
9178,June,2017,Mason,WA,Passenger,56,68,124,43451,43575,0.28,Washington,Washington
9179,June,2017,Cowlitz,WA,Passenger,50,60,110,69653,69763,0.16,Washington,Washington
9180,June,2017,King,WA,Passenger,10028,4104,14132,1375372,1389504,1.02,Washington,Washington
9182,June,2017,Clark,WA,Truck,0,0,0,77648,77648,0.0,Washington,Washington
9183,June,2017,Whitman,WA,Passenger,10,20,30,22038,22068,0.14,Washington,Washington
9186,June,2017,Pend Oreille,WA,Passenger,3,4,7,9316,9323,0.08,Washington,Washington
9189,June,2017,Garfield,WA,Passenger,0,0,0,1295,1295,0.0,Washington,Washington
9196,June,2017,Asotin,WA,Passenger,6,3,9,12427,12436,0.07,Washington,Washington
9202,June,2017,Skamania,WA,Passenger,9,7,16,8566,8582,0.19,Washington,Washington
9204,June,2017,Wahkiakum,WA,Truck,0,0,0,1644,1644,0.0,Washington,Washington
9210,June,2017,Grant,WA,Truck,0,0,0,25220,25220,0.0,Washington,Washington
9216,June,2017,Lincoln,WA,Truck,0,0,0,4429,4429,0.0,Washington,Washington
9222,June,2017,San Juan,WA,Truck,0,0,0,5535,5535,0.0,Washington,Washington
9228,June,2017,Okanogan,WA,Passenger,4,17,21,25707,25728,0.08,Washington,Washington
9229,June,2017,Grant,WA,Passenger,20,27,47,60844,60891,0.08,Washington,Washington
9230,June,2017,Klickitat,WA,Passenger,22,24,46,14799,14845,0.31,Washington,Washington
9231,June,2017,Skagit,WA,Truck,1,0,1,31458,31459,0.0,Washington,Washington
9232,June,2017,Yakima,WA,Truck,0,0,0,57351,57351,0.0,Washington,Washington
9233,June,2017,Benton,WA,Truck,0,0,0,40055,40055,0.0,Washington,Washington
9234,June,2017,Benton,WA,Passenger,148,143,291,128515,128806,0.23,Washington,Washington
9235,June,2017,Adams,WA,Passenger,2,3,5,12204,12209,0.04,Washington,Washington
9239,June,2017,Island,WA,Truck,0,0,0,20501,20501,0.0,Washington,Washington
9241,June,2017,Adams,WA,Truck,0,0,0,5106,5106,0.0,Washington,Washington
9242,June,2017,Yakima,WA,Passenger,45,57,102,159401,159503,0.06,Washington,Washington
9247,June,2017,Kittitas,WA,Passenger,21,17,38,27579,27617,0.14,Washington,Washington
9249,June,2017,Columbia,WA,Passenger,1,1,2,2353,2355,0.08,Washington,Washington
9250,June,2017,Lewis,WA,Passenger,51,34,85,55546,55631,0.15,Washington,Washington
9251,June,2017,Stevens,WA,Truck,0,0,0,18273,18273,0.0,Washington,Washington
9253,June,2017,Columbia,WA,Truck,0,0,0,1531,1531,0.0,Washington,Washington
9254,June,2017,King,WA,Truck,8,1,9,187744,187753,0.0,Washington,Washington
9256,June,2017,Pierce,WA,Passenger,956,842,1798,524957,526755,0.34,Washington,Washington
9258,June,2017,Pacific,WA,Passenger,10,7,17,15145,15162,0.11,Washington,Washington
9260,June,2017,Chelan,WA,Truck,0,0,0,21303,21303,0.0,Washington,Washington
9262,June,2017,Jefferson,WA,Truck,0,0,0,9424,9424,0.0,Washington,Washington
9265,June,2017,Pend Oreille,WA,Truck,0,0,0,5574,5574,0.0,Washington,Washington
9266,June,2017,Island,WA,Passenger,117,136,253,60111,60364,0.42,Washington,Washington
9268,June,2017,Thurston,WA,Truck,0,0,0,53295,53295,0.0,Washington,Washington
9270,June,2017,Spokane,WA,Truck,1,0,1,90624,90625,0.0,Washington,Washington
9272,June,2017,Thurston,WA,Passenger,398,336,734,186654,187388,0.39,Washington,Washington
9273,June,2017,Lincoln,WA,Passenger,2,5,7,7527,7534,0.09,Washington,Washington
9274,June,2017,Clark,WA,Passenger,787,504,1291,299553,300844,0.43,Washington,Washington
9276,June,2017,Clallam,WA,Passenger,90,76,166,48373,48539,0.34,Washington,Washington
9277,June,2018,Spokane,WA,Passenger,340,316,656,303132,303788,0.22,Washington,Washington
9279,June,2018,Garfield,WA,Truck,0,0,0,950,950,0.0,Washington,Washington
9280,June,2018,Lewis,WA,Truck,0,0,0,25481,25481,0.0,Washington,Washington
9286,June,2018,Pierce,WA,Passenger,1228,1173,2401,532275,534676,0.45,Washington,Washington
9288,June,2018,Clallam,WA,Truck,0,0,0,21442,21442,0.0,Washington,Washington
9292,June,2018,Jefferson,WA,Truck,0,0,0,9548,9548,0.0,Washington,Washington
9294,June,2018,King,WA,Passenger,13167,5678,18845,1371166,1390011,1.36,Washington,Washington
9298,June,2018,Skagit,WA,Truck,1,0,1,32042,32043,0.0,Washington,Washington
9299,June,2018,Lincoln,WA,Truck,0,0,0,4559,4559,0.0,Washington,Washington
9301,June,2018,Clark,WA,Passenger,1009,719,1728,307969,309697,0.56,Washington,Washington
9308,June,2018,Pierce,WA,Truck,0,0,0,137831,137831,0.0,Washington,Washington
9312,June,2018,Wahkiakum,WA,Passenger,1,2,3,2915,2918,0.1,Washington,Washington
9313,June,2018,Island,WA,Passenger,197,188,385,62531,62916,0.61,Washington,Washington
9318,June,2018,Adams,WA,Passenger,5,5,10,12616,12626,0.08,Washington,Washington
9322,June,2018,Garfield,WA,Passenger,1,1,2,1316,1318,0.15,Washington,Washington
9325,June,2018,Lewis,WA,Passenger,80,59,139,57688,57827,0.24,Washington,Washington
9326,June,2018,Snohomish,WA,Truck,1,0,1,121653,121654,0.0,Washington,Washington
9327,June,2018,Franklin,WA,Truck,0,0,0,18663,18663,0.0,Washington,Washington
9328,June,2018,Ferry,WA,Passenger,3,3,6,4425,4431,0.14,Washington,Washington
9331,June,2018,Stevens,WA,Passenger,11,25,36,31637,31673,0.11,Washington,Washington
9332,June,2018,Pacific,WA,Passenger,17,20,37,15572,15609,0.24,Washington,Washington
9334,June,2018,Columbia,WA,Passenger,2,2,4,2424,2428,0.16,Washington,Washington
9340,June,2018,Douglas,WA,Truck,0,0,0,11947,11947,0.0,Washington,Washington
9344,June,2018,Kitsap,WA,Truck,1,0,1,53204,53205,0.0,Washington,Washington
9349,June,2018,Thurston,WA,Truck,0,0,0,54326,54326,0.0,Washington,Washington
9355,June,2018,Stevens,WA,Truck,0,0,0,18609,18609,0.0,Washington,Washington
9356,June,2018,Okanogan,WA,Passenger,9,19,28,25958,25986,0.11,Washington,Washington
9359,June,2018,Mason,WA,Truck,0,0,0,19955,19955,0.0,Washington,Washington
9362,June,2018,Kittitas,WA,Truck,0,0,0,14056,14056,0.0,Washington,Washington
9368,June,2018,Skagit,WA,Passenger,206,166,372,90487,90859,0.41,Washington,Washington
9372,June,2018,Ferry,WA,Truck,0,0,0,3512,3512,0.0,Washington,Washington
9373,June,2018,Chelan,WA,Passenger,110,53,163,53555,53718,0.3,Washington,Washington
9374,June,2018,Mason,WA,Passenger,82,92,174,45712,45886,0.38,Washington,Washington
9375,June,2018,Okanogan,WA,Truck,0,0,0,16431,16431,0.0,Washington,Washington
9377,June,2018,Grays Harbor,WA,Truck,0,0,0,20226,20226,0.0,Washington,Washington
9378,June,2018,Kittitas,WA,Passenger,47,32,79,28926,29005,0.27,Washington,Washington
9380,June,2018,Yakima,WA,Truck,0,0,0,58487,58487,0.0,Washington,Washington
9386,June,2018,Yakima,WA,Passenger,60,88,148,163780,163928,0.09,Washington,Washington
9387,June,2018,Asotin,WA,Passenger,9,6,15,12602,12617,0.12,Washington,Washington
9389,June,2018,Grant,WA,Passenger,31,45,76,63139,63215,0.12,Washington,Washington
9390,June,2018,Whatcom,WA,Passenger,631,301,932,147658,148590,0.63,Washington,Washington
9393,June,2018,Pend Oreille,WA,Truck,0,0,0,5682,5682,0.0,Washington,Washington
9395,June,2018,Kitsap,WA,Passenger,796,460,1256,178527,179783,0.7,Washington,Washington
9397,June,2018,Whitman,WA,Passenger,19,28,47,22602,22649,0.21,Washington,Washington
9399,June,2018,Pend Oreille,WA,Passenger,5,5,10,9547,9557,0.1,Washington,Washington
9408,June,2018,Columbia,WA,Truck,0,0,0,1527,1527,0.0,Washington,Washington
9410,June,2018,San Juan,WA,Passenger,145,61,206,14069,14275,1.44,Washington,Washington
9413,June,2018,Lincoln,WA,Passenger,2,6,8,7685,7693,0.1,Washington,Washington
9417,June,2018,Benton,WA,Truck,0,0,0,41024,41024,0.0,Washington,Washington
9419,June,2018,Klickitat,WA,Passenger,25,30,55,15166,15221,0.36,Washington,Washington
9421,June,2018,Chelan,WA,Truck,0,0,0,21872,21872,0.0,Washington,Washington
9426,June,2018,Cowlitz,WA,Passenger,55,74,129,71731,71860,0.18,Washington,Washington
9427,June,2018,Adams,WA,Truck,0,0,0,5165,5165,0.0,Washington,Washington
9433,June,2018,Benton,WA,Passenger,192,199,391,131476,131867,0.3,Washington,Washington
9434,June,2018,Skamania,WA,Truck,0,0,0,3946,3946,0.0,Washington,Washington
9439,June,2018,King,WA,Truck,7,1,8,183054,183062,0.0,Washington,Washington
9440,June,2018,Klickitat,WA,Truck,0,0,0,8117,8117,0.0,Washington,Washington
9441,June,2018,Grays Harbor,WA,Passenger,52,58,110,46575,46685,0.24,Washington,Washington
9442,June,2018,Walla Walla,WA,Truck,0,0,0,13416,13416,0.0,Washington,Washington
9443,June,2018,Pacific,WA,Truck,0,0,0,7600,7600,0.0,Washington,Washington
9445,June,2018,Wahkiakum,WA,Truck,0,0,0,1675,1675,0.0,Washington,Washington
9450,June,2018,San Juan,WA,Truck,0,0,0,5713,5713,0.0,Washington,Washington
9451,June,2018,Franklin,WA,Passenger,39,66,105,57858,57963,0.18,Washington,Washington
9452,June,2018,Clark,WA,Truck,0,0,0,79122,79122,0.0,Washington,Washington
9453,June,2018,Whitman,WA,Truck,0,0,0,8493,8493,0.0,Washington,Washington
9455,June,2018,Cowlitz,WA,Truck,0,0,0,28460,28460,0.0,Washington,Washington
9456,June,2018,Asotin,WA,Truck,0,0,0,6616,6616,0.0,Washington,Washington
9458,June,2018,Walla Walla,WA,Passenger,34,43,77,35660,35737,0.22,Washington,Washington
9459,June,2018,Douglas,WA,Passenger,43,31,74,27649,27723,0.27,Washington,Washington
9462,June,2018,Island,WA,Truck,0,0,0,20955,20955,0.0,Washington,Washington
9463,June,2018,Skamania,WA,Passenger,11,9,20,8660,8680,0.23,Washington,Washington
9465,June,2018,Jefferson,WA,Passenger,144,97,241,24453,24694,0.98,Washington,Washington
9466,June,2018,Grant,WA,Truck,0,0,0,25921,25921,0.0,Washington,Washington
9470,June,2018,Spokane,WA,Truck,1,0,1,92636,92637,0.0,Washington,Washington
9471,June,2018,Clallam,WA,Passenger,124,112,236,49911,50147,0.47,Washington,Washington
9473,June,2018,Snohomish,WA,Passenger,2349,1262,3611,521519,525130,0.69,Washington,Washington
9480,June,2018,Thurston,WA,Passenger,572,481,1053,193030,194083,0.54,Washington,Washington
9483,June,2018,Whatcom,WA,Truck,2,0,2,42285,42287,0.0,Washington,Washington
9489,June,2019,Franklin,WA,Passenger,52,70,122,59912,60034,0.2,Washington,Washington
9493,June,2019,Mason,WA,Passenger,124,122,246,47188,47434,0.52,Washington,Washington
9496,June,2019,Chelan,WA,Truck,0,0,0,22281,22281,0.0,Washington,Washington
9502,June,2019,Stevens,WA,Passenger,19,31,50,31694,31744,0.16,Washington,Washington
9504,June,2019,Douglas,WA,Truck,0,0,0,12182,12182,0.0,Washington,Washington
9509,June,2019,Skagit,WA,Truck,1,0,1,32442,32443,0.0,Washington,Washington
9516,June,2019,Chelan,WA,Passenger,157,68,225,54354,54579,0.41,Washington,Washington
9517,June,2019,Skamania,WA,Truck,0,0,0,4062,4062,0.0,Washington,Washington
9518,June,2019,Clark,WA,Truck,0,0,0,80332,80332,0.0,Washington,Washington
9519,June,2019,Benton,WA,Passenger,259,279,538,133796,134334,0.4,Washington,Washington
9520,June,2019,Ferry,WA,Passenger,5,2,7,4388,4395,0.16,Washington,Washington
9523,June,2019,Kittitas,WA,Truck,0,0,0,14422,14422,0.0,Washington,Washington
9524,June,2019,Pend Oreille,WA,Truck,0,0,0,5732,5732,0.0,Washington,Washington
9530,June,2019,Spokane,WA,Passenger,539,433,972,311797,312769,0.31,Washington,Washington
9533,June,2019,Adams,WA,Passenger,5,6,11,12757,12768,0.09,Washington,Washington
9534,June,2019,King,WA,Passenger,19080,7013,26093,1389199,1415292,1.84,Washington,Washington
9535,June,2019,Adams,WA,Truck,0,0,0,5128,5128,0.0,Washington,Washington
9536,June,2019,Klickitat,WA,Truck,0,0,0,8251,8251,0.0,Washington,Washington
9540,June,2019,Wahkiakum,WA,Passenger,2,2,4,3009,3013,0.13,Washington,Washington
9541,June,2019,Okanogan,WA,Passenger,22,25,47,26076,26123,0.18,Washington,Washington
9543,June,2019,Kitsap,WA,Truck,1,0,1,54095,54096,0.0,Washington,Washington
9547,June,2019,Garfield,WA,Truck,0,0,0,964,964,0.0,Washington,Washington
9550,June,2019,Klickitat,WA,Passenger,35,32,67,15557,15624,0.43,Washington,Washington
9554,June,2019,Skamania,WA,Passenger,23,18,41,8725,8766,0.47,Washington,Washington
9557,June,2019,Asotin,WA,Truck,0,0,0,6667,6667,0.0,Washington,Washington
9559,June,2019,Wahkiakum,WA,Truck,0,0,0,1755,1755,0.0,Washington,Washington
9560,June,2019,Island,WA,Passenger,317,240,557,63386,63943,0.87,Washington,Washington
9561,June,2019,Lewis,WA,Truck,0,0,0,25951,25951,0.0,Washington,Washington
9562,June,2019,Columbia,WA,Truck,0,0,0,1532,1532,0.0,Washington,Washington
9564,June,2019,Lewis,WA,Passenger,99,92,191,59123,59314,0.32,Washington,Washington
9568,June,2019,Spokane,WA,Truck,1,0,1,94860,94861,0.0,Washington,Washington
9572,June,2019,Lincoln,WA,Truck,0,0,0,4676,4676,0.0,Washington,Washington
9573,June,2019,Pend Oreille,WA,Passenger,4,5,9,9531,9540,0.09,Washington,Washington
9577,June,2019,Thurston,WA,Passenger,875,639,1514,197699,199213,0.76,Washington,Washington
9578,June,2019,Pierce,WA,Truck,0,0,0,139794,139794,0.0,Washington,Washington
9579,June,2019,Stevens,WA,Truck,0,0,0,18659,18659,0.0,Washington,Washington
9581,June,2019,Mason,WA,Truck,0,0,0,20361,20361,0.0,Washington,Washington
9585,June,2019,Thurston,WA,Truck,0,0,0,55124,55124,0.0,Washington,Washington
9590,June,2019,Asotin,WA,Passenger,12,8,20,12641,12661,0.16,Washington,Washington
9594,June,2019,Garfield,WA,Passenger,1,1,2,1298,1300,0.15,Washington,Washington
9595,June,2019,Whatcom,WA,Passenger,853,428,1281,150709,151990,0.84,Washington,Washington
9597,June,2019,Ferry,WA,Truck,0,0,0,3570,3570,0.0,Washington,Washington
9600,June,2019,Pacific,WA,Passenger,25,29,54,15975,16029,0.34,Washington,Washington
9605,June,2019,Grays Harbor,WA,Truck,0,0,0,20455,20455,0.0,Washington,Washington
9614,June,2019,Whitman,WA,Passenger,31,46,77,22712,22789,0.34,Washington,Washington
9617,June,2019,Grays Harbor,WA,Passenger,73,85,158,47923,48081,0.33,Washington,Washington
9619,June,2019,Clark,WA,Passenger,1538,926,2464,313856,316320,0.78,Washington,Washington
9620,June,2019,Clallam,WA,Passenger,173,141,314,50501,50815,0.62,Washington,Washington
9623,June,2019,Grant,WA,Truck,0,0,0,26631,26631,0.0,Washington,Washington
9626,June,2019,Clallam,WA,Truck,1,0,1,21740,21741,0.0,Washington,Washington
9627,June,2019,San Juan,WA,Truck,0,0,0,5866,5866,0.0,Washington,Washington
9628,June,2019,Okanogan,WA,Truck,0,0,0,16482,16482,0.0,Washington,Washington
9630,June,2019,Jefferson,WA,Passenger,197,119,316,24995,25311,1.25,Washington,Washington
9634,June,2019,Whatcom,WA,Truck,2,0,2,42910,42912,0.0,Washington,Washington
9636,June,2019,Cowlitz,WA,Truck,0,0,0,28865,28865,0.0,Washington,Washington
9638,June,2019,Pacific,WA,Truck,0,0,0,7654,7654,0.0,Washington,Washington
9640,June,2019,Yakima,WA,Passenger,105,104,209,165147,165356,0.13,Washington,Washington
9645,June,2019,Skagit,WA,Passenger,298,200,498,91940,92438,0.54,Washington,Washington
9648,June,2019,Pierce,WA,Passenger,1808,1556,3364,543069,546433,0.62,Washington,Washington
9651,June,2019,San Juan,WA,Passenger,212,72,284,14409,14693,1.93,Washington,Washington
9652,June,2019,Snohomish,WA,Passenger,3473,1593,5066,531506,536572,0.94,Washington,Washington
9657,June,2019,Kitsap,WA,Passenger,1050,605,1655,180817,182472,0.91,Washington,Washington
9667,June,2019,Yakima,WA,Truck,0,0,0,59138,59138,0.0,Washington,Washington
9669,June,2019,Walla Walla,WA,Passenger,49,61,110,36186,36296,0.3,Washington,Washington
9671,June,2019,Jefferson,WA,Truck,0,0,0,9667,9667,0.0,Washington,Washington
9677,June,2019,Island,WA,Truck,0,0,0,21261,21261,0.0,Washington,Washington
9679,June,2019,Columbia,WA,Passenger,2,2,4,2450,2454,0.16,Washington,Washington
9682,June,2019,Walla Walla,WA,Truck,0,0,0,13593,13593,0.0,Washington,Washington
9683,June,2019,King,WA,Truck,5,1,6,182076,182082,0.0,Washington,Washington
9684,June,2019,Kittitas,WA,Passenger,81,38,119,29608,29727,0.4,Washington,Washington
9688,June,2019,Lincoln,WA,Passenger,2,8,10,7776,7786,0.13,Washington,Washington
9695,June,2019,Benton,WA,Truck,0,0,0,41914,41914,0.0,Washington,Washington
9698,June,2019,Whitman,WA,Truck,0,0,0,8584,8584,0.0,Washington,Washington
9699,June,2019,Cowlitz,WA,Passenger,98,108,206,73013,73219,0.28,Washington,Washington
9701,June,2019,Franklin,WA,Truck,0,0,0,19271,19271,0.0,Washington,Washington
9704,June,2019,Grant,WA,Passenger,41,61,102,64706,64808,0.16,Washington,Washington
9707,June,2019,Snohomish,WA,Truck,0,0,0,122375,122375,0.0,Washington,Washington
9710,June,2019,Douglas,WA,Passenger,57,37,94,28032,28126,0.33,Washington,Washington
9713,June,2020,Pacific,WA,Passenger,33,33,66,15754,15820,0.42,Washington,Washington
9714,June,2020,Wahkiakum,WA,Truck,0,0,0,1737,1737,0.0,Washington,Washington
9717,June,2020,Franklin,WA,Passenger,60,76,136,60644,60780,0.22,Washington,Washington
9718,June,2020,King,WA,Passenger,24109,7712,31821,1371025,1402846,2.27,Washington,Washington
9719,June,2020,Island,WA,Truck,1,0,1,21212,21213,0.0,Washington,Washington
9726,June,2020,Clark,WA,Truck,0,0,0,82225,82225,0.0,Washington,Washington
9731,June,2020,Pierce,WA,Passenger,2380,1692,4072,549665,553737,0.74,Washington,Washington
9734,June,2020,San Juan,WA,Passenger,302,93,395,13968,14363,2.75,Washington,Washington
9736,June,2020,Spokane,WA,Passenger,730,487,1217,315451,316668,0.38,Washington,Washington
9738,June,2020,Lewis,WA,Passenger,102,111,213,58176,58389,0.36,Washington,Washington
9740,June,2020,Cowlitz,WA,Truck,0,0,0,28868,28868,0.0,Washington,Washington
9743,June,2020,Island,WA,Passenger,420,268,688,62807,63495,1.08,Washington,Washington
9746,June,2020,Ferry,WA,Passenger,5,3,8,4330,4338,0.18,Washington,Washington
9748,June,2020,Grant,WA,Truck,0,0,0,27083,27083,0.0,Washington,Washington
9752,June,2020,Mason,WA,Passenger,159,135,294,47272,47566,0.62,Washington,Washington
9755,June,2020,Skamania,WA,Truck,0,0,0,4011,4011,0.0,Washington,Washington
9758,June,2020,Kitsap,WA,Truck,0,0,0,54064,54064,0.0,Washington,Washington
9764,June,2020,Kittitas,WA,Passenger,99,47,146,29805,29951,0.49,Washington,Washington
9765,June,2020,Lincoln,WA,Passenger,5,12,17,7624,7641,0.22,Washington,Washington
9770,June,2020,Chelan,WA,Passenger,231,78,309,54185,54494,0.57,Washington,Washington
9776,June,2020,Stevens,WA,Truck,0,0,0,18645,18645,0.0,Washington,Washington
9777,June,2020,Benton,WA,Truck,0,0,0,42703,42703,0.0,Washington,Washington
9781,June,2020,King,WA,Truck,5,1,6,182171,182177,0.0,Washington,Washington
9791,June,2020,Skagit,WA,Truck,1,0,1,32470,32471,0.0,Washington,Washington
9794,June,2020,Pend Oreille,WA,Truck,0,0,0,5760,5760,0.0,Washington,Washington
9798,June,2020,Garfield,WA,Truck,0,0,0,974,974,0.0,Washington,Washington
9800,June,2020,Columbia,WA,Passenger,4,3,7,2415,2422,0.29,Washington,Washington
9808,June,2020,Mason,WA,Truck,0,0,0,20604,20604,0.0,Washington,Washington
9809,June,2020,Skagit,WA,Passenger,407,221,628,91153,91781,0.68,Washington,Washington
9810,June,2020,Stevens,WA,Passenger,36,33,69,30654,30723,0.22,Washington,Washington
9811,June,2020,Yakima,WA,Passenger,132,119,251,165352,165603,0.15,Washington,Washington
9814,June,2020,Cowlitz,WA,Passenger,138,115,253,72319,72572,0.35,Washington,Washington
9815,June,2020,Adams,WA,Truck,0,0,0,5263,5263,0.0,Washington,Washington
9816,June,2020,Franklin,WA,Truck,0,0,0,19973,19973,0.0,Washington,Washington
9818,June,2020,Spokane,WA,Truck,1,0,1,98330,98331,0.0,Washington,Washington
9819,June,2020,Benton,WA,Passenger,359,321,680,134227,134907,0.5,Washington,Washington
9821,June,2020,Asotin,WA,Truck,0,0,0,6638,6638,0.0,Washington,Washington
9823,June,2020,Thurston,WA,Passenger,1143,736,1879,196906,198785,0.95,Washington,Washington
9830,June,2020,Klickitat,WA,Passenger,53,41,94,15173,15267,0.62,Washington,Washington
9832,June,2020,Clark,WA,Passenger,2014,1058,3072,317682,320754,0.96,Washington,Washington
9836,June,2020,Pierce,WA,Truck,0,0,0,142167,142167,0.0,Washington,Washington
9844,June,2020,Pend Oreille,WA,Passenger,7,6,13,9243,9256,0.14,Washington,Washington
9845,June,2020,Okanogan,WA,Truck,0,0,0,16445,16445,0.0,Washington,Washington
9846,June,2020,Jefferson,WA,Passenger,236,139,375,24797,25172,1.49,Washington,Washington
9847,June,2020,Grays Harbor,WA,Passenger,106,111,217,48145,48362,0.45,Washington,Washington
9848,June,2020,Walla Walla,WA,Truck,0,0,0,13745,13745,0.0,Washington,Washington
9857,June,2020,Thurston,WA,Truck,0,0,0,55742,55742,0.0,Washington,Washington
9860,June,2020,Jefferson,WA,Truck,0,0,0,9533,9533,0.0,Washington,Washington
9864,June,2020,Whatcom,WA,Truck,3,0,3,43006,43009,0.01,Washington,Washington
9868,June,2020,Pacific,WA,Truck,0,0,0,7699,7699,0.0,Washington,Washington
9872,June,2020,Whatcom,WA,Passenger,1064,498,1562,149248,150810,1.04,Washington,Washington
9875,June,2020,Asotin,WA,Passenger,16,12,28,12321,12349,0.23,Washington,Washington
9879,June,2020,Whitman,WA,Passenger,44,48,92,22140,22232,0.41,Washington,Washington
9883,June,2020,Kitsap,WA,Passenger,1330,686,2016,179815,181831,1.11,Washington,Washington
9885,June,2020,San Juan,WA,Truck,0,0,0,5854,5854,0.0,Washington,Washington
9888,June,2020,Adams,WA,Passenger,9,7,16,12786,12802,0.12,Washington,Washington
9892,June,2020,Lewis,WA,Truck,0,0,0,26209,26209,0.0,Washington,Washington
9893,June,2020,Yakima,WA,Truck,0,0,0,59894,59894,0.0,Washington,Washington
9894,June,2020,Whitman,WA,Truck,0,0,0,8508,8508,0.0,Washington,Washington
9898,June,2020,Klickitat,WA,Truck,0,0,0,8102,8102,0.0,Washington,Washington
9899,June,2020,Ferry,WA,Truck,0,0,0,3555,3555,0.0,Washington,Washington
9902,June,2020,Wahkiakum,WA,Passenger,6,6,12,2991,3003,0.4,Washington,Washington
9904,June,2020,Douglas,WA,Passenger,71,40,111,28002,28113,0.39,Washington,Washington
9905,June,2020,Grays Harbor,WA,Truck,0,0,0,20910,20910,0.0,Washington,Washington
9908,June,2020,Grant,WA,Passenger,59,71,130,65239,65369,0.2,Washington,Washington
9909,June,2020,Lincoln,WA,Truck,0,0,0,4624,4624,0.0,Washington,Washington
9910,June,2020,Kittitas,WA,Truck,0,0,0,14591,14591,0.0,Washington,Washington
9911,June,2020,Clallam,WA,Truck,1,0,1,21760,21761,0.0,Washington,Washington
9913,June,2020,Clallam,WA,Passenger,228,168,396,50092,50488,0.78,Washington,Washington
9917,June,2020,Garfield,WA,Passenger,0,1,1,1351,1352,0.07,Washington,Washington
9920,June,2020,Snohomish,WA,Truck,0,0,0,123942,123942,0.0,Washington,Washington
9930,June,2020,Columbia,WA,Truck,0,0,0,1532,1532,0.0,Washington,Washington
9935,June,2020,Snohomish,WA,Passenger,4434,1765,6199,534548,540747,1.15,Washington,Washington
9937,June,2020,Douglas,WA,Truck,0,0,0,12308,12308,0.0,Washington,Washington
9940,June,2020,Skamania,WA,Passenger,31,18,49,8481,8530,0.57,Washington,Washington
9941,June,2020,Walla Walla,WA,Passenger,73,62,135,35832,35967,0.38,Washington,Washington
9945,June,2020,Chelan,WA,Truck,0,0,0,22520,22520,0.0,Washington,Washington
9946,June,2020,Okanogan,WA,Passenger,36,33,69,25848,25917,0.27,Washington,Washington
9955,June,2021,Jefferson,WA,Passenger,331,184,515,24891,25406,2.03,Washington,Washington
9958,June,2021,Snohomish,WA,Passenger,5886,2048,7934,540300,548234,1.45,Washington,Washington
9959,June,2021,Stevens,WA,Passenger,45,45,90,30479,30569,0.29,Washington,Washington
9961,June,2021,Mason,WA,Truck,0,0,0,21335,21335,0.0,Washington,Washington
9962,June,2021,Chelan,WA,Passenger,336,99,435,54745,55180,0.79,Washington,Washington
9963,June,2021,Snohomish,WA,Truck,1,0,1,126272,126273,0.0,Washington,Washington
9965,June,2021,Spokane,WA,Truck,0,0,0,102350,102350,0.0,Washington,Washington
9968,June,2021,Whatcom,WA,Passenger,1419,602,2021,150844,152865,1.32,Washington,Washington
9970,June,2021,Pacific,WA,Passenger,45,53,98,16057,16155,0.61,Washington,Washington
9971,June,2021,King,WA,Passenger,30495,9167,39662,1368513,1408175,2.82,Washington,Washington
9972,June,2021,Chelan,WA,Truck,0,0,0,23127,23127,0.0,Washington,Washington
9976,June,2021,Thurston,WA,Truck,0,0,0,56575,56575,0.0,Washington,Washington
9978,June,2021,Grays Harbor,WA,Truck,0,0,0,21450,21450,0.0,Washington,Washington
9981,June,2021,Asotin,WA,Passenger,20,17,37,12728,12765,0.29,Washington,Washington
9984,June,2021,Okanogan,WA,Truck,0,0,0,16757,16757,0.0,Washington,Washington
9985,June,2021,Whatcom,WA,Truck,4,0,4,43913,43917,0.01,Washington,Washington
9989,June,2021,Pacific,WA,Truck,0,0,0,7965,7965,0.0,Washington,Washington
9992,June,2021,Wahkiakum,WA,Passenger,15,8,23,3109,3132,0.73,Washington,Washington
9995,June,2021,Skamania,WA,Truck,0,0,0,4029,4029,0.0,Washington,Washington
10000,June,2021,Grant,WA,Truck,0,0,0,27912,27912,0.0,Washington,Washington
10001,June,2021,Benton,WA,Passenger,518,394,912,136405,137317,0.66,Washington,Washington
10003,June,2021,Clark,WA,Truck,0,0,0,84343,84343,0.0,Washington,Washington
10005,June,2021,Asotin,WA,Truck,0,0,0,6792,6792,0.0,Washington,Washington
10009,June,2021,Ferry,WA,Passenger,9,3,12,4373,4385,0.27,Washington,Washington
10011,June,2021,Franklin,WA,Passenger,123,97,220,62016,62236,0.35,Washington,Washington
10018,June,2021,Cowlitz,WA,Passenger,224,142,366,72350,72716,0.5,Washington,Washington
10020,June,2021,Island,WA,Passenger,617,317,934,63262,64196,1.45,Washington,Washington
10026,June,2021,Kitsap,WA,Truck,0,0,0,54475,54475,0.0,Washington,Washington
10035,June,2021,Ferry,WA,Truck,0,0,0,3641,3641,0.0,Washington,Washington
10037,June,2021,Garfield,WA,Truck,0,0,0,998,998,0.0,Washington,Washington
10038,June,2021,Whitman,WA,Truck,0,0,0,8585,8585,0.0,Washington,Washington
10041,June,2021,Pierce,WA,Truck,0,0,0,146075,146075,0.0,Washington,Washington
10042,June,2021,Okanogan,WA,Passenger,63,38,101,26512,26613,0.38,Washington,Washington
10045,June,2021,Jefferson,WA,Truck,0,0,0,9625,9625,0.0,Washington,Washington
10047,June,2021,Pend Oreille,WA,Passenger,14,7,21,9267,9288,0.23,Washington,Washington
10048,June,2021,Kittitas,WA,Truck,0,0,0,14785,14785,0.0,Washington,Washington
10050,June,2021,Skagit,WA,Truck,1,0,1,33029,33030,0.0,Washington,Washington
10052,June,2021,Klickitat,WA,Truck,0,0,0,8301,8301,0.0,Washington,Washington
10053,June,2021,Douglas,WA,Passenger,93,48,141,28517,28658,0.49,Washington,Washington
10057,June,2021,Grant,WA,Passenger,107,89,196,66973,67169,0.29,Washington,Washington
10059,June,2021,Yakima,WA,Truck,0,0,0,61725,61725,0.0,Washington,Washington
10063,June,2021,Wahkiakum,WA,Truck,0,0,0,1797,1797,0.0,Washington,Washington
10071,June,2021,Grays Harbor,WA,Passenger,168,144,312,49450,49762,0.63,Washington,Washington
10072,June,2021,Yakima,WA,Passenger,225,155,380,169332,169712,0.22,Washington,Washington
10074,June,2021,Franklin,WA,Truck,0,0,0,20697,20697,0.0,Washington,Washington
10075,June,2021,San Juan,WA,Passenger,431,135,566,14255,14821,3.82,Washington,Washington
10076,June,2021,Columbia,WA,Passenger,6,2,8,2468,2476,0.32,Washington,Washington
10079,June,2021,Kittitas,WA,Passenger,160,67,227,29984,30211,0.75,Washington,Washington
10080,June,2021,Clallam,WA,Passenger,329,217,546,50489,51035,1.07,Washington,Washington
10082,June,2021,Lewis,WA,Passenger,163,139,302,59680,59982,0.5,Washington,Washington
10086,June,2021,Clark,WA,Passenger,2841,1423,4264,322560,326824,1.3,Washington,Washington
10092,June,2021,Whitman,WA,Passenger,58,47,105,21996,22101,0.48,Washington,Washington
10093,June,2021,Cowlitz,WA,Truck,0,0,0,29122,29122,0.0,Washington,Washington
10096,June,2021,Adams,WA,Truck,0,0,0,5386,5386,0.0,Washington,Washington
10101,June,2021,San Juan,WA,Truck,0,0,0,5942,5942,0.0,Washington,Washington
10106,June,2021,Adams,WA,Passenger,16,11,27,13035,13062,0.21,Washington,Washington
10110,June,2021,Pierce,WA,Passenger,3470,1997,5467,560461,565928,0.97,Washington,Washington
10112,June,2021,Lewis,WA,Truck,0,0,0,26859,26859,0.0,Washington,Washington
10119,June,2021,Mason,WA,Passenger,215,140,355,48176,48531,0.73,Washington,Washington
10123,June,2021,Walla Walla,WA,Passenger,113,74,187,36614,36801,0.51,Washington,Washington
10124,June,2021,Lincoln,WA,Truck,0,0,0,4754,4754,0.0,Washington,Washington
10129,June,2021,Klickitat,WA,Passenger,70,51,121,15279,15400,0.79,Washington,Washington
10135,June,2021,Columbia,WA,Truck,0,0,0,1546,1546,0.0,Washington,Washington
10139,June,2021,Spokane,WA,Passenger,1069,646,1715,326466,328181,0.52,Washington,Washington
10145,June,2021,Pend Oreille,WA,Truck,0,0,0,5748,5748,0.0,Washington,Washington
10148,June,2021,Walla Walla,WA,Truck,0,0,0,14076,14076,0.0,Washington,Washington
10156,June,2021,Skagit,WA,Passenger,589,274,863,91973,92836,0.93,Washington,Washington
10157,June,2021,King,WA,Truck,6,1,7,184630,184637,0.0,Washington,Washington
10160,June,2021,Benton,WA,Truck,0,0,0,43627,43627,0.0,Washington,Washington
10167,June,2021,Skamania,WA,Passenger,44,34,78,8407,8485,0.92,Washington,Washington
10168,June,2021,Thurston,WA,Passenger,1585,872,2457,198143,200600,1.22,Washington,Washington
10171,June,2021,Douglas,WA,Truck,0,0,0,12685,12685,0.0,Washington,Washington
10172,June,2021,Stevens,WA,Truck,0,0,0,18947,18947,0.0,Washington,Washington
10173,June,2021,Kitsap,WA,Passenger,1851,859,2710,180524,183234,1.48,Washington,Washington
10186,June,2021,Lincoln,WA,Passenger,5,13,18,7738,7756,0.23,Washington,Washington
10190,June,2021,Clallam,WA,Truck,1,0,1,22026,22027,0.0,Washington,Washington
10193,June,2021,Garfield,WA,Passenger,0,3,3,1375,1378,0.22,Washington,Washington
10198,June,2021,Island,WA,Truck,0,0,0,21624,21624,0.0,Washington,Washington
10205,June,2022,Clallam,WA,Truck,3,0,3,21937,21940,0.01,Washington,Washington
10217,June,2022,Whitman,WA,Truck,1,0,1,8572,8573,0.01,Washington,Washington
10218,June,2022,Yakima,WA,Truck,1,0,1,61408,61409,0.0,Washington,Washington
10223,June,2022,Adams,WA,Truck,1,0,1,5468,5469,0.02,Washington,Washington
10224,June,2022,Ferry,WA,Passenger,19,4,23,4409,4432,0.52,Washington,Washington
10227,June,2022,Lewis,WA,Truck,0,0,0,26412,26412,0.0,Washington,Washington
10232,June,2022,Island,WA,Passenger,818,379,1197,61948,63145,1.9,Washington,Washington
10233,June,2022,Kitsap,WA,Truck,4,0,4,53663,53667,0.01,Washington,Washington
10236,June,2022,Lincoln,WA,Passenger,8,18,26,7710,7736,0.34,Washington,Washington
10237,June,2022,Stevens,WA,Truck,0,0,0,18951,18951,0.0,Washington,Washington
10240,June,2022,Adams,WA,Passenger,17,10,27,12936,12963,0.21,Washington,Washington
10242,June,2022,Mason,WA,Truck,1,0,1,21067,21068,0.0,Washington,Washington
10243,June,2022,Okanogan,WA,Truck,1,0,1,16648,16649,0.01,Washington,Washington
10244,June,2022,Jefferson,WA,Passenger,434,217,651,24594,25245,2.58,Washington,Washington
10246,June,2022,Island,WA,Truck,4,0,4,21382,21386,0.02,Washington,Washington
10249,June,2022,Thurston,WA,Passenger,2182,1055,3237,194425,197662,1.64,Washington,Washington
10251,June,2022,Walla Walla,WA,Truck,0,0,0,13934,13934,0.0,Washington,Washington
10253,June,2022,Whatcom,WA,Truck,7,0,7,43365,43372,0.02,Washington,Washington
10254,June,2022,Garfield,WA,Truck,0,0,0,984,984,0.0,Washington,Washington
10257,June,2022,Mason,WA,Passenger,311,177,488,47350,47838,1.02,Washington,Washington
10263,June,2022,Benton,WA,Truck,3,0,3,43576,43579,0.01,Washington,Washington
10266,June,2022,Spokane,WA,Truck,1,0,1,102259,102260,0.0,Washington,Washington
10267,June,2022,Douglas,WA,Truck,0,0,0,12790,12790,0.0,Washington,Washington
10277,June,2022,Skamania,WA,Passenger,73,47,120,8213,8333,1.44,Washington,Washington
10278,June,2022,Wahkiakum,WA,Passenger,23,11,34,3072,3106,1.09,Washington,Washington
10279,June,2022,Pend Oreille,WA,Passenger,17,11,28,9056,9084,0.31,Washington,Washington
10280,June,2022,Wahkiakum,WA,Truck,0,0,0,1804,1804,0.0,Washington,Washington
10286,June,2022,San Juan,WA,Passenger,513,157,670,14067,14737,4.55,Washington,Washington
10287,June,2022,Stevens,WA,Passenger,68,54,122,30173,30295,0.4,Washington,Washington
10290,June,2022,Skagit,WA,Passenger,780,337,1117,90139,91256,1.22,Washington,Washington
10294,June,2022,Skagit,WA,Truck,3,0,3,32352,32355,0.01,Washington,Washington
10295,June,2022,Clallam,WA,Passenger,421,249,670,49776,50446,1.33,Washington,Washington
10304,June,2022,Klickitat,WA,Truck,0,0,0,8294,8294,0.0,Washington,Washington
10308,June,2022,Chelan,WA,Truck,3,0,3,23068,23071,0.01,Washington,Washington
10320,June,2022,Lincoln,WA,Truck,0,0,0,4832,4832,0.0,Washington,Washington
10325,June,2022,Garfield,WA,Passenger,0,3,3,1322,1325,0.23,Washington,Washington
10326,June,2022,Franklin,WA,Truck,0,0,0,20900,20900,0.0,Washington,Washington
10328,June,2022,King,WA,Truck,66,1,67,180923,180990,0.04,Washington,Washington
10329,June,2022,Benton,WA,Passenger,751,461,1212,135364,136576,0.89,Washington,Washington
10330,June,2022,Asotin,WA,Truck,0,0,0,6720,6720,0.0,Washington,Washington
10333,June,2022,Asotin,WA,Passenger,23,19,42,12740,12782,0.33,Washington,Washington
10335,June,2022,Kittitas,WA,Truck,1,0,1,14655,14656,0.01,Washington,Washington
10339,June,2022,Pend Oreille,WA,Truck,0,0,0,5670,5670,0.0,Washington,Washington
10341,June,2022,King,WA,Passenger,40732,11318,52050,1349910,1401960,3.71,Washington,Washington
10343,June,2022,Pacific,WA,Truck,0,0,0,7916,7916,0.0,Washington,Washington
10347,June,2022,Skamania,WA,Truck,0,0,0,3971,3971,0.0,Washington,Washington
10350,June,2022,Kittitas,WA,Passenger,266,83,349,29763,30112,1.16,Washington,Washington
10353,June,2022,Okanogan,WA,Passenger,83,50,133,26390,26523,0.5,Washington,Washington
10354,June,2022,Chelan,WA,Passenger,461,126,587,54351,54938,1.07,Washington,Washington
10355,June,2022,Spokane,WA,Passenger,1602,848,2450,325470,327920,0.75,Washington,Washington
10360,June,2022,Grant,WA,Truck,0,0,0,28025,28025,0.0,Washington,Washington
10363,June,2022,Kitsap,WA,Passenger,2393,1054,3447,178654,182101,1.89,Washington,Washington
10364,June,2022,Pierce,WA,Passenger,5062,2311,7373,546060,553433,1.33,Washington,Washington
10366,June,2022,Whitman,WA,Passenger,87,60,147,22018,22165,0.66,Washington,Washington
10368,June,2022,Snohomish,WA,Passenger,8361,2528,10889,532982,543871,2.0,Washington,Washington
10369,June,2022,Columbia,WA,Passenger,7,0,7,2444,2451,0.29,Washington,Washington
10371,June,2022,San Juan,WA,Truck,1,0,1,5986,5987,0.02,Washington,Washington
10372,June,2022,Walla Walla,WA,Passenger,172,101,273,35914,36187,0.75,Washington,Washington
10383,June,2022,Douglas,WA,Passenger,131,58,189,28498,28687,0.66,Washington,Washington
10384,June,2022,Grant,WA,Passenger,175,99,274,66817,67091,0.41,Washington,Washington
10386,June,2022,Clark,WA,Passenger,4095,1781,5876,316688,322564,1.82,Washington,Washington
10387,June,2022,Grays Harbor,WA,Truck,1,0,1,21324,21325,0.0,Washington,Washington
10409,June,2022,Cowlitz,WA,Truck,2,1,3,28556,28559,0.01,Washington,Washington
10410,June,2022,Cowlitz,WA,Passenger,336,172,508,70742,71250,0.71,Washington,Washington
10414,June,2022,Whatcom,WA,Passenger,1814,737,2551,149016,151567,1.68,Washington,Washington
10415,June,2022,Grays Harbor,WA,Passenger,210,160,370,49043,49413,0.75,Washington,Washington
10418,June,2022,Klickitat,WA,Passenger,103,55,158,15251,15409,1.03,Washington,Washington
10425,June,2022,Lewis,WA,Passenger,235,177,412,59751,60163,0.68,Washington,Washington
10428,June,2022,Clark,WA,Truck,7,0,7,82837,82844,0.01,Washington,Washington
10429,June,2022,Ferry,WA,Truck,0,0,0,3577,3577,0.0,Washington,Washington
10433,June,2022,Franklin,WA,Passenger,186,109,295,62000,62295,0.47,Washington,Washington
10435,June,2022,Columbia,WA,Truck,0,0,0,1579,1579,0.0,Washington,Washington
10437,June,2022,Pierce,WA,Truck,6,0,6,141892,141898,0.0,Washington,Washington
10438,June,2022,Yakima,WA,Passenger,336,190,526,167038,167564,0.31,Washington,Washington
10446,June,2022,Pacific,WA,Passenger,61,71,132,15895,16027,0.82,Washington,Washington
10447,June,2022,Thurston,WA,Truck,7,0,7,55513,55520,0.01,Washington,Washington
10448,June,2022,Snohomish,WA,Truck,12,0,12,123913,123925,0.01,Washington,Washington
10451,June,2022,Jefferson,WA,Truck,2,0,2,9461,9463,0.02,Washington,Washington
10453,June,2023,Thurston,WA,Truck,60,0,60,53269,53329,0.11,Washington,Washington
10455,June,2023,Spokane,WA,Truck,40,0,40,100674,100714,0.04,Washington,Washington
10456,June,2023,Lincoln,WA,Truck,0,0,0,4817,4817,0.0,Washington,Washington
10457,June,2023,Clark,WA,Passenger,5813,2318,8131,309808,317939,2.56,Washington,Washington
10461,June,2023,Ferry,WA,Passenger,21,4,25,4268,4293,0.58,Washington,Washington
10463,June,2023,Grays Harbor,WA,Passenger,296,186,482,47792,48274,1.0,Washington,Washington
10464,June,2023,Island,WA,Passenger,1074,439,1513,60607,62120,2.44,Washington,Washington
10467,June,2023,San Juan,WA,Passenger,616,172,788,13654,14442,5.46,Washington,Washington
10474,June,2023,Island,WA,Truck,32,0,32,20856,20888,0.15,Washington,Washington
10477,June,2023,Douglas,WA,Truck,5,0,5,12829,12834,0.04,Washington,Washington
10478,June,2023,Stevens,WA,Truck,1,0,1,18505,18506,0.01,Washington,Washington
10482,June,2023,Whitman,WA,Truck,4,0,4,8514,8518,0.05,Washington,Washington
10483,June,2023,Garfield,WA,Truck,0,0,0,957,957,0.0,Washington,Washington
10484,June,2023,Wahkiakum,WA,Passenger,27,17,44,3011,3055,1.44,Washington,Washington
10488,June,2023,Grant,WA,Passenger,277,126,403,66206,66609,0.61,Washington,Washington
10495,June,2023,Ferry,WA,Truck,0,0,0,3530,3530,0.0,Washington,Washington
10497,June,2023,Clallam,WA,Truck,20,0,20,21479,21499,0.09,Washington,Washington
10501,June,2023,Yakima,WA,Passenger,501,257,758,163736,164494,0.46,Washington,Washington
10505,June,2023,Franklin,WA,Truck,5,0,5,20588,20593,0.02,Washington,Washington
10510,June,2023,Pend Oreille,WA,Truck,0,0,0,5519,5519,0.0,Washington,Washington
10516,June,2023,Skamania,WA,Truck,1,0,1,3776,3777,0.03,Washington,Washington
10517,June,2023,Snohomish,WA,Passenger,12560,3041,15601,521750,537351,2.9,Washington,Washington
10523,June,2023,Pacific,WA,Truck,4,0,4,7732,7736,0.05,Washington,Washington
10530,June,2023,Benton,WA,Passenger,1136,563,1699,133564,135263,1.26,Washington,Washington
10534,June,2023,Asotin,WA,Truck,0,0,0,6592,6592,0.0,Washington,Washington
10540,June,2023,Spokane,WA,Passenger,2298,1094,3392,319256,322648,1.05,Washington,Washington
10541,June,2023,San Juan,WA,Truck,11,0,11,5823,5834,0.19,Washington,Washington
10542,June,2023,Kitsap,WA,Passenger,3208,1283,4491,174228,178719,2.51,Washington,Washington
10543,June,2023,Adams,WA,Passenger,25,12,37,12863,12900,0.29,Washington,Washington
10546,June,2023,Wahkiakum,WA,Truck,2,0,2,1746,1748,0.11,Washington,Washington
10547,June,2023,Mason,WA,Passenger,442,206,648,45684,46332,1.4,Washington,Washington
10548,June,2023,Jefferson,WA,Truck,12,0,12,9231,9243,0.13,Washington,Washington
10549,June,2023,Pend Oreille,WA,Passenger,30,13,43,8795,8838,0.49,Washington,Washington
10551,June,2023,Benton,WA,Truck,24,0,24,42574,42598,0.06,Washington,Washington
10552,June,2023,Walla Walla,WA,Truck,5,0,5,13510,13515,0.04,Washington,Washington
10553,June,2023,Kittitas,WA,Truck,8,0,8,14383,14391,0.06,Washington,Washington
10554,June,2023,Skamania,WA,Passenger,104,59,163,7905,8068,2.02,Washington,Washington
10556,June,2023,Stevens,WA,Passenger,112,68,180,29348,29528,0.61,Washington,Washington
10558,June,2023,Garfield,WA,Passenger,1,3,4,1291,1295,0.31,Washington,Washington
10559,June,2023,Lewis,WA,Truck,7,0,7,25651,25658,0.03,Washington,Washington
10560,June,2023,Adams,WA,Truck,3,0,3,5232,5235,0.06,Washington,Washington
10561,June,2023,Pacific,WA,Passenger,76,88,164,15453,15617,1.05,Washington,Washington
10566,June,2023,Lincoln,WA,Passenger,16,18,34,7573,7607,0.45,Washington,Washington
10573,June,2023,Okanogan,WA,Truck,7,0,7,16188,16195,0.04,Washington,Washington
10581,June,2023,Columbia,WA,Truck,0,0,0,1535,1535,0.0,Washington,Washington
10583,June,2023,Jefferson,WA,Passenger,560,258,818,24060,24878,3.29,Washington,Washington
10587,June,2023,Snohomish,WA,Truck,173,0,173,119726,119899,0.14,Washington,Washington
10594,June,2023,Columbia,WA,Passenger,11,1,12,2395,2407,0.5,Washington,Washington
10596,June,2023,Pierce,WA,Passenger,7556,2770,10326,524039,534365,1.93,Washington,Washington
10606,June,2023,Kitsap,WA,Truck,76,0,76,51739,51815,0.15,Washington,Washington
10608,June,2023,Clallam,WA,Passenger,545,283,828,48445,49273,1.68,Washington,Washington
10609,June,2023,Franklin,WA,Passenger,302,137,439,61004,61443,0.71,Washington,Washington
10610,June,2023,Lewis,WA,Passenger,327,206,533,58421,58954,0.9,Washington,Washington
10613,June,2023,Whatcom,WA,Passenger,2467,871,3338,145997,149335,2.24,Washington,Washington
10618,June,2023,Mason,WA,Truck,11,0,11,20405,20416,0.05,Washington,Washington
10619,June,2023,Pierce,WA,Truck,163,0,163,135232,135395,0.12,Washington,Washington
10620,June,2023,Skagit,WA,Truck,21,0,21,31455,31476,0.07,Washington,Washington
10624,June,2023,Cowlitz,WA,Truck,9,0,9,27797,27806,0.03,Washington,Washington
10626,June,2023,Skagit,WA,Passenger,1105,413,1518,87670,89188,1.7,Washington,Washington
10628,June,2023,Grays Harbor,WA,Truck,7,0,7,20684,20691,0.03,Washington,Washington
10629,June,2023,Kittitas,WA,Passenger,350,103,453,28878,29331,1.54,Washington,Washington
10634,June,2023,Chelan,WA,Truck,31,0,31,22830,22861,0.14,Washington,Washington
10635,June,2023,Whatcom,WA,Truck,58,0,58,42106,42164,0.14,Washington,Washington
10636,June,2023,Walla Walla,WA,Passenger,219,111,330,34992,35322,0.93,Washington,Washington
10637,June,2023,Clark,WA,Truck,97,0,97,80308,80405,0.12,Washington,Washington
10638,June,2023,Douglas,WA,Passenger,209,64,273,28488,28761,0.95,Washington,Washington
10642,June,2023,Yakima,WA,Truck,13,0,13,60023,60036,0.02,Washington,Washington
10643,June,2023,Okanogan,WA,Passenger,123,63,186,25802,25988,0.72,Washington,Washington
10649,June,2023,Chelan,WA,Passenger,637,162,799,53633,54432,1.47,Washington,Washington
10653,June,2023,Thurston,WA,Passenger,3092,1222,4314,188101,192415,2.24,Washington,Washington
10654,June,2023,Klickitat,WA,Truck,12,0,12,8137,8149,0.15,Washington,Washington
10656,June,2023,Grant,WA,Truck,11,0,11,27666,27677,0.04,Washington,Washington
10659,June,2023,Whitman,WA,Passenger,150,79,229,21790,22019,1.04,Washington,Washington
10664,June,2023,King,WA,Passenger,56981,14563,71544,1312113,1383657,5.17,Washington,Washington
10665,June,2023,King,WA,Truck,723,2,725,173265,173990,0.42,Washington,Washington
10670,June,2023,Asotin,WA,Passenger,35,22,57,12311,12368,0.46,Washington,Washington
10671,June,2023,Klickitat,WA,Passenger,151,63,214,14939,15153,1.41,Washington,Washington
10673,June,2023,Cowlitz,WA,Passenger,470,215,685,68949,69634,0.98,Washington,Washington
10676,March,2017,Pacific,WA,Passenger,6,8,14,15078,15092,0.09,Washington,Washington
10677,March,2017,Kittitas,WA,Passenger,17,16,33,27117,27150,0.12,Washington,Washington
10679,March,2017,Lincoln,WA,Truck,0,0,0,4469,4469,0.0,Washington,Washington
10681,March,2017,Skagit,WA,Truck,1,0,1,31426,31427,0.0,Washington,Washington
10690,March,2017,Yakima,WA,Passenger,36,50,86,159228,159314,0.05,Washington,Washington
10692,March,2017,Wahkiakum,WA,Passenger,0,2,2,2849,2851,0.07,Washington,Washington
10693,March,2017,Pierce,WA,Passenger,876,784,1660,526368,528028,0.31,Washington,Washington
10695,March,2017,Pacific,WA,Truck,0,0,0,7480,7480,0.0,Washington,Washington
10698,March,2017,Yakima,WA,Truck,0,0,0,57266,57266,0.0,Washington,Washington
10709,March,2017,Grant,WA,Truck,0,0,0,25045,25045,0.0,Washington,Washington
10711,March,2017,Clallam,WA,Truck,0,0,0,21041,21041,0.0,Washington,Washington
10714,March,2017,Cowlitz,WA,Truck,0,0,0,27906,27906,0.0,Washington,Washington
10716,March,2017,Ferry,WA,Passenger,2,1,3,4386,4389,0.07,Washington,Washington
10719,March,2017,Kitsap,WA,Passenger,572,289,861,172480,173341,0.5,Washington,Washington
10721,March,2017,Spokane,WA,Passenger,232,202,434,295454,295888,0.15,Washington,Washington
10723,March,2017,Klickitat,WA,Passenger,21,23,44,14774,14818,0.3,Washington,Washington
10724,March,2017,Lewis,WA,Passenger,45,34,79,55095,55174,0.14,Washington,Washington
10725,March,2017,Douglas,WA,Passenger,29,19,48,26592,26640,0.18,Washington,Washington
10727,March,2017,Grant,WA,Passenger,17,21,38,60332,60370,0.06,Washington,Washington
10729,March,2017,Adams,WA,Truck,0,0,0,5070,5070,0.0,Washington,Washington
10730,March,2017,Mason,WA,Truck,0,0,0,19230,19230,0.0,Washington,Washington
10731,March,2017,Grays Harbor,WA,Truck,0,0,0,19865,19865,0.0,Washington,Washington
10734,March,2017,Asotin,WA,Truck,0,0,0,6511,6511,0.0,Washington,Washington
10735,March,2017,King,WA,Passenger,9317,3787,13104,1382738,1395842,0.94,Washington,Washington
10737,March,2017,Ferry,WA,Truck,0,0,0,3554,3554,0.0,Washington,Washington
10738,March,2017,San Juan,WA,Passenger,88,34,122,13420,13542,0.9,Washington,Washington
10739,March,2017,Columbia,WA,Truck,0,0,0,1529,1529,0.0,Washington,Washington
10743,March,2017,Pend Oreille,WA,Truck,0,0,0,5583,5583,0.0,Washington,Washington
10749,March,2017,Wahkiakum,WA,Truck,0,0,0,1635,1635,0.0,Washington,Washington
10750,March,2017,Clark,WA,Truck,0,0,0,77572,77572,0.0,Washington,Washington
10752,March,2017,Douglas,WA,Truck,0,0,0,11441,11441,0.0,Washington,Washington
10755,March,2017,Chelan,WA,Passenger,55,30,85,51678,51763,0.16,Washington,Washington
10758,March,2017,Benton,WA,Passenger,140,139,279,127941,128220,0.22,Washington,Washington
10761,March,2017,Jefferson,WA,Truck,0,0,0,9447,9447,0.0,Washington,Washington
10763,March,2017,Okanogan,WA,Truck,0,0,0,16304,16304,0.0,Washington,Washington
10764,March,2017,Stevens,WA,Passenger,6,20,26,31284,31310,0.08,Washington,Washington
10765,March,2017,Clallam,WA,Passenger,77,65,142,48078,48220,0.29,Washington,Washington
10767,March,2017,San Juan,WA,Truck,0,0,0,5583,5583,0.0,Washington,Washington
10768,March,2017,Whatcom,WA,Passenger,416,156,572,142234,142806,0.4,Washington,Washington
10773,March,2017,Island,WA,Truck,0,0,0,20500,20500,0.0,Washington,Washington
10774,March,2017,Okanogan,WA,Passenger,3,16,19,25642,25661,0.07,Washington,Washington
10777,March,2017,Chelan,WA,Truck,0,0,0,21220,21220,0.0,Washington,Washington
10778,March,2017,Grays Harbor,WA,Passenger,27,26,53,44419,44472,0.12,Washington,Washington
10779,March,2017,Franklin,WA,Truck,0,0,0,17960,17960,0.0,Washington,Washington
10781,March,2017,Whatcom,WA,Truck,2,0,2,41393,41395,0.0,Washington,Washington
10785,March,2017,Asotin,WA,Passenger,5,2,7,12335,12342,0.06,Washington,Washington
10786,March,2017,Benton,WA,Truck,0,0,0,39849,39849,0.0,Washington,Washington
10787,March,2017,Garfield,WA,Truck,0,0,0,940,940,0.0,Washington,Washington
10788,March,2017,Thurston,WA,Passenger,365,313,678,185430,186108,0.36,Washington,Washington
10791,March,2017,Clark,WA,Passenger,718,454,1172,298270,299442,0.39,Washington,Washington
10797,March,2017,Kittitas,WA,Truck,0,0,0,13423,13423,0.0,Washington,Washington
10798,March,2017,Thurston,WA,Truck,0,0,0,53299,53299,0.0,Washington,Washington
10799,March,2017,Pierce,WA,Truck,0,0,0,138175,138175,0.0,Washington,Washington
10800,March,2017,Whitman,WA,Passenger,9,18,27,21937,21964,0.12,Washington,Washington
10804,March,2017,Adams,WA,Passenger,2,4,6,12107,12113,0.05,Washington,Washington
10806,March,2017,Skagit,WA,Passenger,118,91,209,87516,87725,0.24,Washington,Washington
10808,March,2017,Snohomish,WA,Truck,1,0,1,122199,122200,0.0,Washington,Washington
10813,March,2017,Walla Walla,WA,Truck,0,0,0,13186,13186,0.0,Washington,Washington
10814,March,2017,Klickitat,WA,Truck,0,0,0,7941,7941,0.0,Washington,Washington
10816,March,2017,Snohomish,WA,Passenger,1656,849,2505,513393,515898,0.49,Washington,Washington
10817,March,2017,Stevens,WA,Truck,0,0,0,18309,18309,0.0,Washington,Washington
10821,March,2017,King,WA,Truck,8,1,9,189758,189767,0.0,Washington,Washington
10822,March,2017,Walla Walla,WA,Passenger,20,22,42,34821,34863,0.12,Washington,Washington
10827,March,2017,Franklin,WA,Passenger,26,47,73,55311,55384,0.13,Washington,Washington
10828,March,2017,Skamania,WA,Passenger,8,8,16,8529,8545,0.19,Washington,Washington
10829,March,2017,Garfield,WA,Passenger,0,0,0,1283,1283,0.0,Washington,Washington
10831,March,2017,Pend Oreille,WA,Passenger,1,4,5,9307,9312,0.05,Washington,Washington
10833,March,2017,Whitman,WA,Truck,0,0,0,8389,8389,0.0,Washington,Washington
10841,March,2017,Columbia,WA,Passenger,0,1,1,2355,2356,0.04,Washington,Washington
10842,March,2017,Island,WA,Passenger,105,129,234,59602,59836,0.39,Washington,Washington
10844,March,2017,Lincoln,WA,Passenger,2,4,6,7506,7512,0.08,Washington,Washington
10846,March,2017,Cowlitz,WA,Passenger,51,48,99,69297,69396,0.14,Washington,Washington
10850,March,2017,Jefferson,WA,Passenger,94,57,151,23648,23799,0.63,Washington,Washington
10852,March,2017,Mason,WA,Passenger,50,65,115,42929,43044,0.27,Washington,Washington
10853,March,2017,Kitsap,WA,Truck,1,0,1,52317,52318,0.0,Washington,Washington
10855,March,2017,Lewis,WA,Truck,0,0,0,24813,24813,0.0,Washington,Washington
10856,March,2017,Spokane,WA,Truck,1,0,1,90256,90257,0.0,Washington,Washington
10857,March,2017,Skamania,WA,Truck,0,0,0,3882,3882,0.0,Washington,Washington
10860,March,2018,Kittitas,WA,Truck,0,0,0,13984,13984,0.0,Washington,Washington
10861,March,2018,Thurston,WA,Passenger,518,432,950,191158,192108,0.49,Washington,Washington
10864,March,2018,Pend Oreille,WA,Passenger,4,3,7,9455,9462,0.07,Washington,Washington
10867,March,2018,Okanogan,WA,Truck,0,0,0,16333,16333,0.0,Washington,Washington
10868,March,2018,Chelan,WA,Truck,0,0,0,21720,21720,0.0,Washington,Washington
10871,March,2018,Cowlitz,WA,Truck,0,0,0,28271,28271,0.0,Washington,Washington
10874,March,2018,Cowlitz,WA,Passenger,55,70,125,71222,71347,0.18,Washington,Washington
10875,March,2018,Stevens,WA,Truck,0,0,0,18427,18427,0.0,Washington,Washington
10876,March,2018,Whatcom,WA,Truck,2,0,2,42069,42071,0.0,Washington,Washington
10878,March,2018,Pierce,WA,Passenger,1126,1053,2179,527857,530036,0.41,Washington,Washington
10881,March,2018,Ferry,WA,Passenger,1,3,4,4404,4408,0.09,Washington,Washington
10882,March,2018,Walla Walla,WA,Truck,0,0,0,13311,13311,0.0,Washington,Washington
10883,March,2018,Pierce,WA,Truck,0,0,0,137102,137102,0.0,Washington,Washington
10884,March,2018,Lewis,WA,Truck,0,0,0,25255,25255,0.0,Washington,Washington
10888,March,2018,Ferry,WA,Truck,0,0,0,3504,3504,0.0,Washington,Washington
10892,March,2018,Douglas,WA,Passenger,42,33,75,27415,27490,0.27,Washington,Washington
10895,March,2018,Jefferson,WA,Passenger,132,88,220,24289,24509,0.9,Washington,Washington
10900,March,2018,Columbia,WA,Truck,0,0,0,1532,1532,0.0,Washington,Washington
10902,March,2018,Kittitas,WA,Passenger,40,30,70,28748,28818,0.24,Washington,Washington
10903,March,2018,Clark,WA,Truck,0,0,0,78628,78628,0.0,Washington,Washington
10906,March,2018,Garfield,WA,Truck,0,0,0,952,952,0.0,Washington,Washington
10908,March,2018,Asotin,WA,Passenger,8,5,13,12627,12640,0.1,Washington,Washington
10912,March,2018,Clallam,WA,Truck,0,0,0,21314,21314,0.0,Washington,Washington
10915,March,2018,Columbia,WA,Passenger,2,1,3,2409,2412,0.12,Washington,Washington
10917,March,2018,Whatcom,WA,Passenger,574,260,834,146117,146951,0.57,Washington,Washington
10919,March,2018,Whitman,WA,Passenger,18,23,41,22489,22530,0.18,Washington,Washington
10920,March,2018,Pend Oreille,WA,Truck,0,0,0,5658,5658,0.0,Washington,Washington
10922,March,2018,Klickitat,WA,Passenger,25,27,52,14973,15025,0.35,Washington,Washington
10923,March,2018,Skamania,WA,Passenger,12,8,20,8667,8687,0.23,Washington,Washington
10924,March,2018,Walla Walla,WA,Passenger,32,36,68,35462,35530,0.19,Washington,Washington
10925,March,2018,Douglas,WA,Truck,0,0,0,11857,11857,0.0,Washington,Washington
10927,March,2018,Yakima,WA,Truck,0,0,0,58175,58175,0.0,Washington,Washington
10930,March,2018,Pacific,WA,Truck,0,0,0,7577,7577,0.0,Washington,Washington
10937,March,2018,Yakima,WA,Passenger,63,81,144,162826,162970,0.09,Washington,Washington
10939,March,2018,King,WA,Truck,7,1,8,183718,183726,0.0,Washington,Washington
10942,March,2018,Island,WA,Truck,0,0,0,20857,20857,0.0,Washington,Washington
10949,March,2018,Mason,WA,Passenger,68,83,151,45217,45368,0.33,Washington,Washington
10950,March,2018,Skamania,WA,Truck,0,0,0,3925,3925,0.0,Washington,Washington
10951,March,2018,Adams,WA,Truck,0,0,0,5152,5152,0.0,Washington,Washington
10955,March,2018,Chelan,WA,Passenger,96,41,137,53348,53485,0.26,Washington,Washington
10958,March,2018,Lincoln,WA,Truck,0,0,0,4515,4515,0.0,Washington,Washington
10960,March,2018,Franklin,WA,Passenger,34,55,89,57213,57302,0.16,Washington,Washington
10961,March,2018,King,WA,Passenger,11972,5152,17124,1367947,1385071,1.24,Washington,Washington
10963,March,2018,Pacific,WA,Passenger,15,18,33,15463,15496,0.21,Washington,Washington
10964,March,2018,Klickitat,WA,Truck,0,0,0,8045,8045,0.0,Washington,Washington
10966,March,2018,San Juan,WA,Passenger,140,50,190,13939,14129,1.34,Washington,Washington
10969,March,2018,Kitsap,WA,Truck,1,0,1,52964,52965,0.0,Washington,Washington
10972,March,2018,Garfield,WA,Passenger,1,0,1,1330,1331,0.08,Washington,Washington
10976,March,2018,Spokane,WA,Truck,1,0,1,91900,91901,0.0,Washington,Washington
10980,March,2018,Grant,WA,Truck,0,0,0,25746,25746,0.0,Washington,Washington
10981,March,2018,Jefferson,WA,Truck,0,0,0,9515,9515,0.0,Washington,Washington
10982,March,2018,Snohomish,WA,Truck,1,0,1,121231,121232,0.0,Washington,Washington
10983,March,2018,San Juan,WA,Truck,0,0,0,5658,5658,0.0,Washington,Washington
10985,March,2018,Grays Harbor,WA,Truck,0,0,0,20078,20078,0.0,Washington,Washington
10986,March,2018,Asotin,WA,Truck,0,0,0,6593,6593,0.0,Washington,Washington
10987,March,2018,Grant,WA,Passenger,32,42,74,62599,62673,0.12,Washington,Washington
10988,March,2018,Mason,WA,Truck,0,0,0,19793,19793,0.0,Washington,Washington
10990,March,2018,Lincoln,WA,Passenger,2,5,7,7578,7585,0.09,Washington,Washington
10994,March,2018,Stevens,WA,Passenger,9,21,30,31603,31633,0.09,Washington,Washington
11001,March,2018,Grays Harbor,WA,Passenger,45,46,91,46091,46182,0.2,Washington,Washington
11004,March,2018,Lewis,WA,Passenger,55,47,102,57151,57253,0.18,Washington,Washington
11008,March,2018,Kitsap,WA,Passenger,740,428,1168,176885,178053,0.66,Washington,Washington
11009,March,2018,Snohomish,WA,Passenger,2133,1159,3292,517925,521217,0.63,Washington,Washington
11015,March,2018,Okanogan,WA,Passenger,7,19,26,25733,25759,0.1,Washington,Washington
11021,March,2018,Skagit,WA,Passenger,173,154,327,89895,90222,0.36,Washington,Washington
11022,March,2018,Clark,WA,Passenger,918,641,1559,306002,307561,0.51,Washington,Washington
11024,March,2018,Franklin,WA,Truck,0,0,0,18617,18617,0.0,Washington,Washington
11025,March,2018,Skagit,WA,Truck,1,0,1,31922,31923,0.0,Washington,Washington
11028,March,2018,Benton,WA,Passenger,176,187,363,130785,131148,0.28,Washington,Washington
11030,March,2018,Benton,WA,Truck,0,0,0,40794,40794,0.0,Washington,Washington
11031,March,2018,Island,WA,Passenger,175,178,353,62057,62410,0.57,Washington,Washington
11032,March,2018,Wahkiakum,WA,Passenger,1,2,3,2871,2874,0.1,Washington,Washington
11038,March,2018,Adams,WA,Passenger,5,4,9,12470,12479,0.07,Washington,Washington
11039,March,2018,Spokane,WA,Passenger,304,273,577,301278,301855,0.19,Washington,Washington
11042,March,2018,Whitman,WA,Truck,0,0,0,8453,8453,0.0,Washington,Washington
11048,March,2018,Clallam,WA,Passenger,119,104,223,49504,49727,0.45,Washington,Washington
11049,March,2018,Thurston,WA,Truck,0,0,0,54007,54007,0.0,Washington,Washington
11052,March,2018,Wahkiakum,WA,Truck,0,0,0,1668,1668,0.0,Washington,Washington
11053,March,2019,Douglas,WA,Truck,0,0,0,12157,12157,0.0,Washington,Washington
11061,March,2019,Grays Harbor,WA,Passenger,69,80,149,47589,47738,0.31,Washington,Washington
11067,March,2019,Clark,WA,Truck,0,0,0,79992,79992,0.0,Washington,Washington
11080,March,2019,Wahkiakum,WA,Passenger,1,1,2,3008,3010,0.07,Washington,Washington
11081,March,2019,Jefferson,WA,Passenger,179,118,297,24880,25177,1.18,Washington,Washington
11087,March,2019,Chelan,WA,Passenger,144,67,211,54156,54367,0.39,Washington,Washington
11088,March,2019,Snohomish,WA,Passenger,3195,1519,4714,527994,532708,0.88,Washington,Washington
11091,March,2019,Clallam,WA,Truck,0,0,0,21617,21617,0.0,Washington,Washington
11092,March,2019,Columbia,WA,Truck,0,0,0,1527,1527,0.0,Washington,Washington
11093,March,2019,Lewis,WA,Truck,0,0,0,25755,25755,0.0,Washington,Washington
11096,March,2019,King,WA,Truck,6,1,7,181762,181769,0.0,Washington,Washington
11097,March,2019,Clark,WA,Passenger,1358,881,2239,311974,314213,0.71,Washington,Washington
11100,March,2019,Garfield,WA,Passenger,1,1,2,1310,1312,0.15,Washington,Washington
11103,March,2019,Whatcom,WA,Truck,2,0,2,42724,42726,0.0,Washington,Washington
11104,March,2019,Stevens,WA,Passenger,18,27,45,31632,31677,0.14,Washington,Washington
11108,March,2019,Snohomish,WA,Truck,1,0,1,121910,121911,0.0,Washington,Washington
11109,March,2019,Skagit,WA,Truck,1,0,1,32255,32256,0.0,Washington,Washington
11110,March,2019,Pacific,WA,Passenger,23,26,49,15850,15899,0.31,Washington,Washington
11114,March,2019,Chelan,WA,Truck,0,0,0,22127,22127,0.0,Washington,Washington
11115,March,2019,Benton,WA,Truck,0,0,0,41532,41532,0.0,Washington,Washington
11116,March,2019,Thurston,WA,Passenger,802,598,1400,196182,197582,0.71,Washington,Washington
11118,March,2019,Walla Walla,WA,Passenger,44,56,100,36067,36167,0.28,Washington,Washington
11121,March,2019,Yakima,WA,Passenger,89,102,191,164203,164394,0.12,Washington,Washington
11122,March,2019,Pend Oreille,WA,Truck,0,0,0,5721,5721,0.0,Washington,Washington
11124,March,2019,Walla Walla,WA,Truck,0,0,0,13552,13552,0.0,Washington,Washington
11132,March,2019,Kitsap,WA,Truck,1,0,1,53744,53745,0.0,Washington,Washington
11134,March,2019,Kittitas,WA,Truck,0,0,0,14249,14249,0.0,Washington,Washington
11140,March,2019,Columbia,WA,Passenger,2,2,4,2427,2431,0.16,Washington,Washington
11142,March,2019,Okanogan,WA,Passenger,20,21,41,25907,25948,0.16,Washington,Washington
11143,March,2019,Island,WA,Truck,0,0,0,21186,21186,0.0,Washington,Washington
11145,March,2019,Ferry,WA,Passenger,3,2,5,4362,4367,0.11,Washington,Washington
11147,March,2019,Klickitat,WA,Truck,0,0,0,8207,8207,0.0,Washington,Washington
11153,March,2019,Skamania,WA,Truck,0,0,0,4017,4017,0.0,Washington,Washington
11157,March,2019,Island,WA,Passenger,300,234,534,63126,63660,0.84,Washington,Washington
11160,March,2019,Asotin,WA,Truck,0,0,0,6632,6632,0.0,Washington,Washington
11163,March,2019,Stevens,WA,Truck,0,0,0,18708,18708,0.0,Washington,Washington
11166,March,2019,San Juan,WA,Truck,0,0,0,5811,5811,0.0,Washington,Washington
11169,March,2019,Wahkiakum,WA,Truck,0,0,0,1725,1725,0.0,Washington,Washington
11173,March,2019,Spokane,WA,Truck,1,0,1,94016,94017,0.0,Washington,Washington
11178,March,2019,Jefferson,WA,Truck,0,0,0,9645,9645,0.0,Washington,Washington
11179,March,2019,Lincoln,WA,Truck,0,0,0,4683,4683,0.0,Washington,Washington
11181,March,2019,Thurston,WA,Truck,0,0,0,54948,54948,0.0,Washington,Washington
11182,March,2019,Klickitat,WA,Passenger,32,31,63,15424,15487,0.41,Washington,Washington
11183,March,2019,King,WA,Passenger,17678,6779,24457,1381383,1405840,1.74,Washington,Washington
11184,March,2019,Skagit,WA,Passenger,281,189,470,91327,91797,0.51,Washington,Washington
11190,March,2019,Whitman,WA,Truck,0,0,0,8502,8502,0.0,Washington,Washington
11192,March,2019,Adams,WA,Truck,0,0,0,5105,5105,0.0,Washington,Washington
11194,March,2019,Whatcom,WA,Passenger,792,386,1178,149745,150923,0.78,Washington,Washington
11201,March,2019,Lincoln,WA,Passenger,3,6,9,7733,7742,0.12,Washington,Washington
11204,March,2019,Franklin,WA,Passenger,52,68,120,59371,59491,0.2,Washington,Washington
11205,March,2019,Benton,WA,Passenger,236,251,487,132992,133479,0.36,Washington,Washington
11206,March,2019,Kittitas,WA,Passenger,71,37,108,29440,29548,0.37,Washington,Washington
11207,March,2019,Pierce,WA,Passenger,1635,1457,3092,539431,542523,0.57,Washington,Washington
11210,March,2019,Spokane,WA,Passenger,491,393,884,307777,308661,0.29,Washington,Washington
11212,March,2019,Asotin,WA,Passenger,12,9,21,12660,12681,0.17,Washington,Washington
11214,March,2019,Clallam,WA,Passenger,154,129,283,50317,50600,0.56,Washington,Washington
11218,March,2019,Okanogan,WA,Truck,0,0,0,16439,16439,0.0,Washington,Washington
11223,March,2019,Kitsap,WA,Passenger,997,569,1566,179919,181485,0.86,Washington,Washington
11224,March,2019,Grant,WA,Passenger,34,55,89,64210,64299,0.14,Washington,Washington
11225,March,2019,Douglas,WA,Passenger,53,34,87,27889,27976,0.31,Washington,Washington
11229,March,2019,Mason,WA,Truck,0,0,0,20274,20274,0.0,Washington,Washington
11232,March,2019,Yakima,WA,Truck,0,0,0,58746,58746,0.0,Washington,Washington
11234,March,2019,Pacific,WA,Truck,0,0,0,7655,7655,0.0,Washington,Washington
11236,March,2019,Grays Harbor,WA,Truck,0,0,0,20376,20376,0.0,Washington,Washington
11241,March,2019,Cowlitz,WA,Passenger,84,101,185,72544,72729,0.25,Washington,Washington
11242,March,2019,Skamania,WA,Passenger,21,15,36,8722,8758,0.41,Washington,Washington
11247,March,2019,San Juan,WA,Passenger,197,70,267,14290,14557,1.83,Washington,Washington
11252,March,2019,Garfield,WA,Truck,0,0,0,954,954,0.0,Washington,Washington
11253,March,2019,Whitman,WA,Passenger,27,41,68,22715,22783,0.3,Washington,Washington
11260,March,2019,Pierce,WA,Truck,0,0,0,139004,139004,0.0,Washington,Washington
11262,March,2019,Adams,WA,Passenger,4,6,10,12632,12642,0.08,Washington,Washington
11263,March,2019,Grant,WA,Truck,0,0,0,26337,26337,0.0,Washington,Washington
11264,March,2019,Pend Oreille,WA,Passenger,5,5,10,9474,9484,0.11,Washington,Washington
11265,March,2019,Lewis,WA,Passenger,95,90,185,58524,58709,0.32,Washington,Washington
11268,March,2019,Ferry,WA,Truck,0,0,0,3594,3594,0.0,Washington,Washington
11269,March,2019,Franklin,WA,Truck,0,0,0,19136,19136,0.0,Washington,Washington
11270,March,2019,Mason,WA,Passenger,114,117,231,46714,46945,0.49,Washington,Washington
11272,March,2019,Cowlitz,WA,Truck,0,0,0,28781,28781,0.0,Washington,Washington
11279,March,2020,Douglas,WA,Truck,0,0,0,12333,12333,0.0,Washington,Washington
11281,March,2020,Adams,WA,Passenger,7,7,14,12891,12905,0.11,Washington,Washington
11283,March,2020,Walla Walla,WA,Passenger,68,63,131,36237,36368,0.36,Washington,Washington
11286,March,2020,Walla Walla,WA,Truck,0,0,0,13647,13647,0.0,Washington,Washington
11289,March,2020,Yakima,WA,Truck,0,0,0,59596,59596,0.0,Washington,Washington
11290,March,2020,Stevens,WA,Passenger,33,33,66,31263,31329,0.21,Washington,Washington
11296,March,2020,Cowlitz,WA,Truck,0,0,0,28852,28852,0.0,Washington,Washington
11299,March,2020,San Juan,WA,Truck,0,0,0,5932,5932,0.0,Washington,Washington
11302,March,2020,Mason,WA,Truck,0,0,0,20576,20576,0.0,Washington,Washington
11305,March,2020,Lewis,WA,Passenger,105,108,213,59209,59422,0.36,Washington,Washington
11307,March,2020,Skagit,WA,Truck,1,0,1,32552,32553,0.0,Washington,Washington
11308,March,2020,Skagit,WA,Passenger,391,216,607,92155,92762,0.65,Washington,Washington
11315,March,2020,Thurston,WA,Truck,0,0,0,55680,55680,0.0,Washington,Washington
11318,March,2020,Whatcom,WA,Truck,3,0,3,43025,43028,0.01,Washington,Washington
11324,March,2020,Ferry,WA,Passenger,5,3,8,4365,4373,0.18,Washington,Washington
11327,March,2020,Island,WA,Passenger,406,269,675,63248,63923,1.06,Washington,Washington
11330,March,2020,Grant,WA,Passenger,58,71,129,65493,65622,0.2,Washington,Washington
11336,March,2020,Lewis,WA,Truck,0,0,0,26030,26030,0.0,Washington,Washington
11338,March,2020,Spokane,WA,Passenger,704,473,1177,317986,319163,0.37,Washington,Washington
11339,March,2020,Kitsap,WA,Passenger,1297,674,1971,181797,183768,1.07,Washington,Washington
11342,March,2020,Clallam,WA,Truck,1,0,1,21817,21818,0.0,Washington,Washington
11346,March,2020,Pierce,WA,Truck,0,0,0,141601,141601,0.0,Washington,Washington
11349,March,2020,Wahkiakum,WA,Passenger,6,5,11,3006,3017,0.36,Washington,Washington
11351,March,2020,Mason,WA,Passenger,153,135,288,47512,47800,0.6,Washington,Washington
11354,March,2020,Whatcom,WA,Passenger,1057,490,1547,151217,152764,1.01,Washington,Washington
11355,March,2020,Snohomish,WA,Passenger,4370,1757,6127,537415,543542,1.13,Washington,Washington
11356,March,2020,Cowlitz,WA,Passenger,134,114,248,73167,73415,0.34,Washington,Washington
11358,March,2020,Thurston,WA,Passenger,1131,728,1859,198621,200480,0.93,Washington,Washington
11361,March,2020,Lincoln,WA,Truck,0,0,0,4659,4659,0.0,Washington,Washington
11373,March,2020,Columbia,WA,Truck,0,0,0,1533,1533,0.0,Washington,Washington
11374,March,2020,Jefferson,WA,Passenger,234,141,375,25071,25446,1.47,Washington,Washington
11377,March,2020,Pend Oreille,WA,Passenger,8,7,15,9369,9384,0.16,Washington,Washington
11378,March,2020,Snohomish,WA,Truck,0,0,0,123723,123723,0.0,Washington,Washington
11381,March,2020,Adams,WA,Truck,0,0,0,5219,5219,0.0,Washington,Washington
11383,March,2020,King,WA,Passenger,23884,7720,31604,1397089,1428693,2.21,Washington,Washington
11384,March,2020,Clark,WA,Truck,0,0,0,82047,82047,0.0,Washington,Washington
11386,March,2020,Franklin,WA,Passenger,58,77,135,61018,61153,0.22,Washington,Washington
11387,March,2020,Franklin,WA,Truck,0,0,0,19901,19901,0.0,Washington,Washington
11391,March,2020,Benton,WA,Truck,0,0,0,42519,42519,0.0,Washington,Washington
11400,March,2020,Garfield,WA,Truck,0,0,0,976,976,0.0,Washington,Washington
11407,March,2020,Klickitat,WA,Truck,0,0,0,8273,8273,0.0,Washington,Washington
11413,March,2020,Skamania,WA,Passenger,29,18,47,8716,8763,0.54,Washington,Washington
11416,March,2020,Grays Harbor,WA,Passenger,107,109,216,48321,48537,0.45,Washington,Washington
11418,March,2020,Kittitas,WA,Truck,0,0,0,14621,14621,0.0,Washington,Washington
11423,March,2020,Whitman,WA,Truck,0,0,0,8549,8549,0.0,Washington,Washington
11429,March,2020,Douglas,WA,Passenger,71,40,111,28174,28285,0.39,Washington,Washington
11430,March,2020,Benton,WA,Passenger,344,319,663,135166,135829,0.49,Washington,Washington
11431,March,2020,Asotin,WA,Passenger,16,12,28,12596,12624,0.22,Washington,Washington
11432,March,2020,Pacific,WA,Passenger,29,34,63,16025,16088,0.39,Washington,Washington
11436,March,2020,Kitsap,WA,Truck,1,0,1,54213,54214,0.0,Washington,Washington
11437,March,2020,Pierce,WA,Passenger,2310,1693,4003,551180,555183,0.72,Washington,Washington
11439,March,2020,Skamania,WA,Truck,0,0,0,4082,4082,0.0,Washington,Washington
11444,March,2020,Pend Oreille,WA,Truck,0,0,0,5757,5757,0.0,Washington,Washington
11445,March,2020,San Juan,WA,Passenger,291,86,377,14281,14658,2.57,Washington,Washington
11446,March,2020,Island,WA,Truck,1,0,1,21265,21266,0.0,Washington,Washington
11447,March,2020,Okanogan,WA,Passenger,34,31,65,26068,26133,0.25,Washington,Washington
11453,March,2020,Lincoln,WA,Passenger,2,12,14,7750,7764,0.18,Washington,Washington
11454,March,2020,Garfield,WA,Passenger,0,1,1,1350,1351,0.07,Washington,Washington
11456,March,2020,Grant,WA,Truck,0,0,0,27056,27056,0.0,Washington,Washington
11461,March,2020,Klickitat,WA,Passenger,51,41,92,15597,15689,0.59,Washington,Washington
11464,March,2020,Asotin,WA,Truck,0,0,0,6667,6667,0.0,Washington,Washington
11469,March,2020,Chelan,WA,Truck,0,0,0,22551,22551,0.0,Washington,Washington
11471,March,2020,Ferry,WA,Truck,0,0,0,3565,3565,0.0,Washington,Washington
11474,March,2020,Chelan,WA,Passenger,220,79,299,54482,54781,0.55,Washington,Washington
11475,March,2020,Columbia,WA,Passenger,3,3,6,2416,2422,0.25,Washington,Washington
11478,March,2020,Stevens,WA,Truck,0,0,0,18700,18700,0.0,Washington,Washington
11482,March,2020,Spokane,WA,Truck,1,0,1,97458,97459,0.0,Washington,Washington
11484,March,2020,Whitman,WA,Passenger,42,46,88,22485,22573,0.39,Washington,Washington
11487,March,2020,Wahkiakum,WA,Truck,0,0,0,1760,1760,0.0,Washington,Washington
11488,March,2020,Pacific,WA,Truck,0,0,0,7711,7711,0.0,Washington,Washington
11490,March,2020,Kittitas,WA,Passenger,98,49,147,29998,30145,0.49,Washington,Washington
11492,March,2020,Okanogan,WA,Truck,0,0,0,16458,16458,0.0,Washington,Washington
11495,March,2020,Clallam,WA,Passenger,214,166,380,50661,51041,0.74,Washington,Washington
11498,March,2020,Clark,WA,Passenger,1983,1061,3044,320288,323332,0.94,Washington,Washington
11500,March,2020,Yakima,WA,Passenger,124,116,240,165838,166078,0.14,Washington,Washington
11505,March,2020,Grays Harbor,WA,Truck,0,0,0,20787,20787,0.0,Washington,Washington
11509,March,2020,Jefferson,WA,Truck,0,0,0,9594,9594,0.0,Washington,Washington
11510,March,2020,King,WA,Truck,5,1,6,182420,182426,0.0,Washington,Washington
11519,March,2021,Clallam,WA,Truck,1,0,1,21955,21956,0.0,Washington,Washington
11520,March,2021,Skagit,WA,Truck,1,0,1,32932,32933,0.0,Washington,Washington
11527,March,2021,Yakima,WA,Passenger,188,135,323,168230,168553,0.19,Washington,Washington
11528,March,2021,Pacific,WA,Passenger,39,40,79,15920,15999,0.49,Washington,Washington
11529,March,2021,Pacific,WA,Truck,0,0,0,7879,7879,0.0,Washington,Washington
11532,March,2021,San Juan,WA,Passenger,394,123,517,14117,14634,3.53,Washington,Washington
11538,March,2021,Whatcom,WA,Truck,4,0,4,43783,43787,0.01,Washington,Washington
11545,March,2021,Lewis,WA,Passenger,130,134,264,59293,59557,0.44,Washington,Washington
11547,March,2021,Ferry,WA,Truck,0,0,0,3623,3623,0.0,Washington,Washington
11550,March,2021,Thurston,WA,Passenger,1432,824,2256,197465,199721,1.13,Washington,Washington
11554,March,2021,Chelan,WA,Passenger,304,94,398,54537,54935,0.72,Washington,Washington
11555,March,2021,Kittitas,WA,Passenger,146,55,201,29891,30092,0.67,Washington,Washington
11558,March,2021,Klickitat,WA,Truck,0,0,0,8173,8173,0.0,Washington,Washington
11563,March,2021,Island,WA,Truck,0,0,0,21460,21460,0.0,Washington,Washington
11567,March,2021,Grant,WA,Truck,0,0,0,27760,27760,0.0,Washington,Washington
11568,March,2021,Kitsap,WA,Truck,0,0,0,54392,54392,0.0,Washington,Washington
11569,March,2021,Jefferson,WA,Truck,0,0,0,9591,9591,0.0,Washington,Washington
11571,March,2021,King,WA,Passenger,28522,8567,37089,1365152,1402241,2.64,Washington,Washington
11573,March,2021,Snohomish,WA,Passenger,5384,1931,7315,538886,546201,1.34,Washington,Washington
11578,March,2021,Walla Walla,WA,Truck,0,0,0,13966,13966,0.0,Washington,Washington
11579,March,2021,Skamania,WA,Truck,0,0,0,4027,4027,0.0,Washington,Washington
11585,March,2021,Ferry,WA,Passenger,10,3,13,4349,4362,0.3,Washington,Washington
11586,March,2021,Grays Harbor,WA,Passenger,150,131,281,49026,49307,0.57,Washington,Washington
11592,March,2021,Walla Walla,WA,Passenger,107,72,179,36286,36465,0.49,Washington,Washington
11595,March,2021,Mason,WA,Truck,0,0,0,21168,21168,0.0,Washington,Washington
11596,March,2021,Yakima,WA,Truck,0,0,0,61384,61384,0.0,Washington,Washington
11597,March,2021,Kittitas,WA,Truck,0,0,0,14757,14757,0.0,Washington,Washington
11599,March,2021,Douglas,WA,Truck,0,0,0,12557,12557,0.0,Washington,Washington
11601,March,2021,Kitsap,WA,Passenger,1675,800,2475,179749,182224,1.36,Washington,Washington
11602,March,2021,Adams,WA,Truck,0,0,0,5375,5375,0.0,Washington,Washington
11610,March,2021,Franklin,WA,Truck,0,0,0,20608,20608,0.0,Washington,Washington
11612,March,2021,Spokane,WA,Truck,0,0,0,101439,101439,0.0,Washington,Washington
11613,March,2021,Okanogan,WA,Truck,0,0,0,16672,16672,0.0,Washington,Washington
11614,March,2021,Garfield,WA,Truck,0,0,0,1012,1012,0.0,Washington,Washington
11620,March,2021,Snohomish,WA,Truck,1,0,1,125936,125937,0.0,Washington,Washington
11627,March,2021,Clark,WA,Truck,0,0,0,83850,83850,0.0,Washington,Washington
11628,March,2021,Lincoln,WA,Passenger,5,13,18,7691,7709,0.23,Washington,Washington
11629,March,2021,Cowlitz,WA,Truck,0,0,0,29052,29052,0.0,Washington,Washington
11632,March,2021,Skagit,WA,Passenger,539,260,799,91602,92401,0.86,Washington,Washington
11633,March,2021,Clallam,WA,Passenger,299,199,498,50123,50621,0.98,Washington,Washington
11638,March,2021,Island,WA,Passenger,556,299,855,63006,63861,1.34,Washington,Washington
11640,March,2021,Whitman,WA,Truck,0,0,0,8553,8553,0.0,Washington,Washington
11641,March,2021,Lewis,WA,Truck,0,0,0,26811,26811,0.0,Washington,Washington
11649,March,2021,Jefferson,WA,Passenger,302,174,476,24829,25305,1.88,Washington,Washington
11654,March,2021,Wahkiakum,WA,Truck,0,0,0,1788,1788,0.0,Washington,Washington
11656,March,2021,Franklin,WA,Passenger,100,88,188,61668,61856,0.3,Washington,Washington
11658,March,2021,Douglas,WA,Passenger,86,47,133,28378,28511,0.47,Washington,Washington
11667,March,2021,San Juan,WA,Truck,0,0,0,5885,5885,0.0,Washington,Washington
11669,March,2021,Stevens,WA,Truck,0,0,0,18796,18796,0.0,Washington,Washington
11670,March,2021,King,WA,Truck,6,1,7,184559,184566,0.0,Washington,Washington
11675,March,2021,Whatcom,WA,Passenger,1298,576,1874,150446,152320,1.23,Washington,Washington
11677,March,2021,Grant,WA,Passenger,93,87,180,66441,66621,0.27,Washington,Washington
11681,March,2021,Thurston,WA,Truck,0,0,0,56530,56530,0.0,Washington,Washington
11682,March,2021,Wahkiakum,WA,Passenger,9,7,16,3083,3099,0.52,Washington,Washington
11683,March,2021,Pierce,WA,Passenger,3126,1845,4971,556748,561719,0.88,Washington,Washington
11684,March,2021,Mason,WA,Passenger,185,137,322,47894,48216,0.67,Washington,Washington
11685,March,2021,Okanogan,WA,Passenger,57,35,92,26225,26317,0.35,Washington,Washington
11689,March,2021,Pierce,WA,Truck,0,0,0,145348,145348,0.0,Washington,Washington
11692,March,2021,Spokane,WA,Passenger,952,584,1536,322674,324210,0.47,Washington,Washington
11693,March,2021,Clark,WA,Passenger,2578,1276,3854,320028,323882,1.19,Washington,Washington
11694,March,2021,Chelan,WA,Truck,0,0,0,22987,22987,0.0,Washington,Washington
11699,March,2021,Columbia,WA,Passenger,5,4,9,2466,2475,0.36,Washington,Washington
11705,March,2021,Benton,WA,Passenger,466,369,835,135501,136336,0.61,Washington,Washington
11711,March,2021,Pend Oreille,WA,Truck,0,0,0,5724,5724,0.0,Washington,Washington
11714,March,2021,Cowlitz,WA,Passenger,197,133,330,72161,72491,0.46,Washington,Washington
11721,March,2021,Skamania,WA,Passenger,38,25,63,8308,8371,0.75,Washington,Washington
11723,March,2021,Asotin,WA,Truck,0,0,0,6725,6725,0.0,Washington,Washington
11729,March,2021,Lincoln,WA,Truck,0,0,0,4733,4733,0.0,Washington,Washington
11730,March,2021,Columbia,WA,Truck,0,0,0,1549,1549,0.0,Washington,Washington
11733,March,2021,Benton,WA,Truck,0,0,0,43534,43534,0.0,Washington,Washington
11735,March,2021,Stevens,WA,Passenger,38,43,81,30317,30398,0.27,Washington,Washington
11736,March,2021,Pend Oreille,WA,Passenger,12,6,18,9281,9299,0.19,Washington,Washington
11746,March,2021,Whitman,WA,Passenger,54,44,98,21932,22030,0.44,Washington,Washington
11747,March,2021,Garfield,WA,Passenger,0,2,2,1365,1367,0.15,Washington,Washington
11749,March,2021,Adams,WA,Passenger,10,7,17,12997,13014,0.13,Washington,Washington
11753,March,2021,Klickitat,WA,Passenger,65,46,111,15028,15139,0.73,Washington,Washington
11754,March,2021,Asotin,WA,Passenger,17,14,31,12569,12600,0.25,Washington,Washington
11757,March,2021,Grays Harbor,WA,Truck,0,0,0,21269,21269,0.0,Washington,Washington
11764,March,2022,Whatcom,WA,Truck,4,0,4,43546,43550,0.01,Washington,Washington
11766,March,2022,Cowlitz,WA,Passenger,293,172,465,71084,71549,0.65,Washington,Washington
11772,March,2022,Okanogan,WA,Passenger,77,46,123,26522,26645,0.46,Washington,Washington
11775,March,2022,Columbia,WA,Passenger,6,0,6,2448,2454,0.24,Washington,Washington
11780,March,2022,Skagit,WA,Passenger,731,326,1057,90496,91553,1.15,Washington,Washington
11787,March,2022,Kittitas,WA,Passenger,225,74,299,29794,30093,0.99,Washington,Washington
11795,March,2022,Pend Oreille,WA,Truck,0,0,0,5689,5689,0.0,Washington,Washington
11801,March,2022,Jefferson,WA,Passenger,408,207,615,24697,25312,2.43,Washington,Washington
11804,March,2022,Walla Walla,WA,Truck,0,0,0,14031,14031,0.0,Washington,Washington
11807,March,2022,Cowlitz,WA,Truck,0,1,1,28868,28869,0.0,Washington,Washington
11808,March,2022,Ferry,WA,Truck,0,0,0,3571,3571,0.0,Washington,Washington
11814,March,2022,Adams,WA,Truck,0,0,0,5488,5488,0.0,Washington,Washington
11815,March,2022,Thurston,WA,Truck,3,0,3,55747,55750,0.01,Washington,Washington
11816,March,2022,Clark,WA,Passenger,3744,1656,5400,318350,323750,1.67,Washington,Washington
11822,March,2022,Mason,WA,Passenger,286,171,457,47633,48090,0.95,Washington,Washington
11824,March,2022,Douglas,WA,Truck,0,0,0,12726,12726,0.0,Washington,Washington
11828,March,2022,Whitman,WA,Passenger,79,54,133,22044,22177,0.6,Washington,Washington
11831,March,2022,Pierce,WA,Passenger,4629,2234,6863,550172,557035,1.23,Washington,Washington
11833,March,2022,Clallam,WA,Truck,1,0,1,22058,22059,0.0,Washington,Washington
11843,March,2022,Asotin,WA,Truck,0,0,0,6757,6757,0.0,Washington,Washington
11848,March,2022,Benton,WA,Truck,1,0,1,43613,43614,0.0,Washington,Washington
11850,March,2022,Benton,WA,Passenger,698,444,1142,135765,136907,0.83,Washington,Washington
11858,March,2022,Walla Walla,WA,Passenger,157,91,248,36119,36367,0.68,Washington,Washington
11859,March,2022,Jefferson,WA,Truck,0,0,0,9544,9544,0.0,Washington,Washington
11862,March,2022,Grays Harbor,WA,Truck,0,0,0,21365,21365,0.0,Washington,Washington
11865,March,2022,Skamania,WA,Truck,0,0,0,3973,3973,0.0,Washington,Washington
11873,March,2022,Garfield,WA,Passenger,0,3,3,1332,1335,0.22,Washington,Washington
11876,March,2022,San Juan,WA,Passenger,492,152,644,14129,14773,4.36,Washington,Washington
11882,March,2022,Kittitas,WA,Truck,0,0,0,14720,14720,0.0,Washington,Washington
11886,March,2022,Lewis,WA,Passenger,226,164,390,59495,59885,0.65,Washington,Washington
11888,March,2022,Mason,WA,Truck,0,0,0,21168,21168,0.0,Washington,Washington
11894,March,2022,Columbia,WA,Truck,0,0,0,1589,1589,0.0,Washington,Washington
11901,March,2022,Stevens,WA,Truck,0,0,0,19002,19002,0.0,Washington,Washington
11908,March,2022,King,WA,Passenger,37937,10707,48644,1352308,1400952,3.47,Washington,Washington
11910,March,2022,Snohomish,WA,Passenger,7665,2362,10027,534917,544944,1.84,Washington,Washington
11911,March,2022,Lincoln,WA,Passenger,7,18,25,7668,7693,0.32,Washington,Washington
11913,March,2022,Island,WA,Passenger,758,360,1118,62387,63505,1.76,Washington,Washington
11914,March,2022,Ferry,WA,Passenger,17,3,20,4431,4451,0.45,Washington,Washington
11916,March,2022,Clallam,WA,Passenger,402,240,642,49973,50615,1.27,Washington,Washington
11923,March,2022,Klickitat,WA,Truck,0,0,0,8311,8311,0.0,Washington,Washington
11928,March,2022,Skagit,WA,Truck,1,0,1,32552,32553,0.0,Washington,Washington
11930,March,2022,San Juan,WA,Truck,1,0,1,5995,5996,0.02,Washington,Washington
11932,March,2022,Chelan,WA,Passenger,437,122,559,54596,55155,1.01,Washington,Washington
11933,March,2022,Grays Harbor,WA,Passenger,205,157,362,49309,49671,0.73,Washington,Washington
11934,March,2022,Klickitat,WA,Passenger,96,54,150,15336,15486,0.97,Washington,Washington
11936,March,2022,Pend Oreille,WA,Passenger,16,10,26,9051,9077,0.29,Washington,Washington
11940,March,2022,Franklin,WA,Passenger,179,106,285,62085,62370,0.46,Washington,Washington
11941,March,2022,Douglas,WA,Passenger,125,56,181,28528,28709,0.63,Washington,Washington
11944,March,2022,Clark,WA,Truck,2,0,2,83493,83495,0.0,Washington,Washington
11947,March,2022,Island,WA,Truck,1,0,1,21479,21480,0.0,Washington,Washington
11949,March,2022,Adams,WA,Passenger,16,11,27,12982,13009,0.21,Washington,Washington
11950,March,2022,Pacific,WA,Truck,0,0,0,8008,8008,0.0,Washington,Washington
11954,March,2022,Snohomish,WA,Truck,4,0,4,124827,124831,0.0,Washington,Washington
11959,March,2022,Wahkiakum,WA,Passenger,18,11,29,3077,3106,0.93,Washington,Washington
11961,March,2022,Whatcom,WA,Passenger,1735,695,2430,149237,151667,1.6,Washington,Washington
11964,March,2022,Garfield,WA,Truck,0,0,0,999,999,0.0,Washington,Washington
11966,March,2022,Grant,WA,Truck,0,0,0,28046,28046,0.0,Washington,Washington
11971,March,2022,Franklin,WA,Truck,0,0,0,20940,20940,0.0,Washington,Washington
11975,March,2022,Yakima,WA,Passenger,312,181,493,167703,168196,0.29,Washington,Washington
11977,March,2022,Spokane,WA,Truck,0,0,0,102463,102463,0.0,Washington,Washington
11983,March,2022,Pacific,WA,Passenger,61,68,129,15997,16126,0.8,Washington,Washington
11986,March,2022,Yakima,WA,Truck,0,0,0,61589,61589,0.0,Washington,Washington
11987,March,2022,Asotin,WA,Passenger,22,18,40,12658,12698,0.32,Washington,Washington
11990,March,2022,Kitsap,WA,Passenger,2274,1006,3280,179292,182572,1.8,Washington,Washington
11992,March,2022,Lewis,WA,Truck,0,0,0,26519,26519,0.0,Washington,Washington
11993,March,2022,Wahkiakum,WA,Truck,0,0,0,1814,1814,0.0,Washington,Washington
11994,March,2022,Skamania,WA,Passenger,65,45,110,8278,8388,1.31,Washington,Washington
11995,March,2022,Stevens,WA,Passenger,60,50,110,30089,30199,0.36,Washington,Washington
11996,March,2022,Thurston,WA,Passenger,2028,1000,3028,195451,198479,1.53,Washington,Washington
11998,March,2022,Whitman,WA,Truck,0,0,0,8588,8588,0.0,Washington,Washington
12000,March,2022,Chelan,WA,Truck,0,0,0,23048,23048,0.0,Washington,Washington
12003,March,2022,King,WA,Truck,25,1,26,182051,182077,0.01,Washington,Washington
12011,March,2022,Spokane,WA,Passenger,1443,799,2242,325888,328130,0.68,Washington,Washington
12013,March,2022,Grant,WA,Passenger,151,100,251,66866,67117,0.37,Washington,Washington
12014,March,2022,Lincoln,WA,Truck,0,0,0,4834,4834,0.0,Washington,Washington
12016,March,2022,Okanogan,WA,Truck,0,0,0,16693,16693,0.0,Washington,Washington
12018,March,2022,Pierce,WA,Truck,2,0,2,143506,143508,0.0,Washington,Washington
12019,March,2022,Kitsap,WA,Truck,1,0,1,53996,53997,0.0,Washington,Washington
12023,March,2023,Benton,WA,Passenger,1041,531,1572,135436,137008,1.15,Washington,Washington
12025,March,2023,Okanogan,WA,Passenger,114,58,172,26014,26186,0.66,Washington,Washington
12036,March,2023,Grant,WA,Truck,8,0,8,28019,28027,0.03,Washington,Washington
12038,March,2023,Kittitas,WA,Passenger,325,94,419,29410,29829,1.4,Washington,Washington
12044,March,2023,Lewis,WA,Passenger,295,191,486,58567,59053,0.82,Washington,Washington
12045,March,2023,Klickitat,WA,Truck,6,0,6,8273,8279,0.07,Washington,Washington
12047,March,2023,Snohomish,WA,Truck,134,0,134,121787,121921,0.11,Washington,Washington
12048,March,2023,Columbia,WA,Passenger,8,1,9,2416,2425,0.37,Washington,Washington
12050,March,2023,Walla Walla,WA,Passenger,209,112,321,35444,35765,0.9,Washington,Washington
12051,March,2023,Grant,WA,Passenger,253,113,366,66819,67185,0.54,Washington,Washington
12057,March,2023,Ferry,WA,Truck,0,0,0,3563,3563,0.0,Washington,Washington
12062,March,2023,Clallam,WA,Truck,17,0,17,21712,21729,0.08,Washington,Washington
12064,March,2023,Island,WA,Passenger,987,421,1408,61377,62785,2.24,Washington,Washington
12073,March,2023,Stevens,WA,Truck,2,0,2,18741,18743,0.01,Washington,Washington
12075,March,2023,Cowlitz,WA,Truck,7,0,7,28202,28209,0.02,Washington,Washington
12077,March,2023,King,WA,Truck,566,2,568,176388,176956,0.32,Washington,Washington
12080,March,2023,Chelan,WA,Truck,23,0,23,23105,23128,0.1,Washington,Washington
12083,March,2023,Adams,WA,Passenger,23,11,34,13010,13044,0.26,Washington,Washington
12087,March,2023,Cowlitz,WA,Passenger,433,195,628,69990,70618,0.89,Washington,Washington
12088,March,2023,Columbia,WA,Truck,0,0,0,1572,1572,0.0,Washington,Washington
12091,March,2023,Wahkiakum,WA,Passenger,25,16,41,3059,3100,1.32,Washington,Washington
12094,March,2023,Grays Harbor,WA,Truck,2,0,2,20979,20981,0.01,Washington,Washington
12095,March,2023,Franklin,WA,Truck,5,0,5,20848,20853,0.02,Washington,Washington
12096,March,2023,Douglas,WA,Passenger,181,59,240,28627,28867,0.83,Washington,Washington
12097,March,2023,Kittitas,WA,Truck,7,0,7,14530,14537,0.05,Washington,Washington
12098,March,2023,Skagit,WA,Truck,17,0,17,31985,32002,0.05,Washington,Washington
12100,March,2023,Grays Harbor,WA,Passenger,278,179,457,48396,48853,0.94,Washington,Washington
12101,March,2023,Skagit,WA,Passenger,1026,382,1408,88921,90329,1.56,Washington,Washington
12102,March,2023,Kitsap,WA,Truck,58,0,58,52601,52659,0.11,Washington,Washington
12103,March,2023,Garfield,WA,Truck,0,0,0,977,977,0.0,Washington,Washington
12104,March,2023,Pierce,WA,Passenger,6832,2624,9456,533215,542671,1.74,Washington,Washington
12108,March,2023,Spokane,WA,Passenger,2099,1005,3104,322078,325182,0.95,Washington,Washington
12110,March,2023,Adams,WA,Truck,2,0,2,5333,5335,0.04,Washington,Washington
12112,March,2023,Asotin,WA,Passenger,31,21,52,12420,12472,0.42,Washington,Washington
12114,March,2023,Whatcom,WA,Truck,48,0,48,42816,42864,0.11,Washington,Washington
12117,March,2023,Lincoln,WA,Truck,0,0,0,4848,4848,0.0,Washington,Washington
12118,March,2023,Clark,WA,Passenger,5285,2161,7446,313218,320664,2.32,Washington,Washington
12122,March,2023,Pacific,WA,Passenger,74,84,158,15627,15785,1.0,Washington,Washington
12124,March,2023,Skamania,WA,Passenger,95,53,148,8092,8240,1.8,Washington,Washington
12129,March,2023,Okanogan,WA,Truck,3,0,3,16460,16463,0.02,Washington,Washington
12132,March,2023,Mason,WA,Passenger,403,200,603,46356,46959,1.28,Washington,Washington
12143,March,2023,Pacific,WA,Truck,3,0,3,7805,7808,0.04,Washington,Washington
12144,March,2023,San Juan,WA,Passenger,596,172,768,13839,14607,5.26,Washington,Washington
12151,March,2023,Chelan,WA,Passenger,582,150,732,54135,54867,1.33,Washington,Washington
12152,March,2023,Garfield,WA,Passenger,1,3,4,1323,1327,0.3,Washington,Washington
12156,March,2023,Lewis,WA,Truck,5,0,5,26061,26066,0.02,Washington,Washington
12160,March,2023,Clark,WA,Truck,77,0,77,81356,81433,0.09,Washington,Washington
12161,March,2023,Island,WA,Truck,24,0,24,21070,21094,0.11,Washington,Washington
12167,March,2023,Yakima,WA,Truck,9,0,9,60996,61005,0.01,Washington,Washington
12169,March,2023,San Juan,WA,Truck,10,0,10,5884,5894,0.17,Washington,Washington
12170,March,2023,Thurston,WA,Passenger,2830,1176,4006,190713,194719,2.06,Washington,Washington
12171,March,2023,Ferry,WA,Passenger,19,4,23,4330,4353,0.53,Washington,Washington
12175,March,2023,Pend Oreille,WA,Passenger,28,13,41,8917,8958,0.46,Washington,Washington
12178,March,2023,Skamania,WA,Truck,1,0,1,3842,3843,0.03,Washington,Washington
12179,March,2023,Stevens,WA,Passenger,103,60,163,29814,29977,0.54,Washington,Washington
12180,March,2023,Klickitat,WA,Passenger,133,59,192,15155,15347,1.25,Washington,Washington
12184,March,2023,Mason,WA,Truck,11,0,11,20792,20803,0.05,Washington,Washington
12185,March,2023,Whitman,WA,Passenger,131,72,203,21998,22201,0.91,Washington,Washington
12186,March,2023,Snohomish,WA,Passenger,11288,2890,14178,528298,542476,2.61,Washington,Washington
12188,March,2023,Yakima,WA,Passenger,458,238,696,165666,166362,0.42,Washington,Washington
12194,March,2023,Benton,WA,Truck,16,0,16,43262,43278,0.04,Washington,Washington
12196,March,2023,Jefferson,WA,Passenger,522,247,769,24231,25000,3.08,Washington,Washington
12199,March,2023,Franklin,WA,Passenger,284,129,413,61766,62179,0.66,Washington,Washington
12202,March,2023,Clallam,WA,Passenger,507,275,782,49127,49909,1.57,Washington,Washington
12207,March,2023,Thurston,WA,Truck,52,0,52,54221,54273,0.1,Washington,Washington
12211,March,2023,Wahkiakum,WA,Truck,2,0,2,1779,1781,0.11,Washington,Washington
12215,March,2023,Asotin,WA,Truck,0,0,0,6642,6642,0.0,Washington,Washington
12218,March,2023,Whatcom,WA,Passenger,2264,837,3101,147416,150517,2.06,Washington,Washington
12224,March,2023,Lincoln,WA,Passenger,18,16,34,7696,7730,0.44,Washington,Washington
12225,March,2023,Spokane,WA,Truck,30,0,30,101755,101785,0.03,Washington,Washington
12226,March,2023,Pierce,WA,Truck,126,0,126,137873,137999,0.09,Washington,Washington
12233,March,2023,Kitsap,WA,Passenger,2952,1199,4151,176394,180545,2.3,Washington,Washington
12234,March,2023,Jefferson,WA,Truck,9,0,9,9314,9323,0.1,Washington,Washington
12237,March,2023,Pend Oreille,WA,Truck,0,0,0,5572,5572,0.0,Washington,Washington
12242,March,2023,King,WA,Passenger,51947,13141,65088,1321285,1386373,4.69,Washington,Washington
12247,March,2023,Whitman,WA,Truck,4,0,4,8597,8601,0.05,Washington,Washington
12249,March,2023,Walla Walla,WA,Truck,5,0,5,13756,13761,0.04,Washington,Washington
12250,March,2023,Douglas,WA,Truck,6,0,6,12871,12877,0.05,Washington,Washington
12251,May,2017,Thurston,WA,Passenger,390,334,724,186064,186788,0.39,Washington,Washington
12252,May,2017,Klickitat,WA,Passenger,22,24,46,14787,14833,0.31,Washington,Washington
12254,May,2017,Skamania,WA,Truck,0,0,0,3863,3863,0.0,Washington,Washington
12255,May,2017,King,WA,Passenger,9796,3990,13786,1377129,1390915,0.99,Washington,Washington
12258,May,2017,Walla Walla,WA,Truck,0,0,0,13189,13189,0.0,Washington,Washington
12260,May,2017,Chelan,WA,Truck,0,0,0,21248,21248,0.0,Washington,Washington
12262,May,2017,Garfield,WA,Passenger,0,0,0,1287,1287,0.0,Washington,Washington
12263,May,2017,Pacific,WA,Passenger,9,7,16,15138,15154,0.11,Washington,Washington
12264,May,2017,Pend Oreille,WA,Truck,0,0,0,5564,5564,0.0,Washington,Washington
12266,May,2017,Grays Harbor,WA,Truck,0,0,0,19898,19898,0.0,Washington,Washington
12267,May,2017,Grays Harbor,WA,Passenger,31,30,61,44516,44577,0.14,Washington,Washington
12271,May,2017,Adams,WA,Truck,0,0,0,5079,5079,0.0,Washington,Washington
12272,May,2017,Snohomish,WA,Passenger,1739,867,2606,512625,515231,0.51,Washington,Washington
12274,May,2017,Kitsap,WA,Passenger,595,302,897,172845,173742,0.52,Washington,Washington
12275,May,2017,Pacific,WA,Truck,0,0,0,7463,7463,0.0,Washington,Washington
12278,May,2017,Wahkiakum,WA,Passenger,0,2,2,2837,2839,0.07,Washington,Washington
12285,May,2017,Wahkiakum,WA,Truck,0,0,0,1643,1643,0.0,Washington,Washington
12287,May,2017,San Juan,WA,Truck,0,0,0,5541,5541,0.0,Washington,Washington
12288,May,2017,Lewis,WA,Passenger,49,33,82,55363,55445,0.15,Washington,Washington
12293,May,2017,Thurston,WA,Truck,0,0,0,53243,53243,0.0,Washington,Washington
12294,May,2017,Franklin,WA,Passenger,28,44,72,55459,55531,0.13,Washington,Washington
12297,May,2017,Clark,WA,Truck,0,0,0,77598,77598,0.0,Washington,Washington
12298,May,2017,Benton,WA,Passenger,146,142,288,128293,128581,0.22,Washington,Washington
12302,May,2017,Asotin,WA,Passenger,6,3,9,12376,12385,0.07,Washington,Washington
12304,May,2017,Stevens,WA,Truck,0,0,0,18254,18254,0.0,Washington,Washington
12306,May,2017,Ferry,WA,Truck,0,0,0,3544,3544,0.0,Washington,Washington
12308,May,2017,Skagit,WA,Passenger,134,102,236,87854,88090,0.27,Washington,Washington
12310,May,2017,Stevens,WA,Passenger,8,23,31,31329,31360,0.1,Washington,Washington
12311,May,2017,Columbia,WA,Passenger,0,1,1,2359,2360,0.04,Washington,Washington
12316,May,2017,Yakima,WA,Passenger,42,55,97,159375,159472,0.06,Washington,Washington
12318,May,2017,Lincoln,WA,Truck,0,0,0,4459,4459,0.0,Washington,Washington
12320,May,2017,Okanogan,WA,Truck,0,0,0,16215,16215,0.0,Washington,Washington
12324,May,2017,Pierce,WA,Truck,0,0,0,137682,137682,0.0,Washington,Washington
12325,May,2017,Benton,WA,Truck,0,0,0,39974,39974,0.0,Washington,Washington
12330,May,2017,Yakima,WA,Truck,0,0,0,57281,57281,0.0,Washington,Washington
12331,May,2017,Douglas,WA,Truck,0,0,0,11484,11484,0.0,Washington,Washington
12335,May,2017,Pend Oreille,WA,Passenger,2,4,6,9313,9319,0.06,Washington,Washington
12336,May,2017,Pierce,WA,Passenger,933,823,1756,525215,526971,0.33,Washington,Washington
12340,May,2017,Columbia,WA,Truck,0,0,0,1537,1537,0.0,Washington,Washington
12342,May,2017,Skamania,WA,Passenger,9,7,16,8532,8548,0.19,Washington,Washington
12343,May,2017,Mason,WA,Passenger,51,66,117,43298,43415,0.27,Washington,Washington
12346,May,2017,Kitsap,WA,Truck,1,0,1,52377,52378,0.0,Washington,Washington
12347,May,2017,Grant,WA,Truck,0,0,0,25222,25222,0.0,Washington,Washington
12348,May,2017,Klickitat,WA,Truck,0,0,0,7967,7967,0.0,Washington,Washington
12350,May,2017,Adams,WA,Passenger,2,3,5,12197,12202,0.04,Washington,Washington
12352,May,2017,Chelan,WA,Passenger,60,36,96,51875,51971,0.18,Washington,Washington
12356,May,2017,San Juan,WA,Passenger,104,38,142,13498,13640,1.04,Washington,Washington
12358,May,2017,Spokane,WA,Truck,1,0,1,90329,90330,0.0,Washington,Washington
12359,May,2017,Walla Walla,WA,Passenger,23,24,47,34853,34900,0.13,Washington,Washington
12360,May,2017,Cowlitz,WA,Truck,0,0,0,27873,27873,0.0,Washington,Washington
12361,May,2017,Whitman,WA,Passenger,10,20,30,21988,22018,0.14,Washington,Washington
12371,May,2017,Franklin,WA,Truck,0,0,0,18090,18090,0.0,Washington,Washington
12372,May,2017,Clark,WA,Passenger,770,489,1259,298797,300056,0.42,Washington,Washington
12374,May,2017,Kittitas,WA,Truck,0,0,0,13532,13532,0.0,Washington,Washington
12376,May,2017,Grant,WA,Passenger,20,25,45,60675,60720,0.07,Washington,Washington
12378,May,2017,Lewis,WA,Truck,0,0,0,24822,24822,0.0,Washington,Washington
12379,May,2017,Snohomish,WA,Truck,1,0,1,121865,121866,0.0,Washington,Washington
12380,May,2017,Jefferson,WA,Passenger,103,59,162,23819,23981,0.68,Washington,Washington
12385,May,2017,Skagit,WA,Truck,1,0,1,31389,31390,0.0,Washington,Washington
12386,May,2017,Island,WA,Passenger,113,129,242,59919,60161,0.4,Washington,Washington
12387,May,2017,Okanogan,WA,Passenger,3,16,19,25686,25705,0.07,Washington,Washington
12389,May,2017,Whatcom,WA,Truck,2,0,2,41518,41520,0.0,Washington,Washington
12393,May,2017,Whitman,WA,Truck,0,0,0,8394,8394,0.0,Washington,Washington
12397,May,2017,Kittitas,WA,Passenger,22,17,39,27357,27396,0.14,Washington,Washington
12400,May,2017,Lincoln,WA,Passenger,2,5,7,7507,7514,0.09,Washington,Washington
12402,May,2017,Douglas,WA,Passenger,32,23,55,26684,26739,0.21,Washington,Washington
12406,May,2017,Mason,WA,Truck,0,0,0,19265,19265,0.0,Washington,Washington
12409,May,2017,Cowlitz,WA,Passenger,52,50,102,69536,69638,0.15,Washington,Washington
12414,May,2017,King,WA,Truck,8,1,9,188266,188275,0.0,Washington,Washington
12415,May,2017,Asotin,WA,Truck,0,0,0,6491,6491,0.0,Washington,Washington
12416,May,2017,Jefferson,WA,Truck,0,0,0,9440,9440,0.0,Washington,Washington
12420,May,2017,Whatcom,WA,Passenger,455,167,622,142686,143308,0.43,Washington,Washington
12421,May,2017,Ferry,WA,Passenger,1,1,2,4409,4411,0.05,Washington,Washington
12425,May,2017,Spokane,WA,Passenger,245,211,456,296382,296838,0.15,Washington,Washington
12426,May,2017,Clallam,WA,Passenger,84,74,158,48203,48361,0.33,Washington,Washington
12428,May,2017,Island,WA,Truck,0,0,0,20531,20531,0.0,Washington,Washington
12429,May,2017,Clallam,WA,Truck,0,0,0,20959,20959,0.0,Washington,Washington
12436,May,2017,Garfield,WA,Truck,0,0,0,932,932,0.0,Washington,Washington
12439,May,2018,Wahkiakum,WA,Truck,0,0,0,1674,1674,0.0,Washington,Washington
12440,May,2018,Whitman,WA,Truck,0,0,0,8470,8470,0.0,Washington,Washington
12442,May,2018,Skagit,WA,Passenger,198,163,361,90254,90615,0.4,Washington,Washington
12447,May,2018,Douglas,WA,Truck,0,0,0,11900,11900,0.0,Washington,Washington
12452,May,2018,Pend Oreille,WA,Passenger,4,5,9,9508,9517,0.09,Washington,Washington
12457,May,2018,Mason,WA,Passenger,77,93,170,45592,45762,0.37,Washington,Washington
12458,May,2018,Whatcom,WA,Passenger,612,281,893,147196,148089,0.6,Washington,Washington
12459,May,2018,Kittitas,WA,Truck,0,0,0,14024,14024,0.0,Washington,Washington
12466,May,2018,Okanogan,WA,Truck,0,0,0,16409,16409,0.0,Washington,Washington
12467,May,2018,Whitman,WA,Passenger,19,27,46,22578,22624,0.2,Washington,Washington
12468,May,2018,Okanogan,WA,Passenger,8,19,27,25886,25913,0.1,Washington,Washington
12471,May,2018,Wahkiakum,WA,Passenger,1,2,3,2901,2904,0.1,Washington,Washington
12474,May,2018,Clark,WA,Passenger,963,696,1659,307153,308812,0.54,Washington,Washington
12480,May,2018,Cowlitz,WA,Truck,0,0,0,28359,28359,0.0,Washington,Washington
12481,May,2018,Snohomish,WA,Truck,1,0,1,121479,121480,0.0,Washington,Washington
12483,May,2018,Grays Harbor,WA,Passenger,50,55,105,46409,46514,0.23,Washington,Washington
12484,May,2018,Island,WA,Truck,0,0,0,20885,20885,0.0,Washington,Washington
12486,May,2018,Columbia,WA,Passenger,2,1,3,2412,2415,0.12,Washington,Washington
12492,May,2018,Clark,WA,Truck,0,0,0,78917,78917,0.0,Washington,Washington
12494,May,2018,Walla Walla,WA,Passenger,34,42,76,35569,35645,0.21,Washington,Washington
12495,May,2018,Kitsap,WA,Passenger,780,453,1233,177900,179133,0.69,Washington,Washington
12496,May,2018,Lincoln,WA,Passenger,2,6,8,7644,7652,0.1,Washington,Washington
12498,May,2018,Ferry,WA,Truck,0,0,0,3503,3503,0.0,Washington,Washington
12499,May,2018,Stevens,WA,Passenger,11,25,36,31564,31600,0.11,Washington,Washington
12501,May,2018,Thurston,WA,Passenger,548,468,1016,192389,193405,0.53,Washington,Washington
12505,May,2018,Lewis,WA,Passenger,78,54,132,57567,57699,0.23,Washington,Washington
12507,May,2018,Lincoln,WA,Truck,0,0,0,4537,4537,0.0,Washington,Washington
12509,May,2018,Skagit,WA,Truck,1,0,1,32044,32045,0.0,Washington,Washington
12514,May,2018,Mason,WA,Truck,0,0,0,19874,19874,0.0,Washington,Washington
12515,May,2018,Grays Harbor,WA,Truck,0,0,0,20185,20185,0.0,Washington,Washington
12516,May,2018,Garfield,WA,Truck,0,0,0,956,956,0.0,Washington,Washington
12517,May,2018,Thurston,WA,Truck,0,0,0,54199,54199,0.0,Washington,Washington
12519,May,2018,Ferry,WA,Passenger,2,3,5,4417,4422,0.11,Washington,Washington
12520,May,2018,Pierce,WA,Passenger,1185,1125,2310,530476,532786,0.43,Washington,Washington
12521,May,2018,Grant,WA,Truck,0,0,0,25863,25863,0.0,Washington,Washington
12523,May,2018,Clallam,WA,Passenger,119,110,229,49783,50012,0.46,Washington,Washington
12526,May,2018,Klickitat,WA,Truck,0,0,0,8084,8084,0.0,Washington,Washington
12528,May,2018,Klickitat,WA,Passenger,25,30,55,15106,15161,0.36,Washington,Washington
12532,May,2018,Snohomish,WA,Passenger,2281,1223,3504,520051,523555,0.67,Washington,Washington
12534,May,2018,Skamania,WA,Passenger,12,9,21,8704,8725,0.24,Washington,Washington
12536,May,2018,Pend Oreille,WA,Truck,0,0,0,5671,5671,0.0,Washington,Washington
12541,May,2018,Cowlitz,WA,Passenger,58,75,133,71515,71648,0.19,Washington,Washington
12544,May,2018,Garfield,WA,Passenger,1,1,2,1326,1328,0.15,Washington,Washington
12545,May,2018,Jefferson,WA,Passenger,138,91,229,24389,24618,0.93,Washington,Washington
12549,May,2018,San Juan,WA,Truck,0,0,0,5702,5702,0.0,Washington,Washington
12552,May,2018,Spokane,WA,Truck,1,0,1,92371,92372,0.0,Washington,Washington
12554,May,2018,Jefferson,WA,Truck,0,0,0,9539,9539,0.0,Washington,Washington
12555,May,2018,Asotin,WA,Passenger,8,6,14,12602,12616,0.11,Washington,Washington
12556,May,2018,Clallam,WA,Truck,0,0,0,21412,21412,0.0,Washington,Washington
12557,May,2018,Pacific,WA,Truck,0,0,0,7588,7588,0.0,Washington,Washington
12559,May,2018,Grant,WA,Passenger,30,44,74,63010,63084,0.12,Washington,Washington
12561,May,2018,Chelan,WA,Truck,0,0,0,21823,21823,0.0,Washington,Washington
12562,May,2018,Island,WA,Passenger,187,177,364,62446,62810,0.58,Washington,Washington
12567,May,2018,Adams,WA,Truck,0,0,0,5158,5158,0.0,Washington,Washington
12570,May,2018,Kittitas,WA,Passenger,44,32,76,28906,28982,0.26,Washington,Washington
12571,May,2018,Benton,WA,Truck,0,0,0,40984,40984,0.0,Washington,Washington
12572,May,2018,Franklin,WA,Truck,0,0,0,18644,18644,0.0,Washington,Washington
12574,May,2018,Yakima,WA,Passenger,62,84,146,163646,163792,0.09,Washington,Washington
12575,May,2018,Pacific,WA,Passenger,16,19,35,15552,15587,0.22,Washington,Washington
12577,May,2018,King,WA,Passenger,12744,5480,18224,1369589,1387813,1.31,Washington,Washington
12582,May,2018,Skamania,WA,Truck,0,0,0,3917,3917,0.0,Washington,Washington
12585,May,2018,Benton,WA,Passenger,188,195,383,131301,131684,0.29,Washington,Washington
12594,May,2018,Franklin,WA,Passenger,38,63,101,57692,57793,0.17,Washington,Washington
12596,May,2018,Spokane,WA,Passenger,324,302,626,302459,303085,0.21,Washington,Washington
12600,May,2018,Pierce,WA,Truck,0,0,0,137544,137544,0.0,Washington,Washington
12601,May,2018,King,WA,Truck,7,1,8,183157,183165,0.0,Washington,Washington
12610,May,2018,Stevens,WA,Truck,0,0,0,18590,18590,0.0,Washington,Washington
12613,May,2018,Chelan,WA,Passenger,103,49,152,53497,53649,0.28,Washington,Washington
12616,May,2018,Whatcom,WA,Truck,2,0,2,42191,42193,0.0,Washington,Washington
12618,May,2018,Walla Walla,WA,Truck,0,0,0,13389,13389,0.0,Washington,Washington
12619,May,2018,San Juan,WA,Passenger,141,56,197,14046,14243,1.38,Washington,Washington
12622,May,2018,Douglas,WA,Passenger,44,31,75,27541,27616,0.27,Washington,Washington
12625,May,2018,Columbia,WA,Truck,0,0,0,1526,1526,0.0,Washington,Washington
12629,May,2018,Yakima,WA,Truck,0,0,0,58338,58338,0.0,Washington,Washington
12631,May,2018,Asotin,WA,Truck,0,0,0,6631,6631,0.0,Washington,Washington
12634,May,2018,Kitsap,WA,Truck,1,0,1,53093,53094,0.0,Washington,Washington
12636,May,2018,Adams,WA,Passenger,5,5,10,12597,12607,0.08,Washington,Washington
12640,May,2018,Lewis,WA,Truck,0,0,0,25406,25406,0.0,Washington,Washington
12642,May,2019,Skagit,WA,Passenger,292,200,492,91700,92192,0.53,Washington,Washington
12645,May,2019,Skamania,WA,Truck,0,0,0,4052,4052,0.0,Washington,Washington
12646,May,2019,Snohomish,WA,Passenger,3372,1572,4944,530335,535279,0.92,Washington,Washington
12649,May,2019,Asotin,WA,Passenger,12,8,20,12675,12695,0.16,Washington,Washington
12651,May,2019,Grant,WA,Passenger,39,59,98,64561,64659,0.15,Washington,Washington
12659,May,2019,Yakima,WA,Passenger,94,104,198,165012,165210,0.12,Washington,Washington
12663,May,2019,San Juan,WA,Passenger,207,71,278,14357,14635,1.9,Washington,Washington
12665,May,2019,Garfield,WA,Passenger,1,1,2,1293,1295,0.15,Washington,Washington
12678,May,2019,Walla Walla,WA,Truck,0,0,0,13613,13613,0.0,Washington,Washington
12680,May,2019,Lewis,WA,Passenger,97,93,190,59034,59224,0.32,Washington,Washington
12685,May,2019,Wahkiakum,WA,Passenger,2,2,4,3017,3021,0.13,Washington,Washington
12687,May,2019,Skamania,WA,Passenger,23,17,40,8719,8759,0.46,Washington,Washington
12689,May,2019,Thurston,WA,Truck,0,0,0,55085,55085,0.0,Washington,Washington
12691,May,2019,Grant,WA,Truck,0,0,0,26531,26531,0.0,Washington,Washington
12692,May,2019,Kittitas,WA,Passenger,72,35,107,29555,29662,0.36,Washington,Washington
12695,May,2019,Island,WA,Truck,0,0,0,21242,21242,0.0,Washington,Washington
12699,May,2019,Benton,WA,Passenger,253,272,525,133636,134161,0.39,Washington,Washington
12702,May,2019,Chelan,WA,Truck,0,0,0,22243,22243,0.0,Washington,Washington
12703,May,2019,Benton,WA,Truck,0,0,0,41850,41850,0.0,Washington,Washington
12711,May,2019,Columbia,WA,Passenger,2,2,4,2443,2447,0.16,Washington,Washington
12712,May,2019,Franklin,WA,Truck,0,0,0,19251,19251,0.0,Washington,Washington
12717,May,2019,Cowlitz,WA,Passenger,95,107,202,72910,73112,0.28,Washington,Washington
12718,May,2019,Lincoln,WA,Truck,0,0,0,4695,4695,0.0,Washington,Washington
12721,May,2019,Okanogan,WA,Passenger,21,23,44,26072,26116,0.17,Washington,Washington
12722,May,2019,Pierce,WA,Passenger,1751,1520,3271,542054,545325,0.6,Washington,Washington
12723,May,2019,Ferry,WA,Passenger,5,2,7,4381,4388,0.16,Washington,Washington
12725,May,2019,Douglas,WA,Passenger,56,36,92,28005,28097,0.33,Washington,Washington
12726,May,2019,Stevens,WA,Truck,0,0,0,18677,18677,0.0,Washington,Washington
12727,May,2019,Ferry,WA,Truck,0,0,0,3589,3589,0.0,Washington,Washington
12729,May,2019,Snohomish,WA,Truck,1,0,1,122076,122077,0.0,Washington,Washington
12738,May,2019,Adams,WA,Truck,0,0,0,5127,5127,0.0,Washington,Washington
12748,May,2019,Lincoln,WA,Passenger,3,8,11,7772,7783,0.14,Washington,Washington
12751,May,2019,Thurston,WA,Passenger,844,630,1474,197138,198612,0.74,Washington,Washington
12754,May,2019,Adams,WA,Passenger,5,6,11,12714,12725,0.09,Washington,Washington
12755,May,2019,Mason,WA,Passenger,121,120,241,47012,47253,0.51,Washington,Washington
12756,May,2019,Jefferson,WA,Truck,0,0,0,9668,9668,0.0,Washington,Washington
12757,May,2019,Whatcom,WA,Passenger,837,413,1250,150441,151691,0.82,Washington,Washington
12758,May,2019,Pacific,WA,Passenger,24,28,52,15952,16004,0.32,Washington,Washington
12760,May,2019,Klickitat,WA,Truck,0,0,0,8237,8237,0.0,Washington,Washington
12762,May,2019,Clallam,WA,Truck,0,0,0,21746,21746,0.0,Washington,Washington
12764,May,2019,Cowlitz,WA,Truck,0,0,0,28843,28843,0.0,Washington,Washington
12765,May,2019,Grays Harbor,WA,Truck,0,0,0,20457,20457,0.0,Washington,Washington
12766,May,2019,Asotin,WA,Truck,0,0,0,6652,6652,0.0,Washington,Washington
12768,May,2019,Garfield,WA,Truck,0,0,0,954,954,0.0,Washington,Washington
12773,May,2019,Columbia,WA,Truck,0,0,0,1532,1532,0.0,Washington,Washington
12782,May,2019,Whitman,WA,Passenger,31,45,76,22710,22786,0.33,Washington,Washington
12785,May,2019,Lewis,WA,Truck,0,0,0,25915,25915,0.0,Washington,Washington
12787,May,2019,Skagit,WA,Truck,1,0,1,32417,32418,0.0,Washington,Washington
12788,May,2019,Yakima,WA,Truck,0,0,0,59084,59084,0.0,Washington,Washington
12791,May,2019,Wahkiakum,WA,Truck,0,0,0,1743,1743,0.0,Washington,Washington
12792,May,2019,Stevens,WA,Passenger,20,29,49,31678,31727,0.15,Washington,Washington
12793,May,2019,Spokane,WA,Passenger,529,422,951,310923,311874,0.3,Washington,Washington
12795,May,2019,Pend Oreille,WA,Truck,0,0,0,5743,5743,0.0,Washington,Washington
12797,May,2019,Whatcom,WA,Truck,2,0,2,42822,42824,0.0,Washington,Washington
12800,May,2019,Clark,WA,Passenger,1475,913,2388,313255,315643,0.76,Washington,Washington
12806,May,2019,Grays Harbor,WA,Passenger,73,84,157,47839,47996,0.33,Washington,Washington
12808,May,2019,Chelan,WA,Passenger,153,67,220,54336,54556,0.4,Washington,Washington
12815,May,2019,Okanogan,WA,Truck,0,0,0,16506,16506,0.0,Washington,Washington
12816,May,2019,Franklin,WA,Passenger,52,70,122,59788,59910,0.2,Washington,Washington
12818,May,2019,Kitsap,WA,Truck,1,0,1,54018,54019,0.0,Washington,Washington
12819,May,2019,Island,WA,Passenger,315,234,549,63346,63895,0.86,Washington,Washington
12821,May,2019,Pacific,WA,Truck,0,0,0,7661,7661,0.0,Washington,Washington
12823,May,2019,Pierce,WA,Truck,0,0,0,139646,139646,0.0,Washington,Washington
12826,May,2019,King,WA,Truck,5,1,6,181939,181945,0.0,Washington,Washington
12830,May,2019,Pend Oreille,WA,Passenger,4,5,9,9537,9546,0.09,Washington,Washington
12831,May,2019,Spokane,WA,Truck,1,0,1,94607,94608,0.0,Washington,Washington
12833,May,2019,Clark,WA,Truck,0,0,0,80186,80186,0.0,Washington,Washington
12834,May,2019,Walla Walla,WA,Passenger,46,57,103,36164,36267,0.28,Washington,Washington
12842,May,2019,San Juan,WA,Truck,0,0,0,5850,5850,0.0,Washington,Washington
12843,May,2019,Mason,WA,Truck,0,0,0,20364,20364,0.0,Washington,Washington
12849,May,2019,Kittitas,WA,Truck,0,0,0,14377,14377,0.0,Washington,Washington
12851,May,2019,Kitsap,WA,Passenger,1036,588,1624,180694,182318,0.89,Washington,Washington
12853,May,2019,Jefferson,WA,Passenger,191,119,310,25001,25311,1.22,Washington,Washington
12857,May,2019,Klickitat,WA,Passenger,35,33,68,15550,15618,0.44,Washington,Washington
12859,May,2019,King,WA,Passenger,18616,6948,25564,1387314,1412878,1.81,Washington,Washington
12863,May,2019,Clallam,WA,Passenger,167,137,304,50565,50869,0.6,Washington,Washington
12865,May,2019,Whitman,WA,Truck,0,0,0,8549,8549,0.0,Washington,Washington
12866,May,2019,Douglas,WA,Truck,0,0,0,12182,12182,0.0,Washington,Washington
12870,May,2020,Chelan,WA,Passenger,228,78,306,54111,54417,0.56,Washington,Washington
12872,May,2020,Spokane,WA,Truck,1,0,1,97688,97689,0.0,Washington,Washington
12875,May,2020,Pacific,WA,Truck,0,0,0,7625,7625,0.0,Washington,Washington
12877,May,2020,Wahkiakum,WA,Passenger,6,6,12,2965,2977,0.4,Washington,Washington
12879,May,2020,Columbia,WA,Passenger,4,3,7,2405,2412,0.29,Washington,Washington
12889,May,2020,Whatcom,WA,Passenger,1060,496,1556,149298,150854,1.03,Washington,Washington
12890,May,2020,Yakima,WA,Truck,0,0,0,59572,59572,0.0,Washington,Washington
12894,May,2020,Pierce,WA,Truck,0,0,0,141318,141318,0.0,Washington,Washington
12898,May,2020,Snohomish,WA,Truck,0,0,0,123364,123364,0.0,Washington,Washington
12899,May,2020,Chelan,WA,Truck,0,0,0,22434,22434,0.0,Washington,Washington
12900,May,2020,Grant,WA,Passenger,59,70,129,65207,65336,0.2,Washington,Washington
12901,May,2020,Okanogan,WA,Truck,0,0,0,16391,16391,0.0,Washington,Washington
12903,May,2020,Grays Harbor,WA,Passenger,106,111,217,48015,48232,0.45,Washington,Washington
12904,May,2020,Franklin,WA,Truck,0,0,0,19869,19869,0.0,Washington,Washington
12908,May,2020,Lewis,WA,Truck,0,0,0,26001,26001,0.0,Washington,Washington
12909,May,2020,Clark,WA,Passenger,2003,1055,3058,317495,320553,0.95,Washington,Washington
12918,May,2020,Kittitas,WA,Passenger,102,48,150,29778,29928,0.5,Washington,Washington
12919,May,2020,Franklin,WA,Passenger,58,75,133,60574,60707,0.22,Washington,Washington
12920,May,2020,Skamania,WA,Truck,0,0,0,4029,4029,0.0,Washington,Washington
12924,May,2020,Whatcom,WA,Truck,3,0,3,42847,42850,0.01,Washington,Washington
12932,May,2020,San Juan,WA,Passenger,298,91,389,14062,14451,2.69,Washington,Washington
12934,May,2020,Skagit,WA,Truck,1,0,1,32389,32390,0.0,Washington,Washington
12940,May,2020,Stevens,WA,Truck,0,0,0,18598,18598,0.0,Washington,Washington
12941,May,2020,Douglas,WA,Truck,0,0,0,12279,12279,0.0,Washington,Washington
12949,May,2020,Grays Harbor,WA,Truck,0,0,0,20770,20770,0.0,Washington,Washington
12958,May,2020,Yakima,WA,Passenger,131,117,248,165018,165266,0.15,Washington,Washington
12960,May,2020,Grant,WA,Truck,0,0,0,26982,26982,0.0,Washington,Washington
12966,May,2020,Jefferson,WA,Passenger,233,141,374,24824,25198,1.48,Washington,Washington
12969,May,2020,Okanogan,WA,Passenger,34,33,67,25879,25946,0.26,Washington,Washington
12970,May,2020,Mason,WA,Passenger,157,137,294,47178,47472,0.62,Washington,Washington
12971,May,2020,Island,WA,Passenger,409,270,679,62803,63482,1.07,Washington,Washington
12976,May,2020,Clallam,WA,Truck,1,0,1,21671,21672,0.0,Washington,Washington
12981,May,2020,Douglas,WA,Passenger,69,40,109,27964,28073,0.39,Washington,Washington
12986,May,2020,Asotin,WA,Truck,0,0,0,6587,6587,0.0,Washington,Washington
12993,May,2020,Mason,WA,Truck,0,0,0,20508,20508,0.0,Washington,Washington
12996,May,2020,San Juan,WA,Truck,0,0,0,5860,5860,0.0,Washington,Washington
12997,May,2020,Whitman,WA,Truck,0,0,0,8514,8514,0.0,Washington,Washington
12998,May,2020,Garfield,WA,Passenger,0,1,1,1347,1348,0.07,Washington,Washington
13002,May,2020,Cowlitz,WA,Passenger,136,115,251,72360,72611,0.35,Washington,Washington
13005,May,2020,Klickitat,WA,Truck,0,0,0,8121,8121,0.0,Washington,Washington
13006,May,2020,Columbia,WA,Truck,0,0,0,1523,1523,0.0,Washington,Washington
13014,May,2020,Garfield,WA,Truck,0,0,0,967,967,0.0,Washington,Washington
13017,May,2020,Whitman,WA,Passenger,45,48,93,22175,22268,0.42,Washington,Washington
13018,May,2020,Clark,WA,Truck,0,0,0,81892,81892,0.0,Washington,Washington
13023,May,2020,Clallam,WA,Passenger,222,165,387,50115,50502,0.77,Washington,Washington
13027,May,2020,Spokane,WA,Passenger,721,479,1200,315019,316219,0.38,Washington,Washington
13029,May,2020,Thurston,WA,Truck,0,0,0,55495,55495,0.0,Washington,Washington
13030,May,2020,Kitsap,WA,Passenger,1312,678,1990,179656,181646,1.1,Washington,Washington
13031,May,2020,Adams,WA,Passenger,8,7,15,12719,12734,0.12,Washington,Washington
13032,May,2020,Snohomish,WA,Passenger,4402,1748,6150,533885,540035,1.14,Washington,Washington
13035,May,2020,Skamania,WA,Passenger,30,17,47,8525,8572,0.55,Washington,Washington
13042,May,2020,Cowlitz,WA,Truck,0,0,0,28759,28759,0.0,Washington,Washington
13043,May,2020,Lewis,WA,Passenger,99,108,207,58242,58449,0.35,Washington,Washington
13047,May,2020,Jefferson,WA,Truck,0,0,0,9510,9510,0.0,Washington,Washington
13048,May,2020,King,WA,Truck,5,1,6,181412,181418,0.0,Washington,Washington
13050,May,2020,Stevens,WA,Passenger,34,33,67,30736,30803,0.22,Washington,Washington
13051,May,2020,Kitsap,WA,Truck,0,0,0,53864,53864,0.0,Washington,Washington
13055,May,2020,Ferry,WA,Truck,0,0,0,3540,3540,0.0,Washington,Washington
13060,May,2020,Adams,WA,Truck,0,0,0,5217,5217,0.0,Washington,Washington
13062,May,2020,Kittitas,WA,Truck,0,0,0,14554,14554,0.0,Washington,Washington
13064,May,2020,Island,WA,Truck,1,0,1,21136,21137,0.0,Washington,Washington
13066,May,2020,Lincoln,WA,Truck,0,0,0,4618,4618,0.0,Washington,Washington
13068,May,2020,Pend Oreille,WA,Passenger,7,6,13,9217,9230,0.14,Washington,Washington
13072,May,2020,Pierce,WA,Passenger,2351,1675,4026,547592,551618,0.73,Washington,Washington
13074,May,2020,Thurston,WA,Passenger,1136,733,1869,196825,198694,0.94,Washington,Washington
13075,May,2020,King,WA,Passenger,24017,7688,31705,1374959,1406664,2.25,Washington,Washington
13077,May,2020,Benton,WA,Truck,0,0,0,42474,42474,0.0,Washington,Washington
13082,May,2020,Pend Oreille,WA,Truck,0,0,0,5741,5741,0.0,Washington,Washington
13085,May,2020,Lincoln,WA,Passenger,4,12,16,7640,7656,0.21,Washington,Washington
13087,May,2020,Wahkiakum,WA,Truck,0,0,0,1759,1759,0.0,Washington,Washington
13095,May,2020,Walla Walla,WA,Passenger,70,62,132,35820,35952,0.37,Washington,Washington
13096,May,2020,Asotin,WA,Passenger,16,12,28,12338,12366,0.23,Washington,Washington
13097,May,2020,Benton,WA,Passenger,354,321,675,134165,134840,0.5,Washington,Washington
13098,May,2020,Skagit,WA,Passenger,400,216,616,91169,91785,0.67,Washington,Washington
13101,May,2020,Klickitat,WA,Passenger,53,40,93,15273,15366,0.61,Washington,Washington
13102,May,2020,Pacific,WA,Passenger,31,33,64,15703,15767,0.41,Washington,Washington
13103,May,2020,Walla Walla,WA,Truck,0,0,0,13670,13670,0.0,Washington,Washington
13105,May,2020,Ferry,WA,Passenger,5,3,8,4331,4339,0.18,Washington,Washington
13107,May,2021,Adams,WA,Truck,0,0,0,5374,5374,0.0,Washington,Washington
13108,May,2021,Ferry,WA,Passenger,9,3,12,4373,4385,0.27,Washington,Washington
13109,May,2021,Adams,WA,Passenger,11,9,20,13043,13063,0.15,Washington,Washington
13110,May,2021,Lincoln,WA,Passenger,5,13,18,7733,7751,0.23,Washington,Washington
13111,May,2021,Whatcom,WA,Passenger,1386,596,1982,150988,152970,1.3,Washington,Washington
13115,May,2021,Pend Oreille,WA,Truck,0,0,0,5748,5748,0.0,Washington,Washington
13116,May,2021,Kitsap,WA,Truck,0,0,0,54547,54547,0.0,Washington,Washington
13120,May,2021,Clallam,WA,Truck,1,0,1,22005,22006,0.0,Washington,Washington
13125,May,2021,Asotin,WA,Truck,0,0,0,6783,6783,0.0,Washington,Washington
13130,May,2021,Benton,WA,Passenger,504,385,889,136106,136995,0.65,Washington,Washington
13135,May,2021,Columbia,WA,Passenger,6,3,9,2476,2485,0.36,Washington,Washington
13136,May,2021,Kittitas,WA,Truck,0,0,0,14768,14768,0.0,Washington,Washington
13137,May,2021,Lewis,WA,Passenger,157,135,292,59809,60101,0.49,Washington,Washington
13138,May,2021,Pierce,WA,Passenger,3382,1941,5323,559989,565312,0.94,Washington,Washington
13139,May,2021,San Juan,WA,Passenger,423,131,554,14216,14770,3.75,Washington,Washington
13143,May,2021,Klickitat,WA,Truck,0,0,0,8263,8263,0.0,Washington,Washington
13145,May,2021,Skamania,WA,Truck,0,0,0,4030,4030,0.0,Washington,Washington
13159,May,2021,Chelan,WA,Passenger,322,98,420,54729,55149,0.76,Washington,Washington
13162,May,2021,Asotin,WA,Passenger,19,14,33,12700,12733,0.26,Washington,Washington
13164,May,2021,Cowlitz,WA,Passenger,218,136,354,72447,72801,0.49,Washington,Washington
13165,May,2021,Klickitat,WA,Passenger,66,47,113,15237,15350,0.74,Washington,Washington
13166,May,2021,Skagit,WA,Passenger,577,265,842,91964,92806,0.91,Washington,Washington
13167,May,2021,Walla Walla,WA,Passenger,110,72,182,36556,36738,0.5,Washington,Washington
13171,May,2021,Clark,WA,Truck,0,0,0,84190,84190,0.0,Washington,Washington
13180,May,2021,Lincoln,WA,Truck,0,0,0,4754,4754,0.0,Washington,Washington
13181,May,2021,Columbia,WA,Truck,0,0,0,1552,1552,0.0,Washington,Washington
13183,May,2021,Thurston,WA,Truck,0,0,0,56635,56635,0.0,Washington,Washington
13184,May,2021,Yakima,WA,Passenger,211,145,356,169299,169655,0.21,Washington,Washington
13185,May,2021,Benton,WA,Truck,0,0,0,43665,43665,0.0,Washington,Washington
13188,May,2021,Stevens,WA,Passenger,42,45,87,30559,30646,0.28,Washington,Washington
13190,May,2021,Wahkiakum,WA,Passenger,13,7,20,3113,3133,0.64,Washington,Washington
13192,May,2021,Garfield,WA,Passenger,0,2,2,1370,1372,0.15,Washington,Washington
13194,May,2021,Thurston,WA,Passenger,1543,852,2395,198108,200503,1.19,Washington,Washington
13196,May,2021,Kittitas,WA,Passenger,155,62,217,29978,30195,0.72,Washington,Washington
13203,May,2021,Skagit,WA,Truck,1,0,1,33056,33057,0.0,Washington,Washington
13216,May,2021,Mason,WA,Passenger,207,136,343,48113,48456,0.71,Washington,Washington
13222,May,2021,Pierce,WA,Truck,0,0,0,145896,145896,0.0,Washington,Washington
13223,May,2021,Okanogan,WA,Truck,0,0,0,16755,16755,0.0,Washington,Washington
13227,May,2021,Yakima,WA,Truck,0,0,0,61680,61680,0.0,Washington,Washington
13228,May,2021,Spokane,WA,Passenger,1030,624,1654,325579,327233,0.51,Washington,Washington
13236,May,2021,Franklin,WA,Passenger,117,95,212,61959,62171,0.34,Washington,Washington
13241,May,2021,Jefferson,WA,Truck,0,0,0,9616,9616,0.0,Washington,Washington
13244,May,2021,Grays Harbor,WA,Truck,0,0,0,21430,21430,0.0,Washington,Washington
13245,May,2021,Cowlitz,WA,Truck,0,0,0,29142,29142,0.0,Washington,Washington
13247,May,2021,Pend Oreille,WA,Passenger,14,6,20,9275,9295,0.22,Washington,Washington
13254,May,2021,Ferry,WA,Truck,0,0,0,3661,3661,0.0,Washington,Washington
13259,May,2021,Garfield,WA,Truck,0,0,0,999,999,0.0,Washington,Washington
13266,May,2021,Franklin,WA,Truck,0,0,0,20653,20653,0.0,Washington,Washington
13267,May,2021,Lewis,WA,Truck,0,0,0,26895,26895,0.0,Washington,Washington
13270,May,2021,Douglas,WA,Truck,0,0,0,12664,12664,0.0,Washington,Washington
13271,May,2021,Wahkiakum,WA,Truck,0,0,0,1799,1799,0.0,Washington,Washington
13277,May,2021,Mason,WA,Truck,0,0,0,21339,21339,0.0,Washington,Washington
13280,May,2021,Whitman,WA,Truck,0,0,0,8571,8571,0.0,Washington,Washington
13282,May,2021,King,WA,Truck,6,1,7,184688,184695,0.0,Washington,Washington
13284,May,2021,Island,WA,Passenger,599,310,909,63247,64156,1.42,Washington,Washington
13287,May,2021,Island,WA,Truck,0,0,0,21611,21611,0.0,Washington,Washington
13289,May,2021,Snohomish,WA,Passenger,5729,2002,7731,540294,548025,1.41,Washington,Washington
13298,May,2021,Douglas,WA,Passenger,92,47,139,28516,28655,0.49,Washington,Washington
13300,May,2021,Kitsap,WA,Passenger,1796,833,2629,180423,183052,1.44,Washington,Washington
13304,May,2021,Walla Walla,WA,Truck,0,0,0,14041,14041,0.0,Washington,Washington
13305,May,2021,Grant,WA,Truck,0,0,0,27874,27874,0.0,Washington,Washington
13307,May,2021,Clallam,WA,Passenger,321,208,529,50426,50955,1.04,Washington,Washington
13310,May,2021,Okanogan,WA,Passenger,61,37,98,26414,26512,0.37,Washington,Washington
13311,May,2021,San Juan,WA,Truck,0,0,0,5926,5926,0.0,Washington,Washington
13312,May,2021,Jefferson,WA,Passenger,322,181,503,24893,25396,1.98,Washington,Washington
13315,May,2021,Snohomish,WA,Truck,1,0,1,126365,126366,0.0,Washington,Washington
13316,May,2021,Grant,WA,Passenger,102,87,189,66863,67052,0.28,Washington,Washington
13318,May,2021,Spokane,WA,Truck,0,0,0,102090,102090,0.0,Washington,Washington
13324,May,2021,King,WA,Passenger,30043,8922,38965,1368667,1407632,2.77,Washington,Washington
13325,May,2021,Skamania,WA,Passenger,43,32,75,8395,8470,0.89,Washington,Washington
13328,May,2021,Pacific,WA,Passenger,43,47,90,16070,16160,0.56,Washington,Washington
13332,May,2021,Whitman,WA,Passenger,60,44,104,22016,22120,0.47,Washington,Washington
13341,May,2021,Pacific,WA,Truck,0,0,0,7939,7939,0.0,Washington,Washington
13345,May,2021,Clark,WA,Passenger,2757,1368,4125,321959,326084,1.27,Washington,Washington
13349,May,2021,Chelan,WA,Truck,0,0,0,23102,23102,0.0,Washington,Washington
13350,May,2021,Grays Harbor,WA,Passenger,161,139,300,49369,49669,0.6,Washington,Washington
13352,May,2021,Whatcom,WA,Truck,4,0,4,43874,43878,0.01,Washington,Washington
13354,May,2021,Stevens,WA,Truck,0,0,0,18957,18957,0.0,Washington,Washington
13357,May,2022,Kittitas,WA,Passenger,248,79,327,29757,30084,1.09,Washington,Washington
13369,May,2022,Skagit,WA,Passenger,759,332,1091,90123,91214,1.2,Washington,Washington
13370,May,2022,Spokane,WA,Truck,1,0,1,102240,102241,0.0,Washington,Washington
13374,May,2022,Wahkiakum,WA,Truck,0,0,0,1805,1805,0.0,Washington,Washington
13378,May,2022,Asotin,WA,Passenger,23,19,42,12730,12772,0.33,Washington,Washington
13382,May,2022,Grays Harbor,WA,Passenger,205,158,363,49085,49448,0.73,Washington,Washington
13392,May,2022,Adams,WA,Passenger,16,10,26,12957,12983,0.2,Washington,Washington
13394,May,2022,Kitsap,WA,Passenger,2354,1031,3385,178653,182038,1.86,Washington,Washington
13401,May,2022,Pacific,WA,Passenger,60,68,128,15915,16043,0.8,Washington,Washington
13411,May,2022,King,WA,Truck,43,1,44,181226,181270,0.02,Washington,Washington
13412,May,2022,Spokane,WA,Passenger,1543,832,2375,325374,327749,0.72,Washington,Washington
13423,May,2022,San Juan,WA,Truck,1,0,1,5979,5980,0.02,Washington,Washington
13426,May,2022,Kitsap,WA,Truck,3,0,3,53699,53702,0.01,Washington,Washington
13431,May,2022,Franklin,WA,Truck,0,0,0,20926,20926,0.0,Washington,Washington
13434,May,2022,Columbia,WA,Passenger,7,0,7,2441,2448,0.29,Washington,Washington
13435,May,2022,Pierce,WA,Truck,5,0,5,142329,142334,0.0,Washington,Washington
13436,May,2022,Adams,WA,Truck,0,0,0,5475,5475,0.0,Washington,Washington
13437,May,2022,Walla Walla,WA,Truck,0,0,0,13969,13969,0.0,Washington,Washington
13438,May,2022,Lincoln,WA,Truck,0,0,0,4839,4839,0.0,Washington,Washington
13439,May,2022,Clallam,WA,Passenger,410,244,654,49775,50429,1.3,Washington,Washington
13441,May,2022,Douglas,WA,Truck,0,0,0,12770,12770,0.0,Washington,Washington
13442,May,2022,Clark,WA,Truck,5,0,5,82915,82920,0.01,Washington,Washington
13446,May,2022,Stevens,WA,Passenger,64,54,118,30097,30215,0.39,Washington,Washington
13454,May,2022,Jefferson,WA,Truck,0,0,0,9493,9493,0.0,Washington,Washington
13456,May,2022,Kittitas,WA,Truck,1,0,1,14675,14676,0.01,Washington,Washington
13462,May,2022,Okanogan,WA,Passenger,82,51,133,26409,26542,0.5,Washington,Washington
13464,May,2022,Grant,WA,Passenger,166,97,263,66720,66983,0.39,Washington,Washington
13466,May,2022,Cowlitz,WA,Truck,1,1,2,28601,28603,0.01,Washington,Washington
13467,May,2022,Pend Oreille,WA,Truck,0,0,0,5629,5629,0.0,Washington,Washington
13470,May,2022,Klickitat,WA,Passenger,99,54,153,15249,15402,0.99,Washington,Washington
13471,May,2022,Lewis,WA,Passenger,231,173,404,59518,59922,0.67,Washington,Washington
13476,May,2022,Okanogan,WA,Truck,0,0,0,16665,16665,0.0,Washington,Washington
13480,May,2022,Asotin,WA,Truck,0,0,0,6709,6709,0.0,Washington,Washington
13481,May,2022,Yakima,WA,Passenger,325,189,514,167089,167603,0.31,Washington,Washington
13485,May,2022,Garfield,WA,Truck,0,0,0,981,981,0.0,Washington,Washington
13496,May,2022,Skamania,WA,Truck,0,0,0,3971,3971,0.0,Washington,Washington
13497,May,2022,Whitman,WA,Truck,0,0,0,8562,8562,0.0,Washington,Washington
13499,May,2022,Wahkiakum,WA,Passenger,22,10,32,3085,3117,1.03,Washington,Washington
13517,May,2022,Whatcom,WA,Passenger,1799,729,2528,148935,151463,1.67,Washington,Washington
13520,May,2022,Thurston,WA,Passenger,2127,1028,3155,194514,197669,1.6,Washington,Washington
13522,May,2022,Lewis,WA,Truck,0,0,0,26423,26423,0.0,Washington,Washington
13525,May,2022,Snohomish,WA,Truck,6,0,6,124132,124138,0.0,Washington,Washington
13527,May,2022,Pacific,WA,Truck,0,0,0,7950,7950,0.0,Washington,Washington
13528,May,2022,Douglas,WA,Passenger,131,58,189,28516,28705,0.66,Washington,Washington
13529,May,2022,Ferry,WA,Truck,0,0,0,3569,3569,0.0,Washington,Washington
13533,May,2022,San Juan,WA,Passenger,499,152,651,14097,14748,4.41,Washington,Washington
13535,May,2022,Lincoln,WA,Passenger,8,18,26,7692,7718,0.34,Washington,Washington
13539,May,2022,Pend Oreille,WA,Passenger,16,11,27,9013,9040,0.3,Washington,Washington
13540,May,2022,Benton,WA,Truck,2,0,2,43549,43551,0.0,Washington,Washington
13542,May,2022,Chelan,WA,Truck,2,0,2,23067,23069,0.01,Washington,Washington
13544,May,2022,Jefferson,WA,Passenger,425,215,640,24617,25257,2.53,Washington,Washington
13548,May,2022,Chelan,WA,Passenger,450,126,576,54379,54955,1.05,Washington,Washington
13549,May,2022,Columbia,WA,Truck,0,0,0,1581,1581,0.0,Washington,Washington
13552,May,2022,Thurston,WA,Truck,4,0,4,55452,55456,0.01,Washington,Washington
13553,May,2022,Pierce,WA,Passenger,4952,2291,7243,546758,554001,1.31,Washington,Washington
13556,May,2022,Skamania,WA,Passenger,70,45,115,8209,8324,1.38,Washington,Washington
13557,May,2022,Grays Harbor,WA,Truck,0,0,0,21307,21307,0.0,Washington,Washington
13558,May,2022,Whitman,WA,Passenger,84,58,142,22034,22176,0.64,Washington,Washington
13560,May,2022,Franklin,WA,Passenger,181,110,291,62027,62318,0.47,Washington,Washington
13561,May,2022,Skagit,WA,Truck,2,0,2,32401,32403,0.01,Washington,Washington
13562,May,2022,Klickitat,WA,Truck,1,0,1,8293,8294,0.01,Washington,Washington
13563,May,2022,Grant,WA,Truck,0,0,0,27995,27995,0.0,Washington,Washington
13566,May,2022,Island,WA,Truck,1,0,1,21433,21434,0.0,Washington,Washington
13568,May,2022,Garfield,WA,Passenger,0,3,3,1329,1332,0.23,Washington,Washington
13572,May,2022,Snohomish,WA,Passenger,8141,2474,10615,533059,543674,1.95,Washington,Washington
13577,May,2022,Ferry,WA,Passenger,20,4,24,4434,4458,0.54,Washington,Washington
13578,May,2022,Mason,WA,Truck,1,0,1,21058,21059,0.0,Washington,Washington
13583,May,2022,Island,WA,Passenger,797,373,1170,62040,63210,1.85,Washington,Washington
13585,May,2022,Clallam,WA,Truck,1,0,1,21957,21958,0.0,Washington,Washington
13586,May,2022,Mason,WA,Passenger,304,179,483,47338,47821,1.01,Washington,Washington
13588,May,2022,Stevens,WA,Truck,0,0,0,18961,18961,0.0,Washington,Washington
13589,May,2022,Cowlitz,WA,Passenger,322,175,497,70710,71207,0.7,Washington,Washington
13594,May,2022,King,WA,Passenger,40013,11054,51067,1349163,1400230,3.65,Washington,Washington
13601,May,2022,Yakima,WA,Truck,0,0,0,61425,61425,0.0,Washington,Washington
13602,May,2022,Walla Walla,WA,Passenger,171,97,268,35973,36241,0.74,Washington,Washington
13605,May,2022,Clark,WA,Passenger,3936,1735,5671,316813,322484,1.76,Washington,Washington
13607,May,2022,Benton,WA,Passenger,729,455,1184,135276,136460,0.87,Washington,Washington
13608,May,2022,Whatcom,WA,Truck,5,0,5,43377,43382,0.01,Washington,Washington
13617,May,2023,King,WA,Truck,684,2,686,174691,175377,0.39,Washington,Washington
13624,May,2023,Adams,WA,Truck,2,0,2,5262,5264,0.04,Washington,Washington
13626,May,2023,Garfield,WA,Truck,0,0,0,964,964,0.0,Washington,Washington
13632,May,2023,Walla Walla,WA,Passenger,215,115,330,35196,35526,0.93,Washington,Washington
13634,May,2023,Klickitat,WA,Truck,11,0,11,8198,8209,0.13,Washington,Washington
13638,May,2023,Wahkiakum,WA,Passenger,26,17,43,3018,3061,1.4,Washington,Washington
13640,May,2023,Chelan,WA,Truck,29,0,29,22965,22994,0.13,Washington,Washington
13643,May,2023,Kitsap,WA,Truck,70,0,70,52120,52190,0.13,Washington,Washington
13644,May,2023,Spokane,WA,Truck,39,0,39,101203,101242,0.04,Washington,Washington
13647,May,2023,Stevens,WA,Passenger,110,64,174,29562,29736,0.59,Washington,Washington
13649,May,2023,San Juan,WA,Passenger,611,173,784,13720,14504,5.41,Washington,Washington
13655,May,2023,Asotin,WA,Passenger,34,20,54,12351,12405,0.44,Washington,Washington
13658,May,2023,Whitman,WA,Truck,4,0,4,8547,8551,0.05,Washington,Washington
13659,May,2023,Snohomish,WA,Passenger,12139,2974,15113,524703,539816,2.8,Washington,Washington
13664,May,2023,Mason,WA,Passenger,429,206,635,45953,46588,1.36,Washington,Washington
13666,May,2023,Chelan,WA,Passenger,619,159,778,53890,54668,1.42,Washington,Washington
13668,May,2023,Clark,WA,Truck,90,0,90,80813,80903,0.11,Washington,Washington
13670,May,2023,Pierce,WA,Passenger,7397,2707,10104,527950,538054,1.88,Washington,Washington
13671,May,2023,Franklin,WA,Truck,4,0,4,20695,20699,0.02,Washington,Washington
13673,May,2023,Whatcom,WA,Truck,57,0,57,42393,42450,0.13,Washington,Washington
13678,May,2023,Grant,WA,Passenger,275,122,397,66534,66931,0.59,Washington,Washington
13680,May,2023,Jefferson,WA,Passenger,549,260,809,24141,24950,3.24,Washington,Washington
13681,May,2023,Whatcom,WA,Passenger,2374,867,3241,146794,150035,2.16,Washington,Washington
13685,May,2023,Skagit,WA,Passenger,1081,403,1484,88295,89779,1.65,Washington,Washington
13686,May,2023,Pend Oreille,WA,Truck,0,0,0,5568,5568,0.0,Washington,Washington
13687,May,2023,Yakima,WA,Truck,12,0,12,60495,60507,0.02,Washington,Washington
13691,May,2023,Okanogan,WA,Truck,7,0,7,16336,16343,0.04,Washington,Washington
13693,May,2023,Benton,WA,Passenger,1120,555,1675,134506,136181,1.23,Washington,Washington
13695,May,2023,Skamania,WA,Truck,1,0,1,3802,3803,0.03,Washington,Washington
13697,May,2023,Ferry,WA,Passenger,20,4,24,4292,4316,0.56,Washington,Washington
13701,May,2023,Spokane,WA,Passenger,2227,1062,3289,320686,323975,1.02,Washington,Washington
13703,May,2023,Whitman,WA,Passenger,144,76,220,21873,22093,1.0,Washington,Washington
13705,May,2023,Jefferson,WA,Truck,12,0,12,9267,9279,0.13,Washington,Washington
13708,May,2023,Mason,WA,Truck,10,0,10,20553,20563,0.05,Washington,Washington
13710,May,2023,Lincoln,WA,Passenger,16,17,33,7646,7679,0.43,Washington,Washington
13711,May,2023,Clallam,WA,Passenger,533,280,813,48629,49442,1.64,Washington,Washington
13712,May,2023,Columbia,WA,Passenger,9,1,10,2407,2417,0.41,Washington,Washington
13715,May,2023,Lewis,WA,Truck,7,0,7,25864,25871,0.03,Washington,Washington
13719,May,2023,Grays Harbor,WA,Truck,6,0,6,20817,20823,0.03,Washington,Washington
13722,May,2023,Thurston,WA,Truck,57,0,57,53621,53678,0.11,Washington,Washington
13728,May,2023,Pierce,WA,Truck,152,0,152,136292,136444,0.11,Washington,Washington
13729,May,2023,Franklin,WA,Passenger,300,136,436,61492,61928,0.7,Washington,Washington
13732,May,2023,Garfield,WA,Passenger,1,3,4,1303,1307,0.31,Washington,Washington
13734,May,2023,Island,WA,Truck,29,0,29,20927,20956,0.14,Washington,Washington
13735,May,2023,Cowlitz,WA,Truck,8,0,8,28004,28012,0.03,Washington,Washington
13740,May,2023,Okanogan,WA,Passenger,123,62,185,25949,26134,0.71,Washington,Washington
13741,May,2023,Snohomish,WA,Truck,162,0,162,120661,120823,0.13,Washington,Washington
13743,May,2023,San Juan,WA,Truck,12,0,12,5866,5878,0.2,Washington,Washington
13744,May,2023,Thurston,WA,Passenger,3033,1203,4236,189258,193494,2.19,Washington,Washington
13746,May,2023,Walla Walla,WA,Truck,5,0,5,13644,13649,0.04,Washington,Washington
13748,May,2023,Douglas,WA,Passenger,198,61,259,28577,28836,0.9,Washington,Washington
13750,May,2023,Adams,WA,Passenger,25,12,37,12934,12971,0.29,Washington,Washington
13751,May,2023,Stevens,WA,Truck,1,0,1,18642,18643,0.01,Washington,Washington
13756,May,2023,Ferry,WA,Truck,0,0,0,3538,3538,0.0,Washington,Washington
13757,May,2023,Columbia,WA,Truck,0,0,0,1546,1546,0.0,Washington,Washington
13760,May,2023,Clallam,WA,Truck,20,0,20,21594,21614,0.09,Washington,Washington
13765,May,2023,Pacific,WA,Passenger,76,90,166,15521,15687,1.06,Washington,Washington
13769,May,2023,Douglas,WA,Truck,7,0,7,12885,12892,0.05,Washington,Washington
13771,May,2023,Grays Harbor,WA,Passenger,290,181,471,48014,48485,0.97,Washington,Washington
13775,May,2023,Cowlitz,WA,Passenger,454,206,660,69496,70156,0.94,Washington,Washington
13778,May,2023,Pend Oreille,WA,Passenger,30,11,41,8845,8886,0.46,Washington,Washington
13780,May,2023,King,WA,Passenger,55335,14137,69472,1316224,1385696,5.01,Washington,Washington
13781,May,2023,Asotin,WA,Truck,0,0,0,6599,6599,0.0,Washington,Washington
13782,May,2023,Skagit,WA,Truck,19,0,19,31695,31714,0.06,Washington,Washington
13784,May,2023,Clark,WA,Passenger,5619,2279,7898,311557,319455,2.47,Washington,Washington
13785,May,2023,Kittitas,WA,Truck,8,0,8,14448,14456,0.06,Washington,Washington
13791,May,2023,Pacific,WA,Truck,3,0,3,7785,7788,0.04,Washington,Washington
13796,May,2023,Kittitas,WA,Passenger,339,102,441,29165,29606,1.49,Washington,Washington
13799,May,2023,Kitsap,WA,Passenger,3126,1246,4372,175192,179564,2.43,Washington,Washington
13800,May,2023,Wahkiakum,WA,Truck,2,0,2,1753,1755,0.11,Washington,Washington
13807,May,2023,Skamania,WA,Passenger,101,58,159,7977,8136,1.95,Washington,Washington
13812,May,2023,Lewis,WA,Passenger,309,203,512,58552,59064,0.87,Washington,Washington
13813,May,2023,Yakima,WA,Passenger,484,249,733,164633,165366,0.44,Washington,Washington
13820,May,2023,Grant,WA,Truck,10,0,10,27771,27781,0.04,Washington,Washington
13823,May,2023,Lincoln,WA,Truck,0,0,0,4844,4844,0.0,Washington,Washington
13824,May,2023,Klickitat,WA,Passenger,145,63,208,15072,15280,1.36,Washington,Washington
13829,May,2023,Benton,WA,Truck,22,0,22,42823,42845,0.05,Washington,Washington
13830,May,2023,Island,WA,Passenger,1044,430,1474,60998,62472,2.36,Washington,Washington
13836,November,2017,Ferry,WA,Passenger,1,3,4,4408,4412,0.09,Washington,Washington
13837,November,2017,Okanogan,WA,Passenger,5,17,22,25731,25753,0.09,Washington,Washington
13839,November,2017,Pacific,WA,Truck,0,0,0,7535,7535,0.0,Washington,Washington
13840,November,2017,Clallam,WA,Truck,0,0,0,21181,21181,0.0,Washington,Washington
13841,November,2017,Skagit,WA,Truck,1,0,1,31687,31688,0.0,Washington,Washington
13845,November,2017,Klickitat,WA,Truck,0,0,0,8002,8002,0.0,Washington,Washington
13846,November,2017,Jefferson,WA,Truck,0,0,0,9461,9461,0.0,Washington,Washington
13847,November,2017,Franklin,WA,Passenger,31,48,79,56681,56760,0.14,Washington,Washington
13851,November,2017,San Juan,WA,Passenger,126,41,167,13785,13952,1.2,Washington,Washington
13852,November,2017,Spokane,WA,Truck,1,0,1,91421,91422,0.0,Washington,Washington
13853,November,2017,Clark,WA,Passenger,840,558,1398,303188,304586,0.46,Washington,Washington
13854,November,2017,Pacific,WA,Passenger,15,11,26,15334,15360,0.17,Washington,Washington
13859,November,2017,Adams,WA,Passenger,3,5,8,12358,12366,0.06,Washington,Washington
13860,November,2017,Skamania,WA,Passenger,10,7,17,8576,8593,0.2,Washington,Washington
13861,November,2017,Whitman,WA,Truck,0,0,0,8437,8437,0.0,Washington,Washington
13863,November,2017,Pend Oreille,WA,Passenger,3,4,7,9428,9435,0.07,Washington,Washington
13866,November,2017,Columbia,WA,Truck,0,0,0,1537,1537,0.0,Washington,Washington
13868,November,2017,Thurston,WA,Passenger,457,380,837,189509,190346,0.44,Washington,Washington
13870,November,2017,King,WA,Passenger,11131,4614,15745,1371535,1387280,1.13,Washington,Washington
13872,November,2017,Douglas,WA,Passenger,37,33,70,27072,27142,0.26,Washington,Washington
13873,November,2017,Island,WA,Truck,0,0,0,20694,20694,0.0,Washington,Washington
13874,November,2017,Wahkiakum,WA,Truck,0,0,0,1661,1661,0.0,Washington,Washington
13879,November,2017,Benton,WA,Truck,0,0,0,40497,40497,0.0,Washington,Washington
13880,November,2017,Lewis,WA,Truck,0,0,0,25234,25234,0.0,Washington,Washington
13882,November,2017,Thurston,WA,Truck,0,0,0,53689,53689,0.0,Washington,Washington
13884,November,2017,Klickitat,WA,Passenger,23,26,49,14871,14920,0.33,Washington,Washington
13886,November,2017,Whatcom,WA,Truck,1,0,1,41929,41930,0.0,Washington,Washington
13888,November,2017,Yakima,WA,Truck,0,0,0,57917,57917,0.0,Washington,Washington
13889,November,2017,Kitsap,WA,Passenger,676,367,1043,175388,176431,0.59,Washington,Washington
13892,November,2017,Clallam,WA,Passenger,98,86,184,48866,49050,0.38,Washington,Washington
13894,November,2017,Mason,WA,Passenger,63,72,135,44603,44738,0.3,Washington,Washington
13895,November,2017,Walla Walla,WA,Passenger,29,31,60,35239,35299,0.17,Washington,Washington
13897,November,2017,Wahkiakum,WA,Passenger,0,2,2,2868,2870,0.07,Washington,Washington
13898,November,2017,Columbia,WA,Passenger,2,1,3,2391,2394,0.13,Washington,Washington
13899,November,2017,Ferry,WA,Truck,0,0,0,3544,3544,0.0,Washington,Washington
13905,November,2017,Cowlitz,WA,Truck,0,0,0,28144,28144,0.0,Washington,Washington
13907,November,2017,Cowlitz,WA,Passenger,54,65,119,70592,70711,0.17,Washington,Washington
13908,November,2017,Skagit,WA,Passenger,159,131,290,89317,89607,0.32,Washington,Washington
13912,November,2017,Snohomish,WA,Passenger,1987,1019,3006,516018,519024,0.58,Washington,Washington
13913,November,2017,Pierce,WA,Passenger,1050,942,1992,526013,528005,0.38,Washington,Washington
13918,November,2017,Chelan,WA,Truck,0,0,0,21519,21519,0.0,Washington,Washington
13920,November,2017,Stevens,WA,Passenger,10,21,31,31554,31585,0.1,Washington,Washington
13921,November,2017,King,WA,Truck,7,1,8,185511,185519,0.0,Washington,Washington
13923,November,2017,Grays Harbor,WA,Passenger,42,41,83,45582,45665,0.18,Washington,Washington
13924,November,2017,San Juan,WA,Truck,0,0,0,5574,5574,0.0,Washington,Washington
13927,November,2017,Island,WA,Passenger,147,156,303,61346,61649,0.49,Washington,Washington
13933,November,2017,Garfield,WA,Passenger,1,0,1,1313,1314,0.08,Washington,Washington
13936,November,2017,Benton,WA,Passenger,165,160,325,129883,130208,0.25,Washington,Washington
13937,November,2017,Lincoln,WA,Passenger,2,5,7,7552,7559,0.09,Washington,Washington
13941,November,2017,Whitman,WA,Passenger,16,19,35,22387,22422,0.16,Washington,Washington
13943,November,2017,Lewis,WA,Passenger,53,39,92,56418,56510,0.16,Washington,Washington
13948,November,2017,Lincoln,WA,Truck,0,0,0,4484,4484,0.0,Washington,Washington
13950,November,2017,Okanogan,WA,Truck,0,0,0,16273,16273,0.0,Washington,Washington
13956,November,2017,Kittitas,WA,Passenger,34,24,58,28271,28329,0.2,Washington,Washington
13958,November,2017,Pierce,WA,Truck,0,0,0,137030,137030,0.0,Washington,Washington
13962,November,2017,Grays Harbor,WA,Truck,0,0,0,20019,20019,0.0,Washington,Washington
13964,November,2017,Asotin,WA,Passenger,7,5,12,12514,12526,0.1,Washington,Washington
13966,November,2017,Chelan,WA,Passenger,83,36,119,52832,52951,0.22,Washington,Washington
13971,November,2017,Adams,WA,Truck,0,0,0,5141,5141,0.0,Washington,Washington
13972,November,2017,Kittitas,WA,Truck,0,0,0,13759,13759,0.0,Washington,Washington
13973,November,2017,Jefferson,WA,Passenger,116,71,187,24182,24369,0.77,Washington,Washington
13974,November,2017,Snohomish,WA,Truck,1,0,1,121380,121381,0.0,Washington,Washington
13975,November,2017,Whatcom,WA,Passenger,524,214,738,144659,145397,0.51,Washington,Washington
13976,November,2017,Yakima,WA,Passenger,57,73,130,161627,161757,0.08,Washington,Washington
13980,November,2017,Pend Oreille,WA,Truck,0,0,0,5595,5595,0.0,Washington,Washington
13982,November,2017,Spokane,WA,Passenger,291,239,530,299642,300172,0.18,Washington,Washington
13983,November,2017,Grant,WA,Passenger,24,33,57,61891,61948,0.09,Washington,Washington
13990,November,2017,Asotin,WA,Truck,0,0,0,6552,6552,0.0,Washington,Washington
13993,November,2017,Walla Walla,WA,Truck,0,0,0,13312,13312,0.0,Washington,Washington
13995,November,2017,Garfield,WA,Truck,0,0,0,937,937,0.0,Washington,Washington
13999,November,2017,Mason,WA,Truck,0,0,0,19540,19540,0.0,Washington,Washington
14000,November,2017,Douglas,WA,Truck,0,0,0,11702,11702,0.0,Washington,Washington
14007,November,2017,Clark,WA,Truck,0,0,0,78247,78247,0.0,Washington,Washington
14012,November,2017,Stevens,WA,Truck,0,0,0,18334,18334,0.0,Washington,Washington
14013,November,2017,Kitsap,WA,Truck,1,0,1,52629,52630,0.0,Washington,Washington
14016,November,2017,Franklin,WA,Truck,0,0,0,18414,18414,0.0,Washington,Washington
14017,November,2017,Skamania,WA,Truck,0,0,0,3893,3893,0.0,Washington,Washington
14018,November,2017,Grant,WA,Truck,0,0,0,25520,25520,0.0,Washington,Washington
14022,November,2018,Kittitas,WA,Passenger,61,34,95,29286,29381,0.32,Washington,Washington
14028,November,2018,Whatcom,WA,Passenger,730,355,1085,149134,150219,0.72,Washington,Washington
14032,November,2018,Adams,WA,Truck,0,0,0,5160,5160,0.0,Washington,Washington
14037,November,2018,Mason,WA,Truck,0,0,0,20190,20190,0.0,Washington,Washington
14038,November,2018,San Juan,WA,Truck,0,0,0,5805,5805,0.0,Washington,Washington
14040,November,2018,Asotin,WA,Truck,0,0,0,6620,6620,0.0,Washington,Washington
14041,November,2018,Whatcom,WA,Truck,2,0,2,42656,42658,0.0,Washington,Washington
14045,November,2018,Garfield,WA,Passenger,1,1,2,1331,1333,0.15,Washington,Washington
14048,November,2018,Pierce,WA,Truck,0,0,0,139061,139061,0.0,Washington,Washington
14049,November,2018,Pend Oreille,WA,Passenger,5,5,10,9557,9567,0.1,Washington,Washington
14052,November,2018,Wahkiakum,WA,Truck,0,0,0,1704,1704,0.0,Washington,Washington
14056,November,2018,Whitman,WA,Truck,0,0,0,8531,8531,0.0,Washington,Washington
14057,November,2018,Chelan,WA,Passenger,135,60,195,54064,54259,0.36,Washington,Washington
14058,November,2018,Spokane,WA,Passenger,408,358,766,306895,307661,0.25,Washington,Washington
14059,November,2018,Clallam,WA,Truck,0,0,0,21613,21613,0.0,Washington,Washington
14061,November,2018,Skamania,WA,Passenger,18,14,32,8731,8763,0.37,Washington,Washington
14062,November,2018,King,WA,Passenger,15784,6398,22182,1377200,1399382,1.59,Washington,Washington
14064,November,2018,Adams,WA,Passenger,5,5,10,12749,12759,0.08,Washington,Washington
14065,November,2018,Yakima,WA,Truck,0,0,0,58751,58751,0.0,Washington,Washington
14066,November,2018,Snohomish,WA,Passenger,2789,1415,4204,526785,530989,0.79,Washington,Washington
14071,November,2018,Clallam,WA,Passenger,147,121,268,50323,50591,0.53,Washington,Washington
14072,November,2018,Columbia,WA,Truck,0,0,0,1516,1516,0.0,Washington,Washington
14076,November,2018,Lewis,WA,Passenger,89,71,160,58211,58371,0.27,Washington,Washington
14079,November,2018,Kitsap,WA,Truck,1,0,1,53652,53653,0.0,Washington,Washington
14080,November,2018,Douglas,WA,Passenger,49,33,82,27967,28049,0.29,Washington,Washington
14081,November,2018,Spokane,WA,Truck,1,0,1,93666,93667,0.0,Washington,Washington
14082,November,2018,Franklin,WA,Truck,0,0,0,18987,18987,0.0,Washington,Washington
14086,November,2018,Lincoln,WA,Truck,0,0,0,4630,4630,0.0,Washington,Washington
14091,November,2018,Wahkiakum,WA,Passenger,1,1,2,2984,2986,0.07,Washington,Washington
14097,November,2018,Chelan,WA,Truck,0,0,0,22082,22082,0.0,Washington,Washington
14098,November,2018,Ferry,WA,Passenger,3,2,5,4383,4388,0.11,Washington,Washington
14100,November,2018,Okanogan,WA,Passenger,15,22,37,26132,26169,0.14,Washington,Washington
14102,November,2018,Grays Harbor,WA,Passenger,61,68,129,47373,47502,0.27,Washington,Washington
14103,November,2018,Island,WA,Truck,0,0,0,21178,21178,0.0,Washington,Washington
14104,November,2018,Benton,WA,Truck,0,0,0,41442,41442,0.0,Washington,Washington
14109,November,2018,Whitman,WA,Passenger,20,35,55,22795,22850,0.24,Washington,Washington
14110,November,2018,Lincoln,WA,Passenger,2,6,8,7771,7779,0.1,Washington,Washington
14112,November,2018,Skagit,WA,Passenger,249,184,433,91187,91620,0.47,Washington,Washington
14115,November,2018,Clark,WA,Truck,0,0,0,79742,79742,0.0,Washington,Washington
14116,November,2018,Thurston,WA,Truck,0,0,0,54923,54923,0.0,Washington,Washington
14120,November,2018,King,WA,Truck,6,1,7,182760,182767,0.0,Washington,Washington
14121,November,2018,Douglas,WA,Truck,0,0,0,12123,12123,0.0,Washington,Washington
14123,November,2018,Skamania,WA,Truck,0,0,0,4005,4005,0.0,Washington,Washington
14124,November,2018,Kitsap,WA,Passenger,916,522,1438,180341,181779,0.79,Washington,Washington
14143,November,2018,Stevens,WA,Truck,0,0,0,18731,18731,0.0,Washington,Washington
14145,November,2018,Pend Oreille,WA,Truck,0,0,0,5742,5742,0.0,Washington,Washington
14146,November,2018,Skagit,WA,Truck,1,0,1,32338,32339,0.0,Washington,Washington
14150,November,2018,Grays Harbor,WA,Truck,0,0,0,20338,20338,0.0,Washington,Washington
14157,November,2018,Yakima,WA,Passenger,78,98,176,164686,164862,0.11,Washington,Washington
14161,November,2018,Klickitat,WA,Truck,0,0,0,8183,8183,0.0,Washington,Washington
14167,November,2018,Columbia,WA,Passenger,2,2,4,2437,2441,0.16,Washington,Washington
14168,November,2018,Walla Walla,WA,Passenger,38,52,90,36092,36182,0.25,Washington,Washington
14169,November,2018,Stevens,WA,Passenger,16,27,43,31791,31834,0.14,Washington,Washington
14172,November,2018,Thurston,WA,Passenger,707,567,1274,195458,196732,0.65,Washington,Washington
14173,November,2018,San Juan,WA,Passenger,176,68,244,14214,14458,1.69,Washington,Washington
14179,November,2018,Island,WA,Passenger,266,224,490,63109,63599,0.77,Washington,Washington
14181,November,2018,Benton,WA,Passenger,210,224,434,132792,133226,0.33,Washington,Washington
14182,November,2018,Franklin,WA,Passenger,38,64,102,58943,59045,0.17,Washington,Washington
14183,November,2018,Walla Walla,WA,Truck,0,0,0,13518,13518,0.0,Washington,Washington
14184,November,2018,Pacific,WA,Passenger,20,23,43,15810,15853,0.27,Washington,Washington
14188,November,2018,Jefferson,WA,Passenger,169,104,273,24795,25068,1.09,Washington,Washington
14189,November,2018,Snohomish,WA,Truck,1,0,1,121952,121953,0.0,Washington,Washington
14191,November,2018,Garfield,WA,Truck,0,0,0,964,964,0.0,Washington,Washington
14192,November,2018,Okanogan,WA,Truck,0,0,0,16492,16492,0.0,Washington,Washington
14194,November,2018,Grant,WA,Passenger,32,52,84,64032,64116,0.13,Washington,Washington
14201,November,2018,Klickitat,WA,Passenger,23,32,55,15421,15476,0.36,Washington,Washington
14203,November,2018,Clark,WA,Passenger,1188,830,2018,310997,313015,0.64,Washington,Washington
14204,November,2018,Ferry,WA,Truck,0,0,0,3582,3582,0.0,Washington,Washington
14209,November,2018,Cowlitz,WA,Passenger,69,91,160,72372,72532,0.22,Washington,Washington
14213,November,2018,Kittitas,WA,Truck,0,0,0,14162,14162,0.0,Washington,Washington
14215,November,2018,Mason,WA,Passenger,103,110,213,46427,46640,0.46,Washington,Washington
14218,November,2018,Lewis,WA,Truck,0,0,0,25625,25625,0.0,Washington,Washington
14220,November,2018,Grant,WA,Truck,0,0,0,26159,26159,0.0,Washington,Washington
14222,November,2018,Cowlitz,WA,Truck,0,0,0,28723,28723,0.0,Washington,Washington
14229,November,2018,Jefferson,WA,Truck,0,0,0,9615,9615,0.0,Washington,Washington
14231,November,2018,Pacific,WA,Truck,0,0,0,7611,7611,0.0,Washington,Washington
14232,November,2018,Asotin,WA,Passenger,12,9,21,12726,12747,0.16,Washington,Washington
14234,November,2018,Pierce,WA,Passenger,1470,1339,2809,538424,541233,0.52,Washington,Washington
14243,November,2019,Asotin,WA,Passenger,13,8,21,12655,12676,0.17,Washington,Washington
14248,November,2019,Wahkiakum,WA,Passenger,4,3,7,3037,3044,0.23,Washington,Washington
14250,November,2019,Grant,WA,Truck,0,0,0,26953,26953,0.0,Washington,Washington
14252,November,2019,Skamania,WA,Truck,0,0,0,4096,4096,0.0,Washington,Washington
14258,November,2019,Jefferson,WA,Truck,0,0,0,9654,9654,0.0,Washington,Washington
14260,November,2019,Pacific,WA,Passenger,29,30,59,16115,16174,0.36,Washington,Washington
14261,November,2019,Whatcom,WA,Truck,2,0,2,43148,43150,0.0,Washington,Washington
14271,November,2019,Lincoln,WA,Truck,0,0,0,4695,4695,0.0,Washington,Washington
14272,November,2019,Clallam,WA,Passenger,195,153,348,50908,51256,0.68,Washington,Washington
14273,November,2019,Lewis,WA,Passenger,109,103,212,59509,59721,0.35,Washington,Washington
14277,November,2019,Walla Walla,WA,Truck,0,0,0,13674,13674,0.0,Washington,Washington
14278,November,2019,Wahkiakum,WA,Truck,0,0,0,1752,1752,0.0,Washington,Washington
14284,November,2019,Jefferson,WA,Passenger,212,132,344,25183,25527,1.35,Washington,Washington
14286,November,2019,Island,WA,Passenger,363,251,614,63666,64280,0.96,Washington,Washington
14294,November,2019,Ferry,WA,Passenger,5,2,7,4414,4421,0.16,Washington,Washington
14295,November,2019,San Juan,WA,Truck,0,0,0,5929,5929,0.0,Washington,Washington
14296,November,2019,Benton,WA,Truck,0,0,0,42413,42413,0.0,Washington,Washington
14297,November,2019,Asotin,WA,Truck,0,0,0,6694,6694,0.0,Washington,Washington
14303,November,2019,Okanogan,WA,Passenger,27,30,57,26234,26291,0.22,Washington,Washington
14304,November,2019,Kitsap,WA,Passenger,1190,649,1839,182242,184081,1.0,Washington,Washington
14305,November,2019,Franklin,WA,Passenger,53,75,128,60785,60913,0.21,Washington,Washington
14306,November,2019,Chelan,WA,Passenger,196,75,271,54642,54913,0.49,Washington,Washington
14308,November,2019,Skagit,WA,Passenger,347,210,557,92574,93131,0.6,Washington,Washington
14310,November,2019,Whitman,WA,Truck,0,0,0,8581,8581,0.0,Washington,Washington
14311,November,2019,Spokane,WA,Truck,1,0,1,96217,96218,0.0,Washington,Washington
14313,November,2019,Kitsap,WA,Truck,1,0,1,54405,54406,0.0,Washington,Washington
14314,November,2019,Pend Oreille,WA,Truck,0,0,0,5733,5733,0.0,Washington,Washington
14319,November,2019,Cowlitz,WA,Truck,0,0,0,29029,29029,0.0,Washington,Washington
14321,November,2019,King,WA,Truck,6,1,7,182343,182350,0.0,Washington,Washington
14326,November,2019,Douglas,WA,Passenger,65,38,103,28288,28391,0.36,Washington,Washington
14330,November,2019,Skamania,WA,Passenger,26,20,46,8789,8835,0.52,Washington,Washington
14331,November,2019,Stevens,WA,Truck,0,0,0,18795,18795,0.0,Washington,Washington
14333,November,2019,Stevens,WA,Passenger,31,30,61,31606,31667,0.19,Washington,Washington
14335,November,2019,Adams,WA,Passenger,6,7,13,12928,12941,0.1,Washington,Washington
14336,November,2019,Pierce,WA,Passenger,2083,1635,3718,547543,551261,0.67,Washington,Washington
14344,November,2019,Clark,WA,Truck,0,0,0,81279,81279,0.0,Washington,Washington
14345,November,2019,San Juan,WA,Passenger,243,78,321,14405,14726,2.18,Washington,Washington
14349,November,2019,Thurston,WA,Truck,0,0,0,55656,55656,0.0,Washington,Washington
14351,November,2019,Mason,WA,Passenger,140,130,270,47611,47881,0.56,Washington,Washington
14352,November,2019,Benton,WA,Passenger,310,308,618,135108,135726,0.46,Washington,Washington
14354,November,2019,Whatcom,WA,Passenger,964,470,1434,151593,153027,0.94,Washington,Washington
14356,November,2019,Grays Harbor,WA,Truck,0,0,0,20750,20750,0.0,Washington,Washington
14357,November,2019,Whitman,WA,Passenger,41,46,87,22704,22791,0.38,Washington,Washington
14363,November,2019,Grant,WA,Passenger,53,65,118,65498,65616,0.18,Washington,Washington
14369,November,2019,Garfield,WA,Passenger,0,1,1,1304,1305,0.08,Washington,Washington
14370,November,2019,Lewis,WA,Truck,0,0,0,26110,26110,0.0,Washington,Washington
14371,November,2019,Thurston,WA,Passenger,1035,700,1735,199127,200862,0.86,Washington,Washington
14372,November,2019,King,WA,Passenger,21598,7457,29055,1395552,1424607,2.04,Washington,Washington
14375,November,2019,Columbia,WA,Passenger,3,2,5,2443,2448,0.2,Washington,Washington
14380,November,2019,Garfield,WA,Truck,0,0,0,965,965,0.0,Washington,Washington
14384,November,2019,Clark,WA,Passenger,1806,1025,2831,317525,320356,0.88,Washington,Washington
14388,November,2019,Lincoln,WA,Passenger,1,11,12,7798,7810,0.15,Washington,Washington
14394,November,2019,Skagit,WA,Truck,1,0,1,32541,32542,0.0,Washington,Washington
14398,November,2019,Walla Walla,WA,Passenger,64,61,125,36282,36407,0.34,Washington,Washington
14400,November,2019,Island,WA,Truck,1,0,1,21317,21318,0.0,Washington,Washington
14402,November,2019,Kittitas,WA,Passenger,89,46,135,30012,30147,0.45,Washington,Washington
14404,November,2019,Snohomish,WA,Truck,0,0,0,123166,123166,0.0,Washington,Washington
14405,November,2019,Yakima,WA,Truck,0,0,0,59589,59589,0.0,Washington,Washington
14409,November,2019,Pacific,WA,Truck,0,0,0,7740,7740,0.0,Washington,Washington
14413,November,2019,Klickitat,WA,Passenger,45,38,83,15673,15756,0.53,Washington,Washington
14414,November,2019,Kittitas,WA,Truck,0,0,0,14619,14619,0.0,Washington,Washington
14418,November,2019,Pend Oreille,WA,Passenger,7,7,14,9516,9530,0.15,Washington,Washington
14424,November,2019,Cowlitz,WA,Passenger,114,106,220,73591,73811,0.3,Washington,Washington
14426,November,2019,Spokane,WA,Passenger,631,470,1101,314632,315733,0.35,Washington,Washington
14428,November,2019,Douglas,WA,Truck,0,0,0,12301,12301,0.0,Washington,Washington
14432,November,2019,Ferry,WA,Truck,0,0,0,3581,3581,0.0,Washington,Washington
14433,November,2019,Grays Harbor,WA,Passenger,99,99,198,48351,48549,0.41,Washington,Washington
14435,November,2019,Franklin,WA,Truck,0,0,0,19729,19729,0.0,Washington,Washington
14440,November,2019,Chelan,WA,Truck,0,0,0,22517,22517,0.0,Washington,Washington
14446,November,2019,Columbia,WA,Truck,0,0,0,1535,1535,0.0,Washington,Washington
14447,November,2019,Snohomish,WA,Passenger,3943,1706,5649,535420,541069,1.04,Washington,Washington
14449,November,2019,Okanogan,WA,Truck,0,0,0,16557,16557,0.0,Washington,Washington
14451,November,2019,Adams,WA,Truck,0,0,0,5184,5184,0.0,Washington,Washington
14454,November,2019,Clallam,WA,Truck,1,0,1,21847,21848,0.0,Washington,Washington
14455,November,2019,Pierce,WA,Truck,0,0,0,140707,140707,0.0,Washington,Washington
14465,November,2019,Yakima,WA,Passenger,117,116,233,166000,166233,0.14,Washington,Washington
14467,November,2019,Klickitat,WA,Truck,0,0,0,8306,8306,0.0,Washington,Washington
14470,November,2019,Mason,WA,Truck,0,0,0,20508,20508,0.0,Washington,Washington
14476,November,2020,Adams,WA,Passenger,10,6,16,12942,12958,0.12,Washington,Washington
14477,November,2020,Walla Walla,WA,Passenger,95,66,161,36066,36227,0.44,Washington,Washington
14480,November,2020,Pend Oreille,WA,Truck,0,0,0,5718,5718,0.0,Washington,Washington
14482,November,2020,Skamania,WA,Passenger,33,21,54,8305,8359,0.65,Washington,Washington
14483,November,2020,San Juan,WA,Truck,0,0,0,5866,5866,0.0,Washington,Washington
14485,November,2020,Clallam,WA,Passenger,262,176,438,49872,50310,0.87,Washington,Washington
14498,November,2020,Pierce,WA,Passenger,2759,1756,4515,554918,559433,0.81,Washington,Washington
14499,November,2020,Whitman,WA,Passenger,51,44,95,21963,22058,0.43,Washington,Washington
14500,November,2020,Lewis,WA,Truck,0,0,0,26547,26547,0.0,Washington,Washington
14503,November,2020,Cowlitz,WA,Truck,0,0,0,28871,28871,0.0,Washington,Washington
14504,November,2020,Yakima,WA,Passenger,166,122,288,167009,167297,0.17,Washington,Washington
14505,November,2020,Adams,WA,Truck,0,0,0,5325,5325,0.0,Washington,Washington
14506,November,2020,Mason,WA,Truck,0,0,0,20860,20860,0.0,Washington,Washington
14508,November,2020,Mason,WA,Passenger,169,135,304,47500,47804,0.64,Washington,Washington
14510,November,2020,Skagit,WA,Truck,1,0,1,32715,32716,0.0,Washington,Washington
14513,November,2020,King,WA,Truck,6,1,7,184180,184187,0.0,Washington,Washington
14514,November,2020,Asotin,WA,Truck,0,0,0,6665,6665,0.0,Washington,Washington
14516,November,2020,Pacific,WA,Passenger,36,34,70,15737,15807,0.44,Washington,Washington
14521,November,2020,Spokane,WA,Passenger,859,542,1401,320275,321676,0.44,Washington,Washington
14523,November,2020,Stevens,WA,Passenger,36,39,75,30275,30350,0.25,Washington,Washington
14525,November,2020,Garfield,WA,Truck,0,0,0,997,997,0.0,Washington,Washington
14529,November,2020,Thurston,WA,Passenger,1290,763,2053,197232,199285,1.03,Washington,Washington
14532,November,2020,Jefferson,WA,Passenger,276,153,429,24728,25157,1.71,Washington,Washington
14534,November,2020,Columbia,WA,Truck,0,0,0,1530,1530,0.0,Washington,Washington
14535,November,2020,Kittitas,WA,Truck,0,0,0,14645,14645,0.0,Washington,Washington
14540,November,2020,Okanogan,WA,Passenger,51,37,88,25984,26072,0.34,Washington,Washington
14545,November,2020,Asotin,WA,Passenger,17,14,31,12411,12442,0.25,Washington,Washington
14552,November,2020,Clark,WA,Passenger,2284,1140,3424,318828,322252,1.06,Washington,Washington
14553,November,2020,Snohomish,WA,Passenger,4956,1823,6779,538061,544840,1.24,Washington,Washington
14555,November,2020,San Juan,WA,Passenger,355,106,461,14017,14478,3.18,Washington,Washington
14559,November,2020,Benton,WA,Passenger,426,348,774,134791,135565,0.57,Washington,Washington
14567,November,2020,Klickitat,WA,Truck,0,0,0,8086,8086,0.0,Washington,Washington
14573,November,2020,Island,WA,Passenger,480,287,767,62942,63709,1.2,Washington,Washington
14575,November,2020,Stevens,WA,Truck,0,0,0,18671,18671,0.0,Washington,Washington
14581,November,2020,Douglas,WA,Passenger,82,43,125,28127,28252,0.44,Washington,Washington
14582,November,2020,Whatcom,WA,Truck,3,0,3,43487,43490,0.01,Washington,Washington
14587,November,2020,Klickitat,WA,Passenger,62,42,104,14976,15080,0.69,Washington,Washington
14591,November,2020,Wahkiakum,WA,Truck,0,0,0,1766,1766,0.0,Washington,Washington
14593,November,2020,Skagit,WA,Passenger,481,235,716,91415,92131,0.78,Washington,Washington
14599,November,2020,Snohomish,WA,Truck,0,0,0,125469,125469,0.0,Washington,Washington
14600,November,2020,Grant,WA,Passenger,78,79,157,65766,65923,0.24,Washington,Washington
14602,November,2020,Chelan,WA,Truck,0,0,0,22778,22778,0.0,Washington,Washington
14603,November,2020,Clark,WA,Truck,0,0,0,83228,83228,0.0,Washington,Washington
14608,November,2020,Clallam,WA,Truck,1,0,1,21782,21783,0.0,Washington,Washington
14610,November,2020,Whitman,WA,Truck,0,0,0,8487,8487,0.0,Washington,Washington
14613,November,2020,Lewis,WA,Passenger,117,117,234,58633,58867,0.4,Washington,Washington
14614,November,2020,Cowlitz,WA,Passenger,170,124,294,72016,72310,0.41,Washington,Washington
14615,November,2020,Jefferson,WA,Truck,0,0,0,9582,9582,0.0,Washington,Washington
14622,November,2020,Grays Harbor,WA,Passenger,122,117,239,48546,48785,0.49,Washington,Washington
14624,November,2020,Franklin,WA,Truck,0,0,0,20378,20378,0.0,Washington,Washington
14629,November,2020,Walla Walla,WA,Truck,0,0,0,13819,13819,0.0,Washington,Washington
14634,November,2020,Ferry,WA,Passenger,8,3,11,4347,4358,0.25,Washington,Washington
14637,November,2020,Pierce,WA,Truck,0,0,0,144543,144543,0.0,Washington,Washington
14643,November,2020,Pacific,WA,Truck,0,0,0,7762,7762,0.0,Washington,Washington
14644,November,2020,Okanogan,WA,Truck,0,0,0,16579,16579,0.0,Washington,Washington
14646,November,2020,Whatcom,WA,Passenger,1203,534,1737,149736,151473,1.15,Washington,Washington
14650,November,2020,Kittitas,WA,Passenger,125,52,177,29743,29920,0.59,Washington,Washington
14651,November,2020,Benton,WA,Truck,0,0,0,43111,43111,0.0,Washington,Washington
14653,November,2020,Kitsap,WA,Passenger,1521,737,2258,179773,182031,1.24,Washington,Washington
14656,November,2020,Yakima,WA,Truck,0,0,0,60772,60772,0.0,Washington,Washington
14661,November,2020,Island,WA,Truck,0,0,0,21304,21304,0.0,Washington,Washington
14664,November,2020,Garfield,WA,Passenger,0,1,1,1363,1364,0.07,Washington,Washington
14667,November,2020,Lincoln,WA,Truck,0,0,0,4660,4660,0.0,Washington,Washington
14668,November,2020,Spokane,WA,Truck,0,0,0,100377,100377,0.0,Washington,Washington
14670,November,2020,Skamania,WA,Truck,0,0,0,4008,4008,0.0,Washington,Washington
14672,November,2020,Pend Oreille,WA,Passenger,9,4,13,9146,9159,0.14,Washington,Washington
14684,November,2020,Lincoln,WA,Passenger,5,11,16,7617,7633,0.21,Washington,Washington
14686,November,2020,Grays Harbor,WA,Truck,0,0,0,21133,21133,0.0,Washington,Washington
14687,November,2020,Columbia,WA,Passenger,4,3,7,2439,2446,0.29,Washington,Washington
14692,November,2020,Franklin,WA,Passenger,78,80,158,61166,61324,0.26,Washington,Washington
14693,November,2020,Kitsap,WA,Truck,0,0,0,54292,54292,0.0,Washington,Washington
14697,November,2020,Grant,WA,Truck,0,0,0,27418,27418,0.0,Washington,Washington
14702,November,2020,Thurston,WA,Truck,0,0,0,56280,56280,0.0,Washington,Washington
14707,November,2020,Ferry,WA,Truck,0,0,0,3598,3598,0.0,Washington,Washington
14709,November,2020,Wahkiakum,WA,Passenger,6,6,12,3039,3051,0.39,Washington,Washington
14713,November,2020,King,WA,Passenger,26599,8083,34682,1371168,1405850,2.47,Washington,Washington
14715,November,2020,Chelan,WA,Passenger,271,84,355,54377,54732,0.65,Washington,Washington
14717,November,2020,Douglas,WA,Truck,0,0,0,12451,12451,0.0,Washington,Washington
14721,November,2021,Whitman,WA,Passenger,66,58,124,21959,22083,0.56,Washington,Washington
14729,November,2021,Spokane,WA,Passenger,1262,748,2010,327064,329074,0.61,Washington,Washington
14733,November,2021,Douglas,WA,Passenger,106,53,159,28610,28769,0.55,Washington,Washington
14738,November,2021,Benton,WA,Truck,0,0,0,43650,43650,0.0,Washington,Washington
14742,November,2021,Mason,WA,Passenger,255,158,413,47799,48212,0.86,Washington,Washington
14745,November,2021,Benton,WA,Passenger,625,435,1060,136011,137071,0.77,Washington,Washington
14757,November,2021,Snohomish,WA,Truck,2,0,2,125685,125687,0.0,Washington,Washington
14760,November,2021,Pend Oreille,WA,Truck,0,0,0,5696,5696,0.0,Washington,Washington
14763,November,2021,Wahkiakum,WA,Truck,0,0,0,1817,1817,0.0,Washington,Washington
14765,November,2021,Stevens,WA,Passenger,54,43,97,30313,30410,0.32,Washington,Washington
14768,November,2021,Skamania,WA,Passenger,57,40,97,8344,8441,1.15,Washington,Washington
14769,November,2021,San Juan,WA,Passenger,473,147,620,14195,14815,4.18,Washington,Washington
14770,November,2021,Klickitat,WA,Truck,0,0,0,8335,8335,0.0,Washington,Washington
14772,November,2021,Yakima,WA,Truck,0,0,0,61715,61715,0.0,Washington,Washington
14773,November,2021,Yakima,WA,Passenger,272,167,439,168647,169086,0.26,Washington,Washington
14774,November,2021,Island,WA,Passenger,701,342,1043,62971,64014,1.63,Washington,Washington
14779,November,2021,Grant,WA,Passenger,131,97,228,66942,67170,0.34,Washington,Washington
14783,November,2021,Columbia,WA,Passenger,6,2,8,2459,2467,0.32,Washington,Washington
14785,November,2021,Skagit,WA,Truck,1,0,1,32804,32805,0.0,Washington,Washington
14786,November,2021,Kitsap,WA,Passenger,2083,941,3024,180487,183511,1.65,Washington,Washington
14788,November,2021,Columbia,WA,Truck,0,0,0,1552,1552,0.0,Washington,Washington
14791,November,2021,Jefferson,WA,Passenger,372,195,567,24790,25357,2.24,Washington,Washington
14793,November,2021,Ferry,WA,Truck,0,0,0,3600,3600,0.0,Washington,Washington
14802,November,2021,Skamania,WA,Truck,0,0,0,4003,4003,0.0,Washington,Washington
14804,November,2021,King,WA,Passenger,34716,10089,44805,1362899,1407704,3.18,Washington,Washington
14808,November,2021,Thurston,WA,Passenger,1845,949,2794,197125,199919,1.4,Washington,Washington
14810,November,2021,Okanogan,WA,Truck,0,0,0,16689,16689,0.0,Washington,Washington
14814,November,2021,Whatcom,WA,Passenger,1611,660,2271,150227,152498,1.49,Washington,Washington
14817,November,2021,San Juan,WA,Truck,0,0,0,5996,5996,0.0,Washington,Washington
14820,November,2021,Pacific,WA,Truck,0,0,0,8004,8004,0.0,Washington,Washington
14828,November,2021,Pierce,WA,Passenger,4130,2111,6241,557334,563575,1.11,Washington,Washington
14831,November,2021,Walla Walla,WA,Passenger,137,85,222,36395,36617,0.61,Washington,Washington
14833,November,2021,Kittitas,WA,Truck,0,0,0,14805,14805,0.0,Washington,Washington
14835,November,2021,Klickitat,WA,Passenger,88,52,140,15349,15489,0.9,Washington,Washington
14836,November,2021,Cowlitz,WA,Truck,0,1,1,29027,29028,0.0,Washington,Washington
14842,November,2021,Asotin,WA,Truck,0,0,0,6760,6760,0.0,Washington,Washington
14844,November,2021,Jefferson,WA,Truck,0,0,0,9601,9601,0.0,Washington,Washington
14850,November,2021,Lincoln,WA,Passenger,7,16,23,7693,7716,0.3,Washington,Washington
14851,November,2021,Asotin,WA,Passenger,21,17,38,12753,12791,0.3,Washington,Washington
14863,November,2021,Douglas,WA,Truck,0,0,0,12693,12693,0.0,Washington,Washington
14866,November,2021,Franklin,WA,Truck,0,0,0,20782,20782,0.0,Washington,Washington
14872,November,2021,Garfield,WA,Truck,0,0,0,995,995,0.0,Washington,Washington
14875,November,2021,Pend Oreille,WA,Passenger,18,7,25,9167,9192,0.27,Washington,Washington
14876,November,2021,Lewis,WA,Passenger,199,163,362,59631,59993,0.6,Washington,Washington
14879,November,2021,Lewis,WA,Truck,0,0,0,26719,26719,0.0,Washington,Washington
14883,November,2021,Clark,WA,Truck,0,0,0,84070,84070,0.0,Washington,Washington
14888,November,2021,Wahkiakum,WA,Passenger,17,10,27,3091,3118,0.87,Washington,Washington
14889,November,2021,Stevens,WA,Truck,0,0,0,18924,18924,0.0,Washington,Washington
14893,November,2021,Snohomish,WA,Passenger,6837,2229,9066,538413,547479,1.66,Washington,Washington
14894,November,2021,Cowlitz,WA,Passenger,265,159,424,71773,72197,0.59,Washington,Washington
14895,November,2021,Kitsap,WA,Truck,0,0,0,54275,54275,0.0,Washington,Washington
14897,November,2021,Walla Walla,WA,Truck,0,0,0,14078,14078,0.0,Washington,Washington
14900,November,2021,Grays Harbor,WA,Truck,0,0,0,21428,21428,0.0,Washington,Washington
14902,November,2021,Adams,WA,Truck,0,0,0,5421,5421,0.0,Washington,Washington
14908,November,2021,Whatcom,WA,Truck,4,0,4,43702,43706,0.01,Washington,Washington
14913,November,2021,Thurston,WA,Truck,0,0,0,56178,56178,0.0,Washington,Washington
14914,November,2021,Clark,WA,Passenger,3363,1536,4899,320835,325734,1.5,Washington,Washington
14916,November,2021,Lincoln,WA,Truck,0,0,0,4811,4811,0.0,Washington,Washington
14921,November,2021,Okanogan,WA,Passenger,67,43,110,26601,26711,0.41,Washington,Washington
14922,November,2021,Clallam,WA,Passenger,372,238,610,50508,51118,1.19,Washington,Washington
14924,November,2021,Spokane,WA,Truck,0,0,0,102699,102699,0.0,Washington,Washington
14926,November,2021,Whitman,WA,Truck,0,0,0,8556,8556,0.0,Washington,Washington
14927,November,2021,Chelan,WA,Passenger,400,113,513,54703,55216,0.93,Washington,Washington
14929,November,2021,King,WA,Truck,6,1,7,183330,183337,0.0,Washington,Washington
14937,November,2021,Island,WA,Truck,0,0,0,21547,21547,0.0,Washington,Washington
14939,November,2021,Adams,WA,Passenger,16,14,30,13044,13074,0.23,Washington,Washington
14940,November,2021,Franklin,WA,Passenger,154,103,257,62279,62536,0.41,Washington,Washington
14941,November,2021,Skagit,WA,Passenger,667,299,966,91301,92267,1.05,Washington,Washington
14942,November,2021,Ferry,WA,Passenger,13,3,16,4457,4473,0.36,Washington,Washington
14945,November,2021,Grays Harbor,WA,Passenger,191,155,346,49503,49849,0.69,Washington,Washington
14955,November,2021,Pierce,WA,Truck,0,0,0,145138,145138,0.0,Washington,Washington
14957,November,2021,Kittitas,WA,Passenger,196,75,271,29843,30114,0.9,Washington,Washington
14958,November,2021,Pacific,WA,Passenger,51,64,115,16071,16186,0.71,Washington,Washington
14961,November,2021,Clallam,WA,Truck,1,0,1,22115,22116,0.0,Washington,Washington
14962,November,2021,Mason,WA,Truck,0,0,0,21254,21254,0.0,Washington,Washington
14963,November,2021,Grant,WA,Truck,0,0,0,28045,28045,0.0,Washington,Washington
14969,November,2021,Chelan,WA,Truck,0,0,0,23094,23094,0.0,Washington,Washington
14970,November,2021,Garfield,WA,Passenger,0,3,3,1350,1353,0.22,Washington,Washington
14984,November,2022,Whitman,WA,Passenger,109,65,174,21989,22163,0.79,Washington,Washington
14986,November,2022,Grays Harbor,WA,Passenger,242,161,403,48681,49084,0.82,Washington,Washington
14990,November,2022,Whatcom,WA,Passenger,2054,800,2854,148864,151718,1.88,Washington,Washington
14993,November,2022,King,WA,Truck,337,2,339,179007,179346,0.19,Washington,Washington
14997,November,2022,Wahkiakum,WA,Passenger,25,13,38,3045,3083,1.23,Washington,Washington
14998,November,2022,Franklin,WA,Passenger,246,117,363,61801,62164,0.58,Washington,Washington
14999,November,2022,Douglas,WA,Passenger,162,59,221,28510,28731,0.77,Washington,Washington
15001,November,2022,Island,WA,Passenger,922,394,1316,61562,62878,2.09,Washington,Washington
15003,November,2022,Douglas,WA,Truck,2,0,2,12811,12813,0.02,Washington,Washington
15009,November,2022,Chelan,WA,Truck,11,0,11,23139,23150,0.05,Washington,Washington
15020,November,2022,San Juan,WA,Truck,7,0,7,5939,5946,0.12,Washington,Washington
15021,November,2022,Pierce,WA,Truck,71,0,71,139968,140039,0.05,Washington,Washington
15025,November,2022,Ferry,WA,Passenger,24,4,28,4370,4398,0.64,Washington,Washington
15026,November,2022,Benton,WA,Truck,7,0,7,43416,43423,0.02,Washington,Washington
15036,November,2022,Pierce,WA,Passenger,5996,2477,8473,540119,548592,1.54,Washington,Washington
15039,November,2022,Garfield,WA,Truck,0,0,0,981,981,0.0,Washington,Washington
15042,November,2022,Stevens,WA,Passenger,88,56,144,30077,30221,0.48,Washington,Washington
15050,November,2022,Adams,WA,Passenger,22,11,33,13032,13065,0.25,Washington,Washington
15052,November,2022,Ferry,WA,Truck,0,0,0,3579,3579,0.0,Washington,Washington
15055,November,2022,Asotin,WA,Passenger,29,20,49,12522,12571,0.39,Washington,Washington
15058,November,2022,Cowlitz,WA,Passenger,389,188,577,70283,70860,0.81,Washington,Washington
15059,November,2022,Jefferson,WA,Truck,6,0,6,9386,9392,0.06,Washington,Washington
15060,November,2022,Benton,WA,Passenger,914,491,1405,135879,137284,1.02,Washington,Washington
15066,November,2022,Lewis,WA,Passenger,260,178,438,59990,60428,0.72,Washington,Washington
15068,November,2022,Island,WA,Truck,15,0,15,21264,21279,0.07,Washington,Washington
15071,November,2022,Clallam,WA,Passenger,470,261,731,49431,50162,1.46,Washington,Washington
15074,November,2022,Clark,WA,Passenger,4776,1979,6755,315151,321906,2.1,Washington,Washington
15079,November,2022,Grant,WA,Passenger,220,110,330,66830,67160,0.49,Washington,Washington
15080,November,2022,Kitsap,WA,Passenger,2699,1134,3833,177551,181384,2.11,Washington,Washington
15083,November,2022,Lincoln,WA,Passenger,12,19,31,7772,7803,0.4,Washington,Washington
15086,November,2022,Grant,WA,Truck,4,0,4,27996,28000,0.01,Washington,Washington
15090,November,2022,Whatcom,WA,Truck,21,0,21,43111,43132,0.05,Washington,Washington
15092,November,2022,Spokane,WA,Truck,19,0,19,101973,101992,0.02,Washington,Washington
15096,November,2022,Whitman,WA,Truck,3,0,3,8630,8633,0.03,Washington,Washington
15099,November,2022,Lewis,WA,Truck,2,0,2,26343,26345,0.01,Washington,Washington
15104,November,2022,Grays Harbor,WA,Truck,3,0,3,21117,21120,0.01,Washington,Washington
15106,November,2022,Columbia,WA,Truck,0,0,0,1591,1591,0.0,Washington,Washington
15109,November,2022,Lincoln,WA,Truck,0,0,0,4862,4862,0.0,Washington,Washington
15110,November,2022,Yakima,WA,Passenger,410,218,628,166511,167139,0.38,Washington,Washington
15112,November,2022,San Juan,WA,Passenger,554,168,722,13981,14703,4.91,Washington,Washington
15113,November,2022,Clark,WA,Truck,39,0,39,82070,82109,0.05,Washington,Washington
15114,November,2022,Kittitas,WA,Passenger,297,93,390,29569,29959,1.3,Washington,Washington
15118,November,2022,Cowlitz,WA,Truck,4,0,4,28412,28416,0.01,Washington,Washington
15120,November,2022,Skagit,WA,Passenger,908,352,1260,89513,90773,1.39,Washington,Washington
15124,November,2022,Pend Oreille,WA,Truck,0,0,0,5602,5602,0.0,Washington,Washington
15126,November,2022,Adams,WA,Truck,1,0,1,5396,5397,0.02,Washington,Washington
15128,November,2022,Walla Walla,WA,Passenger,201,108,309,35703,36012,0.86,Washington,Washington
15129,November,2022,Thurston,WA,Passenger,2552,1116,3668,192629,196297,1.87,Washington,Washington
15134,November,2022,Kitsap,WA,Truck,28,0,28,53049,53077,0.05,Washington,Washington
15138,November,2022,King,WA,Passenger,46991,12053,59044,1341209,1400253,4.22,Washington,Washington
15141,November,2022,Asotin,WA,Truck,0,0,0,6694,6694,0.0,Washington,Washington
15145,November,2022,Skamania,WA,Passenger,89,51,140,8127,8267,1.69,Washington,Washington
15156,November,2022,Stevens,WA,Truck,2,0,2,18874,18876,0.01,Washington,Washington
15159,November,2022,Yakima,WA,Truck,6,0,6,61264,61270,0.01,Washington,Washington
15163,November,2022,Pacific,WA,Passenger,70,79,149,15759,15908,0.94,Washington,Washington
15164,November,2022,Snohomish,WA,Truck,79,0,79,122767,122846,0.06,Washington,Washington
15165,November,2022,Kittitas,WA,Truck,5,0,5,14582,14587,0.03,Washington,Washington
15166,November,2022,Spokane,WA,Passenger,1896,915,2811,324763,327574,0.86,Washington,Washington
15168,November,2022,Jefferson,WA,Passenger,474,229,703,24392,25095,2.8,Washington,Washington
15169,November,2022,Wahkiakum,WA,Truck,1,0,1,1804,1805,0.06,Washington,Washington
15171,November,2022,Skamania,WA,Truck,0,0,0,3892,3892,0.0,Washington,Washington
15174,November,2022,Pend Oreille,WA,Passenger,19,13,32,8989,9021,0.35,Washington,Washington
15175,November,2022,Columbia,WA,Passenger,8,1,9,2431,2440,0.37,Washington,Washington
15178,November,2022,Snohomish,WA,Passenger,9877,2716,12593,530771,543364,2.32,Washington,Washington
15179,November,2022,Klickitat,WA,Truck,3,0,3,8251,8254,0.04,Washington,Washington
15181,November,2022,Franklin,WA,Truck,3,0,3,20955,20958,0.01,Washington,Washington
15182,November,2022,Clallam,WA,Truck,8,0,8,21885,21893,0.04,Washington,Washington
15186,November,2022,Okanogan,WA,Truck,2,0,2,16474,16476,0.01,Washington,Washington
15190,November,2022,Okanogan,WA,Passenger,98,51,149,26251,26400,0.56,Washington,Washington
15194,November,2022,Walla Walla,WA,Truck,3,0,3,13912,13915,0.02,Washington,Washington
15198,November,2022,Pacific,WA,Truck,1,0,1,7853,7854,0.01,Washington,Washington
15201,November,2022,Mason,WA,Truck,7,0,7,20895,20902,0.03,Washington,Washington
15205,November,2022,Garfield,WA,Passenger,1,3,4,1307,1311,0.31,Washington,Washington
15207,November,2022,Thurston,WA,Truck,34,0,34,54782,54816,0.06,Washington,Washington
15213,November,2022,Klickitat,WA,Passenger,120,53,173,15133,15306,1.13,Washington,Washington
15214,November,2022,Skagit,WA,Truck,8,0,8,32208,32216,0.02,Washington,Washington
15215,November,2022,Mason,WA,Passenger,360,190,550,46961,47511,1.16,Washington,Washington
15217,November,2022,Chelan,WA,Passenger,525,142,667,54281,54948,1.21,Washington,Washington
15220,October,2017,Adams,WA,Passenger,3,3,6,12283,12289,0.05,Washington,Washington
15221,October,2017,Mason,WA,Truck,0,0,0,19470,19470,0.0,Washington,Washington
15222,October,2017,Pend Oreille,WA,Passenger,3,4,7,9370,9377,0.07,Washington,Washington
15227,October,2017,Grant,WA,Passenger,20,33,53,61666,61719,0.09,Washington,Washington
15228,October,2017,Garfield,WA,Truck,0,0,0,943,943,0.0,Washington,Washington
15229,October,2017,Thurston,WA,Truck,0,0,0,53577,53577,0.0,Washington,Washington
15235,October,2017,Wahkiakum,WA,Truck,0,0,0,1672,1672,0.0,Washington,Washington
15238,October,2017,Franklin,WA,Passenger,31,49,80,56508,56588,0.14,Washington,Washington
15240,October,2017,Adams,WA,Truck,0,0,0,5135,5135,0.0,Washington,Washington
15242,October,2017,Whatcom,WA,Truck,2,0,2,41876,41878,0.0,Washington,Washington
15243,October,2017,Lewis,WA,Truck,0,0,0,25209,25209,0.0,Washington,Washington
15245,October,2017,Skamania,WA,Passenger,10,7,17,8571,8588,0.2,Washington,Washington
15247,October,2017,Grays Harbor,WA,Passenger,38,41,79,45374,45453,0.17,Washington,Washington
15249,October,2017,Ferry,WA,Truck,0,0,0,3549,3549,0.0,Washington,Washington
15250,October,2017,San Juan,WA,Truck,0,0,0,5569,5569,0.0,Washington,Washington
15251,October,2017,Douglas,WA,Truck,0,0,0,11656,11656,0.0,Washington,Washington
15252,October,2017,Yakima,WA,Truck,0,0,0,57813,57813,0.0,Washington,Washington
15254,October,2017,Grays Harbor,WA,Truck,0,0,0,20007,20007,0.0,Washington,Washington
15255,October,2017,Cowlitz,WA,Passenger,54,65,119,70430,70549,0.17,Washington,Washington
15258,October,2017,Whitman,WA,Passenger,12,20,32,22299,22331,0.14,Washington,Washington
15264,October,2017,Pierce,WA,Passenger,1040,916,1956,525482,527438,0.37,Washington,Washington
15267,October,2017,Clallam,WA,Truck,0,0,0,21147,21147,0.0,Washington,Washington
15268,October,2017,Clark,WA,Passenger,829,559,1388,302262,303650,0.46,Washington,Washington
15272,October,2017,Asotin,WA,Passenger,7,5,12,12479,12491,0.1,Washington,Washington
15275,October,2017,Benton,WA,Truck,0,0,0,40386,40386,0.0,Washington,Washington
15277,October,2017,Mason,WA,Passenger,61,74,135,44453,44588,0.3,Washington,Washington
15280,October,2017,Benton,WA,Passenger,164,155,319,129410,129729,0.25,Washington,Washington
15281,October,2017,Kitsap,WA,Truck,1,0,1,52588,52589,0.0,Washington,Washington
15282,October,2017,Snohomish,WA,Passenger,1947,999,2946,515244,518190,0.57,Washington,Washington
15283,October,2017,Klickitat,WA,Truck,0,0,0,8005,8005,0.0,Washington,Washington
15289,October,2017,Skagit,WA,Truck,1,0,1,31629,31630,0.0,Washington,Washington
15291,October,2017,Thurston,WA,Passenger,442,371,813,188869,189682,0.43,Washington,Washington
15292,October,2017,Clark,WA,Truck,0,0,0,78122,78122,0.0,Washington,Washington
15293,October,2017,Pacific,WA,Passenger,14,10,24,15322,15346,0.16,Washington,Washington
15296,October,2017,Chelan,WA,Passenger,77,36,113,52717,52830,0.21,Washington,Washington
15298,October,2017,Okanogan,WA,Passenger,5,17,22,25713,25735,0.09,Washington,Washington
15299,October,2017,Franklin,WA,Truck,0,0,0,18324,18324,0.0,Washington,Washington
15300,October,2017,Snohomish,WA,Truck,1,0,1,121462,121463,0.0,Washington,Washington
15306,October,2017,Jefferson,WA,Passenger,116,68,184,24072,24256,0.76,Washington,Washington
15307,October,2017,Columbia,WA,Truck,0,0,0,1542,1542,0.0,Washington,Washington
15308,October,2017,Lincoln,WA,Truck,0,0,0,4491,4491,0.0,Washington,Washington
15309,October,2017,Stevens,WA,Truck,0,0,0,18305,18305,0.0,Washington,Washington
15318,October,2017,Garfield,WA,Passenger,1,0,1,1315,1316,0.08,Washington,Washington
15322,October,2017,Chelan,WA,Truck,0,0,0,21490,21490,0.0,Washington,Washington
15324,October,2017,Kittitas,WA,Passenger,33,23,56,28118,28174,0.2,Washington,Washington
15325,October,2017,King,WA,Passenger,10942,4483,15425,1372199,1387624,1.11,Washington,Washington
15329,October,2017,King,WA,Truck,7,1,8,185856,185864,0.0,Washington,Washington
15330,October,2017,Pend Oreille,WA,Truck,0,0,0,5562,5562,0.0,Washington,Washington
15332,October,2017,San Juan,WA,Passenger,127,40,167,13759,13926,1.2,Washington,Washington
15334,October,2017,Skamania,WA,Truck,0,0,0,3892,3892,0.0,Washington,Washington
15335,October,2017,Whitman,WA,Truck,0,0,0,8440,8440,0.0,Washington,Washington
15336,October,2017,Kittitas,WA,Truck,0,0,0,13695,13695,0.0,Washington,Washington
15338,October,2017,Walla Walla,WA,Truck,0,0,0,13256,13256,0.0,Washington,Washington
15345,October,2017,Yakima,WA,Passenger,57,72,129,161008,161137,0.08,Washington,Washington
15349,October,2017,Spokane,WA,Truck,1,0,1,91331,91332,0.0,Washington,Washington
15351,October,2017,Stevens,WA,Passenger,9,22,31,31532,31563,0.1,Washington,Washington
15352,October,2017,Island,WA,Passenger,138,153,291,61081,61372,0.47,Washington,Washington
15354,October,2017,Spokane,WA,Passenger,286,238,524,298905,299429,0.17,Washington,Washington
15355,October,2017,Okanogan,WA,Truck,0,0,0,16246,16246,0.0,Washington,Washington
15360,October,2017,Lincoln,WA,Passenger,2,5,7,7575,7582,0.09,Washington,Washington
15363,October,2017,Columbia,WA,Passenger,1,1,2,2393,2395,0.08,Washington,Washington
15364,October,2017,Lewis,WA,Passenger,53,39,92,56275,56367,0.16,Washington,Washington
15367,October,2017,Jefferson,WA,Truck,0,0,0,9438,9438,0.0,Washington,Washington
15368,October,2017,Walla Walla,WA,Passenger,28,28,56,35147,35203,0.16,Washington,Washington
15371,October,2017,Ferry,WA,Passenger,1,1,2,4396,4398,0.05,Washington,Washington
15375,October,2017,Pacific,WA,Truck,0,0,0,7521,7521,0.0,Washington,Washington
15378,October,2017,Whatcom,WA,Passenger,510,202,712,144316,145028,0.49,Washington,Washington
15380,October,2017,Douglas,WA,Passenger,36,32,68,26967,27035,0.25,Washington,Washington
15381,October,2017,Clallam,WA,Passenger,96,85,181,48722,48903,0.37,Washington,Washington
15385,October,2017,Kitsap,WA,Passenger,661,355,1016,174891,175907,0.58,Washington,Washington
15386,October,2017,Skagit,WA,Passenger,151,126,277,88959,89236,0.31,Washington,Washington
15390,October,2017,Pierce,WA,Truck,0,0,0,137020,137020,0.0,Washington,Washington
15392,October,2017,Asotin,WA,Truck,0,0,0,6524,6524,0.0,Washington,Washington
15394,October,2017,Wahkiakum,WA,Passenger,0,2,2,2849,2851,0.07,Washington,Washington
15400,October,2017,Island,WA,Truck,0,0,0,20596,20596,0.0,Washington,Washington
15401,October,2017,Klickitat,WA,Passenger,22,27,49,14805,14854,0.33,Washington,Washington
15402,October,2017,Grant,WA,Truck,0,0,0,25459,25459,0.0,Washington,Washington
15405,October,2017,Cowlitz,WA,Truck,0,0,0,28114,28114,0.0,Washington,Washington
15409,October,2018,Island,WA,Truck,0,0,0,21130,21130,0.0,Washington,Washington
15414,October,2018,Columbia,WA,Passenger,2,2,4,2432,2436,0.16,Washington,Washington
15417,October,2018,Franklin,WA,Passenger,35,66,101,58751,58852,0.17,Washington,Washington
15418,October,2018,Lewis,WA,Truck,0,0,0,25611,25611,0.0,Washington,Washington
15421,October,2018,Snohomish,WA,Passenger,2637,1378,4015,525955,529970,0.76,Washington,Washington
15423,October,2018,Whitman,WA,Truck,0,0,0,8531,8531,0.0,Washington,Washington
15426,October,2018,Adams,WA,Truck,0,0,0,5151,5151,0.0,Washington,Washington
15430,October,2018,Columbia,WA,Truck,0,0,0,1518,1518,0.0,Washington,Washington
15431,October,2018,Yakima,WA,Truck,0,0,0,58757,58757,0.0,Washington,Washington
15439,October,2018,Cowlitz,WA,Passenger,69,86,155,72155,72310,0.21,Washington,Washington
15441,October,2018,Walla Walla,WA,Passenger,36,50,86,35994,36080,0.24,Washington,Washington
15452,October,2018,Mason,WA,Truck,0,0,0,20174,20174,0.0,Washington,Washington
15454,October,2018,Jefferson,WA,Truck,0,0,0,9612,9612,0.0,Washington,Washington
15457,October,2018,Grays Harbor,WA,Truck,0,0,0,20286,20286,0.0,Washington,Washington
15460,October,2018,Skagit,WA,Passenger,240,180,420,91010,91430,0.46,Washington,Washington
15462,October,2018,Yakima,WA,Passenger,71,96,167,164423,164590,0.1,Washington,Washington
15463,October,2018,Asotin,WA,Truck,0,0,0,6636,6636,0.0,Washington,Washington
15464,October,2018,Jefferson,WA,Passenger,163,101,264,24781,25045,1.05,Washington,Washington
15467,October,2018,Thurston,WA,Truck,0,0,0,54803,54803,0.0,Washington,Washington
15468,October,2018,Skamania,WA,Truck,0,0,0,3983,3983,0.0,Washington,Washington
15472,October,2018,Douglas,WA,Passenger,47,33,80,27894,27974,0.29,Washington,Washington
15473,October,2018,Cowlitz,WA,Truck,0,0,0,28666,28666,0.0,Washington,Washington
15475,October,2018,Snohomish,WA,Truck,1,0,1,121864,121865,0.0,Washington,Washington
15477,October,2018,Grant,WA,Passenger,32,50,82,63918,64000,0.13,Washington,Washington
15485,October,2018,Benton,WA,Passenger,192,217,409,132576,132985,0.31,Washington,Washington
15487,October,2018,Pacific,WA,Passenger,19,23,42,15765,15807,0.27,Washington,Washington
15488,October,2018,Chelan,WA,Passenger,126,59,185,53932,54117,0.34,Washington,Washington
15489,October,2018,Chelan,WA,Truck,0,0,0,22058,22058,0.0,Washington,Washington
15493,October,2018,San Juan,WA,Passenger,169,69,238,14212,14450,1.65,Washington,Washington
15495,October,2018,Whatcom,WA,Passenger,700,341,1041,148806,149847,0.69,Washington,Washington
15496,October,2018,Spokane,WA,Passenger,383,352,735,306205,306940,0.24,Washington,Washington
15497,October,2018,Clallam,WA,Truck,0,0,0,21569,21569,0.0,Washington,Washington
15504,October,2018,Okanogan,WA,Truck,0,0,0,16501,16501,0.0,Washington,Washington
15507,October,2018,Clallam,WA,Passenger,136,119,255,50301,50556,0.5,Washington,Washington
15510,October,2018,Thurston,WA,Passenger,663,552,1215,195071,196286,0.62,Washington,Washington
15511,October,2018,Skamania,WA,Passenger,18,12,30,8728,8758,0.34,Washington,Washington
15512,October,2018,Walla Walla,WA,Truck,0,0,0,13507,13507,0.0,Washington,Washington
15513,October,2018,Pierce,WA,Truck,0,0,0,138782,138782,0.0,Washington,Washington
15516,October,2018,Garfield,WA,Truck,0,0,0,960,960,0.0,Washington,Washington
15520,October,2018,Pend Oreille,WA,Passenger,6,5,11,9588,9599,0.11,Washington,Washington
15522,October,2018,Whatcom,WA,Truck,2,0,2,42555,42557,0.0,Washington,Washington
15524,October,2018,Douglas,WA,Truck,0,0,0,12077,12077,0.0,Washington,Washington
15526,October,2018,Adams,WA,Passenger,5,5,10,12720,12730,0.08,Washington,Washington
15531,October,2018,Grays Harbor,WA,Passenger,60,66,126,47272,47398,0.27,Washington,Washington
15533,October,2018,Mason,WA,Passenger,101,108,209,46356,46565,0.45,Washington,Washington
15534,October,2018,Stevens,WA,Truck,0,0,0,18721,18721,0.0,Washington,Washington
15535,October,2018,Lincoln,WA,Passenger,2,6,8,7740,7748,0.1,Washington,Washington
15538,October,2018,Island,WA,Passenger,244,216,460,63045,63505,0.72,Washington,Washington
15539,October,2018,Benton,WA,Truck,0,0,0,41429,41429,0.0,Washington,Washington
15549,October,2018,Whitman,WA,Passenger,19,33,52,22745,22797,0.23,Washington,Washington
15550,October,2018,Skagit,WA,Truck,1,0,1,32334,32335,0.0,Washington,Washington
15551,October,2018,Okanogan,WA,Passenger,15,21,36,26108,26144,0.14,Washington,Washington
15553,October,2018,Wahkiakum,WA,Passenger,1,1,2,2984,2986,0.07,Washington,Washington
15559,October,2018,Pend Oreille,WA,Truck,0,0,0,5752,5752,0.0,Washington,Washington
15560,October,2018,Kittitas,WA,Passenger,57,35,92,29279,29371,0.31,Washington,Washington
15561,October,2018,Ferry,WA,Truck,0,0,0,3566,3566,0.0,Washington,Washington
15563,October,2018,Clark,WA,Passenger,1149,814,1963,310425,312388,0.63,Washington,Washington
15567,October,2018,Lewis,WA,Passenger,88,70,158,58040,58198,0.27,Washington,Washington
15568,October,2018,Clark,WA,Truck,0,0,0,79579,79579,0.0,Washington,Washington
15569,October,2018,King,WA,Passenger,15034,6221,21255,1376342,1397597,1.52,Washington,Washington
15576,October,2018,Garfield,WA,Passenger,1,1,2,1330,1332,0.15,Washington,Washington
15577,October,2018,Asotin,WA,Passenger,12,9,21,12713,12734,0.16,Washington,Washington
15578,October,2018,Kitsap,WA,Passenger,880,507,1387,179926,181313,0.76,Washington,Washington
15583,October,2018,Klickitat,WA,Truck,0,0,0,8154,8154,0.0,Washington,Washington
15586,October,2018,Grant,WA,Truck,0,0,0,26085,26085,0.0,Washington,Washington
15587,October,2018,Pacific,WA,Truck,0,0,0,7630,7630,0.0,Washington,Washington
15590,October,2018,Wahkiakum,WA,Truck,0,0,0,1701,1701,0.0,Washington,Washington
15591,October,2018,Lincoln,WA,Truck,0,0,0,4608,4608,0.0,Washington,Washington
15593,October,2018,Klickitat,WA,Passenger,24,32,56,15389,15445,0.36,Washington,Washington
15597,October,2018,Spokane,WA,Truck,1,0,1,93433,93434,0.0,Washington,Washington
15600,October,2018,Kitsap,WA,Truck,1,0,1,53622,53623,0.0,Washington,Washington
15601,October,2018,Stevens,WA,Passenger,14,28,42,31809,31851,0.13,Washington,Washington
15604,October,2018,Pierce,WA,Passenger,1405,1305,2710,537166,539876,0.5,Washington,Washington
15608,October,2018,Franklin,WA,Truck,0,0,0,18952,18952,0.0,Washington,Washington
15609,October,2018,Kittitas,WA,Truck,0,0,0,14126,14126,0.0,Washington,Washington
15613,October,2018,San Juan,WA,Truck,0,0,0,5787,5787,0.0,Washington,Washington
15621,October,2018,King,WA,Truck,7,1,8,182837,182845,0.0,Washington,Washington
15622,October,2018,Ferry,WA,Passenger,3,2,5,4406,4411,0.11,Washington,Washington
15623,October,2019,Cowlitz,WA,Truck,0,0,0,29023,29023,0.0,Washington,Washington
15625,October,2019,Douglas,WA,Passenger,63,38,101,28272,28373,0.36,Washington,Washington
15629,October,2019,Whatcom,WA,Passenger,949,470,1419,151478,152897,0.93,Washington,Washington
15632,October,2019,Asotin,WA,Passenger,12,8,20,12644,12664,0.16,Washington,Washington
15635,October,2019,Clark,WA,Passenger,1782,1016,2798,316964,319762,0.88,Washington,Washington
15638,October,2019,Ferry,WA,Passenger,5,2,7,4425,4432,0.16,Washington,Washington
15647,October,2019,Kitsap,WA,Truck,1,0,1,54352,54353,0.0,Washington,Washington
15648,October,2019,Cowlitz,WA,Passenger,112,106,218,73568,73786,0.3,Washington,Washington
15657,October,2019,Franklin,WA,Passenger,53,76,129,60628,60757,0.21,Washington,Washington
15658,October,2019,Spokane,WA,Passenger,616,464,1080,314332,315412,0.34,Washington,Washington
15664,October,2019,Stevens,WA,Passenger,29,28,57,31624,31681,0.18,Washington,Washington
15666,October,2019,Okanogan,WA,Passenger,24,28,52,26251,26303,0.2,Washington,Washington
15667,October,2019,Adams,WA,Passenger,6,6,12,12912,12924,0.09,Washington,Washington
15674,October,2019,Grant,WA,Truck,0,0,0,26891,26891,0.0,Washington,Washington
15676,October,2019,Pierce,WA,Passenger,2058,1629,3687,546972,550659,0.67,Washington,Washington
15681,October,2019,Grays Harbor,WA,Truck,0,0,0,20730,20730,0.0,Washington,Washington
15686,October,2019,Clallam,WA,Truck,1,0,1,21846,21847,0.0,Washington,Washington
15689,October,2019,Clallam,WA,Passenger,194,150,344,50936,51280,0.67,Washington,Washington
15691,October,2019,Lincoln,WA,Passenger,2,11,13,7831,7844,0.17,Washington,Washington
15692,October,2019,Thurston,WA,Passenger,1005,686,1691,199109,200800,0.84,Washington,Washington
15696,October,2019,Pacific,WA,Passenger,30,29,59,16110,16169,0.36,Washington,Washington
15698,October,2019,Snohomish,WA,Truck,0,0,0,123012,123012,0.0,Washington,Washington
15702,October,2019,Island,WA,Passenger,362,250,612,63634,64246,0.95,Washington,Washington
15707,October,2019,Asotin,WA,Truck,0,0,0,6694,6694,0.0,Washington,Washington
15709,October,2019,King,WA,Truck,6,1,7,182394,182401,0.0,Washington,Washington
15711,October,2019,Pend Oreille,WA,Passenger,7,6,13,9493,9506,0.14,Washington,Washington
15712,October,2019,Okanogan,WA,Truck,0,0,0,16523,16523,0.0,Washington,Washington
15714,October,2019,Skagit,WA,Passenger,336,210,546,92600,93146,0.59,Washington,Washington
15716,October,2019,Whitman,WA,Truck,0,0,0,8596,8596,0.0,Washington,Washington
15718,October,2019,Grant,WA,Passenger,55,64,119,65376,65495,0.18,Washington,Washington
15720,October,2019,Stevens,WA,Truck,0,0,0,18773,18773,0.0,Washington,Washington
15723,October,2019,Clark,WA,Truck,0,0,0,81150,81150,0.0,Washington,Washington
15724,October,2019,Benton,WA,Truck,0,0,0,42370,42370,0.0,Washington,Washington
15726,October,2019,Wahkiakum,WA,Truck,0,0,0,1752,1752,0.0,Washington,Washington
15727,October,2019,Douglas,WA,Truck,0,0,0,12295,12295,0.0,Washington,Washington
15729,October,2019,Yakima,WA,Truck,0,0,0,59494,59494,0.0,Washington,Washington
15730,October,2019,Garfield,WA,Truck,0,0,0,963,963,0.0,Washington,Washington
15731,October,2019,Thurston,WA,Truck,0,0,0,55645,55645,0.0,Washington,Washington
15733,October,2019,Kitsap,WA,Passenger,1177,645,1822,182157,183979,0.99,Washington,Washington
15734,October,2019,Walla Walla,WA,Passenger,62,62,124,36327,36451,0.34,Washington,Washington
15737,October,2019,San Juan,WA,Truck,0,0,0,5924,5924,0.0,Washington,Washington
15738,October,2019,Pend Oreille,WA,Truck,0,0,0,5739,5739,0.0,Washington,Washington
15740,October,2019,Jefferson,WA,Truck,0,0,0,9672,9672,0.0,Washington,Washington
15741,October,2019,Skamania,WA,Truck,0,0,0,4101,4101,0.0,Washington,Washington
15751,October,2019,Benton,WA,Passenger,307,302,609,134942,135551,0.45,Washington,Washington
15756,October,2019,Mason,WA,Passenger,140,129,269,47564,47833,0.56,Washington,Washington
15761,October,2019,Adams,WA,Truck,0,0,0,5154,5154,0.0,Washington,Washington
15762,October,2019,Yakima,WA,Passenger,115,114,229,165908,166137,0.14,Washington,Washington
15767,October,2019,Wahkiakum,WA,Passenger,4,3,7,3049,3056,0.23,Washington,Washington
15770,October,2019,Jefferson,WA,Passenger,210,126,336,25159,25495,1.32,Washington,Washington
15772,October,2019,King,WA,Passenger,21367,7391,28758,1396136,1424894,2.02,Washington,Washington
15779,October,2019,San Juan,WA,Passenger,236,76,312,14410,14722,2.12,Washington,Washington
15780,October,2019,Pacific,WA,Truck,0,0,0,7726,7726,0.0,Washington,Washington
15781,October,2019,Kittitas,WA,Truck,0,0,0,14618,14618,0.0,Washington,Washington
15785,October,2019,Garfield,WA,Passenger,0,1,1,1301,1302,0.08,Washington,Washington
15786,October,2019,Franklin,WA,Truck,0,0,0,19656,19656,0.0,Washington,Washington
15788,October,2019,Mason,WA,Truck,0,0,0,20466,20466,0.0,Washington,Washington
15790,October,2019,Columbia,WA,Passenger,3,2,5,2435,2440,0.2,Washington,Washington
15791,October,2019,Pierce,WA,Truck,0,0,0,140688,140688,0.0,Washington,Washington
15793,October,2019,Snohomish,WA,Passenger,3897,1683,5580,535121,540701,1.03,Washington,Washington
15795,October,2019,Ferry,WA,Truck,0,0,0,3575,3575,0.0,Washington,Washington
15801,October,2019,Klickitat,WA,Passenger,43,37,80,15665,15745,0.51,Washington,Washington
15806,October,2019,Island,WA,Truck,0,0,0,21320,21320,0.0,Washington,Washington
15807,October,2019,Lewis,WA,Passenger,108,102,210,59447,59657,0.35,Washington,Washington
15815,October,2019,Chelan,WA,Passenger,191,75,266,54655,54921,0.48,Washington,Washington
15816,October,2019,Skamania,WA,Passenger,25,20,45,8803,8848,0.51,Washington,Washington
15818,October,2019,Whatcom,WA,Truck,2,0,2,43096,43098,0.0,Washington,Washington
15820,October,2019,Kittitas,WA,Passenger,87,45,132,29964,30096,0.44,Washington,Washington
15822,October,2019,Columbia,WA,Truck,0,0,0,1533,1533,0.0,Washington,Washington
15823,October,2019,Klickitat,WA,Truck,0,0,0,8311,8311,0.0,Washington,Washington
15824,October,2019,Lewis,WA,Truck,0,0,0,26045,26045,0.0,Washington,Washington
15825,October,2019,Walla Walla,WA,Truck,0,0,0,13670,13670,0.0,Washington,Washington
15830,October,2019,Whitman,WA,Passenger,38,45,83,22717,22800,0.36,Washington,Washington
15834,October,2019,Grays Harbor,WA,Passenger,95,95,190,48305,48495,0.39,Washington,Washington
15837,October,2019,Spokane,WA,Truck,1,0,1,96090,96091,0.0,Washington,Washington
15840,October,2019,Skagit,WA,Truck,1,0,1,32558,32559,0.0,Washington,Washington
15850,October,2019,Chelan,WA,Truck,0,0,0,22495,22495,0.0,Washington,Washington
15855,October,2019,Lincoln,WA,Truck,0,0,0,4691,4691,0.0,Washington,Washington
15861,October,2020,Whitman,WA,Passenger,50,46,96,21981,22077,0.43,Washington,Washington
15868,October,2020,Clark,WA,Passenger,2212,1121,3333,318837,322170,1.03,Washington,Washington
15870,October,2020,Stevens,WA,Truck,0,0,0,18696,18696,0.0,Washington,Washington
15871,October,2020,Thurston,WA,Truck,0,0,0,56300,56300,0.0,Washington,Washington
15872,October,2020,Whatcom,WA,Passenger,1169,531,1700,149671,151371,1.12,Washington,Washington
15874,October,2020,Skagit,WA,Truck,1,0,1,32682,32683,0.0,Washington,Washington
15877,October,2020,Klickitat,WA,Truck,0,0,0,8088,8088,0.0,Washington,Washington
15879,October,2020,Columbia,WA,Truck,0,0,0,1532,1532,0.0,Washington,Washington
15883,October,2020,Ferry,WA,Truck,0,0,0,3596,3596,0.0,Washington,Washington
15886,October,2020,Walla Walla,WA,Passenger,86,65,151,36014,36165,0.42,Washington,Washington
15887,October,2020,San Juan,WA,Truck,0,0,0,5864,5864,0.0,Washington,Washington
15889,October,2020,Pierce,WA,Truck,0,0,0,144394,144394,0.0,Washington,Washington
15892,October,2020,Clark,WA,Truck,0,0,0,83170,83170,0.0,Washington,Washington
15893,October,2020,Island,WA,Passenger,463,284,747,62908,63655,1.17,Washington,Washington
15897,October,2020,Whatcom,WA,Truck,3,0,3,43462,43465,0.01,Washington,Washington
15898,October,2020,Kitsap,WA,Truck,0,0,0,54236,54236,0.0,Washington,Washington
15901,October,2020,San Juan,WA,Passenger,340,103,443,13969,14412,3.07,Washington,Washington
15905,October,2020,King,WA,Passenger,25876,8012,33888,1372970,1406858,2.41,Washington,Washington
15917,October,2020,Walla Walla,WA,Truck,0,0,0,13797,13797,0.0,Washington,Washington
15918,October,2020,Garfield,WA,Passenger,0,1,1,1352,1353,0.07,Washington,Washington
15919,October,2020,Spokane,WA,Passenger,828,525,1353,319743,321096,0.42,Washington,Washington
15922,October,2020,Douglas,WA,Truck,0,0,0,12416,12416,0.0,Washington,Washington
15925,October,2020,Douglas,WA,Passenger,80,43,123,28068,28191,0.44,Washington,Washington
15930,October,2020,Grant,WA,Truck,0,0,0,27386,27386,0.0,Washington,Washington
15932,October,2020,Benton,WA,Truck,0,0,0,43068,43068,0.0,Washington,Washington
15933,October,2020,Okanogan,WA,Passenger,47,36,83,25991,26074,0.32,Washington,Washington
15934,October,2020,Clallam,WA,Truck,1,0,1,21767,21768,0.0,Washington,Washington
15938,October,2020,Skamania,WA,Passenger,32,20,52,8331,8383,0.62,Washington,Washington
15943,October,2020,Franklin,WA,Truck,0,0,0,20373,20373,0.0,Washington,Washington
15946,October,2020,Clallam,WA,Passenger,252,173,425,49893,50318,0.84,Washington,Washington
15956,October,2020,Chelan,WA,Passenger,265,82,347,54374,54721,0.63,Washington,Washington
15962,October,2020,Cowlitz,WA,Truck,0,0,0,28894,28894,0.0,Washington,Washington
15963,October,2020,Kittitas,WA,Truck,0,0,0,14630,14630,0.0,Washington,Washington
15966,October,2020,Adams,WA,Passenger,8,7,15,12936,12951,0.12,Washington,Washington
15967,October,2020,Ferry,WA,Passenger,8,3,11,4351,4362,0.25,Washington,Washington
15968,October,2020,Kittitas,WA,Passenger,121,49,170,29701,29871,0.57,Washington,Washington
15970,October,2020,Pacific,WA,Passenger,34,34,68,15725,15793,0.43,Washington,Washington
15971,October,2020,Mason,WA,Passenger,165,134,299,47497,47796,0.63,Washington,Washington
15972,October,2020,Wahkiakum,WA,Passenger,6,6,12,3035,3047,0.39,Washington,Washington
15974,October,2020,Skamania,WA,Truck,0,0,0,3995,3995,0.0,Washington,Washington
15976,October,2020,Asotin,WA,Truck,0,0,0,6685,6685,0.0,Washington,Washington
15979,October,2020,Lewis,WA,Truck,0,0,0,26496,26496,0.0,Washington,Washington
15985,October,2020,Pacific,WA,Truck,0,0,0,7752,7752,0.0,Washington,Washington
15987,October,2020,Thurston,WA,Passenger,1254,761,2015,197304,199319,1.01,Washington,Washington
15991,October,2020,Yakima,WA,Truck,0,0,0,60694,60694,0.0,Washington,Washington
16001,October,2020,Chelan,WA,Truck,0,0,0,22770,22770,0.0,Washington,Washington
16002,October,2020,Lincoln,WA,Truck,0,0,0,4661,4661,0.0,Washington,Washington
16005,October,2020,Kitsap,WA,Passenger,1465,730,2195,179705,181900,1.21,Washington,Washington
16014,October,2020,Klickitat,WA,Passenger,59,44,103,15003,15106,0.68,Washington,Washington
16015,October,2020,Spokane,WA,Truck,0,0,0,100211,100211,0.0,Washington,Washington
16016,October,2020,Wahkiakum,WA,Truck,0,0,0,1764,1764,0.0,Washington,Washington
16026,October,2020,Lincoln,WA,Passenger,5,10,15,7609,7624,0.2,Washington,Washington
16028,October,2020,Franklin,WA,Passenger,73,78,151,61101,61252,0.25,Washington,Washington
16029,October,2020,Yakima,WA,Passenger,157,122,279,166886,167165,0.17,Washington,Washington
16034,October,2020,Cowlitz,WA,Passenger,160,122,282,72100,72382,0.39,Washington,Washington
16036,October,2020,Stevens,WA,Passenger,36,39,75,30368,30443,0.25,Washington,Washington
16037,October,2020,Skagit,WA,Passenger,466,231,697,91532,92229,0.76,Washington,Washington
16038,October,2020,Okanogan,WA,Truck,0,0,0,16573,16573,0.0,Washington,Washington
16047,October,2020,Grant,WA,Passenger,71,81,152,65747,65899,0.23,Washington,Washington
16049,October,2020,Jefferson,WA,Truck,0,0,0,9575,9575,0.0,Washington,Washington
16050,October,2020,Pend Oreille,WA,Truck,0,0,0,5717,5717,0.0,Washington,Washington
16054,October,2020,King,WA,Truck,5,1,6,184061,184067,0.0,Washington,Washington
16055,October,2020,Pend Oreille,WA,Passenger,8,4,12,9158,9170,0.13,Washington,Washington
16056,October,2020,Snohomish,WA,Truck,0,0,0,125318,125318,0.0,Washington,Washington
16058,October,2020,Benton,WA,Passenger,403,339,742,134682,135424,0.55,Washington,Washington
16059,October,2020,Jefferson,WA,Passenger,260,151,411,24723,25134,1.64,Washington,Washington
16061,October,2020,Mason,WA,Truck,0,0,0,20836,20836,0.0,Washington,Washington
16066,October,2020,Garfield,WA,Truck,0,0,0,991,991,0.0,Washington,Washington
16072,October,2020,Grays Harbor,WA,Passenger,118,117,235,48521,48756,0.48,Washington,Washington
16080,October,2020,Grays Harbor,WA,Truck,0,0,0,21123,21123,0.0,Washington,Washington
16083,October,2020,Columbia,WA,Passenger,4,3,7,2439,2446,0.29,Washington,Washington
16089,October,2020,Lewis,WA,Passenger,114,115,229,58451,58680,0.39,Washington,Washington
16092,October,2020,Pierce,WA,Passenger,2660,1740,4400,554816,559216,0.79,Washington,Washington
16093,October,2020,Asotin,WA,Passenger,17,14,31,12401,12432,0.25,Washington,Washington
16094,October,2020,Whitman,WA,Truck,0,0,0,8487,8487,0.0,Washington,Washington
16095,October,2020,Snohomish,WA,Passenger,4831,1816,6647,537854,544501,1.22,Washington,Washington
16096,October,2020,Adams,WA,Truck,0,0,0,5335,5335,0.0,Washington,Washington
16097,October,2020,Island,WA,Truck,1,0,1,21311,21312,0.0,Washington,Washington
16103,October,2021,Kitsap,WA,Passenger,2042,916,2958,180643,183601,1.61,Washington,Washington
16104,October,2021,Ferry,WA,Passenger,11,3,14,4446,4460,0.31,Washington,Washington
16110,October,2021,Snohomish,WA,Truck,2,0,2,125795,125797,0.0,Washington,Washington
16111,October,2021,Stevens,WA,Truck,0,0,0,18891,18891,0.0,Washington,Washington
16113,October,2021,Island,WA,Truck,0,0,0,21569,21569,0.0,Washington,Washington
16116,October,2021,Chelan,WA,Truck,0,0,0,23075,23075,0.0,Washington,Washington
16117,October,2021,Walla Walla,WA,Passenger,132,82,214,36363,36577,0.59,Washington,Washington
16119,October,2021,Grays Harbor,WA,Truck,0,0,0,21396,21396,0.0,Washington,Washington
16120,October,2021,Klickitat,WA,Passenger,87,51,138,15357,15495,0.89,Washington,Washington
16122,October,2021,Cowlitz,WA,Truck,0,1,1,29069,29070,0.0,Washington,Washington
16123,October,2021,Grant,WA,Passenger,133,95,228,66824,67052,0.34,Washington,Washington
16124,October,2021,Whatcom,WA,Truck,4,0,4,43778,43782,0.01,Washington,Washington
16135,October,2021,Asotin,WA,Passenger,21,17,38,12770,12808,0.3,Washington,Washington
16136,October,2021,Grant,WA,Truck,0,0,0,28018,28018,0.0,Washington,Washington
16137,October,2021,Wahkiakum,WA,Passenger,17,8,25,3065,3090,0.81,Washington,Washington
16143,October,2021,Lewis,WA,Passenger,194,158,352,59631,59983,0.59,Washington,Washington
16144,October,2021,Adams,WA,Truck,0,0,0,5409,5409,0.0,Washington,Washington
16147,October,2021,Whatcom,WA,Passenger,1581,646,2227,150431,152658,1.46,Washington,Washington
16151,October,2021,Pacific,WA,Truck,0,0,0,7990,7990,0.0,Washington,Washington
16154,October,2021,Yakima,WA,Passenger,270,165,435,168835,169270,0.26,Washington,Washington
16156,October,2021,Pierce,WA,Passenger,4001,2085,6086,557924,564010,1.08,Washington,Washington
16157,October,2021,Columbia,WA,Passenger,7,2,9,2439,2448,0.37,Washington,Washington
16158,October,2021,Clark,WA,Truck,0,0,0,84034,84034,0.0,Washington,Washington
16160,October,2021,Pend Oreille,WA,Passenger,18,7,25,9206,9231,0.27,Washington,Washington
16162,October,2021,Snohomish,WA,Passenger,6655,2197,8852,538791,547643,1.62,Washington,Washington
16166,October,2021,King,WA,Passenger,33841,9915,43756,1363940,1407696,3.11,Washington,Washington
16167,October,2021,Jefferson,WA,Passenger,362,191,553,24778,25331,2.18,Washington,Washington
16169,October,2021,Klickitat,WA,Truck,0,0,0,8316,8316,0.0,Washington,Washington
16178,October,2021,Garfield,WA,Passenger,0,3,3,1355,1358,0.22,Washington,Washington
16181,October,2021,Lewis,WA,Truck,0,0,0,26738,26738,0.0,Washington,Washington
16182,October,2021,Island,WA,Passenger,679,333,1012,63091,64103,1.58,Washington,Washington
16185,October,2021,Clark,WA,Passenger,3253,1514,4767,321077,325844,1.46,Washington,Washington
16188,October,2021,Lincoln,WA,Passenger,7,16,23,7707,7730,0.3,Washington,Washington
16191,October,2021,Douglas,WA,Passenger,103,51,154,28576,28730,0.54,Washington,Washington
16200,October,2021,Whitman,WA,Truck,0,0,0,8556,8556,0.0,Washington,Washington
16206,October,2021,Kittitas,WA,Passenger,193,72,265,29844,30109,0.88,Washington,Washington
16208,October,2021,Spokane,WA,Truck,0,0,0,102587,102587,0.0,Washington,Washington
16213,October,2021,Mason,WA,Passenger,246,156,402,47894,48296,0.83,Washington,Washington
16219,October,2021,Cowlitz,WA,Passenger,258,154,412,71857,72269,0.57,Washington,Washington
16228,October,2021,Franklin,WA,Passenger,144,102,246,62082,62328,0.39,Washington,Washington
16232,October,2021,Skamania,WA,Truck,0,0,0,4019,4019,0.0,Washington,Washington
16238,October,2021,Thurston,WA,Passenger,1803,921,2724,197240,199964,1.36,Washington,Washington
16239,October,2021,Clallam,WA,Truck,1,0,1,22063,22064,0.0,Washington,Washington
16243,October,2021,Pacific,WA,Passenger,49,59,108,16114,16222,0.67,Washington,Washington
16245,October,2021,Clallam,WA,Passenger,365,235,600,50522,51122,1.17,Washington,Washington
16246,October,2021,Whitman,WA,Passenger,63,58,121,21932,22053,0.55,Washington,Washington
16247,October,2021,Garfield,WA,Truck,0,0,0,999,999,0.0,Washington,Washington
16250,October,2021,Columbia,WA,Truck,0,0,0,1537,1537,0.0,Washington,Washington
16257,October,2021,Wahkiakum,WA,Truck,0,0,0,1827,1827,0.0,Washington,Washington
16258,October,2021,San Juan,WA,Truck,0,0,0,5976,5976,0.0,Washington,Washington
16260,October,2021,Pierce,WA,Truck,0,0,0,145249,145249,0.0,Washington,Washington
16266,October,2021,Pend Oreille,WA,Truck,0,0,0,5687,5687,0.0,Washington,Washington
16267,October,2021,Jefferson,WA,Truck,0,0,0,9592,9592,0.0,Washington,Washington
16268,October,2021,Kitsap,WA,Truck,0,0,0,54245,54245,0.0,Washington,Washington
16269,October,2021,Asotin,WA,Truck,0,0,0,6748,6748,0.0,Washington,Washington
16271,October,2021,Mason,WA,Truck,0,0,0,21283,21283,0.0,Washington,Washington
16276,October,2021,Okanogan,WA,Passenger,66,44,110,26572,26682,0.41,Washington,Washington
16278,October,2021,Douglas,WA,Truck,0,0,0,12679,12679,0.0,Washington,Washington
16280,October,2021,Benton,WA,Truck,0,0,0,43707,43707,0.0,Washington,Washington
16284,October,2021,Benton,WA,Passenger,595,426,1021,136009,137030,0.75,Washington,Washington
16285,October,2021,Skamania,WA,Passenger,58,39,97,8335,8432,1.15,Washington,Washington
16286,October,2021,Franklin,WA,Truck,0,0,0,20773,20773,0.0,Washington,Washington
16288,October,2021,San Juan,WA,Passenger,469,146,615,14189,14804,4.15,Washington,Washington
16289,October,2021,Grays Harbor,WA,Passenger,187,151,338,49486,49824,0.68,Washington,Washington
16293,October,2021,Ferry,WA,Truck,0,0,0,3592,3592,0.0,Washington,Washington
16295,October,2021,Thurston,WA,Truck,0,0,0,56195,56195,0.0,Washington,Washington
16303,October,2021,Walla Walla,WA,Truck,0,0,0,14050,14050,0.0,Washington,Washington
16308,October,2021,Skagit,WA,Truck,1,0,1,32836,32837,0.0,Washington,Washington
16309,October,2021,Yakima,WA,Truck,0,0,0,61670,61670,0.0,Washington,Washington
16310,October,2021,Adams,WA,Passenger,16,14,30,13034,13064,0.23,Washington,Washington
16322,October,2021,King,WA,Truck,4,1,5,183489,183494,0.0,Washington,Washington
16323,October,2021,Stevens,WA,Passenger,52,43,95,30243,30338,0.31,Washington,Washington
16328,October,2021,Skagit,WA,Passenger,649,295,944,91478,92422,1.02,Washington,Washington
16329,October,2021,Spokane,WA,Passenger,1218,727,1945,326533,328478,0.59,Washington,Washington
16331,October,2021,Kittitas,WA,Truck,0,0,0,14773,14773,0.0,Washington,Washington
16333,October,2021,Chelan,WA,Passenger,385,110,495,54679,55174,0.9,Washington,Washington
16342,October,2021,Lincoln,WA,Truck,0,0,0,4804,4804,0.0,Washington,Washington
16348,October,2021,Okanogan,WA,Truck,0,0,0,16678,16678,0.0,Washington,Washington
16359,October,2022,Walla Walla,WA,Passenger,190,107,297,35711,36008,0.82,Washington,Washington
16361,October,2022,Pend Oreille,WA,Passenger,18,12,30,9012,9042,0.33,Washington,Washington
16363,October,2022,Ferry,WA,Passenger,24,4,28,4384,4412,0.63,Washington,Washington
16366,October,2022,Mason,WA,Passenger,350,187,537,46978,47515,1.13,Washington,Washington
16369,October,2022,Yakima,WA,Passenger,394,214,608,166433,167041,0.36,Washington,Washington
16376,October,2022,Walla Walla,WA,Truck,3,0,3,13949,13952,0.02,Washington,Washington
16377,October,2022,Whitman,WA,Passenger,103,65,168,21978,22146,0.76,Washington,Washington
16379,October,2022,Snohomish,WA,Passenger,9424,2670,12094,531029,543123,2.23,Washington,Washington
16382,October,2022,Grant,WA,Truck,2,0,2,28024,28026,0.01,Washington,Washington
16387,October,2022,Pierce,WA,Passenger,5747,2449,8196,540967,549163,1.49,Washington,Washington
16388,October,2022,Thurston,WA,Truck,30,0,30,54906,54936,0.05,Washington,Washington
16389,October,2022,Grays Harbor,WA,Truck,2,0,2,21098,21100,0.01,Washington,Washington
16390,October,2022,Chelan,WA,Truck,8,0,8,23087,23095,0.03,Washington,Washington
16392,October,2022,Pend Oreille,WA,Truck,0,0,0,5614,5614,0.0,Washington,Washington
16394,October,2022,Clark,WA,Truck,31,0,31,82151,82182,0.04,Washington,Washington
16398,October,2022,Whatcom,WA,Truck,20,0,20,43123,43143,0.05,Washington,Washington
16399,October,2022,Jefferson,WA,Truck,5,0,5,9394,9399,0.05,Washington,Washington
16407,October,2022,Asotin,WA,Truck,0,0,0,6692,6692,0.0,Washington,Washington
16415,October,2022,Kittitas,WA,Passenger,291,94,385,29590,29975,1.28,Washington,Washington
16419,October,2022,Garfield,WA,Passenger,1,3,4,1315,1319,0.3,Washington,Washington
16425,October,2022,Jefferson,WA,Passenger,464,225,689,24416,25105,2.74,Washington,Washington
16431,October,2022,San Juan,WA,Truck,7,0,7,5952,5959,0.12,Washington,Washington
16432,October,2022,Skagit,WA,Truck,8,0,8,32247,32255,0.02,Washington,Washington
16433,October,2022,Franklin,WA,Passenger,239,112,351,61817,62168,0.56,Washington,Washington
16434,October,2022,San Juan,WA,Passenger,549,165,714,13992,14706,4.86,Washington,Washington
16435,October,2022,Lincoln,WA,Truck,0,0,0,4863,4863,0.0,Washington,Washington
16443,October,2022,Lewis,WA,Truck,2,0,2,26372,26374,0.01,Washington,Washington
16447,October,2022,Clark,WA,Passenger,4606,1925,6531,315200,321731,2.03,Washington,Washington
16448,October,2022,Spokane,WA,Truck,14,0,14,101936,101950,0.01,Washington,Washington
16449,October,2022,Douglas,WA,Passenger,158,59,217,28437,28654,0.76,Washington,Washington
16453,October,2022,Stevens,WA,Passenger,84,56,140,30055,30195,0.46,Washington,Washington
16457,October,2022,Columbia,WA,Passenger,8,1,9,2442,2451,0.37,Washington,Washington
16458,October,2022,Chelan,WA,Passenger,508,140,648,54201,54849,1.18,Washington,Washington
16465,October,2022,Whitman,WA,Truck,3,0,3,8609,8612,0.03,Washington,Washington
16466,October,2022,Garfield,WA,Truck,0,0,0,977,977,0.0,Washington,Washington
16467,October,2022,Kittitas,WA,Truck,5,0,5,14601,14606,0.03,Washington,Washington
16469,October,2022,Wahkiakum,WA,Truck,1,0,1,1800,1801,0.06,Washington,Washington
16470,October,2022,Whatcom,WA,Passenger,1993,786,2779,148767,151546,1.83,Washington,Washington
16478,October,2022,Cowlitz,WA,Truck,4,0,4,28459,28463,0.01,Washington,Washington
16479,October,2022,Franklin,WA,Truck,2,0,2,20887,20889,0.01,Washington,Washington
16487,October,2022,Okanogan,WA,Truck,1,0,1,16478,16479,0.01,Washington,Washington
16488,October,2022,Lewis,WA,Passenger,261,179,440,59898,60338,0.73,Washington,Washington
16490,October,2022,King,WA,Passenger,45341,11925,57266,1343327,1400593,4.09,Washington,Washington
16495,October,2022,Benton,WA,Passenger,867,485,1352,135773,137125,0.99,Washington,Washington
16496,October,2022,Grant,WA,Passenger,210,108,318,66743,67061,0.47,Washington,Washington
16497,October,2022,Asotin,WA,Passenger,26,19,45,12566,12611,0.36,Washington,Washington
16498,October,2022,Clallam,WA,Passenger,456,256,712,49453,50165,1.42,Washington,Washington
16499,October,2022,Pierce,WA,Truck,62,0,62,140244,140306,0.04,Washington,Washington
16509,October,2022,Kitsap,WA,Passenger,2634,1125,3759,177642,181401,2.07,Washington,Washington
16510,October,2022,Yakima,WA,Truck,5,0,5,61277,61282,0.01,Washington,Washington
16511,October,2022,Spokane,WA,Passenger,1837,910,2747,324785,327532,0.84,Washington,Washington
16525,October,2022,Skagit,WA,Passenger,886,349,1235,89523,90758,1.36,Washington,Washington
16529,October,2022,Lincoln,WA,Passenger,12,17,29,7735,7764,0.37,Washington,Washington
16532,October,2022,Skamania,WA,Truck,0,0,0,3897,3897,0.0,Washington,Washington
16536,October,2022,Benton,WA,Truck,7,0,7,43350,43357,0.02,Washington,Washington
16537,October,2022,Mason,WA,Truck,6,0,6,20938,20944,0.03,Washington,Washington
16538,October,2022,Ferry,WA,Truck,0,0,0,3593,3593,0.0,Washington,Washington
16548,October,2022,Island,WA,Passenger,901,389,1290,61684,62974,2.05,Washington,Washington
16552,October,2022,Douglas,WA,Truck,2,0,2,12811,12813,0.02,Washington,Washington
16557,October,2022,Wahkiakum,WA,Passenger,24,12,36,3064,3100,1.16,Washington,Washington
16558,October,2022,Thurston,WA,Passenger,2467,1109,3576,192794,196370,1.82,Washington,Washington
16560,October,2022,Grays Harbor,WA,Passenger,231,166,397,48742,49139,0.81,Washington,Washington
16562,October,2022,Island,WA,Truck,14,0,14,21277,21291,0.07,Washington,Washington
16564,October,2022,Okanogan,WA,Passenger,95,49,144,26284,26428,0.54,Washington,Washington
16565,October,2022,Pacific,WA,Passenger,68,74,142,15756,15898,0.89,Washington,Washington
16566,October,2022,Pacific,WA,Truck,1,0,1,7875,7876,0.01,Washington,Washington
16567,October,2022,Adams,WA,Truck,1,0,1,5429,5430,0.02,Washington,Washington
16568,October,2022,Columbia,WA,Truck,0,0,0,1583,1583,0.0,Washington,Washington
16573,October,2022,Cowlitz,WA,Passenger,381,184,565,70323,70888,0.8,Washington,Washington
16574,October,2022,Stevens,WA,Truck,2,0,2,18903,18905,0.01,Washington,Washington
16576,October,2022,Adams,WA,Passenger,22,12,34,13045,13079,0.26,Washington,Washington
16583,October,2022,Snohomish,WA,Truck,76,0,76,122941,123017,0.06,Washington,Washington
16584,October,2022,King,WA,Truck,300,2,302,179312,179614,0.17,Washington,Washington
16586,October,2022,Klickitat,WA,Passenger,114,51,165,15116,15281,1.08,Washington,Washington
16587,October,2022,Skamania,WA,Passenger,85,51,136,8110,8246,1.65,Washington,Washington
16589,October,2022,Klickitat,WA,Truck,3,0,3,8250,8253,0.04,Washington,Washington
16591,October,2022,Clallam,WA,Truck,7,0,7,21890,21897,0.03,Washington,Washington
16593,October,2022,Kitsap,WA,Truck,25,0,25,53166,53191,0.05,Washington,Washington
16599,September,2017,Kittitas,WA,Passenger,33,21,54,27988,28042,0.19,Washington,Washington
16600,September,2017,Ferry,WA,Truck,0,0,0,3538,3538,0.0,Washington,Washington
16601,September,2017,Pierce,WA,Passenger,1012,898,1910,525165,527075,0.36,Washington,Washington
16607,September,2017,Grant,WA,Passenger,20,33,53,61457,61510,0.09,Washington,Washington
16608,September,2017,Adams,WA,Passenger,3,3,6,12263,12269,0.05,Washington,Washington
16610,September,2017,King,WA,Truck,7,1,8,186365,186373,0.0,Washington,Washington
16612,September,2017,Pend Oreille,WA,Passenger,3,4,7,9371,9378,0.07,Washington,Washington
16614,September,2017,Wahkiakum,WA,Truck,0,0,0,1667,1667,0.0,Washington,Washington
16616,September,2017,Whitman,WA,Passenger,12,22,34,22193,22227,0.15,Washington,Washington
16619,September,2017,Okanogan,WA,Passenger,5,18,23,25690,25713,0.09,Washington,Washington
16622,September,2017,Lincoln,WA,Truck,0,0,0,4472,4472,0.0,Washington,Washington
16623,September,2017,Spokane,WA,Truck,1,0,1,91172,91173,0.0,Washington,Washington
16625,September,2017,Lewis,WA,Passenger,53,38,91,56022,56113,0.16,Washington,Washington
16627,September,2017,Whitman,WA,Truck,0,0,0,8428,8428,0.0,Washington,Washington
16629,September,2017,Wahkiakum,WA,Passenger,0,2,2,2836,2838,0.07,Washington,Washington
16631,September,2017,Stevens,WA,Passenger,8,22,30,31547,31577,0.1,Washington,Washington
16634,September,2017,Walla Walla,WA,Passenger,27,28,55,35036,35091,0.16,Washington,Washington
16635,September,2017,Benton,WA,Passenger,163,150,313,129262,129575,0.24,Washington,Washington
16639,September,2017,Pacific,WA,Passenger,12,9,21,15262,15283,0.14,Washington,Washington
16641,September,2017,Skagit,WA,Passenger,148,120,268,88642,88910,0.3,Washington,Washington
16643,September,2017,Kitsap,WA,Truck,1,0,1,52599,52600,0.0,Washington,Washington
16644,September,2017,Cowlitz,WA,Passenger,52,64,116,70272,70388,0.16,Washington,Washington
16648,September,2017,Columbia,WA,Passenger,1,1,2,2378,2380,0.08,Washington,Washington
16649,September,2017,Okanogan,WA,Truck,0,0,0,16235,16235,0.0,Washington,Washington
16651,September,2017,Klickitat,WA,Passenger,22,26,48,14774,14822,0.32,Washington,Washington
16652,September,2017,Garfield,WA,Passenger,1,0,1,1295,1296,0.08,Washington,Washington
16655,September,2017,Grays Harbor,WA,Truck,0,0,0,19976,19976,0.0,Washington,Washington
16660,September,2017,Pacific,WA,Truck,0,0,0,7514,7514,0.0,Washington,Washington
16663,September,2017,Skamania,WA,Passenger,10,7,17,8572,8589,0.2,Washington,Washington
16669,September,2017,Kitsap,WA,Passenger,653,346,999,174309,175308,0.57,Washington,Washington
16670,September,2017,Clark,WA,Passenger,810,542,1352,301404,302756,0.45,Washington,Washington
16671,September,2017,Lincoln,WA,Passenger,2,6,8,7563,7571,0.11,Washington,Washington
16672,September,2017,Island,WA,Passenger,129,149,278,60853,61131,0.45,Washington,Washington
16679,September,2017,Clallam,WA,Passenger,95,83,178,48609,48787,0.36,Washington,Washington
16681,September,2017,Jefferson,WA,Passenger,114,65,179,24008,24187,0.74,Washington,Washington
16682,September,2017,Chelan,WA,Truck,0,0,0,21414,21414,0.0,Washington,Washington
16684,September,2017,Snohomish,WA,Passenger,1911,975,2886,514376,517262,0.56,Washington,Washington
16685,September,2017,Walla Walla,WA,Truck,0,0,0,13243,13243,0.0,Washington,Washington
16686,September,2017,Pend Oreille,WA,Truck,0,0,0,5552,5552,0.0,Washington,Washington
16693,September,2017,San Juan,WA,Passenger,117,42,159,13676,13835,1.15,Washington,Washington
16694,September,2017,Yakima,WA,Passenger,57,69,126,160618,160744,0.08,Washington,Washington
16696,September,2017,Columbia,WA,Truck,0,0,0,1557,1557,0.0,Washington,Washington
16697,September,2017,Mason,WA,Truck,0,0,0,19379,19379,0.0,Washington,Washington
16699,September,2017,Jefferson,WA,Truck,0,0,0,9419,9419,0.0,Washington,Washington
16701,September,2017,Clark,WA,Truck,0,0,0,77868,77868,0.0,Washington,Washington
16702,September,2017,Asotin,WA,Passenger,7,5,12,12463,12475,0.1,Washington,Washington
16705,September,2017,Whatcom,WA,Passenger,496,190,686,143859,144545,0.47,Washington,Washington
16708,September,2017,Thurston,WA,Passenger,435,363,798,188247,189045,0.42,Washington,Washington
16709,September,2017,Yakima,WA,Truck,0,0,0,57707,57707,0.0,Washington,Washington
16710,September,2017,Island,WA,Truck,0,0,0,20564,20564,0.0,Washington,Washington
16711,September,2017,Benton,WA,Truck,0,0,0,40273,40273,0.0,Washington,Washington
16713,September,2017,Snohomish,WA,Truck,1,0,1,121526,121527,0.0,Washington,Washington
16714,September,2017,Chelan,WA,Passenger,75,37,112,52503,52615,0.21,Washington,Washington
16723,September,2017,Mason,WA,Passenger,61,73,134,44172,44306,0.3,Washington,Washington
16724,September,2017,Lewis,WA,Truck,0,0,0,25113,25113,0.0,Washington,Washington
16725,September,2017,Douglas,WA,Truck,0,0,0,11592,11592,0.0,Washington,Washington
16726,September,2017,Douglas,WA,Passenger,35,29,64,26927,26991,0.24,Washington,Washington
16727,September,2017,King,WA,Passenger,10654,4350,15004,1372562,1387566,1.08,Washington,Washington
16730,September,2017,Grant,WA,Truck,0,0,0,25425,25425,0.0,Washington,Washington
16733,September,2017,Clallam,WA,Truck,0,0,0,21085,21085,0.0,Washington,Washington
16734,September,2017,Franklin,WA,Passenger,29,48,77,56181,56258,0.14,Washington,Washington
16735,September,2017,Skagit,WA,Truck,1,0,1,31550,31551,0.0,Washington,Washington
16736,September,2017,San Juan,WA,Truck,0,0,0,5559,5559,0.0,Washington,Washington
16738,September,2017,Skamania,WA,Truck,0,0,0,3878,3878,0.0,Washington,Washington
16742,September,2017,Franklin,WA,Truck,0,0,0,18248,18248,0.0,Washington,Washington
16743,September,2017,Whatcom,WA,Truck,2,0,2,41837,41839,0.0,Washington,Washington
16745,September,2017,Klickitat,WA,Truck,0,0,0,7988,7988,0.0,Washington,Washington
16746,September,2017,Grays Harbor,WA,Passenger,38,38,76,45132,45208,0.17,Washington,Washington
16750,September,2017,Ferry,WA,Passenger,1,1,2,4380,4382,0.05,Washington,Washington
16751,September,2017,Kittitas,WA,Truck,0,0,0,13657,13657,0.0,Washington,Washington
16760,September,2017,Adams,WA,Truck,0,0,0,5123,5123,0.0,Washington,Washington
16765,September,2017,Thurston,WA,Truck,0,0,0,53500,53500,0.0,Washington,Washington
16766,September,2017,Garfield,WA,Truck,0,0,0,940,940,0.0,Washington,Washington
16770,September,2017,Pierce,WA,Truck,0,0,0,137078,137078,0.0,Washington,Washington
16774,September,2017,Spokane,WA,Passenger,276,229,505,298150,298655,0.17,Washington,Washington
16777,September,2017,Cowlitz,WA,Truck,0,0,0,28041,28041,0.0,Washington,Washington
16778,September,2017,Asotin,WA,Truck,0,0,0,6507,6507,0.0,Washington,Washington
16781,September,2017,Stevens,WA,Truck,0,0,0,18251,18251,0.0,Washington,Washington
16784,September,2018,Cowlitz,WA,Passenger,63,85,148,72024,72172,0.21,Washington,Washington
16786,September,2018,Walla Walla,WA,Truck,0,0,0,13492,13492,0.0,Washington,Washington
16787,September,2018,Skagit,WA,Passenger,222,176,398,90860,91258,0.44,Washington,Washington
16792,September,2018,Klickitat,WA,Passenger,24,32,56,15362,15418,0.36,Washington,Washington
16795,September,2018,Ferry,WA,Truck,0,0,0,3559,3559,0.0,Washington,Washington
16797,September,2018,Whatcom,WA,Truck,2,0,2,42433,42435,0.0,Washington,Washington
16799,September,2018,Chelan,WA,Passenger,117,59,176,53803,53979,0.33,Washington,Washington
16800,September,2018,Snohomish,WA,Passenger,2516,1329,3845,524563,528408,0.73,Washington,Washington
16807,September,2018,Wahkiakum,WA,Passenger,1,1,2,2980,2982,0.07,Washington,Washington
16811,September,2018,Skamania,WA,Truck,0,0,0,3967,3967,0.0,Washington,Washington
16812,September,2018,Pacific,WA,Passenger,18,22,40,15733,15773,0.25,Washington,Washington
16813,September,2018,Wahkiakum,WA,Truck,0,0,0,1691,1691,0.0,Washington,Washington
16817,September,2018,Stevens,WA,Truck,0,0,0,18680,18680,0.0,Washington,Washington
16823,September,2018,King,WA,Truck,7,1,8,182870,182878,0.0,Washington,Washington
16824,September,2018,Jefferson,WA,Passenger,153,99,252,24693,24945,1.01,Washington,Washington
16825,September,2018,Walla Walla,WA,Passenger,36,50,86,35925,36011,0.24,Washington,Washington
16827,September,2018,Jefferson,WA,Truck,0,0,0,9644,9644,0.0,Washington,Washington
16831,September,2018,Adams,WA,Truck,0,0,0,5158,5158,0.0,Washington,Washington
16834,September,2018,Mason,WA,Passenger,94,100,194,46187,46381,0.42,Washington,Washington
16835,September,2018,Kittitas,WA,Truck,0,0,0,14105,14105,0.0,Washington,Washington
16843,September,2018,Grant,WA,Truck,0,0,0,26068,26068,0.0,Washington,Washington
16844,September,2018,Clark,WA,Passenger,1089,784,1873,309720,311593,0.6,Washington,Washington
16850,September,2018,Columbia,WA,Passenger,2,2,4,2429,2433,0.16,Washington,Washington
16855,September,2018,Lewis,WA,Truck,0,0,0,25568,25568,0.0,Washington,Washington
16857,September,2018,Clark,WA,Truck,0,0,0,79366,79366,0.0,Washington,Washington
16859,September,2018,Clallam,WA,Passenger,129,122,251,50164,50415,0.5,Washington,Washington
16860,September,2018,Benton,WA,Passenger,188,209,397,132434,132831,0.3,Washington,Washington
16862,September,2018,Okanogan,WA,Truck,0,0,0,16497,16497,0.0,Washington,Washington
16864,September,2018,Grays Harbor,WA,Passenger,55,65,120,47163,47283,0.25,Washington,Washington
16867,September,2018,Yakima,WA,Passenger,67,93,160,164243,164403,0.1,Washington,Washington
16872,September,2018,Island,WA,Truck,0,0,0,21101,21101,0.0,Washington,Washington
16877,September,2018,Skamania,WA,Passenger,15,11,26,8710,8736,0.3,Washington,Washington
16878,September,2018,Columbia,WA,Truck,0,0,0,1521,1521,0.0,Washington,Washington
16883,September,2018,Whitman,WA,Passenger,20,32,52,22690,22742,0.23,Washington,Washington
16884,September,2018,Klickitat,WA,Truck,0,0,0,8137,8137,0.0,Washington,Washington
16885,September,2018,Pierce,WA,Passenger,1325,1267,2592,535571,538163,0.48,Washington,Washington
16886,September,2018,Grant,WA,Passenger,33,50,83,63766,63849,0.13,Washington,Washington
16893,September,2018,Snohomish,WA,Truck,1,0,1,121775,121776,0.0,Washington,Washington
16895,September,2018,Kitsap,WA,Passenger,841,499,1340,179462,180802,0.74,Washington,Washington
16896,September,2018,Whatcom,WA,Passenger,666,335,1001,148503,149504,0.67,Washington,Washington
16898,September,2018,Clallam,WA,Truck,0,0,0,21492,21492,0.0,Washington,Washington
16899,September,2018,King,WA,Passenger,14203,6079,20282,1373990,1394272,1.45,Washington,Washington
16901,September,2018,Lincoln,WA,Truck,0,0,0,4580,4580,0.0,Washington,Washington
16903,September,2018,Kitsap,WA,Truck,1,0,1,53537,53538,0.0,Washington,Washington
16904,September,2018,Benton,WA,Truck,0,0,0,41347,41347,0.0,Washington,Washington
16905,September,2018,Pend Oreille,WA,Passenger,5,5,10,9589,9599,0.1,Washington,Washington
16908,September,2018,Island,WA,Passenger,227,208,435,62869,63304,0.69,Washington,Washington
16911,September,2018,Ferry,WA,Passenger,2,2,4,4406,4410,0.09,Washington,Washington
16917,September,2018,Okanogan,WA,Passenger,10,20,30,26057,26087,0.11,Washington,Washington
16920,September,2018,Douglas,WA,Passenger,48,33,81,27849,27930,0.29,Washington,Washington
16926,September,2018,Cowlitz,WA,Truck,0,0,0,28600,28600,0.0,Washington,Washington
16929,September,2018,Lewis,WA,Passenger,84,66,150,57934,58084,0.26,Washington,Washington
16932,September,2018,Garfield,WA,Passenger,1,1,2,1320,1322,0.15,Washington,Washington
16934,September,2018,Lincoln,WA,Passenger,2,6,8,7748,7756,0.1,Washington,Washington
16935,September,2018,Stevens,WA,Passenger,13,27,40,31699,31739,0.13,Washington,Washington
16937,September,2018,Spokane,WA,Passenger,359,344,703,305145,305848,0.23,Washington,Washington
16938,September,2018,Grays Harbor,WA,Truck,0,0,0,20307,20307,0.0,Washington,Washington
16939,September,2018,Asotin,WA,Passenger,11,8,19,12678,12697,0.15,Washington,Washington
16944,September,2018,Thurston,WA,Truck,0,0,0,54640,54640,0.0,Washington,Washington
16945,September,2018,Douglas,WA,Truck,0,0,0,12012,12012,0.0,Washington,Washington
16951,September,2018,Spokane,WA,Truck,1,0,1,93185,93186,0.0,Washington,Washington
16953,September,2018,Whitman,WA,Truck,0,0,0,8517,8517,0.0,Washington,Washington
16954,September,2018,Thurston,WA,Passenger,621,527,1148,194606,195754,0.59,Washington,Washington
16960,September,2018,Pacific,WA,Truck,0,0,0,7632,7632,0.0,Washington,Washington
16961,September,2018,Pend Oreille,WA,Truck,0,0,0,5744,5744,0.0,Washington,Washington
16963,September,2018,Yakima,WA,Truck,0,0,0,58690,58690,0.0,Washington,Washington
16965,September,2018,Franklin,WA,Passenger,37,65,102,58512,58614,0.17,Washington,Washington
16968,September,2018,Mason,WA,Truck,0,0,0,20090,20090,0.0,Washington,Washington
16971,September,2018,San Juan,WA,Truck,0,0,0,5761,5761,0.0,Washington,Washington
16972,September,2018,Asotin,WA,Truck,0,0,0,6631,6631,0.0,Washington,Washington
16976,September,2018,San Juan,WA,Passenger,161,68,229,14183,14412,1.59,Washington,Washington
16978,September,2018,Chelan,WA,Truck,0,0,0,22027,22027,0.0,Washington,Washington
16980,September,2018,Skagit,WA,Truck,1,0,1,32261,32262,0.0,Washington,Washington
16984,September,2018,Garfield,WA,Truck,0,0,0,966,966,0.0,Washington,Washington
16988,September,2018,Franklin,WA,Truck,0,0,0,18876,18876,0.0,Washington,Washington
16991,September,2018,Pierce,WA,Truck,0,0,0,138460,138460,0.0,Washington,Washington
16993,September,2018,Adams,WA,Passenger,5,5,10,12682,12692,0.08,Washington,Washington
16994,September,2018,Kittitas,WA,Passenger,55,36,91,29200,29291,0.31,Washington,Washington
16999,September,2019,Cowlitz,WA,Passenger,106,106,212,73309,73521,0.29,Washington,Washington
17002,September,2019,King,WA,Passenger,20421,7282,27703,1394905,1422608,1.95,Washington,Washington
17003,September,2019,Wahkiakum,WA,Passenger,2,3,5,3049,3054,0.16,Washington,Washington
17007,September,2019,Pacific,WA,Truck,0,0,0,7676,7676,0.0,Washington,Washington
17010,September,2019,Walla Walla,WA,Passenger,59,63,122,36254,36376,0.34,Washington,Washington
17016,September,2019,Snohomish,WA,Truck,0,0,0,122968,122968,0.0,Washington,Washington
17025,September,2019,Mason,WA,Passenger,133,129,262,47444,47706,0.55,Washington,Washington
17030,September,2019,Pacific,WA,Passenger,25,29,54,16078,16132,0.33,Washington,Washington
17032,September,2019,Thurston,WA,Truck,0,0,0,55538,55538,0.0,Washington,Washington
17034,September,2019,Chelan,WA,Passenger,174,71,245,54511,54756,0.45,Washington,Washington
17037,September,2019,Snohomish,WA,Passenger,3740,1661,5401,533934,539335,1.0,Washington,Washington
17046,September,2019,Spokane,WA,Truck,1,0,1,95761,95762,0.0,Washington,Washington
17048,September,2019,Whatcom,WA,Passenger,922,460,1382,151337,152719,0.9,Washington,Washington
17049,September,2019,Columbia,WA,Truck,0,0,0,1536,1536,0.0,Washington,Washington
17051,September,2019,Ferry,WA,Truck,0,0,0,3583,3583,0.0,Washington,Washington
17054,September,2019,Cowlitz,WA,Truck,0,0,0,28959,28959,0.0,Washington,Washington
17055,September,2019,Clallam,WA,Truck,1,0,1,21843,21844,0.0,Washington,Washington
17057,September,2019,Ferry,WA,Passenger,5,2,7,4423,4430,0.16,Washington,Washington
17059,September,2019,Yakima,WA,Truck,0,0,0,59399,59399,0.0,Washington,Washington
17061,September,2019,Lewis,WA,Passenger,107,101,208,59362,59570,0.35,Washington,Washington
17063,September,2019,Skagit,WA,Passenger,315,210,525,92513,93038,0.56,Washington,Washington
17064,September,2019,Kitsap,WA,Passenger,1135,641,1776,181617,183393,0.97,Washington,Washington
17066,September,2019,Clark,WA,Passenger,1700,982,2682,316090,318772,0.84,Washington,Washington
17067,September,2019,Asotin,WA,Passenger,12,8,20,12631,12651,0.16,Washington,Washington
17071,September,2019,Island,WA,Passenger,346,249,595,63481,64076,0.93,Washington,Washington
17072,September,2019,Asotin,WA,Truck,0,0,0,6682,6682,0.0,Washington,Washington
17076,September,2019,Lewis,WA,Truck,0,0,0,25970,25970,0.0,Washington,Washington
17086,September,2019,Kitsap,WA,Truck,1,0,1,54211,54212,0.0,Washington,Washington
17087,September,2019,Kittitas,WA,Truck,0,0,0,14565,14565,0.0,Washington,Washington
17089,September,2019,Thurston,WA,Passenger,953,672,1625,198595,200220,0.81,Washington,Washington
17090,September,2019,Pend Oreille,WA,Passenger,6,6,12,9472,9484,0.13,Washington,Washington
17093,September,2019,Grays Harbor,WA,Passenger,89,89,178,48096,48274,0.37,Washington,Washington
17094,September,2019,Skamania,WA,Truck,0,0,0,4086,4086,0.0,Washington,Washington
17099,September,2019,Klickitat,WA,Passenger,38,36,74,15624,15698,0.47,Washington,Washington
17101,September,2019,Okanogan,WA,Passenger,24,26,50,26237,26287,0.19,Washington,Washington
17103,September,2019,Klickitat,WA,Truck,0,0,0,8298,8298,0.0,Washington,Washington
17110,September,2019,Pierce,WA,Passenger,1966,1602,3568,545437,549005,0.65,Washington,Washington
17111,September,2019,Whitman,WA,Passenger,36,45,81,22710,22791,0.36,Washington,Washington
17112,September,2019,Island,WA,Truck,0,0,0,21294,21294,0.0,Washington,Washington
17114,September,2019,Garfield,WA,Truck,0,0,0,970,970,0.0,Washington,Washington
17115,September,2019,Lincoln,WA,Passenger,2,10,12,7807,7819,0.15,Washington,Washington
17117,September,2019,Grays Harbor,WA,Truck,0,0,0,20636,20636,0.0,Washington,Washington
17124,September,2019,San Juan,WA,Truck,0,0,0,5916,5916,0.0,Washington,Washington
17125,September,2019,Chelan,WA,Truck,0,0,0,22420,22420,0.0,Washington,Washington
17127,September,2019,Whitman,WA,Truck,0,0,0,8604,8604,0.0,Washington,Washington
17129,September,2019,San Juan,WA,Passenger,229,73,302,14431,14733,2.05,Washington,Washington
17132,September,2019,Clallam,WA,Passenger,185,151,336,50854,51190,0.66,Washington,Washington
17141,September,2019,Walla Walla,WA,Truck,0,0,0,13687,13687,0.0,Washington,Washington
17142,September,2019,Yakima,WA,Passenger,111,113,224,165657,165881,0.14,Washington,Washington
17146,September,2019,Pend Oreille,WA,Truck,0,0,0,5712,5712,0.0,Washington,Washington
17149,September,2019,Lincoln,WA,Truck,0,0,0,4690,4690,0.0,Washington,Washington
17150,September,2019,Benton,WA,Truck,0,0,0,42229,42229,0.0,Washington,Washington
17152,September,2019,Franklin,WA,Truck,0,0,0,19536,19536,0.0,Washington,Washington
17153,September,2019,King,WA,Truck,6,1,7,182395,182402,0.0,Washington,Washington
17156,September,2019,Franklin,WA,Passenger,51,73,124,60363,60487,0.21,Washington,Washington
17160,September,2019,Kittitas,WA,Passenger,81,44,125,29832,29957,0.42,Washington,Washington
17163,September,2019,Jefferson,WA,Truck,0,0,0,9682,9682,0.0,Washington,Washington
17166,September,2019,Stevens,WA,Truck,0,0,0,18754,18754,0.0,Washington,Washington
17167,September,2019,Skamania,WA,Passenger,26,18,44,8787,8831,0.5,Washington,Washington
17173,September,2019,Stevens,WA,Passenger,27,28,55,31672,31727,0.17,Washington,Washington
17184,September,2019,Grant,WA,Truck,0,0,0,26789,26789,0.0,Washington,Washington
17186,September,2019,Columbia,WA,Passenger,3,2,5,2446,2451,0.2,Washington,Washington
17192,September,2019,Skagit,WA,Truck,1,0,1,32515,32516,0.0,Washington,Washington
17194,September,2019,Wahkiakum,WA,Truck,0,0,0,1760,1760,0.0,Washington,Washington
17197,September,2019,Okanogan,WA,Truck,0,0,0,16497,16497,0.0,Washington,Washington
17199,September,2019,Benton,WA,Passenger,291,297,588,134616,135204,0.43,Washington,Washington
17202,September,2019,Adams,WA,Passenger,5,5,10,12887,12897,0.08,Washington,Washington
17204,September,2019,Garfield,WA,Passenger,0,1,1,1311,1312,0.08,Washington,Washington
17205,September,2019,Pierce,WA,Truck,0,0,0,140471,140471,0.0,Washington,Washington
17209,September,2019,Whatcom,WA,Truck,2,0,2,43030,43032,0.0,Washington,Washington
17210,September,2019,Mason,WA,Truck,0,0,0,20438,20438,0.0,Washington,Washington
17211,September,2019,Adams,WA,Truck,0,0,0,5139,5139,0.0,Washington,Washington
17213,September,2019,Douglas,WA,Truck,0,0,0,12275,12275,0.0,Washington,Washington
17215,September,2019,Clark,WA,Truck,0,0,0,80968,80968,0.0,Washington,Washington
17217,September,2019,Spokane,WA,Passenger,596,445,1041,313551,314592,0.33,Washington,Washington
17221,September,2019,Jefferson,WA,Passenger,207,126,333,25125,25458,1.31,Washington,Washington
17223,September,2019,Grant,WA,Passenger,48,63,111,65170,65281,0.17,Washington,Washington
17225,September,2019,Douglas,WA,Passenger,62,37,99,28207,28306,0.35,Washington,Washington
17227,September,2020,Cowlitz,WA,Passenger,157,120,277,72161,72438,0.38,Washington,Washington
17229,September,2020,Mason,WA,Truck,0,0,0,20804,20804,0.0,Washington,Washington
17230,September,2020,Adams,WA,Truck,0,0,0,5309,5309,0.0,Washington,Washington
17232,September,2020,Skamania,WA,Truck,0,0,0,4005,4005,0.0,Washington,Washington
17238,September,2020,Grant,WA,Truck,0,0,0,27301,27301,0.0,Washington,Washington
17239,September,2020,Walla Walla,WA,Truck,0,0,0,13789,13789,0.0,Washington,Washington
17240,September,2020,Pacific,WA,Passenger,32,34,66,15716,15782,0.42,Washington,Washington
17248,September,2020,Garfield,WA,Passenger,0,1,1,1348,1349,0.07,Washington,Washington
17251,September,2020,Wahkiakum,WA,Passenger,6,6,12,3016,3028,0.4,Washington,Washington
17259,September,2020,Clark,WA,Passenger,2174,1098,3272,318408,321680,1.02,Washington,Washington
17264,September,2020,San Juan,WA,Passenger,331,100,431,13907,14338,3.01,Washington,Washington
17269,September,2020,Asotin,WA,Passenger,17,14,31,12398,12429,0.25,Washington,Washington
17272,September,2020,Walla Walla,WA,Passenger,86,62,148,35944,36092,0.41,Washington,Washington
17274,September,2020,Grant,WA,Passenger,67,80,147,65582,65729,0.22,Washington,Washington
17275,September,2020,Whatcom,WA,Passenger,1140,525,1665,149401,151066,1.1,Washington,Washington
17277,September,2020,Kittitas,WA,Passenger,113,48,161,29701,29862,0.54,Washington,Washington
17283,September,2020,Douglas,WA,Passenger,79,45,124,28040,28164,0.44,Washington,Washington
17288,September,2020,Snohomish,WA,Truck,0,0,0,124936,124936,0.0,Washington,Washington
17289,September,2020,Ferry,WA,Truck,0,0,0,3582,3582,0.0,Washington,Washington
17290,September,2020,Spokane,WA,Passenger,797,513,1310,318772,320082,0.41,Washington,Washington
17300,September,2020,Okanogan,WA,Passenger,45,36,81,25965,26046,0.31,Washington,Washington
17306,September,2020,San Juan,WA,Truck,0,0,0,5848,5848,0.0,Washington,Washington
17307,September,2020,Pacific,WA,Truck,0,0,0,7742,7742,0.0,Washington,Washington
17313,September,2020,Benton,WA,Passenger,394,329,723,134382,135105,0.54,Washington,Washington
17318,September,2020,Yakima,WA,Passenger,154,124,278,166493,166771,0.17,Washington,Washington
17322,September,2020,Pierce,WA,Truck,0,0,0,143993,143993,0.0,Washington,Washington
17324,September,2020,Snohomish,WA,Passenger,4694,1808,6502,537221,543723,1.2,Washington,Washington
17327,September,2020,Ferry,WA,Passenger,8,3,11,4305,4316,0.25,Washington,Washington
17328,September,2020,Clallam,WA,Passenger,245,173,418,49886,50304,0.83,Washington,Washington
17330,September,2020,Skagit,WA,Truck,1,0,1,32643,32644,0.0,Washington,Washington
17331,September,2020,Garfield,WA,Truck,0,0,0,987,987,0.0,Washington,Washington
17334,September,2020,Lewis,WA,Truck,0,0,0,26446,26446,0.0,Washington,Washington
17342,September,2020,Columbia,WA,Passenger,4,3,7,2421,2428,0.29,Washington,Washington
17347,September,2020,Klickitat,WA,Passenger,58,42,100,15023,15123,0.66,Washington,Washington
17348,September,2020,King,WA,Passenger,25389,7895,33284,1371586,1404870,2.37,Washington,Washington
17349,September,2020,Benton,WA,Truck,0,0,0,43090,43090,0.0,Washington,Washington
17351,September,2020,Chelan,WA,Passenger,260,80,340,54306,54646,0.62,Washington,Washington
17362,September,2020,Thurston,WA,Passenger,1211,753,1964,197219,199183,0.99,Washington,Washington
17364,September,2020,Stevens,WA,Passenger,35,38,73,30417,30490,0.24,Washington,Washington
17368,September,2020,Jefferson,WA,Truck,0,0,0,9541,9541,0.0,Washington,Washington
17370,September,2020,Spokane,WA,Truck,1,0,1,99865,99866,0.0,Washington,Washington
17374,September,2020,Chelan,WA,Truck,0,0,0,22729,22729,0.0,Washington,Washington
17381,September,2020,Douglas,WA,Truck,0,0,0,12380,12380,0.0,Washington,Washington
17382,September,2020,Pierce,WA,Passenger,2575,1710,4285,553881,558166,0.77,Washington,Washington
17384,September,2020,Cowlitz,WA,Truck,0,0,0,28936,28936,0.0,Washington,Washington
17385,September,2020,Asotin,WA,Truck,0,0,0,6693,6693,0.0,Washington,Washington
17388,September,2020,Skagit,WA,Passenger,447,228,675,91505,92180,0.73,Washington,Washington
17395,September,2020,Thurston,WA,Truck,0,0,0,56132,56132,0.0,Washington,Washington
17397,September,2020,Lincoln,WA,Passenger,5,10,15,7595,7610,0.2,Washington,Washington
17398,September,2020,Clallam,WA,Truck,1,0,1,21773,21774,0.0,Washington,Washington
17401,September,2020,Lincoln,WA,Truck,0,0,0,4640,4640,0.0,Washington,Washington
17402,September,2020,Island,WA,Passenger,444,280,724,62886,63610,1.14,Washington,Washington
17404,September,2020,Adams,WA,Passenger,8,7,15,12918,12933,0.12,Washington,Washington
17406,September,2020,Island,WA,Truck,1,0,1,21261,21262,0.0,Washington,Washington
17409,September,2020,Kittitas,WA,Truck,0,0,0,14601,14601,0.0,Washington,Washington
17410,September,2020,King,WA,Truck,5,1,6,183674,183680,0.0,Washington,Washington
17412,September,2020,Pend Oreille,WA,Truck,0,0,0,5727,5727,0.0,Washington,Washington
17417,September,2020,Whitman,WA,Truck,0,0,0,8497,8497,0.0,Washington,Washington
17419,September,2020,Grays Harbor,WA,Truck,0,0,0,21093,21093,0.0,Washington,Washington
17424,September,2020,Wahkiakum,WA,Truck,0,0,0,1759,1759,0.0,Washington,Washington
17426,September,2020,Skamania,WA,Passenger,32,22,54,8373,8427,0.64,Washington,Washington
17427,September,2020,Mason,WA,Passenger,162,131,293,47460,47753,0.61,Washington,Washington
17432,September,2020,Lewis,WA,Passenger,111,117,228,58309,58537,0.39,Washington,Washington
17437,September,2020,Whatcom,WA,Truck,3,0,3,43388,43391,0.01,Washington,Washington
17445,September,2020,Grays Harbor,WA,Passenger,115,116,231,48482,48713,0.47,Washington,Washington
17446,September,2020,Whitman,WA,Passenger,47,47,94,21996,22090,0.43,Washington,Washington
17450,September,2020,Klickitat,WA,Truck,0,0,0,8105,8105,0.0,Washington,Washington
17453,September,2020,Jefferson,WA,Passenger,257,148,405,24734,25139,1.61,Washington,Washington
17454,September,2020,Clark,WA,Truck,0,0,0,82868,82868,0.0,Washington,Washington
17456,September,2020,Kitsap,WA,Truck,0,0,0,54186,54186,0.0,Washington,Washington
17457,September,2020,Yakima,WA,Truck,0,0,0,60573,60573,0.0,Washington,Washington
17458,September,2020,Pend Oreille,WA,Passenger,8,4,12,9189,9201,0.13,Washington,Washington
17460,September,2020,Franklin,WA,Truck,0,0,0,20289,20289,0.0,Washington,Washington
17464,September,2020,Franklin,WA,Passenger,68,76,144,60928,61072,0.24,Washington,Washington
17465,September,2020,Stevens,WA,Truck,0,0,0,18704,18704,0.0,Washington,Washington
17469,September,2020,Okanogan,WA,Truck,0,0,0,16547,16547,0.0,Washington,Washington
17470,September,2020,Columbia,WA,Truck,0,0,0,1532,1532,0.0,Washington,Washington
17471,September,2020,Kitsap,WA,Passenger,1426,713,2139,179647,181786,1.18,Washington,Washington
17473,September,2021,Walla Walla,WA,Truck,0,0,0,14076,14076,0.0,Washington,Washington
17479,September,2021,Lewis,WA,Truck,0,0,0,26704,26704,0.0,Washington,Washington
17480,September,2021,Grant,WA,Passenger,125,97,222,66876,67098,0.33,Washington,Washington
17494,September,2021,Skagit,WA,Truck,1,0,1,32933,32934,0.0,Washington,Washington
17495,September,2021,Cowlitz,WA,Truck,0,1,1,29037,29038,0.0,Washington,Washington
17502,September,2021,Walla Walla,WA,Passenger,128,82,210,36440,36650,0.57,Washington,Washington
17508,September,2021,Kittitas,WA,Truck,0,0,0,14782,14782,0.0,Washington,Washington
17510,September,2021,Mason,WA,Passenger,239,151,390,47982,48372,0.81,Washington,Washington
17511,September,2021,Columbia,WA,Passenger,7,2,9,2451,2460,0.37,Washington,Washington
17514,September,2021,Franklin,WA,Passenger,138,100,238,62127,62365,0.38,Washington,Washington
17516,September,2021,Yakima,WA,Passenger,257,164,421,168958,169379,0.25,Washington,Washington
17521,September,2021,Skagit,WA,Passenger,641,291,932,91682,92614,1.01,Washington,Washington
17522,September,2021,Clark,WA,Passenger,3150,1486,4636,321804,326440,1.42,Washington,Washington
17523,September,2021,Ferry,WA,Passenger,10,3,13,4403,4416,0.29,Washington,Washington
17526,September,2021,Douglas,WA,Passenger,103,51,154,28572,28726,0.54,Washington,Washington
17527,September,2021,Chelan,WA,Truck,0,0,0,23103,23103,0.0,Washington,Washington
17531,September,2021,Wahkiakum,WA,Passenger,16,8,24,3071,3095,0.78,Washington,Washington
17532,September,2021,Pierce,WA,Truck,0,0,0,145459,145459,0.0,Washington,Washington
17536,September,2021,Thurston,WA,Passenger,1751,908,2659,197543,200202,1.33,Washington,Washington
17543,September,2021,Kitsap,WA,Truck,0,0,0,54327,54327,0.0,Washington,Washington
17544,September,2021,Columbia,WA,Truck,0,0,0,1537,1537,0.0,Washington,Washington
17545,September,2021,Thurston,WA,Truck,0,0,0,56349,56349,0.0,Washington,Washington
17548,September,2021,Snohomish,WA,Truck,1,0,1,125958,125959,0.0,Washington,Washington
17553,September,2021,Okanogan,WA,Truck,0,0,0,16701,16701,0.0,Washington,Washington
17555,September,2021,Ferry,WA,Truck,0,0,0,3592,3592,0.0,Washington,Washington
17562,September,2021,Adams,WA,Truck,0,0,0,5403,5403,0.0,Washington,Washington
17566,September,2021,Whatcom,WA,Truck,4,0,4,43814,43818,0.01,Washington,Washington
17572,September,2021,Kittitas,WA,Passenger,180,72,252,29865,30117,0.84,Washington,Washington
17578,September,2021,Spokane,WA,Passenger,1187,703,1890,326207,328097,0.58,Washington,Washington
17584,September,2021,Whitman,WA,Truck,0,0,0,8558,8558,0.0,Washington,Washington
17587,September,2021,King,WA,Truck,5,1,6,183901,183907,0.0,Washington,Washington
17589,September,2021,Mason,WA,Truck,0,0,0,21291,21291,0.0,Washington,Washington
17590,September,2021,Lincoln,WA,Passenger,7,16,23,7682,7705,0.3,Washington,Washington
17593,September,2021,Yakima,WA,Truck,0,0,0,61737,61737,0.0,Washington,Washington
17606,September,2021,Skamania,WA,Passenger,53,39,92,8385,8477,1.09,Washington,Washington
17608,September,2021,Garfield,WA,Truck,0,0,0,998,998,0.0,Washington,Washington
17611,September,2021,Jefferson,WA,Passenger,358,186,544,24810,25354,2.15,Washington,Washington
17612,September,2021,Pend Oreille,WA,Passenger,17,7,24,9240,9264,0.26,Washington,Washington
17613,September,2021,Island,WA,Truck,0,0,0,21574,21574,0.0,Washington,Washington
17614,September,2021,Chelan,WA,Passenger,375,104,479,54762,55241,0.87,Washington,Washington
17618,September,2021,Pierce,WA,Passenger,3877,2069,5946,559042,564988,1.05,Washington,Washington
17619,September,2021,Skamania,WA,Truck,0,0,0,4043,4043,0.0,Washington,Washington
17620,September,2021,Garfield,WA,Passenger,0,3,3,1366,1369,0.22,Washington,Washington
17626,September,2021,Franklin,WA,Truck,0,0,0,20718,20718,0.0,Washington,Washington
17627,September,2021,Grant,WA,Truck,0,0,0,28010,28010,0.0,Washington,Washington
17628,September,2021,Douglas,WA,Truck,0,0,0,12713,12713,0.0,Washington,Washington
17629,September,2021,Lincoln,WA,Truck,0,0,0,4784,4784,0.0,Washington,Washington
17630,September,2021,Clark,WA,Truck,0,0,0,84157,84157,0.0,Washington,Washington
17631,September,2021,Benton,WA,Truck,0,0,0,43672,43672,0.0,Washington,Washington
17634,September,2021,Stevens,WA,Truck,0,0,0,18892,18892,0.0,Washington,Washington
17636,September,2021,Grays Harbor,WA,Truck,0,0,0,21400,21400,0.0,Washington,Washington
17637,September,2021,Kitsap,WA,Passenger,1993,907,2900,180805,183705,1.58,Washington,Washington
17641,September,2021,Spokane,WA,Truck,0,0,0,102568,102568,0.0,Washington,Washington
17645,September,2021,Asotin,WA,Passenger,20,17,37,12736,12773,0.29,Washington,Washington
17647,September,2021,Cowlitz,WA,Passenger,246,154,400,72035,72435,0.55,Washington,Washington
17648,September,2021,Lewis,WA,Passenger,185,149,334,59589,59923,0.56,Washington,Washington
17656,September,2021,Adams,WA,Passenger,16,14,30,13045,13075,0.23,Washington,Washington
17658,September,2021,San Juan,WA,Truck,0,0,0,5983,5983,0.0,Washington,Washington
17659,September,2021,Snohomish,WA,Passenger,6456,2164,8620,539501,548121,1.57,Washington,Washington
17664,September,2021,Pend Oreille,WA,Truck,0,0,0,5690,5690,0.0,Washington,Washington
17670,September,2021,Wahkiakum,WA,Truck,0,0,0,1815,1815,0.0,Washington,Washington
17671,September,2021,Jefferson,WA,Truck,0,0,0,9619,9619,0.0,Washington,Washington
17673,September,2021,Clallam,WA,Passenger,359,229,588,50550,51138,1.15,Washington,Washington
17675,September,2021,Whitman,WA,Passenger,64,56,120,21929,22049,0.54,Washington,Washington
17677,September,2021,Grays Harbor,WA,Passenger,183,150,333,49489,49822,0.67,Washington,Washington
17679,September,2021,King,WA,Passenger,32879,9690,42569,1365552,1408121,3.02,Washington,Washington
17683,September,2021,Benton,WA,Passenger,581,414,995,136268,137263,0.72,Washington,Washington
17685,September,2021,Pacific,WA,Truck,0,0,0,7998,7998,0.0,Washington,Washington
17688,September,2021,Okanogan,WA,Passenger,67,44,111,26541,26652,0.42,Washington,Washington
17691,September,2021,Asotin,WA,Truck,0,0,0,6755,6755,0.0,Washington,Washington
17700,September,2021,Whatcom,WA,Passenger,1540,641,2181,150546,152727,1.43,Washington,Washington
17706,September,2021,Stevens,WA,Passenger,51,42,93,30327,30420,0.31,Washington,Washington
17707,September,2021,Island,WA,Passenger,661,329,990,63226,64216,1.54,Washington,Washington
17708,September,2021,Pacific,WA,Passenger,49,57,106,16073,16179,0.66,Washington,Washington
17716,September,2021,Klickitat,WA,Passenger,83,51,134,15391,15525,0.86,Washington,Washington
17718,September,2021,San Juan,WA,Passenger,462,143,605,14187,14792,4.09,Washington,Washington
17719,September,2021,Klickitat,WA,Truck,0,0,0,8341,8341,0.0,Washington,Washington
17722,September,2021,Clallam,WA,Truck,1,0,1,22018,22019,0.0,Washington,Washington
17724,September,2022,Pend Oreille,WA,Truck,0,0,0,5638,5638,0.0,Washington,Washington
17726,September,2022,Douglas,WA,Truck,1,0,1,12781,12782,0.01,Washington,Washington
17727,September,2022,Walla Walla,WA,Truck,2,0,2,13946,13948,0.01,Washington,Washington
17729,September,2022,Skagit,WA,Passenger,869,349,1218,89712,90930,1.34,Washington,Washington
17731,September,2022,Grays Harbor,WA,Passenger,224,166,390,48799,49189,0.79,Washington,Washington
17733,September,2022,Thurston,WA,Passenger,2380,1102,3482,192946,196428,1.77,Washington,Washington
17735,September,2022,Whitman,WA,Passenger,96,64,160,21991,22151,0.72,Washington,Washington
17738,September,2022,King,WA,Passenger,43484,11789,55273,1345189,1400462,3.95,Washington,Washington
17743,September,2022,Skagit,WA,Truck,6,0,6,32229,32235,0.02,Washington,Washington
17748,September,2022,King,WA,Truck,241,2,243,179679,179922,0.14,Washington,Washington
17749,September,2022,Columbia,WA,Passenger,8,0,8,2439,2447,0.33,Washington,Washington
17750,September,2022,Clark,WA,Truck,19,0,19,82316,82335,0.02,Washington,Washington
17752,September,2022,Lewis,WA,Truck,1,0,1,26365,26366,0.0,Washington,Washington
17753,September,2022,Clark,WA,Passenger,4480,1890,6370,315618,321988,1.98,Washington,Washington
17761,September,2022,Pacific,WA,Truck,0,0,0,7871,7871,0.0,Washington,Washington
17762,September,2022,Benton,WA,Passenger,833,480,1313,135629,136942,0.96,Washington,Washington
17765,September,2022,Pacific,WA,Passenger,70,74,144,15784,15928,0.9,Washington,Washington
17767,September,2022,Cowlitz,WA,Passenger,368,180,548,70395,70943,0.77,Washington,Washington
17768,September,2022,Klickitat,WA,Truck,2,0,2,8263,8265,0.02,Washington,Washington
17769,September,2022,Grant,WA,Passenger,200,108,308,66776,67084,0.46,Washington,Washington
17773,September,2022,Chelan,WA,Passenger,495,135,630,54143,54773,1.15,Washington,Washington
17774,September,2022,Lincoln,WA,Passenger,10,16,26,7725,7751,0.34,Washington,Washington
17779,September,2022,Stevens,WA,Passenger,81,56,137,30090,30227,0.45,Washington,Washington
17780,September,2022,Pierce,WA,Passenger,5530,2431,7961,541956,549917,1.45,Washington,Washington
17784,September,2022,Yakima,WA,Passenger,376,210,586,166551,167137,0.35,Washington,Washington
17786,September,2022,Douglas,WA,Passenger,147,61,208,28445,28653,0.73,Washington,Washington
17789,September,2022,Whatcom,WA,Truck,14,0,14,43119,43133,0.03,Washington,Washington
17796,September,2022,Grant,WA,Truck,2,0,2,28018,28020,0.01,Washington,Washington
17797,September,2022,Spokane,WA,Passenger,1770,889,2659,324764,327423,0.81,Washington,Washington
17798,September,2022,Island,WA,Truck,10,0,10,21293,21303,0.05,Washington,Washington
17800,September,2022,Asotin,WA,Passenger,25,19,44,12615,12659,0.35,Washington,Washington
17804,September,2022,Jefferson,WA,Truck,3,0,3,9383,9386,0.03,Washington,Washington
17807,September,2022,Snohomish,WA,Truck,59,0,59,123094,123153,0.05,Washington,Washington
17809,September,2022,Wahkiakum,WA,Truck,1,0,1,1801,1802,0.06,Washington,Washington
17811,September,2022,Asotin,WA,Truck,0,0,0,6710,6710,0.0,Washington,Washington
17818,September,2022,Whitman,WA,Truck,2,0,2,8588,8590,0.02,Washington,Washington
17822,September,2022,Franklin,WA,Passenger,231,112,343,61926,62269,0.55,Washington,Washington
17823,September,2022,Yakima,WA,Truck,3,0,3,61428,61431,0.0,Washington,Washington
17826,September,2022,Klickitat,WA,Passenger,109,53,162,15150,15312,1.06,Washington,Washington
17829,September,2022,Grays Harbor,WA,Truck,2,0,2,21184,21186,0.01,Washington,Washington
17835,September,2022,Columbia,WA,Truck,0,0,0,1577,1577,0.0,Washington,Washington
17841,September,2022,Adams,WA,Truck,1,0,1,5425,5426,0.02,Washington,Washington
17842,September,2022,Okanogan,WA,Truck,1,0,1,16528,16529,0.01,Washington,Washington
17843,September,2022,Wahkiakum,WA,Passenger,24,12,36,3078,3114,1.16,Washington,Washington
17846,September,2022,Garfield,WA,Truck,0,0,0,970,970,0.0,Washington,Washington
17849,September,2022,Kitsap,WA,Passenger,2572,1110,3682,177870,181552,2.03,Washington,Washington
17850,September,2022,Stevens,WA,Truck,1,0,1,18922,18923,0.01,Washington,Washington
17853,September,2022,Cowlitz,WA,Truck,3,0,3,28470,28473,0.01,Washington,Washington
17855,September,2022,Kittitas,WA,Passenger,290,91,381,29618,29999,1.27,Washington,Washington
17858,September,2022,San Juan,WA,Truck,6,0,6,5955,5961,0.1,Washington,Washington
17859,September,2022,Lewis,WA,Passenger,252,176,428,59836,60264,0.71,Washington,Washington
17863,September,2022,San Juan,WA,Passenger,536,162,698,14006,14704,4.75,Washington,Washington
17866,September,2022,Thurston,WA,Truck,21,0,21,55058,55079,0.04,Washington,Washington
17868,September,2022,Lincoln,WA,Truck,0,0,0,4853,4853,0.0,Washington,Washington
17874,September,2022,Franklin,WA,Truck,2,0,2,20933,20935,0.01,Washington,Washington
17875,September,2022,Ferry,WA,Truck,0,0,0,3616,3616,0.0,Washington,Washington
17882,September,2022,Chelan,WA,Truck,6,0,6,23093,23099,0.03,Washington,Washington
17884,September,2022,Snohomish,WA,Passenger,9066,2624,11690,531280,542970,2.15,Washington,Washington
17886,September,2022,Benton,WA,Truck,5,0,5,43402,43407,0.01,Washington,Washington
17887,September,2022,Skamania,WA,Passenger,85,51,136,8126,8262,1.65,Washington,Washington
17896,September,2022,Adams,WA,Passenger,22,10,32,13017,13049,0.25,Washington,Washington
17900,September,2022,Garfield,WA,Passenger,1,3,4,1324,1328,0.3,Washington,Washington
17905,September,2022,Okanogan,WA,Passenger,93,49,142,26316,26458,0.54,Washington,Washington
17906,September,2022,Whatcom,WA,Passenger,1952,772,2724,148826,151550,1.8,Washington,Washington
17908,September,2022,Mason,WA,Truck,4,0,4,21008,21012,0.02,Washington,Washington
17911,September,2022,Island,WA,Passenger,877,382,1259,61751,63010,2.0,Washington,Washington
17914,September,2022,Walla Walla,WA,Passenger,187,105,292,35831,36123,0.81,Washington,Washington
17919,September,2022,Spokane,WA,Truck,12,0,12,101973,101985,0.01,Washington,Washington
17922,September,2022,Kitsap,WA,Truck,23,0,23,53242,53265,0.04,Washington,Washington
17924,September,2022,Jefferson,WA,Passenger,454,224,678,24444,25122,2.7,Washington,Washington
17930,September,2022,Pierce,WA,Truck,46,0,46,140496,140542,0.03,Washington,Washington
17931,September,2022,Pend Oreille,WA,Passenger,18,12,30,9024,9054,0.33,Washington,Washington
17932,September,2022,Clallam,WA,Passenger,442,249,691,49482,50173,1.38,Washington,Washington
17941,September,2022,Clallam,WA,Truck,6,0,6,21889,21895,0.03,Washington,Washington
17949,September,2022,Kittitas,WA,Truck,4,0,4,14604,14608,0.03,Washington,Washington
17952,September,2022,Skamania,WA,Truck,0,0,0,3908,3908,0.0,Washington,Washington
17956,September,2022,Ferry,WA,Passenger,22,4,26,4400,4426,0.59,Washington,Washington
17963,September,2022,Mason,WA,Passenger,339,178,517,46951,47468,1.09,Washington,Washington
