,Month_ending,Year,County,State,Primary_use,Battery_BEVs,Hybrid_(PHEVs),EV_Total,Non-Electric_Total,Total_Veh,%_Electric,Proximity
0,April,2017,Pinal,AZ,Passenger,2,0,2,254,256,0.78,Nearest
1,April,2017,Island,WA,Passenger,108,128,236,59768,60004,0.39,Washington
2,April,2017,Clark,WA,Truck,0,0,0,77561,77561,0.0,Washington
3,April,2017,Allegheny,PA,Passenger,1,0,1,93,94,1.06,Furthest
4,April,2017,Shelby,TN,Passenger,0,1,1,109,110,0.91,Furthest
5,April,2017,Dale,AL,Passenger,0,1,1,65,66,1.52,Furthest
6,April,2017,Jefferson,WA,Passenger,98,56,154,23744,23898,0.64,Washington
8,April,2017,Harnett,NC,Passenger,1,0,1,257,258,0.39,Furthest
9,April,2017,Salt Lake,UT,Passenger,0,1,1,289,290,0.34,Nearest
10,April,2017,Yakima,WA,Truck,0,0,0,57219,57219,0.0,Washington
11,April,2017,Montgomery,PA,Passenger,1,0,1,41,42,2.38,Furthest
12,April,2017,Skamania,WA,Truck,0,0,0,3874,3874,0.0,Washington
13,April,2017,Whitman,WA,Passenger,9,19,28,21964,21992,0.13,Washington
14,April,2017,Utah,UT,Passenger,0,1,1,164,165,0.61,Nearest
15,April,2017,Clark,WA,Passenger,755,471,1226,298474,299700,0.41,Washington
16,April,2017,Adams,WA,Passenger,2,3,5,12128,12133,0.04,Washington
17,April,2017,Franklin,WA,Passenger,27,47,74,55348,55422,0.13,Washington
18,April,2017,Ferry,WA,Truck,0,0,0,3549,3549,0.0,Washington
19,April,2017,San Juan,WA,Truck,0,0,0,5551,5551,0.0,Washington
20,April,2017,Los Angeles,CA,Passenger,3,1,4,1345,1349,0.3,Nearest
21,April,2017,Lee,AL,Passenger,1,0,1,35,36,2.78,Furthest
22,April,2017,Klickitat,WA,Passenger,22,23,45,14768,14813,0.3,Washington
23,April,2017,Clark,NV,Passenger,1,3,4,857,861,0.46,Nearest
24,April,2017,Tarrant,TX,Passenger,0,2,2,273,275,0.73,Mid-Distance
25,April,2017,Skagit,WA,Truck,1,0,1,31395,31396,0.0,Washington
26,April,2017,Monterey,CA,Passenger,0,1,1,210,211,0.47,Nearest
27,April,2017,San Juan,WA,Passenger,98,35,133,13479,13612,0.98,Washington
28,April,2017,Douglas,OR,Passenger,0,1,1,74,75,1.33,Nearest
29,April,2017,Montgomery,TN,Passenger,1,0,1,293,294,0.34,Furthest
30,April,2017,Adams,WA,Truck,0,0,0,5072,5072,0.0,Washington
31,April,2017,Lewis,WA,Passenger,46,33,79,55192,55271,0.14,Washington
32,April,2017,Lane,OR,Passenger,0,1,1,247,248,0.4,Nearest
33,April,2017,Whatcom,WA,Truck,2,0,2,41449,41451,0.0,Washington
34,April,2017,Lincoln,WA,Truck,0,0,0,4464,4464,0.0,Washington
35,April,2017,Cobb,GA,Passenger,0,1,1,77,78,1.28,Furthest
36,April,2017,Juneau,AK,Passenger,0,1,1,53,54,1.85,Nearest
37,April,2017,Morris,NJ,Passenger,1,0,1,22,23,4.35,Furthest
38,April,2017,Grays Harbor,WA,Truck,0,0,0,19850,19850,0.0,Washington
39,April,2017,Wayne,MI,Passenger,0,1,1,70,71,1.41,Furthest
40,April,2017,Okanogan,WA,Passenger,3,16,19,25595,25614,0.07,Washington
41,April,2017,Canyon,ID,Passenger,0,1,1,102,103,0.97,Nearest
42,April,2017,Kitsap,WA,Truck,1,0,1,52312,52313,0.0,Washington
43,April,2017,Fulton,GA,Passenger,1,1,2,119,121,1.65,Furthest
44,April,2017,Manatee,FL,Passenger,1,0,1,48,49,2.04,Furthest
45,April,2017,Garfield,WA,Truck,0,0,0,938,938,0.0,Washington
46,April,2017,Nassau,NY,Passenger,0,1,1,40,41,2.44,Furthest
47,April,2017,Multnomah,OR,Passenger,0,3,3,1068,1071,0.28,Nearest
48,April,2017,Lewis,WA,Truck,0,0,0,24797,24797,0.0,Washington
49,April,2017,Asotin,WA,Passenger,6,2,8,12343,12351,0.06,Washington
50,April,2017,Latah,ID,Passenger,0,1,1,120,121,0.83,Nearest
51,April,2017,Santa Clara,CA,Passenger,6,2,8,411,419,1.91,Nearest
52,April,2017,Moore,NC,Passenger,0,1,1,205,206,0.49,Furthest
53,April,2017,Thurston,WA,Passenger,385,319,704,185729,186433,0.38,Washington
54,April,2017,Middlesex,MA,Passenger,1,0,1,148,149,0.67,Furthest
55,April,2017,Bexar,TX,Passenger,1,0,1,1025,1026,0.1,Mid-Distance
56,April,2017,Walla Walla,WA,Passenger,22,24,46,34828,34874,0.13,Washington
57,April,2017,Stevens,WA,Passenger,8,22,30,31233,31263,0.1,Washington
58,April,2017,Okanogan,WA,Truck,0,0,0,16256,16256,0.0,Washington
59,April,2017,Pierce,WA,Truck,0,0,0,137818,137818,0.0,Washington
60,April,2017,Douglas,WA,Passenger,31,21,52,26603,26655,0.2,Washington
61,April,2017,Franklin,WA,Truck,0,0,0,17995,17995,0.0,Washington
62,April,2017,Manassas,VA,Passenger,0,1,1,10,11,9.09,Furthest
63,April,2017,Albemarle,VA,Passenger,0,1,1,31,32,3.12,Furthest
64,April,2017,Prince George's,MD,Passenger,0,1,1,182,183,0.55,Furthest
65,April,2017,Hamilton,TN,Passenger,1,0,1,26,27,3.7,Furthest
66,April,2017,Tulare,CA,Passenger,1,0,1,194,195,0.51,Nearest
67,April,2017,Franklin,MA,Passenger,0,1,1,4,5,20.0,Furthest
68,April,2017,Hardin,KY,Passenger,0,1,1,123,124,0.81,Furthest
69,April,2017,Fairfax,VA,Passenger,2,2,4,860,864,0.46,Furthest
70,April,2017,Okaloosa,FL,Passenger,1,0,1,194,195,0.51,Furthest
71,April,2017,Spokane,WA,Truck,1,0,1,90266,90267,0.0,Washington
72,April,2017,Hamilton,IN,Passenger,1,0,1,61,62,1.61,Furthest
73,April,2017,Muscogee,GA,Passenger,0,1,1,247,248,0.4,Furthest
74,April,2017,Nueces,TX,Passenger,0,1,1,98,99,1.01,Mid-Distance
75,April,2017,King,WA,Truck,8,1,9,188938,188947,0.0,Washington
76,April,2017,Franklin,OH,Passenger,0,1,1,126,127,0.79,Furthest
77,April,2017,Klickitat,WA,Truck,0,0,0,7954,7954,0.0,Washington
78,April,2017,Virginia Beach,VA,Passenger,2,1,3,645,648,0.46,Furthest
79,April,2017,Bergen,NJ,Passenger,0,2,2,32,34,5.88,Furthest
80,April,2017,Orleans,LA,Passenger,0,1,1,49,50,2.0,Mid-Distance
81,April,2017,San Diego,CA,Passenger,5,1,6,2768,2774,0.22,Nearest
82,April,2017,Clallam,WA,Passenger,80,68,148,48127,48275,0.31,Washington
83,April,2017,Thurston,WA,Truck,0,0,0,53255,53255,0.0,Washington
84,April,2017,Anne Arundel,MD,Passenger,0,1,1,500,501,0.2,Furthest
85,April,2017,Saratoga,NY,Passenger,1,1,2,75,77,2.6,Furthest
86,April,2017,Pacific,WA,Truck,0,0,0,7464,7464,0.0,Washington
87,April,2017,Cumberland,NC,Passenger,1,0,1,612,613,0.16,Furthest
88,April,2017,Marion,OR,Passenger,1,0,1,181,182,0.55,Nearest
89,April,2017,Marin,CA,Passenger,1,0,1,60,61,1.64,Nearest
90,April,2017,Columbia,WA,Truck,0,0,0,1536,1536,0.0,Washington
91,April,2017,El Paso,CO,Passenger,1,1,2,820,822,0.24,Mid-Distance
92,April,2017,Lincoln,WA,Passenger,2,4,6,7481,7487,0.08,Washington
93,April,2017,St. Lucie,FL,Passenger,1,0,1,32,33,3.03,Furthest
94,April,2017,DeKalb,IN,Passenger,1,0,1,1,2,50.0,Furthest
95,April,2017,Richmond,GA,Passenger,0,1,1,93,94,1.06,Furthest
96,April,2017,Essex,NJ,Passenger,1,0,1,16,17,5.88,Furthest
97,April,2017,Santa Fe,NM,Passenger,0,1,1,44,45,2.22,Mid-Distance
98,April,2017,Travis,TX,Passenger,0,1,1,195,196,0.51,Mid-Distance
99,April,2017,Deschutes,OR,Passenger,1,0,1,198,199,0.5,Nearest
100,April,2017,Gwinnett,GA,Passenger,0,1,1,87,88,1.14,Furthest
101,April,2017,Grant,WA,Truck,0,0,0,25091,25091,0.0,Washington
102,April,2017,Norfolk,MA,Passenger,1,0,1,38,39,2.56,Furthest
103,April,2017,Clackamas,OR,Passenger,1,1,2,325,327,0.61,Nearest
104,April,2017,Ventura,CA,Passenger,0,1,1,362,363,0.28,Nearest
105,April,2017,Pacific,WA,Passenger,9,8,17,15082,15099,0.11,Washington
106,April,2017,Jefferson,WA,Truck,0,0,0,9442,9442,0.0,Washington
107,April,2017,Missoula,MT,Passenger,1,0,1,77,78,1.28,Nearest
108,April,2017,Charles,MD,Passenger,0,1,1,90,91,1.1,Furthest
109,April,2017,Volusia,FL,Passenger,0,1,1,47,48,2.08,Furthest
110,April,2017,Yakima,WA,Passenger,38,54,92,159283,159375,0.06,Washington
111,April,2017,Duval,FL,Passenger,1,1,2,378,380,0.53,Furthest
112,April,2017,Prince William,VA,Passenger,0,3,3,275,278,1.08,Furthest
113,April,2017,Orange,CA,Passenger,2,1,3,646,649,0.46,Nearest
114,April,2017,Walla Walla,WA,Truck,0,0,0,13177,13177,0.0,Washington
115,April,2017,Chelan,WA,Truck,0,0,0,21208,21208,0.0,Washington
116,April,2017,Madison,ID,Passenger,1,0,1,41,42,2.38,Nearest
117,April,2017,Grant,WA,Passenger,18,21,39,60489,60528,0.06,Washington
118,April,2017,Whitman,WA,Truck,0,0,0,8380,8380,0.0,Washington
119,April,2017,Lewis,NY,Passenger,0,1,1,10,11,9.09,Furthest
120,April,2017,Maui,HI,Passenger,1,0,1,72,73,1.37,Nearest
121,April,2017,Santa Rosa,FL,Passenger,1,0,1,109,110,0.91,Furthest
122,April,2017,Spokane,WA,Passenger,236,208,444,295746,296190,0.15,Washington
123,April,2017,Grays Harbor,WA,Passenger,29,30,59,44477,44536,0.13,Washington
124,April,2017,Maricopa,AZ,Passenger,2,0,2,1800,1802,0.11,Nearest
125,April,2017,Wahkiakum,WA,Passenger,0,2,2,2848,2850,0.07,Washington
126,April,2017,Nantucket,MA,Passenger,1,0,1,3,4,25.0,Furthest
127,April,2017,Skamania,WA,Passenger,9,8,17,8521,8538,0.2,Washington
128,April,2017,Arlington,VA,Passenger,1,1,2,166,168,1.19,Furthest
129,April,2017,New London,CT,Passenger,1,1,2,257,259,0.77,Furthest
130,April,2017,Mason,WA,Truck,0,0,0,19242,19242,0.0,Washington
131,April,2017,Pima,AZ,Passenger,0,2,2,442,444,0.45,Nearest
132,April,2017,New Haven,CT,Passenger,0,1,1,60,61,1.64,Furthest
133,April,2017,Norfolk,VA,Passenger,1,1,2,301,303,0.66,Furthest
134,April,2017,DeKalb,GA,Passenger,1,0,1,84,85,1.18,Furthest
135,April,2017,Hidalgo,TX,Passenger,0,1,1,98,99,1.01,Mid-Distance
136,April,2017,King,WA,Passenger,9558,3882,13440,1378548,1391988,0.97,Washington
137,April,2017,Orange,FL,Passenger,1,1,2,149,151,1.32,Furthest
138,April,2017,Clallam,WA,Truck,0,0,0,20962,20962,0.0,Washington
139,April,2017,Sumter,FL,Passenger,0,1,1,10,11,9.09,Furthest
140,April,2017,Pierce,WA,Passenger,917,807,1724,525754,527478,0.33,Washington
141,April,2017,Jefferson,NY,Passenger,1,1,2,255,257,0.78,Furthest
142,April,2017,Benton,WA,Passenger,143,140,283,128087,128370,0.22,Washington
143,April,2017,Island,WA,Truck,0,0,0,20526,20526,0.0,Washington
144,April,2017,Cape May,NJ,Passenger,0,1,1,18,19,5.26,Furthest
145,April,2017,Guilford,NC,Passenger,1,0,1,31,32,3.12,Furthest
146,April,2017,Kittitas,WA,Truck,0,0,0,13478,13478,0.0,Washington
147,April,2017,San Mateo,CA,Passenger,0,1,1,158,159,0.63,Nearest
148,April,2017,District of Columbia,DC,Passenger,0,3,3,225,228,1.32,Furthest
149,April,2017,Skagit,WA,Passenger,123,97,220,87597,87817,0.25,Washington
150,April,2017,Stevens,WA,Truck,0,0,0,18286,18286,0.0,Washington
151,April,2017,Cowlitz,WA,Truck,0,0,0,27856,27856,0.0,Washington
152,April,2017,Snohomish,WA,Passenger,1709,861,2570,512767,515337,0.5,Washington
153,April,2017,Riverside,CA,Passenger,1,1,2,829,831,0.24,Nearest
154,April,2017,Dallas,TX,Passenger,0,1,1,196,197,0.51,Mid-Distance
155,April,2017,Alameda,CA,Passenger,2,1,3,379,382,0.79,Nearest
156,April,2017,Portsmouth,VA,Passenger,0,1,1,68,69,1.45,Furthest
157,April,2017,Jackson,MO,Passenger,1,0,1,68,69,1.45,Furthest
158,April,2017,Ferry,WA,Passenger,2,1,3,4397,4400,0.07,Washington
159,April,2017,Kitsap,WA,Passenger,584,298,882,172672,173554,0.51,Washington
160,April,2017,Dakota,MN,Passenger,0,1,1,40,41,2.44,Mid-Distance
161,April,2017,Douglas,WA,Truck,0,0,0,11451,11451,0.0,Washington
162,April,2017,Wahkiakum,WA,Truck,0,0,0,1631,1631,0.0,Washington
163,April,2017,Honolulu,HI,Passenger,4,2,6,604,610,0.98,Nearest
164,April,2017,Montgomery,MD,Passenger,1,0,1,308,309,0.32,Furthest
165,April,2017,Chelan,WA,Passenger,55,31,86,51695,51781,0.17,Washington
166,April,2017,Mason,WA,Passenger,49,64,113,43002,43115,0.26,Washington
167,April,2017,Polk,FL,Passenger,1,0,1,67,68,1.47,Furthest
168,April,2017,Kent,MI,Passenger,0,1,1,37,38,2.63,Furthest
169,April,2017,Hawaii,HI,Passenger,1,0,1,84,85,1.18,Nearest
170,April,2017,Cascade,MT,Passenger,0,1,1,61,62,1.61,Nearest
171,April,2017,Northampton,PA,Passenger,2,0,2,192,194,1.03,Furthest
172,April,2017,Columbia,WA,Passenger,0,1,1,2358,2359,0.04,Washington
173,April,2017,Asotin,WA,Truck,0,0,0,6504,6504,0.0,Washington
174,April,2017,Dane,WI,Passenger,1,0,1,138,139,0.72,Mid-Distance
175,April,2017,Whatcom,WA,Passenger,441,159,600,142459,143059,0.42,Washington
176,April,2017,Carroll,NH,Passenger,0,1,1,0,1,100.0,Furthest
177,April,2017,Monroe,NY,Passenger,1,0,1,27,28,3.57,Furthest
178,April,2017,Garfield,WA,Passenger,0,0,0,1283,1283,0.0,Washington
179,April,2017,Palm Beach,FL,Passenger,0,1,1,100,101,0.99,Furthest
180,April,2017,Pend Oreille,WA,Truck,0,0,0,5586,5586,0.0,Washington
181,April,2017,Benton,WA,Truck,0,0,0,39892,39892,0.0,Washington
182,April,2017,Pend Oreille,WA,Passenger,1,4,5,9320,9325,0.05,Washington
183,April,2017,Cowlitz,WA,Passenger,52,48,100,69320,69420,0.14,Washington
184,April,2017,Kittitas,WA,Passenger,21,17,38,27202,27240,0.14,Washington
185,April,2017,Snohomish,WA,Truck,1,0,1,122009,122010,0.0,Washington
186,April,2017,Howard,MD,Passenger,0,2,2,90,92,2.17,Furthest
187,April,2018,Howard,MD,Passenger,0,1,1,85,86,1.16,Furthest
188,April,2018,Lincoln,WA,Truck,0,0,0,4532,4532,0.0,Washington
189,April,2018,Norfolk,VA,Passenger,1,2,3,326,329,0.91,Furthest
190,April,2018,Santa Clara,CA,Passenger,6,1,7,380,387,1.81,Nearest
191,April,2018,Franklin,WA,Truck,0,0,0,18597,18597,0.0,Washington
192,April,2018,Los Angeles,CA,Passenger,6,4,10,1172,1182,0.85,Nearest
193,April,2018,Charles,MD,Passenger,0,1,1,82,83,1.2,Furthest
194,April,2018,Grays Harbor,WA,Passenger,47,52,99,46287,46386,0.21,Washington
195,April,2018,Ferry,WA,Truck,0,0,0,3499,3499,0.0,Washington
196,April,2018,Riverside,CA,Passenger,2,2,4,706,710,0.56,Nearest
197,April,2018,Spokane,WA,Truck,1,0,1,92061,92062,0.0,Washington
198,April,2018,Gwinnett,GA,Passenger,0,1,1,80,81,1.23,Furthest
199,April,2018,Latah,ID,Passenger,0,1,1,78,79,1.27,Nearest
200,April,2018,Montgomery,TX,Passenger,1,0,1,63,64,1.56,Mid-Distance
201,April,2018,Lee,FL,Passenger,1,0,1,58,59,1.69,Furthest
202,April,2018,Yakima,WA,Truck,0,0,0,58216,58216,0.0,Washington
203,April,2018,Flathead,MT,Passenger,1,0,1,51,52,1.92,Nearest
204,April,2018,Monterey,CA,Passenger,0,1,1,188,189,0.53,Nearest
205,April,2018,Benton,WA,Passenger,178,188,366,130946,131312,0.28,Washington
206,April,2018,Skamania,WA,Truck,0,0,0,3922,3922,0.0,Washington
207,April,2018,Thurston,WA,Truck,0,0,0,54065,54065,0.0,Washington
208,April,2018,Tulsa,OK,Passenger,0,1,1,47,48,2.08,Mid-Distance
209,April,2018,Whatcom,WA,Truck,2,0,2,42122,42124,0.0,Washington
210,April,2018,Columbia,WA,Passenger,2,1,3,2414,2417,0.12,Washington
211,April,2018,Montgomery,TN,Passenger,1,0,1,270,271,0.37,Furthest
212,April,2018,Douglas,WA,Passenger,41,32,73,27438,27511,0.27,Washington
213,April,2018,Franklin,MA,Passenger,0,1,1,2,3,33.33,Furthest
214,April,2018,Thurston,WA,Passenger,523,444,967,191803,192770,0.5,Washington
215,April,2018,Essex,NJ,Passenger,1,0,1,11,12,8.33,Furthest
216,April,2018,Fairfax,VA,Passenger,2,2,4,832,836,0.48,Furthest
217,April,2018,Kent,MI,Passenger,0,1,1,33,34,2.94,Furthest
218,April,2018,Volusia,FL,Passenger,0,1,1,33,34,2.94,Furthest
219,April,2018,Cowlitz,WA,Passenger,55,73,128,71356,71484,0.18,Washington
220,April,2018,San Juan,WA,Passenger,141,53,194,13961,14155,1.37,Washington
221,April,2018,Richland,SC,Passenger,0,1,1,173,174,0.57,Furthest
222,April,2018,Garfield,WA,Passenger,1,0,1,1330,1331,0.08,Washington
223,April,2018,Walla Walla,WA,Truck,0,0,0,13332,13332,0.0,Washington
224,April,2018,Beaufort,SC,Passenger,1,0,1,38,39,2.56,Furthest
225,April,2018,Cowlitz,WA,Truck,0,0,0,28292,28292,0.0,Washington
226,April,2018,Mason,WA,Passenger,71,87,158,45392,45550,0.35,Washington
227,April,2018,Pacific,WA,Passenger,14,19,33,15488,15521,0.21,Washington
228,April,2018,Santa Rosa,FL,Passenger,1,0,1,100,101,0.99,Furthest
229,April,2018,Nantucket,MA,Passenger,1,0,1,4,5,20.0,Furthest
230,April,2018,Prince George,VA,Passenger,0,1,1,73,74,1.35,Furthest
231,April,2018,Northampton,PA,Passenger,0,1,1,64,65,1.54,Furthest
232,April,2018,Maricopa,AZ,Passenger,2,1,3,1572,1575,0.19,Nearest
233,April,2018,Okaloosa,FL,Passenger,1,0,1,172,173,0.58,Furthest
234,April,2018,Pinal,AZ,Passenger,2,0,2,207,209,0.96,Nearest
235,April,2018,Ventura,CA,Passenger,0,1,1,319,320,0.31,Nearest
236,April,2018,Snohomish,WA,Truck,1,0,1,121256,121257,0.0,Washington
237,April,2018,Lane,OR,Passenger,0,1,1,190,191,0.52,Nearest
238,April,2018,Yakima,WA,Passenger,62,84,146,163240,163386,0.09,Washington
239,April,2018,Twin Falls,ID,Passenger,0,1,1,23,24,4.17,Nearest
240,April,2018,Prince William,VA,Passenger,0,4,4,265,269,1.49,Furthest
241,April,2018,New Haven,CT,Passenger,0,1,1,50,51,1.96,Furthest
242,April,2018,Anne Arundel,MD,Passenger,0,2,2,448,450,0.44,Furthest
243,April,2018,Skamania,WA,Passenger,12,8,20,8705,8725,0.23,Washington
244,April,2018,Chelan,WA,Passenger,98,45,143,53398,53541,0.27,Washington
245,April,2018,Skagit,WA,Passenger,182,155,337,90035,90372,0.37,Washington
246,April,2018,Wahkiakum,WA,Passenger,1,3,4,2887,2891,0.14,Washington
247,April,2018,Cape May,NJ,Passenger,0,1,1,21,22,4.55,Furthest
248,April,2018,Santa Fe,NM,Passenger,0,1,1,41,42,2.38,Mid-Distance
249,April,2018,Allegheny,PA,Passenger,1,0,1,76,77,1.3,Furthest
250,April,2018,Montgomery,MD,Passenger,1,0,1,293,294,0.34,Furthest
251,April,2018,Asotin,WA,Truck,0,0,0,6594,6594,0.0,Washington
252,April,2018,Grays Harbor,WA,Truck,0,0,0,20130,20130,0.0,Washington
253,April,2018,Stevens,WA,Truck,0,0,0,18512,18512,0.0,Washington
254,April,2018,Lewis,WA,Truck,0,0,0,25310,25310,0.0,Washington
255,April,2018,Snohomish,WA,Passenger,2189,1194,3383,518822,522205,0.65,Washington
256,April,2018,Kootenai,ID,Passenger,0,1,1,224,225,0.44,Nearest
257,April,2018,Columbia,WA,Truck,0,0,0,1523,1523,0.0,Washington
258,April,2018,Dallas,TX,Passenger,0,1,1,188,189,0.53,Mid-Distance
259,April,2018,Clark,WA,Passenger,943,657,1600,306447,308047,0.52,Washington
260,April,2018,Lee,AL,Passenger,1,0,1,32,33,3.03,Furthest
261,April,2018,Utah,UT,Passenger,0,1,1,136,137,0.73,Nearest
262,April,2018,Washtenaw,MI,Passenger,1,0,1,39,40,2.5,Furthest
263,April,2018,Marion,IN,Passenger,1,0,1,116,117,0.85,Furthest
264,April,2018,Adams,WA,Passenger,5,4,9,12523,12532,0.07,Washington
265,April,2018,Lewis,WA,Passenger,78,51,129,57351,57480,0.22,Washington
266,April,2018,Moore,NC,Passenger,0,1,1,195,196,0.51,Furthest
267,April,2018,Canyon,ID,Passenger,0,1,1,87,88,1.14,Nearest
268,April,2018,Sacramento,CA,Passenger,1,0,1,298,299,0.33,Nearest
269,April,2018,Pend Oreille,WA,Passenger,4,5,9,9474,9483,0.09,Washington
270,April,2018,Jefferson,NY,Passenger,1,0,1,220,221,0.45,Furthest
271,April,2018,Pierce,WA,Passenger,1154,1091,2245,529160,531405,0.42,Washington
272,April,2018,Shelby,TN,Passenger,0,1,1,101,102,0.98,Furthest
273,April,2018,Monroe,IL,Passenger,1,0,1,5,6,16.67,Mid-Distance
274,April,2018,Travis,TX,Passenger,0,1,1,189,190,0.53,Mid-Distance
275,April,2018,Jefferson,CO,Passenger,0,1,1,72,73,1.37,Mid-Distance
276,April,2018,El Paso,TX,Passenger,1,0,1,518,519,0.19,Mid-Distance
277,April,2018,Clallam,WA,Passenger,117,105,222,49605,49827,0.45,Washington
278,April,2018,San Mateo,CA,Passenger,1,1,2,133,135,1.48,Nearest
279,April,2018,Douglas,WA,Truck,0,0,0,11882,11882,0.0,Washington
280,April,2018,Williamson,TX,Passenger,0,1,1,157,158,0.63,Mid-Distance
281,April,2018,Richmond,GA,Passenger,0,1,1,91,92,1.09,Furthest
282,April,2018,Morris,NJ,Passenger,1,0,1,18,19,5.26,Furthest
283,April,2018,Benton,WA,Truck,0,0,0,40852,40852,0.0,Washington
284,April,2018,Fulton,GA,Passenger,1,1,2,100,102,1.96,Furthest
285,April,2018,Klickitat,WA,Truck,0,0,0,8070,8070,0.0,Washington
286,April,2018,Duval,FL,Passenger,1,2,3,377,380,0.79,Furthest
287,April,2018,Whatcom,WA,Passenger,593,269,862,146611,147473,0.58,Washington
288,April,2018,Hawaii,HI,Passenger,1,0,1,75,76,1.32,Nearest
289,April,2018,Dakota,MN,Passenger,0,2,2,37,39,5.13,Mid-Distance
290,April,2018,Walla Walla,WA,Passenger,34,40,74,35454,35528,0.21,Washington
291,April,2018,Spokane,WA,Passenger,318,288,606,301923,302529,0.2,Washington
292,April,2018,Adams,WA,Truck,0,0,0,5150,5150,0.0,Washington
293,April,2018,Hardin,KY,Passenger,0,1,1,118,119,0.84,Furthest
294,April,2018,Pacific,WA,Truck,0,0,0,7596,7596,0.0,Washington
295,April,2018,St. Clair,IL,Passenger,0,1,1,150,151,0.66,Mid-Distance
296,April,2018,Kitsap,WA,Passenger,742,441,1183,177372,178555,0.66,Washington
297,April,2018,Stevens,WA,Passenger,10,24,34,31585,31619,0.11,Washington
298,April,2018,Prince George's,MD,Passenger,1,1,2,185,187,1.07,Furthest
299,April,2018,San Juan,WA,Truck,0,0,0,5698,5698,0.0,Washington
300,April,2018,Manassas,VA,Passenger,0,1,1,9,10,10.0,Furthest
301,April,2018,Nueces,TX,Passenger,1,1,2,96,98,2.04,Mid-Distance
302,April,2018,Kittitas,WA,Passenger,40,32,72,28774,28846,0.25,Washington
303,April,2018,Clark,NV,Passenger,1,2,3,746,749,0.4,Nearest
304,April,2018,Polk,FL,Passenger,1,0,1,63,64,1.56,Furthest
305,April,2018,Broward,FL,Passenger,0,1,1,130,131,0.76,Furthest
306,April,2018,Grant,WA,Passenger,31,42,73,62794,62867,0.12,Washington
307,April,2018,Kitsap,WA,Truck,1,0,1,52991,52992,0.0,Washington
308,April,2018,Clallam,WA,Truck,0,0,0,21359,21359,0.0,Washington
309,April,2018,Sedgwick,KS,Passenger,0,1,1,99,100,1.0,Mid-Distance
310,April,2018,Whitman,WA,Passenger,20,24,44,22555,22599,0.19,Washington
311,April,2018,Whitman,WA,Truck,0,0,0,8463,8463,0.0,Washington
312,April,2018,Island,WA,Truck,0,0,0,20845,20845,0.0,Washington
313,April,2018,Carroll,NH,Passenger,0,1,1,1,2,50.0,Furthest
314,April,2018,Asotin,WA,Passenger,8,6,14,12640,12654,0.11,Washington
315,April,2018,San Francisco,CA,Passenger,0,1,1,133,134,0.75,Nearest
316,April,2018,Marin,CA,Passenger,1,0,1,56,57,1.75,Nearest
317,April,2018,Hamilton,TN,Passenger,1,0,1,23,24,4.17,Furthest
318,April,2018,Sumter,FL,Passenger,0,1,1,10,11,9.09,Furthest
319,April,2018,Klamath,OR,Passenger,1,0,1,34,35,2.86,Nearest
320,April,2018,Orleans,LA,Passenger,0,1,1,47,48,2.08,Mid-Distance
321,April,2018,Tuolumne,CA,Passenger,0,1,1,13,14,7.14,Nearest
322,April,2018,Queens,NY,Passenger,1,0,1,62,63,1.59,Furthest
323,April,2018,Clackamas,OR,Passenger,0,1,1,227,228,0.44,Nearest
324,April,2018,Deschutes,OR,Passenger,1,0,1,172,173,0.58,Nearest
325,April,2018,Ferry,WA,Passenger,2,3,5,4414,4419,0.11,Washington
326,April,2018,Garfield,WA,Truck,0,0,0,950,950,0.0,Washington
327,April,2018,Honolulu,HI,Passenger,2,2,4,532,536,0.75,Nearest
328,April,2018,Lumpkin,GA,Passenger,1,0,1,7,8,12.5,Furthest
329,April,2018,Wahkiakum,WA,Truck,0,0,0,1668,1668,0.0,Washington
330,April,2018,Pend Oreille,WA,Truck,0,0,0,5654,5654,0.0,Washington
331,April,2018,Pima,AZ,Passenger,1,1,2,415,417,0.48,Nearest
332,April,2018,New London,CT,Passenger,0,1,1,250,251,0.4,Furthest
333,April,2018,Norfolk,MA,Passenger,1,0,1,36,37,2.7,Furthest
334,April,2018,Virginia Beach,VA,Passenger,2,1,3,683,686,0.44,Furthest
335,April,2018,Arlington,VA,Passenger,1,2,3,172,175,1.71,Furthest
336,April,2018,Franklin,WA,Passenger,37,59,96,57403,57499,0.17,Washington
337,April,2018,Garfield,OK,Passenger,1,0,1,19,20,5.0,Mid-Distance
338,April,2018,Bexar,TX,Passenger,2,2,4,777,781,0.51,Mid-Distance
339,April,2018,Multnomah,OR,Passenger,4,4,8,816,824,0.97,Nearest
340,April,2018,Manatee,FL,Passenger,1,0,1,38,39,2.56,Furthest
341,April,2018,Mason,WA,Truck,0,0,0,19808,19808,0.0,Washington
342,April,2018,St. Lucie,FL,Passenger,1,0,1,26,27,3.7,Furthest
343,April,2018,Ada,ID,Passenger,0,2,2,331,333,0.6,Nearest
344,April,2018,El Paso,CO,Passenger,2,0,2,751,753,0.27,Mid-Distance
345,April,2018,Sangamon,IL,Passenger,1,0,1,11,12,8.33,Mid-Distance
346,April,2018,Brevard,FL,Passenger,0,1,1,102,103,0.97,Furthest
347,April,2018,San Diego,CA,Passenger,7,1,8,2553,2561,0.31,Nearest
348,April,2018,Tarrant,TX,Passenger,1,0,1,216,217,0.46,Mid-Distance
349,April,2018,Klickitat,WA,Passenger,24,29,53,15050,15103,0.35,Washington
350,April,2018,Palm Beach,FL,Passenger,0,1,1,87,88,1.14,Furthest
351,April,2018,Madison,ID,Passenger,1,0,1,37,38,2.63,Nearest
352,April,2018,DeKalb,GA,Passenger,1,0,1,83,84,1.19,Furthest
353,April,2018,Caddo,LA,Passenger,0,1,1,22,23,4.35,Mid-Distance
354,April,2018,Frederick,MD,Passenger,0,1,1,86,87,1.15,Furthest
355,April,2018,King,WA,Truck,7,1,8,183356,183364,0.0,Washington
356,April,2018,Orange,CA,Passenger,3,1,4,568,572,0.7,Nearest
357,April,2018,King,WA,Passenger,12284,5290,17574,1368427,1386001,1.27,Washington
358,April,2018,District of Columbia,DC,Passenger,0,3,3,192,195,1.54,Furthest
359,April,2018,Island,WA,Passenger,184,177,361,62281,62642,0.58,Washington
360,April,2018,Pierce,WA,Truck,0,0,0,137364,137364,0.0,Washington
361,April,2018,Jefferson,WA,Truck,0,0,0,9525,9525,0.0,Washington
362,April,2018,Ramsey,MN,Passenger,1,0,1,39,40,2.5,Mid-Distance
363,April,2018,Kittitas,WA,Truck,0,0,0,13993,13993,0.0,Washington
364,April,2018,Nassau,NY,Passenger,1,0,1,37,38,2.63,Furthest
366,April,2018,Skagit,WA,Truck,1,0,1,31980,31981,0.0,Washington
367,April,2018,Okanogan,WA,Passenger,8,19,27,25823,25850,0.1,Washington
368,April,2018,Clay,FL,Passenger,0,1,1,100,101,0.99,Furthest
369,April,2018,Lincoln,WA,Passenger,2,6,8,7613,7621,0.1,Washington
370,April,2018,DuPage,IL,Passenger,1,0,1,63,64,1.56,Mid-Distance
371,April,2018,Okanogan,WA,Truck,0,0,0,16350,16350,0.0,Washington
372,April,2018,Alameda,CA,Passenger,0,1,1,352,353,0.28,Nearest
373,April,2018,Saratoga,NY,Passenger,1,1,2,66,68,2.94,Furthest
374,April,2018,Orange,FL,Passenger,2,1,3,169,172,1.74,Furthest
375,April,2018,Hamilton,IN,Passenger,1,0,1,47,48,2.08,Furthest
376,April,2018,Portsmouth,VA,Passenger,0,1,1,73,74,1.35,Furthest
377,April,2018,Juneau,AK,Passenger,0,1,1,46,47,2.13,Nearest
378,April,2018,Maui,HI,Passenger,1,0,1,58,59,1.69,Nearest
379,April,2018,Cook,IL,Passenger,1,0,1,271,272,0.37,Mid-Distance
380,April,2018,Grant,WA,Truck,0,0,0,25855,25855,0.0,Washington
381,April,2018,Chelan,WA,Truck,0,0,0,21764,21764,0.0,Washington
382,April,2018,Montgomery,PA,Passenger,1,0,1,35,36,2.78,Furthest
383,April,2018,Dale,AL,Passenger,0,1,1,63,64,1.56,Furthest
384,April,2018,Contra Costa,CA,Passenger,0,1,1,461,462,0.22,Nearest
385,April,2018,Clark,WA,Truck,0,0,0,78735,78735,0.0,Washington
386,April,2018,DeKalb,IN,Passenger,1,0,1,1,2,50.0,Furthest
387,April,2018,Jefferson,WA,Passenger,134,88,222,24353,24575,0.9,Washington
388,April,2019,Pierce,WA,Passenger,1692,1486,3178,540913,544091,0.58,Washington
389,April,2019,New London,CT,Passenger,0,2,2,250,252,0.79,Furthest
390,April,2019,Clark,WA,Truck,0,0,0,80105,80105,0.0,Washington
391,April,2019,Grant,WA,Truck,0,0,0,26430,26430,0.0,Washington
392,April,2019,Anne Arundel,MD,Passenger,0,2,2,448,450,0.44,Furthest
393,April,2019,Wahkiakum,WA,Truck,0,0,0,1733,1733,0.0,Washington
394,April,2019,Travis,TX,Passenger,2,1,3,196,199,1.51,Mid-Distance
395,April,2019,Jefferson,NY,Passenger,0,2,2,219,221,0.9,Furthest
396,April,2019,Wahkiakum,WA,Passenger,1,1,2,3014,3016,0.07,Washington
397,April,2019,Hennepin,MN,Passenger,2,0,2,103,105,1.9,Mid-Distance
398,April,2019,Yakima,WA,Passenger,93,103,196,164616,164812,0.12,Washington
399,April,2019,Douglas,NE,Passenger,0,1,1,63,64,1.56,Mid-Distance
400,April,2019,Montgomery,PA,Passenger,2,0,2,38,40,5.0,Furthest
401,April,2019,Nueces,TX,Passenger,1,1,2,96,98,2.04,Mid-Distance
402,April,2019,Whitman,WA,Passenger,29,45,74,22711,22785,0.32,Washington
403,April,2019,Skamania,WA,Truck,0,0,0,4039,4039,0.0,Washington
404,April,2019,San Juan,PR,Passenger,0,1,1,3,4,25.0,Mid-Distance
405,April,2019,Benton,WA,Passenger,248,263,511,133307,133818,0.38,Washington
406,April,2019,Whitman,WA,Truck,0,0,0,8517,8517,0.0,Washington
407,April,2019,Manassas,VA,Passenger,0,1,1,8,9,11.11,Furthest
408,April,2019,Nantucket,MA,Passenger,1,0,1,3,4,25.0,Furthest
409,April,2019,Norfolk,VA,Passenger,2,2,4,352,356,1.12,Furthest
410,April,2019,Jefferson,WA,Passenger,187,118,305,24901,25206,1.21,Washington
411,April,2019,Walla Walla,WA,Passenger,46,57,103,36137,36240,0.28,Washington
412,April,2019,Lake,FL,Passenger,1,0,1,19,20,5.0,Furthest
413,April,2019,St. Clair,IL,Passenger,0,1,1,160,161,0.62,Mid-Distance
414,April,2019,Ramsey,MN,Passenger,1,0,1,43,44,2.27,Mid-Distance
415,April,2019,Owyhee,ID,Passenger,1,0,1,5,6,16.67,Nearest
416,April,2019,San Mateo,CA,Passenger,2,1,3,122,125,2.4,Nearest
417,April,2019,Brevard,FL,Passenger,0,1,1,85,86,1.16,Furthest
418,April,2019,Cochise,AZ,Passenger,0,1,1,116,117,0.85,Nearest
419,April,2019,Pinal,AZ,Passenger,2,0,2,195,197,1.02,Nearest
420,April,2019,Chelan,WA,Truck,0,0,0,22173,22173,0.0,Washington
421,April,2019,Cape May,NJ,Passenger,0,1,1,17,18,5.56,Furthest
422,April,2019,Pierce,WA,Truck,0,0,0,139350,139350,0.0,Washington
423,April,2019,Columbia,WA,Passenger,2,2,4,2441,2445,0.16,Washington
424,April,2019,Honolulu,HI,Passenger,2,3,5,503,508,0.98,Nearest
425,April,2019,Charleston,SC,Passenger,1,0,1,119,120,0.83,Furthest
426,April,2019,Arlington,VA,Passenger,1,2,3,160,163,1.84,Furthest
427,April,2019,Dale,AL,Passenger,0,1,1,56,57,1.75,Furthest
428,April,2019,Yakima,WA,Truck,0,0,0,58948,58948,0.0,Washington
429,April,2019,Skamania,WA,Passenger,21,16,37,8713,8750,0.42,Washington
430,April,2019,Allegheny,PA,Passenger,1,0,1,84,85,1.18,Furthest
431,April,2019,San Joaquin,CA,Passenger,1,0,1,133,134,0.75,Nearest
432,April,2019,Sedgwick,KS,Passenger,0,1,1,102,103,0.97,Mid-Distance
433,April,2019,Washtenaw,MI,Passenger,1,0,1,37,38,2.63,Furthest
434,April,2019,Bucks,PA,Passenger,1,0,1,17,18,5.56,Furthest
435,April,2019,Okanogan,WA,Passenger,20,22,42,26020,26062,0.16,Washington
436,April,2019,Garfield,WA,Truck,0,0,0,958,958,0.0,Washington
437,April,2019,Duval,FL,Passenger,1,2,3,382,385,0.78,Furthest
438,April,2019,Clark,WA,Passenger,1414,896,2310,312581,314891,0.73,Washington
439,April,2019,San Diego,CA,Passenger,10,3,13,2654,2667,0.49,Nearest
440,April,2019,Cowlitz,WA,Truck,0,0,0,28852,28852,0.0,Washington
441,April,2019,Ventura,CA,Passenger,0,2,2,311,313,0.64,Nearest
442,April,2019,Kern,CA,Passenger,0,1,1,225,226,0.44,Nearest
443,April,2019,Montgomery,MD,Passenger,1,0,1,272,273,0.37,Furthest
444,April,2019,Palm Beach,FL,Passenger,0,1,1,92,93,1.08,Furthest
445,April,2019,Caddo,LA,Passenger,0,1,1,23,24,4.17,Mid-Distance
446,April,2019,Charles,MD,Passenger,0,1,1,82,83,1.2,Furthest
447,April,2019,DeKalb,GA,Passenger,1,0,1,80,81,1.23,Furthest
448,April,2019,Alexandria,VA,Passenger,1,0,1,154,155,0.65,Furthest
449,April,2019,Multnomah,OR,Passenger,4,5,9,749,758,1.19,Nearest
450,April,2019,St. Lucie,FL,Passenger,1,0,1,30,31,3.23,Furthest
452,April,2019,Bexar,TX,Passenger,3,4,7,677,684,1.02,Mid-Distance
453,April,2019,Montgomery,AL,Passenger,0,1,1,44,45,2.22,Furthest
454,April,2019,Shasta,CA,Passenger,1,0,1,40,41,2.44,Nearest
455,April,2019,Sumter,FL,Passenger,0,1,1,10,11,9.09,Furthest
456,April,2019,Richmond,GA,Passenger,0,1,1,93,94,1.06,Furthest
457,April,2019,Los Angeles,CA,Passenger,8,5,13,1095,1108,1.17,Nearest
458,April,2019,Orange,CA,Passenger,6,1,7,529,536,1.31,Nearest
459,April,2019,Harnett,NC,Passenger,1,1,2,214,216,0.93,Furthest
460,April,2019,Asotin,WA,Passenger,12,8,20,12659,12679,0.16,Washington
461,April,2019,Cascade,MT,Passenger,0,1,1,58,59,1.69,Nearest
462,April,2019,King,WA,Passenger,18277,6871,25148,1384099,1409247,1.78,Washington
463,April,2019,Whatcom,WA,Truck,2,0,2,42771,42773,0.0,Washington
464,April,2019,Whatcom,WA,Passenger,823,394,1217,150081,151298,0.8,Washington
465,April,2019,Santa Rosa,FL,Passenger,1,0,1,87,88,1.14,Furthest
466,April,2019,Deschutes,OR,Passenger,2,0,2,154,156,1.28,Nearest
467,April,2019,Santa Fe,NM,Passenger,0,1,1,40,41,2.44,Mid-Distance
468,April,2019,Broward,FL,Passenger,2,1,3,128,131,2.29,Furthest
469,April,2019,Penobscot,ME,Passenger,0,1,1,13,14,7.14,Furthest
470,April,2019,Douglas,WA,Truck,0,0,0,12176,12176,0.0,Washington
471,April,2019,Sangamon,IL,Passenger,2,0,2,7,9,22.22,Mid-Distance
472,April,2019,Pacific,WA,Truck,0,0,0,7660,7660,0.0,Washington
473,April,2019,Chelan,WA,Passenger,147,66,213,54294,54507,0.39,Washington
474,April,2019,Pend Oreille,WA,Truck,0,0,0,5753,5753,0.0,Washington
475,April,2019,Dakota,MN,Passenger,0,2,2,36,38,5.26,Mid-Distance
476,April,2019,Grant,WA,Passenger,35,60,95,64382,64477,0.15,Washington
477,April,2019,Klickitat,WA,Passenger,33,33,66,15507,15573,0.42,Washington
478,April,2019,Fresno,CA,Passenger,1,0,1,187,188,0.53,Nearest
479,April,2019,Volusia,FL,Passenger,0,1,1,36,37,2.7,Furthest
480,April,2019,Walla Walla,WA,Truck,0,0,0,13603,13603,0.0,Washington
481,April,2019,Howard,MD,Passenger,0,1,1,77,78,1.28,Furthest
482,April,2019,Richland,SC,Passenger,0,1,1,161,162,0.62,Furthest
483,April,2019,Fairfax,VA,Passenger,3,2,5,781,786,0.64,Furthest
484,April,2019,Kitsap,WA,Passenger,1009,575,1584,180200,181784,0.87,Washington
485,April,2019,DuPage,IL,Passenger,1,0,1,60,61,1.64,Mid-Distance
486,April,2019,Tulsa,OK,Passenger,1,1,2,46,48,4.17,Mid-Distance
487,April,2019,Mecklenburg,NC,Passenger,1,0,1,83,84,1.19,Furthest
488,April,2019,Santa Clara,CA,Passenger,8,1,9,362,371,2.43,Nearest
489,April,2019,Portsmouth,VA,Passenger,0,1,1,75,76,1.32,Furthest
490,April,2019,Kittitas,WA,Passenger,71,35,106,29489,29595,0.36,Washington
491,April,2019,Mason,WA,Truck,0,0,0,20326,20326,0.0,Washington
492,April,2019,Pend Oreille,WA,Passenger,4,5,9,9505,9514,0.09,Washington
493,April,2019,Franklin,MA,Passenger,0,1,1,1,2,50.0,Furthest
494,April,2019,Clay,FL,Passenger,0,1,1,87,88,1.14,Furthest
495,April,2019,Thurston,WA,Passenger,821,613,1434,196770,198204,0.72,Washington
496,April,2019,Saratoga,NY,Passenger,1,0,1,58,59,1.69,Furthest
497,April,2019,Tarrant,TX,Passenger,2,0,2,200,202,0.99,Mid-Distance
498,April,2019,Asotin,WA,Truck,0,0,0,6629,6629,0.0,Washington
499,April,2019,Berkshire,MA,Passenger,0,1,1,4,5,20.0,Furthest
500,April,2019,Spokane,WA,Truck,1,0,1,94382,94383,0.0,Washington
501,April,2019,Clallam,WA,Passenger,160,132,292,50458,50750,0.58,Washington
502,April,2019,Oldham,KY,Passenger,0,1,1,5,6,16.67,Furthest
503,April,2019,King,WA,Truck,5,1,6,181820,181826,0.0,Washington
504,April,2019,New Haven,CT,Passenger,0,2,2,49,51,3.92,Furthest
505,April,2019,El Paso,TX,Passenger,3,0,3,486,489,0.61,Mid-Distance
506,April,2019,Stevens,WA,Truck,0,0,0,18683,18683,0.0,Washington
507,April,2019,Klamath,OR,Passenger,1,0,1,38,39,2.56,Nearest
508,April,2019,St. Mary's,MD,Passenger,1,0,1,210,211,0.47,Furthest
509,April,2019,Thurston,WA,Truck,0,0,0,55024,55024,0.0,Washington
510,April,2019,Adams,WA,Passenger,5,6,11,12657,12668,0.09,Washington
511,April,2019,Ferry,WA,Passenger,4,2,6,4370,4376,0.14,Washington
512,April,2019,Washoe,NV,Passenger,2,0,2,110,112,1.79,Nearest
513,April,2019,Lee,AL,Passenger,1,0,1,35,36,2.78,Furthest
514,April,2019,Rogers,OK,Passenger,1,0,1,5,6,16.67,Mid-Distance
515,April,2019,Bergen,NJ,Passenger,1,0,1,26,27,3.7,Furthest
516,April,2019,Santa Cruz,CA,Passenger,1,0,1,39,40,2.5,Nearest
517,April,2019,Harris,TX,Passenger,0,1,1,248,249,0.4,Mid-Distance
518,April,2019,Polk,FL,Passenger,1,0,1,65,66,1.52,Furthest
519,April,2019,Tuolumne,CA,Passenger,0,1,1,12,13,7.69,Nearest
520,April,2019,Frederick,MD,Passenger,1,1,2,78,80,2.5,Furthest
521,April,2019,Benton,WA,Truck,0,0,0,41655,41655,0.0,Washington
522,April,2019,Lincoln,WA,Truck,0,0,0,4700,4700,0.0,Washington
523,April,2019,Randolph,NC,Passenger,1,0,1,6,7,14.29,Furthest
524,April,2019,Riverside,CA,Passenger,2,2,4,663,667,0.6,Nearest
525,April,2019,Calvert,MD,Passenger,0,2,2,86,88,2.27,Furthest
526,April,2019,Norfolk,MA,Passenger,1,0,1,37,38,2.63,Furthest
527,April,2019,Contra Costa,CA,Passenger,2,2,4,389,393,1.02,Nearest
528,April,2019,Moore,NC,Passenger,0,1,1,181,182,0.55,Furthest
529,April,2019,San Juan,WA,Truck,0,0,0,5834,5834,0.0,Washington
530,April,2019,Larimer,CO,Passenger,1,0,1,58,59,1.69,Mid-Distance
531,April,2019,Lumpkin,GA,Passenger,1,0,1,6,7,14.29,Furthest
532,April,2019,Carson City,NV,Passenger,1,0,1,14,15,6.67,Nearest
533,April,2019,Grays Harbor,WA,Truck,0,0,0,20395,20395,0.0,Washington
534,April,2019,Middlesex,MA,Passenger,1,1,2,116,118,1.69,Furthest
535,April,2019,Klickitat,WA,Truck,0,0,0,8222,8222,0.0,Washington
536,April,2019,Ada,ID,Passenger,0,2,2,309,311,0.64,Nearest
537,April,2019,Williamson,TX,Passenger,0,1,1,143,144,0.69,Mid-Distance
538,April,2019,Maricopa,AZ,Passenger,6,2,8,1537,1545,0.52,Nearest
539,April,2019,Okanogan,WA,Truck,0,0,0,16478,16478,0.0,Washington
540,April,2019,Prince George's,MD,Passenger,1,1,2,185,187,1.07,Furthest
541,April,2019,Flathead,MT,Passenger,1,0,1,60,61,1.64,Nearest
542,April,2019,DeKalb,IN,Passenger,1,0,1,1,2,50.0,Furthest
543,April,2019,Spokane,WA,Passenger,512,407,919,309575,310494,0.3,Washington
544,April,2019,Kent,MI,Passenger,0,1,1,22,23,4.35,Furthest
545,April,2019,Lee,FL,Passenger,1,0,1,53,54,1.85,Furthest
546,April,2019,Cowlitz,WA,Passenger,89,101,190,72747,72937,0.26,Washington
547,April,2019,Alameda,CA,Passenger,3,2,5,311,316,1.58,Nearest
548,April,2019,Mason,WA,Passenger,117,118,235,46864,47099,0.5,Washington
549,April,2019,Stevens,WA,Passenger,19,27,46,31638,31684,0.15,Washington
550,April,2019,Kootenai,ID,Passenger,1,1,2,215,217,0.92,Nearest
551,April,2019,Snohomish,WA,Truck,1,0,1,122012,122013,0.0,Washington
552,April,2019,Grays Harbor,WA,Passenger,70,84,154,47665,47819,0.32,Washington
553,April,2019,Prince William,VA,Passenger,1,4,5,257,262,1.91,Furthest
554,April,2019,Island,WA,Passenger,310,241,551,63255,63806,0.86,Washington
555,April,2019,Pacific,WA,Passenger,23,28,51,15922,15973,0.32,Washington
556,April,2019,Island,WA,Truck,0,0,0,21247,21247,0.0,Washington
557,April,2019,Pima,AZ,Passenger,1,1,2,398,400,0.5,Nearest
558,April,2019,Lewis,WA,Truck,0,0,0,25826,25826,0.0,Washington
559,April,2019,San Francisco,CA,Passenger,2,1,3,111,114,2.63,Nearest
560,April,2019,Suffolk,MA,Passenger,0,1,1,40,41,2.44,Furthest
561,April,2019,District of Columbia,DC,Passenger,1,1,2,207,209,0.96,Furthest
562,April,2019,Lincoln,WA,Passenger,3,6,9,7756,7765,0.12,Washington
563,April,2019,Camden,NJ,Passenger,0,1,1,25,26,3.85,Furthest
564,April,2019,Franklin,WA,Truck,0,0,0,19218,19218,0.0,Washington
565,April,2019,Franklin,WA,Passenger,53,67,120,59469,59589,0.2,Washington
566,April,2019,Collin,TX,Passenger,1,1,2,132,134,1.49,Mid-Distance
567,April,2019,Marion,OR,Passenger,1,0,1,115,116,0.86,Nearest
568,April,2019,San Juan,WA,Passenger,204,69,273,14332,14605,1.87,Washington
569,April,2019,Shelby,TN,Passenger,0,1,1,94,95,1.05,Furthest
570,April,2019,Monroe,IL,Passenger,1,0,1,4,5,20.0,Mid-Distance
571,April,2019,Hawaii,HI,Passenger,1,0,1,61,62,1.61,Nearest
572,April,2019,Wayne,MI,Passenger,0,1,1,69,70,1.43,Furthest
573,April,2019,Valencia,NM,Passenger,1,0,1,8,9,11.11,Mid-Distance
574,April,2019,Guadalupe,TX,Passenger,1,0,1,76,77,1.3,Mid-Distance
575,April,2019,Douglas,WA,Passenger,55,34,89,27972,28061,0.32,Washington
576,April,2019,Virginia Beach,VA,Passenger,1,1,2,702,704,0.28,Furthest
577,April,2019,Cumberland,NC,Passenger,0,2,2,507,509,0.39,Furthest
578,April,2019,Clark,NV,Passenger,3,2,5,690,695,0.72,Nearest
579,April,2019,Jefferson,WA,Truck,0,0,0,9652,9652,0.0,Washington
580,April,2019,Snohomish,WA,Passenger,3292,1539,4831,529161,533992,0.9,Washington
581,April,2019,Jefferson,CO,Passenger,0,2,2,59,61,3.28,Mid-Distance
582,April,2019,Denver,CO,Passenger,1,0,1,130,131,0.76,Mid-Distance
583,April,2019,Montgomery,TX,Passenger,2,0,2,59,61,3.28,Mid-Distance
584,April,2019,Adams,WA,Truck,0,0,0,5104,5104,0.0,Washington
585,April,2019,Ferry,WA,Truck,0,0,0,3592,3592,0.0,Washington
586,April,2019,Skagit,WA,Passenger,292,197,489,91537,92026,0.53,Washington
587,April,2019,Vigo,IN,Passenger,1,0,1,5,6,16.67,Furthest
588,April,2019,Clallam,WA,Truck,0,0,0,21681,21681,0.0,Washington
589,April,2019,Fulton,GA,Passenger,1,2,3,112,115,2.61,Furthest
590,April,2019,Carroll,NH,Passenger,0,1,1,2,3,33.33,Furthest
591,April,2019,Kitsap,WA,Truck,1,0,1,53874,53875,0.0,Washington
592,April,2019,Nassau,NY,Passenger,3,0,3,40,43,6.98,Furthest
593,April,2019,Lewis,WA,Passenger,95,91,186,58821,59007,0.32,Washington
594,April,2019,Spartanburg,SC,Passenger,0,1,1,33,34,2.94,Furthest
595,April,2019,Kittitas,WA,Truck,0,0,0,14296,14296,0.0,Washington
596,April,2019,Twin Falls,ID,Passenger,0,1,1,22,23,4.35,Nearest
597,April,2019,Garfield,WA,Passenger,1,1,2,1298,1300,0.15,Washington
598,April,2019,Clackamas,OR,Passenger,1,1,2,206,208,0.96,Nearest
599,April,2019,Maui,HI,Passenger,1,0,1,47,48,2.08,Nearest
600,April,2019,Goochland,VA,Passenger,1,1,2,251,253,0.79,Furthest
601,April,2019,El Paso,CO,Passenger,3,2,5,751,756,0.66,Mid-Distance
602,April,2019,Skagit,WA,Truck,1,0,1,32325,32326,0.0,Washington
603,April,2019,Albemarle,VA,Passenger,1,0,1,25,26,3.85,Furthest
604,April,2019,Manatee,FL,Passenger,1,0,1,32,33,3.03,Furthest
605,April,2019,Columbia,WA,Truck,0,0,0,1531,1531,0.0,Washington
606,April,2019,Juneau,AK,Passenger,0,2,2,32,34,5.88,Nearest
607,April,2019,Cook,IL,Passenger,1,0,1,241,242,0.41,Mid-Distance
608,April,2019,Houston,GA,Passenger,1,0,1,54,55,1.82,Furthest
609,April,2020,Sumter,FL,Passenger,0,1,1,9,10,10.0,Furthest
610,April,2020,Placer,CA,Passenger,2,0,2,89,91,2.2,Nearest
611,April,2020,New Haven,CT,Passenger,0,2,2,41,43,4.65,Furthest
612,April,2020,King,WA,Passenger,24085,7696,31781,1386024,1417805,2.24,Washington
613,April,2020,Pend Oreille,WA,Truck,0,0,0,5739,5739,0.0,Washington
614,April,2020,DeKalb,GA,Passenger,1,0,1,80,81,1.23,Furthest
615,April,2020,Pierce,WA,Passenger,2347,1682,4029,548871,552900,0.73,Washington
616,April,2020,Garfield,WA,Truck,0,0,0,968,968,0.0,Washington
617,April,2020,Cowlitz,WA,Truck,0,0,0,28765,28765,0.0,Washington
618,April,2020,Frederick,MD,Passenger,1,1,2,76,78,2.56,Furthest
619,April,2020,Shelby,OH,Passenger,0,1,1,1,2,50.0,Furthest
620,April,2020,Tarrant,TX,Passenger,1,0,1,178,179,0.56,Mid-Distance
621,April,2020,San Diego,CA,Passenger,13,5,18,2764,2782,0.65,Nearest
622,April,2020,Alexandria,VA,Passenger,1,0,1,140,141,0.71,Furthest
623,April,2020,Camden,NJ,Passenger,0,2,2,21,23,8.7,Furthest
624,April,2020,Dallas,TX,Passenger,1,0,1,202,203,0.49,Mid-Distance
625,April,2020,Adams,WA,Truck,0,0,0,5206,5206,0.0,Washington
626,April,2020,Montgomery,AL,Passenger,0,1,1,38,39,2.56,Furthest
627,April,2020,Manassas,VA,Passenger,0,1,1,5,6,16.67,Furthest
628,April,2020,Prince George's,MD,Passenger,1,1,2,164,166,1.2,Furthest
629,April,2020,Rockingham,NH,Passenger,1,0,1,27,28,3.57,Furthest
630,April,2020,Montgomery,OH,Passenger,0,1,1,46,47,2.13,Furthest
631,April,2020,Yakima,WA,Passenger,129,115,244,165261,165505,0.15,Washington
632,April,2020,Williams,ND,Passenger,0,1,1,13,14,7.14,Mid-Distance
633,April,2020,Shelby,TN,Passenger,0,1,1,89,90,1.11,Furthest
634,April,2020,DuPage,IL,Passenger,3,0,3,58,61,4.92,Mid-Distance
635,April,2020,Ferry,WA,Passenger,5,3,8,4331,4339,0.18,Washington
636,April,2020,Nassau,NY,Passenger,4,0,4,33,37,10.81,Furthest
637,April,2020,St. Clair,IL,Passenger,1,0,1,139,140,0.71,Mid-Distance
638,April,2020,Hudson,NJ,Passenger,1,0,1,38,39,2.56,Furthest
639,April,2020,Denton,TX,Passenger,1,0,1,90,91,1.1,Mid-Distance
640,April,2020,Mason,WA,Truck,0,0,0,20531,20531,0.0,Washington
641,April,2020,Fresno,CA,Passenger,1,0,1,183,184,0.54,Nearest
642,April,2020,Hawaii,HI,Passenger,1,0,1,57,58,1.72,Nearest
643,April,2020,Monroe,IL,Passenger,1,0,1,4,5,20.0,Mid-Distance
644,April,2020,Montgomery,PA,Passenger,1,0,1,31,32,3.12,Furthest
645,April,2020,Klickitat,WA,Truck,0,0,0,8193,8193,0.0,Washington
646,April,2020,Palm Beach,FL,Passenger,0,1,1,80,81,1.23,Furthest
647,April,2020,Ramsey,MN,Passenger,1,0,1,39,40,2.5,Mid-Distance
648,April,2020,Prince William,VA,Passenger,2,3,5,222,227,2.2,Furthest
649,April,2020,Greene,MO,Passenger,0,1,1,31,32,3.12,Furthest
650,April,2020,Whitman,WA,Passenger,44,48,92,22313,22405,0.41,Washington
651,April,2020,Ventura,CA,Passenger,0,3,3,287,290,1.03,Nearest
652,April,2020,Asotin,WA,Truck,0,0,0,6617,6617,0.0,Washington
653,April,2020,Columbia,WA,Truck,0,0,0,1524,1524,0.0,Washington
654,April,2020,Shasta,CA,Passenger,1,0,1,37,38,2.63,Nearest
655,April,2020,El Paso,TX,Passenger,3,0,3,436,439,0.68,Mid-Distance
656,April,2020,Kitsap,WA,Truck,1,0,1,53907,53908,0.0,Washington
657,April,2020,Virginia Beach,VA,Passenger,1,0,1,672,673,0.15,Furthest
658,April,2020,Wahkiakum,WA,Passenger,6,5,11,2973,2984,0.37,Washington
659,April,2020,Pinellas,FL,Passenger,1,1,2,109,111,1.8,Furthest
660,April,2020,Moore,NC,Passenger,0,1,1,162,163,0.61,Furthest
661,April,2020,Duval,FL,Passenger,0,2,2,358,360,0.56,Furthest
662,April,2020,Collin,TX,Passenger,1,1,2,124,126,1.59,Mid-Distance
663,April,2020,Benton,WA,Passenger,348,321,669,134556,135225,0.49,Washington
664,April,2020,Juneau,AK,Passenger,0,2,2,31,33,6.06,Nearest
665,April,2020,Putnam,TN,Passenger,0,1,1,3,4,25.0,Furthest
666,April,2020,Cascade,MT,Passenger,0,1,1,55,56,1.79,Nearest
667,April,2020,Spokane,WA,Passenger,711,473,1184,316298,317482,0.37,Washington
668,April,2020,Houston,GA,Passenger,1,0,1,58,59,1.69,Furthest
669,April,2020,Arlington,VA,Passenger,0,2,2,150,152,1.32,Furthest
670,April,2020,Oldham,KY,Passenger,0,1,1,4,5,20.0,Furthest
671,April,2020,Chelan,WA,Truck,0,0,0,22460,22460,0.0,Washington
672,April,2020,Valencia,NM,Passenger,1,0,1,5,6,16.67,Mid-Distance
673,April,2020,Washington,OR,Passenger,1,0,1,446,447,0.22,Nearest
674,April,2020,Clallam,WA,Passenger,219,166,385,50341,50726,0.76,Washington
675,April,2020,District of Columbia,DC,Passenger,1,1,2,202,204,0.98,Furthest
676,April,2020,Richland,SC,Passenger,0,1,1,156,157,0.64,Furthest
677,April,2020,Clark,WA,Passenger,1992,1056,3048,318746,321794,0.95,Washington
678,April,2020,Washtenaw,MI,Passenger,1,0,1,36,37,2.7,Furthest
679,April,2020,Cowlitz,WA,Passenger,136,115,251,72718,72969,0.34,Washington
680,April,2020,Skagit,WA,Truck,1,0,1,32387,32388,0.0,Washington
681,April,2020,Fort Bend,TX,Passenger,1,0,1,46,47,2.13,Mid-Distance
682,April,2020,Riverside,CA,Passenger,3,1,4,629,633,0.63,Nearest
683,April,2020,Jefferson,WA,Passenger,234,142,376,24908,25284,1.49,Washington
684,April,2020,Middlesex,MA,Passenger,1,1,2,96,98,2.04,Furthest
685,April,2020,Spartanburg,SC,Passenger,0,1,1,49,50,2.0,Furthest
686,April,2020,Charles,MD,Passenger,0,1,1,74,75,1.33,Furthest
687,April,2020,Skamania,WA,Passenger,29,17,46,8615,8661,0.53,Washington
688,April,2020,Stevens,WA,Truck,0,0,0,18611,18611,0.0,Washington
689,April,2020,Tulsa,OK,Passenger,1,1,2,43,45,4.44,Mid-Distance
690,April,2020,Polk,FL,Passenger,1,0,1,65,66,1.52,Furthest
691,April,2020,Spokane,WA,Truck,1,0,1,97398,97399,0.0,Washington
692,April,2020,King,WA,Truck,5,1,6,181518,181524,0.0,Washington
693,April,2020,Denver,CO,Passenger,1,0,1,120,121,0.83,Mid-Distance
694,April,2020,Guadalupe,TX,Passenger,1,0,1,65,66,1.52,Mid-Distance
695,April,2020,Garfield,WA,Passenger,0,1,1,1341,1342,0.07,Washington
696,April,2020,Boone,MO,Passenger,0,1,1,12,13,7.69,Furthest
697,April,2020,Anne Arundel,MD,Passenger,0,1,1,415,416,0.24,Furthest
698,April,2020,Pierce,WA,Truck,0,0,0,141140,141140,0.0,Washington
699,April,2020,Ferry,WA,Truck,0,0,0,3543,3543,0.0,Washington
700,April,2020,Los Angeles,CA,Passenger,7,11,18,1001,1019,1.77,Nearest
701,April,2020,Harris,TX,Passenger,1,0,1,233,234,0.43,Mid-Distance
702,April,2020,Ada,ID,Passenger,0,1,1,282,283,0.35,Nearest
703,April,2020,Harrison,MS,Passenger,1,0,1,57,58,1.72,Mid-Distance
704,April,2020,Maui,HI,Passenger,1,0,1,34,35,2.86,Nearest
705,April,2020,Walla Walla,WA,Passenger,69,63,132,36000,36132,0.37,Washington
706,April,2020,Lake,FL,Passenger,1,0,1,20,21,4.76,Furthest
707,April,2020,Osceola,FL,Passenger,1,0,1,41,42,2.38,Furthest
708,April,2020,Orange,CA,Passenger,7,2,9,493,502,1.79,Nearest
709,April,2020,Thurston,WA,Truck,0,0,0,55499,55499,0.0,Washington
710,April,2020,San Juan,WA,Truck,0,0,0,5898,5898,0.0,Washington
711,April,2020,Carroll,NH,Passenger,0,1,1,4,5,20.0,Furthest
712,April,2020,Richmond,GA,Passenger,0,1,1,86,87,1.15,Furthest
713,April,2020,Grant,WA,Truck,0,0,0,26995,26995,0.0,Washington
714,April,2020,Penobscot,ME,Passenger,0,1,1,15,16,6.25,Furthest
715,April,2020,Okanogan,WA,Passenger,34,31,65,25891,25956,0.25,Washington
716,April,2020,Harnett,NC,Passenger,1,0,1,201,202,0.5,Furthest
717,April,2020,Stevens,WA,Passenger,33,33,66,30969,31035,0.21,Washington
718,April,2020,St. Mary's,MD,Passenger,1,0,1,217,218,0.46,Furthest
719,April,2020,Deschutes,OR,Passenger,3,0,3,139,142,2.11,Nearest
720,April,2020,Hamilton,IN,Passenger,1,0,1,40,41,2.44,Furthest
721,April,2020,Kittitas,WA,Passenger,101,49,150,29857,30007,0.5,Washington
722,April,2020,Tuolumne,CA,Passenger,0,1,1,10,11,9.09,Nearest
723,April,2020,Klamath,OR,Passenger,1,0,1,34,35,2.86,Nearest
724,April,2020,San Mateo,CA,Passenger,0,1,1,116,117,0.85,Nearest
725,April,2020,Jones,GA,Passenger,1,0,1,1,2,50.0,Furthest
726,April,2020,Island,WA,Truck,1,0,1,21149,21150,0.0,Washington
727,April,2020,Clark,NV,Passenger,3,2,5,674,679,0.74,Nearest
728,April,2020,Okanogan,WA,Truck,0,0,0,16384,16384,0.0,Washington
729,April,2020,Broward,FL,Passenger,3,1,4,115,119,3.36,Furthest
730,April,2020,Mason,WA,Passenger,155,135,290,47212,47502,0.61,Washington
731,April,2020,Jefferson,CO,Passenger,0,1,1,58,59,1.69,Mid-Distance
732,April,2020,Lee,FL,Passenger,1,0,1,51,52,1.92,Furthest
733,April,2020,Pacific,WA,Passenger,30,34,64,15837,15901,0.4,Washington
734,April,2020,Bexar,TX,Passenger,2,5,7,613,620,1.13,Mid-Distance
735,April,2020,Hennepin,MN,Passenger,3,1,4,90,94,4.26,Mid-Distance
736,April,2020,Clackamas,OR,Passenger,2,0,2,201,203,0.99,Nearest
737,April,2020,Randolph,NC,Passenger,1,0,1,7,8,12.5,Furthest
738,April,2020,San Francisco,CA,Passenger,2,1,3,98,101,2.97,Nearest
739,April,2020,Ulster,NY,Passenger,1,0,1,8,9,11.11,Furthest
740,April,2020,Cochise,AZ,Passenger,0,1,1,101,102,0.98,Nearest
742,April,2020,DeKalb,IN,Passenger,1,0,1,1,2,50.0,Furthest
743,April,2020,Kootenai,ID,Passenger,1,0,1,225,226,0.44,Nearest
744,April,2020,Chelan,WA,Passenger,224,80,304,54232,54536,0.56,Washington
745,April,2020,Loudoun,VA,Passenger,1,0,1,89,90,1.11,Furthest
746,April,2020,Alameda,CA,Passenger,3,1,4,277,281,1.42,Nearest
747,April,2020,Benton,WA,Truck,0,0,0,42485,42485,0.0,Washington
748,April,2020,Williamson,TX,Passenger,0,2,2,139,141,1.42,Mid-Distance
749,April,2020,Cape May,NJ,Passenger,0,1,1,13,14,7.14,Furthest
750,April,2020,Lewis,WA,Passenger,99,106,205,58652,58857,0.35,Washington
751,April,2020,Pacific,WA,Truck,0,0,0,7665,7665,0.0,Washington
752,April,2020,Queens,NY,Passenger,1,0,1,53,54,1.85,Furthest
753,April,2020,Fulton,GA,Passenger,1,2,3,104,107,2.8,Furthest
754,April,2020,Kent,MI,Passenger,0,1,1,23,24,4.17,Furthest
755,April,2020,Clallam,WA,Truck,1,0,1,21696,21697,0.0,Washington
756,April,2020,Allegheny,PA,Passenger,1,0,1,74,75,1.33,Furthest
757,April,2020,Bucks,PA,Passenger,1,0,1,20,21,4.76,Furthest
758,April,2020,Chesapeake,VA,Passenger,0,2,2,422,424,0.47,Furthest
759,April,2020,Island,WA,Passenger,405,270,675,62863,63538,1.06,Washington
760,April,2020,Franklin,WA,Truck,0,0,0,19844,19844,0.0,Washington
761,April,2020,St. Louis,MO,Passenger,1,0,1,99,100,1.0,Furthest
762,April,2020,Rogers,OK,Passenger,1,0,1,5,6,16.67,Mid-Distance
763,April,2020,Charleston,SC,Passenger,1,0,1,105,106,0.94,Furthest
764,April,2020,Multnomah,OR,Passenger,4,7,11,721,732,1.5,Nearest
765,April,2020,Wahkiakum,WA,Truck,0,0,0,1760,1760,0.0,Washington
766,April,2020,Norfolk,VA,Passenger,2,2,4,347,351,1.14,Furthest
767,April,2020,Carson City,NV,Passenger,1,0,1,11,12,8.33,Nearest
768,April,2020,Clay,FL,Passenger,0,1,1,80,81,1.23,Furthest
769,April,2020,Skamania,WA,Truck,0,0,0,4054,4054,0.0,Washington
770,April,2020,Grays Harbor,WA,Truck,0,0,0,20728,20728,0.0,Washington
771,April,2020,Erie,NY,Passenger,1,0,1,44,45,2.22,Furthest
772,April,2020,Arapahoe,CO,Passenger,1,0,1,136,137,0.73,Mid-Distance
773,April,2020,Suffolk,MA,Passenger,0,2,2,36,38,5.26,Furthest
774,April,2020,Santa Cruz,CA,Passenger,1,0,1,37,38,2.63,Nearest
775,April,2020,Sacramento,CA,Passenger,1,0,1,268,269,0.37,Nearest
776,April,2020,Whitman,WA,Truck,0,0,0,8532,8532,0.0,Washington
777,April,2020,Grant,WA,Passenger,59,71,130,65268,65398,0.2,Washington
778,April,2020,Santa Clara,CA,Passenger,7,2,9,318,327,2.75,Nearest
779,April,2020,Vigo,IN,Passenger,1,0,1,5,6,16.67,Furthest
780,April,2020,Solano,CA,Passenger,1,0,1,211,212,0.47,Nearest
781,April,2020,Montgomery,TX,Passenger,1,0,1,52,53,1.89,Mid-Distance
782,April,2020,El Paso,CO,Passenger,2,0,2,722,724,0.28,Mid-Distance
783,April,2020,Twin Falls,ID,Passenger,0,1,1,28,29,3.45,Nearest
784,April,2020,Thurston,WA,Passenger,1141,730,1871,197497,199368,0.94,Washington
785,April,2020,Lincoln,WA,Truck,0,0,0,4627,4627,0.0,Washington
786,April,2020,Pima,AZ,Passenger,3,1,4,351,355,1.13,Nearest
787,April,2020,Kitsap,WA,Passenger,1312,676,1988,180568,182556,1.09,Washington
788,April,2020,Suffolk,VA,Passenger,1,0,1,126,127,0.79,Furthest
789,April,2020,Walla Walla,WA,Truck,0,0,0,13622,13622,0.0,Washington
790,April,2020,Douglas,WA,Truck,0,0,0,12271,12271,0.0,Washington
791,April,2020,Cumberland,NC,Passenger,0,2,2,471,473,0.42,Furthest
792,April,2020,Snohomish,WA,Truck,0,0,0,123316,123316,0.0,Washington
793,April,2020,Columbia,WA,Passenger,3,3,6,2407,2413,0.25,Washington
794,April,2020,Sedgwick,KS,Passenger,1,1,2,93,95,2.11,Mid-Distance
795,April,2020,Honolulu,HI,Passenger,4,2,6,457,463,1.3,Nearest
796,April,2020,Boulder,CO,Passenger,0,1,1,46,47,2.13,Mid-Distance
797,April,2020,Pend Oreille,WA,Passenger,8,6,14,9257,9271,0.15,Washington
798,April,2020,Franklin,WA,Passenger,58,76,134,60733,60867,0.22,Washington
799,April,2020,Nueces,TX,Passenger,1,0,1,82,83,1.2,Mid-Distance
800,April,2020,Brevard,FL,Passenger,0,1,1,86,87,1.15,Furthest
801,April,2020,Larimer,CO,Passenger,1,0,1,52,53,1.89,Mid-Distance
802,April,2020,Douglas,NE,Passenger,0,1,1,55,56,1.79,Mid-Distance
803,April,2020,Asotin,WA,Passenger,16,12,28,12444,12472,0.22,Washington
804,April,2020,Douglas,WA,Passenger,69,40,109,28017,28126,0.39,Washington
805,April,2020,Lake,IL,Passenger,1,0,1,164,165,0.61,Mid-Distance
806,April,2020,Travis,TX,Passenger,2,1,3,183,186,1.61,Mid-Distance
807,April,2020,Calvert,MD,Passenger,0,2,2,89,91,2.2,Furthest
808,April,2020,Jefferson,WA,Truck,0,0,0,9531,9531,0.0,Washington
809,April,2020,Fairfax,VA,Passenger,4,3,7,740,747,0.94,Furthest
810,April,2020,Portsmouth,VA,Passenger,0,1,1,79,80,1.25,Furthest
811,April,2020,Washoe,NV,Passenger,1,0,1,106,107,0.93,Nearest
812,April,2020,Howard,MD,Passenger,0,1,1,71,72,1.39,Furthest
813,April,2020,Bartow,GA,Passenger,0,1,1,3,4,25.0,Furthest
814,April,2020,Adams,WA,Passenger,7,7,14,12756,12770,0.11,Washington
815,April,2020,Sarasota,FL,Passenger,2,0,2,24,26,7.69,Furthest
816,April,2020,Skagit,WA,Passenger,397,215,612,91480,92092,0.66,Washington
817,April,2020,Jefferson,NY,Passenger,0,1,1,212,213,0.47,Furthest
818,April,2020,San Joaquin,CA,Passenger,1,0,1,130,131,0.76,Nearest
819,April,2020,RÃ­o Grande,PR,Passenger,1,0,1,1,2,50.0,Mid-Distance
820,April,2020,Whatcom,WA,Passenger,1058,490,1548,150136,151684,1.02,Washington
821,April,2020,Fairbanks North Star,AK,Passenger,0,1,1,98,99,1.01,Nearest
822,April,2020,Stafford,VA,Passenger,1,1,2,90,92,2.17,Furthest
823,April,2020,New London,CT,Passenger,1,2,3,243,246,1.22,Furthest
824,April,2020,Kern,CA,Passenger,0,1,1,225,226,0.44,Nearest
825,April,2020,Kittitas,WA,Truck,0,0,0,14593,14593,0.0,Washington
826,April,2020,Saginaw,MI,Passenger,1,0,1,10,11,9.09,Furthest
827,April,2020,Dakota,MN,Passenger,0,1,1,32,33,3.03,Mid-Distance
828,April,2020,Maricopa,AZ,Passenger,7,6,13,1447,1460,0.89,Nearest
829,April,2020,Albemarle,VA,Passenger,1,0,1,21,22,4.55,Furthest
830,April,2020,Lewis,WA,Truck,0,0,0,25979,25979,0.0,Washington
831,April,2020,Gwinnett,GA,Passenger,1,0,1,73,74,1.35,Furthest
832,April,2020,Powhatan,VA,Passenger,1,0,1,0,1,100.0,Furthest
833,April,2020,Wilson,TX,Passenger,0,1,1,7,8,12.5,Mid-Distance
834,April,2020,Yakima,WA,Truck,0,0,0,59516,59516,0.0,Washington
835,April,2020,Goochland,VA,Passenger,2,1,3,258,261,1.15,Furthest
836,April,2020,Oklahoma,OK,Passenger,0,1,1,126,127,0.79,Mid-Distance
837,April,2020,Contra Costa,CA,Passenger,3,2,5,322,327,1.53,Nearest
838,April,2020,Clark,WA,Truck,0,0,0,81837,81837,0.0,Washington
839,April,2020,Snohomish,WA,Passenger,4400,1751,6151,535202,541353,1.14,Washington
840,April,2020,Owyhee,ID,Passenger,1,0,1,3,4,25.0,Nearest
841,April,2020,Flathead,MT,Passenger,1,0,1,63,64,1.56,Nearest
842,April,2020,Grays Harbor,WA,Passenger,106,110,216,48072,48288,0.45,Washington
843,April,2020,Lincoln,WA,Passenger,4,12,16,7676,7692,0.21,Washington
844,April,2020,Klickitat,WA,Passenger,53,41,94,15425,15519,0.61,Washington
845,April,2020,Whatcom,WA,Truck,3,0,3,42832,42835,0.01,Washington
846,April,2020,Pinal,AZ,Passenger,1,0,1,185,186,0.54,Nearest
847,April,2020,San Juan,WA,Passenger,295,88,383,14157,14540,2.63,Washington
848,April,2021,Thurston,WA,Truck,0,0,0,56710,56710,0.0,Washington
849,April,2021,Snohomish,WA,Truck,1,0,1,126400,126401,0.0,Washington
850,April,2021,Skagit,WA,Truck,1,0,1,33024,33025,0.0,Washington
851,April,2021,Carroll,MD,Passenger,0,1,1,18,19,5.26,Furthest
852,April,2021,Jones,GA,Passenger,1,0,1,1,2,50.0,Furthest
853,April,2021,Dakota,MN,Passenger,0,1,1,25,26,3.85,Mid-Distance
854,April,2021,Douglas,CO,Passenger,0,1,1,76,77,1.3,Mid-Distance
855,April,2021,Utah,UT,Passenger,0,1,1,119,120,0.83,Nearest
856,April,2021,Clackamas,OR,Passenger,2,0,2,176,178,1.12,Nearest
857,April,2021,Saginaw,MI,Passenger,2,0,2,10,12,16.67,Furthest
858,April,2021,Boone,MO,Passenger,0,1,1,9,10,10.0,Furthest
859,April,2021,Charleston,SC,Passenger,2,0,2,85,87,2.3,Furthest
860,April,2021,Douglas,WA,Passenger,88,46,134,28472,28606,0.47,Washington
861,April,2021,Columbia,WA,Truck,0,0,0,1560,1560,0.0,Washington
862,April,2021,Sumter,FL,Passenger,0,1,1,10,11,9.09,Furthest
863,April,2021,Walla Walla,WA,Passenger,108,71,179,36527,36706,0.49,Washington
864,April,2021,District of Columbia,DC,Passenger,4,1,5,194,199,2.51,Furthest
865,April,2021,Salt Lake,UT,Passenger,0,1,1,171,172,0.58,Nearest
866,April,2021,Harrison,MS,Passenger,2,0,2,50,52,3.85,Mid-Distance
867,April,2021,Pend Oreille,WA,Passenger,14,5,19,9302,9321,0.2,Washington
868,April,2021,Bexar,TX,Passenger,4,5,9,538,547,1.65,Mid-Distance
869,April,2021,Ventura,CA,Passenger,1,1,2,265,267,0.75,Nearest
870,April,2021,Santa Clara,CA,Passenger,8,2,10,260,270,3.7,Nearest
871,April,2021,Spartanburg,SC,Passenger,0,1,1,51,52,1.92,Furthest
872,April,2021,Montgomery,MD,Passenger,1,0,1,228,229,0.44,Furthest
873,April,2021,Grays Harbor,WA,Truck,0,0,0,21415,21415,0.0,Washington
874,April,2021,Louisa,VA,Passenger,0,1,1,1,2,50.0,Furthest
875,April,2021,Boulder,CO,Passenger,0,1,1,46,47,2.13,Mid-Distance
876,April,2021,Jefferson,NY,Passenger,0,1,1,211,212,0.47,Furthest
877,April,2021,Chelan,WA,Truck,0,0,0,23068,23068,0.0,Washington
878,April,2021,New York,NY,Passenger,1,0,1,47,48,2.08,Furthest
879,April,2021,Nassau,FL,Passenger,1,0,1,32,33,3.03,Furthest
880,April,2021,Island,WA,Truck,0,0,0,21561,21561,0.0,Washington
881,April,2021,Prince William,VA,Passenger,1,1,2,213,215,0.93,Furthest
882,April,2021,Norfolk,VA,Passenger,2,3,5,324,329,1.52,Furthest
883,April,2021,Asotin,WA,Passenger,19,14,33,12659,12692,0.26,Washington
884,April,2021,Arapahoe,CO,Passenger,1,0,1,116,117,0.85,Mid-Distance
885,April,2021,Whatcom,WA,Truck,4,0,4,43870,43874,0.01,Washington
886,April,2021,Stevens,WA,Truck,0,0,0,18874,18874,0.0,Washington
887,April,2021,Manassas,VA,Passenger,0,1,1,6,7,14.29,Furthest
888,April,2021,Okaloosa,FL,Passenger,0,1,1,124,125,0.8,Furthest
889,April,2021,Lewis,WA,Truck,0,0,0,26910,26910,0.0,Washington
890,April,2021,Prince George's,MD,Passenger,2,1,3,142,145,2.07,Furthest
891,April,2021,Sarasota,FL,Passenger,2,0,2,27,29,6.9,Furthest
892,April,2021,Philadelphia,PA,Passenger,1,0,1,51,52,1.92,Furthest
893,April,2021,RÃ­o Grande,PR,Passenger,1,0,1,1,2,50.0,Mid-Distance
894,April,2021,Kittitas,WA,Passenger,153,58,211,29983,30194,0.7,Washington
895,April,2021,Whatcom,WA,Passenger,1355,582,1937,151158,153095,1.27,Washington
896,April,2021,Camden,NJ,Passenger,0,1,1,15,16,6.25,Furthest
897,April,2021,Pima,AZ,Passenger,2,1,3,290,293,1.02,Nearest
898,April,2021,Asotin,WA,Truck,0,0,0,6769,6769,0.0,Washington
899,April,2021,Anchorage,AK,Passenger,1,0,1,141,142,0.7,Nearest
900,April,2021,Polk,FL,Passenger,1,0,1,54,55,1.82,Furthest
901,April,2021,Wilson,TX,Passenger,0,1,1,3,4,25.0,Mid-Distance
902,April,2021,Harris,TX,Passenger,1,1,2,200,202,0.99,Mid-Distance
903,April,2021,Thurston,WA,Passenger,1494,834,2328,198087,200415,1.16,Washington
904,April,2021,Anne Arundel,MD,Passenger,4,2,6,393,399,1.5,Furthest
905,April,2021,Hudson,NJ,Passenger,1,0,1,43,44,2.27,Furthest
906,April,2021,El Paso,CO,Passenger,3,0,3,683,686,0.44,Mid-Distance
907,April,2021,Suffolk,MA,Passenger,0,2,2,33,35,5.71,Furthest
908,April,2021,Sedgwick,KS,Passenger,1,1,2,86,88,2.27,Mid-Distance
909,April,2021,Rockingham,NH,Passenger,1,0,1,23,24,4.17,Furthest
910,April,2021,Howard,MD,Passenger,0,1,1,63,64,1.56,Furthest
911,April,2021,Owyhee,ID,Passenger,1,0,1,3,4,25.0,Nearest
912,April,2021,Douglas,NE,Passenger,1,1,2,50,52,3.85,Mid-Distance
913,April,2021,San Mateo,CA,Passenger,1,1,2,102,104,1.92,Nearest
914,April,2021,Richland,SC,Passenger,0,1,1,139,140,0.71,Furthest
915,April,2021,Portsmouth,VA,Passenger,0,1,1,78,79,1.27,Furthest
916,April,2021,Hampshire,MA,Passenger,1,0,1,6,7,14.29,Furthest
917,April,2021,Danville,VA,Passenger,1,0,1,0,1,100.0,Furthest
918,April,2021,Allegheny,PA,Passenger,1,1,2,64,66,3.03,Furthest
919,April,2021,Carroll,NH,Passenger,0,1,1,5,6,16.67,Furthest
920,April,2021,Carson City,NV,Passenger,1,0,1,11,12,8.33,Nearest
921,April,2021,Pierce,WA,Passenger,3272,1903,5175,559851,565026,0.92,Washington
922,April,2021,Bartow,GA,Passenger,0,1,1,4,5,20.0,Furthest
923,April,2021,Klamath,OR,Passenger,1,0,1,31,32,3.12,Nearest
924,April,2021,Richmond,NY,Passenger,1,0,1,8,9,11.11,Furthest
925,April,2021,Nassau,NY,Passenger,4,0,4,26,30,13.33,Furthest
926,April,2021,Franklin,WA,Passenger,109,95,204,61946,62150,0.33,Washington
927,April,2021,Los Angeles,CA,Passenger,10,11,21,903,924,2.27,Nearest
928,April,2021,Klickitat,WA,Truck,0,0,0,8248,8248,0.0,Washington
929,April,2021,Jefferson,WA,Truck,0,0,0,9623,9623,0.0,Washington
930,April,2021,Skagit,WA,Passenger,562,268,830,91975,92805,0.89,Washington
931,April,2021,Larimer,CO,Passenger,1,0,1,52,53,1.89,Mid-Distance
933,April,2021,Yamhill,OR,Passenger,1,0,1,37,38,2.63,Nearest
934,April,2021,Leavenworth,KS,Passenger,0,1,1,119,120,0.83,Mid-Distance
935,April,2021,Houston,GA,Passenger,1,0,1,50,51,1.96,Furthest
936,April,2021,Greene,MO,Passenger,0,1,1,31,32,3.12,Furthest
937,April,2021,Placer,CA,Passenger,2,0,2,79,81,2.47,Nearest
938,April,2021,Hamilton,IN,Passenger,2,0,2,34,36,5.56,Furthest
939,April,2021,Pend Oreille,WA,Truck,0,0,0,5738,5738,0.0,Washington
940,April,2021,Collin,TX,Passenger,1,1,2,115,117,1.71,Mid-Distance
941,April,2021,Stafford,VA,Passenger,2,1,3,99,102,2.94,Furthest
942,April,2021,Riverside,CA,Passenger,5,1,6,567,573,1.05,Nearest
943,April,2021,Hennepin,MN,Passenger,2,0,2,78,80,2.5,Mid-Distance
944,April,2021,Grays Harbor,WA,Passenger,156,134,290,49368,49658,0.58,Washington
945,April,2021,Okanogan,WA,Truck,0,0,0,16751,16751,0.0,Washington
946,April,2021,Sacramento,CA,Passenger,2,0,2,227,229,0.87,Nearest
947,April,2021,Bucks,PA,Passenger,1,0,1,17,18,5.56,Furthest
948,April,2021,Kings,NY,Passenger,1,0,1,67,68,1.47,Furthest
949,April,2021,San Diego,CA,Passenger,16,6,22,2633,2655,0.83,Nearest
950,April,2021,Pennington,SD,Passenger,1,0,1,32,33,3.03,Mid-Distance
951,April,2021,Milwaukee,WI,Passenger,1,0,1,38,39,2.56,Mid-Distance
952,April,2021,DeKalb,GA,Passenger,1,0,1,62,63,1.59,Furthest
953,April,2021,Garfield,WA,Passenger,0,2,2,1376,1378,0.15,Washington
954,April,2021,Montgomery,TX,Passenger,1,1,2,43,45,4.44,Mid-Distance
955,April,2021,Alameda,CA,Passenger,3,0,3,243,246,1.22,Nearest
956,April,2021,Montgomery,OH,Passenger,0,1,1,57,58,1.72,Furthest
957,April,2021,Walla Walla,WA,Truck,0,0,0,14047,14047,0.0,Washington
958,April,2021,Fort Bend,TX,Passenger,1,0,1,39,40,2.5,Mid-Distance
959,April,2021,Gwinnett,GA,Passenger,1,0,1,66,67,1.49,Furthest
960,April,2021,Vigo,IN,Passenger,1,0,1,5,6,16.67,Furthest
961,April,2021,Missoula,MT,Passenger,1,0,1,61,62,1.61,Nearest
962,April,2021,Contra Costa,CA,Passenger,3,4,7,278,285,2.46,Nearest
963,April,2021,Cape May,NJ,Passenger,0,1,1,8,9,11.11,Furthest
964,April,2021,Yakima,WA,Truck,0,0,0,61656,61656,0.0,Washington
965,April,2021,Lee,FL,Passenger,1,0,1,38,39,2.56,Furthest
966,April,2021,King,WA,Truck,6,1,7,184931,184938,0.0,Washington
967,April,2021,Orange,CA,Passenger,4,3,7,434,441,1.59,Nearest
968,April,2021,DuPage,IL,Passenger,2,0,2,55,57,3.51,Mid-Distance
969,April,2021,St. Louis,MO,Passenger,1,0,1,88,89,1.12,Furthest
970,April,2021,King,WA,Passenger,29460,8753,38213,1369496,1407709,2.71,Washington
971,April,2021,Benton,WA,Passenger,496,377,873,136100,136973,0.64,Washington
972,April,2021,Benton,WA,Truck,0,0,0,43685,43685,0.0,Washington
973,April,2021,Denver,CO,Passenger,1,0,1,113,114,0.88,Mid-Distance
974,April,2021,Adams,WA,Truck,0,0,0,5406,5406,0.0,Washington
975,April,2021,Middlesex,MA,Passenger,1,1,2,92,94,2.13,Furthest
976,April,2021,Franklin,WA,Truck,0,0,0,20683,20683,0.0,Washington
977,April,2021,Yakima,WA,Passenger,206,139,345,169220,169565,0.2,Washington
978,April,2021,Jefferson,WA,Passenger,310,178,488,24904,25392,1.92,Washington
979,April,2021,San Francisco,CA,Passenger,1,1,2,89,91,2.2,Nearest
980,April,2021,San Juan,WA,Passenger,406,125,531,14147,14678,3.62,Washington
981,April,2021,Fulton,GA,Passenger,0,1,1,80,81,1.23,Furthest
982,April,2021,Howard,IN,Passenger,0,1,1,3,4,25.0,Furthest
983,April,2021,Adams,WA,Passenger,11,9,20,13054,13074,0.15,Washington
984,April,2021,Rogers,OK,Passenger,1,0,1,3,4,25.0,Mid-Distance
985,April,2021,Powhatan,VA,Passenger,1,0,1,1,2,50.0,Furthest
986,April,2021,Cumberland,NC,Passenger,0,2,2,432,434,0.46,Furthest
987,April,2021,Ferry,WA,Passenger,10,3,13,4406,4419,0.29,Washington
988,April,2021,New Haven,CT,Passenger,0,2,2,31,33,6.06,Furthest
989,April,2021,St. Mary's,MD,Passenger,1,0,1,211,212,0.47,Furthest
990,April,2021,Miami-Dade,FL,Passenger,1,0,1,97,98,1.02,Furthest
991,April,2021,Kauai,HI,Passenger,1,0,1,16,17,5.88,Nearest
992,April,2021,San Joaquin,CA,Passenger,1,0,1,105,106,0.94,Nearest
993,April,2021,Island,WA,Passenger,582,308,890,63254,64144,1.39,Washington
994,April,2021,Shelby,OH,Passenger,0,1,1,1,2,50.0,Furthest
995,April,2021,Monterey,CA,Passenger,0,1,1,147,148,0.68,Nearest
996,April,2021,New London,CT,Passenger,1,2,3,223,226,1.33,Furthest
997,April,2021,Plaquemines,LA,Passenger,0,1,1,16,17,5.88,Mid-Distance
998,April,2021,Cowlitz,WA,Passenger,211,134,345,72518,72863,0.47,Washington
999,April,2021,Tulsa,OK,Passenger,1,0,1,41,42,2.38,Mid-Distance
1000,April,2021,Lake,IL,Passenger,2,0,2,153,155,1.29,Mid-Distance
1001,April,2021,Clallam,WA,Passenger,309,206,515,50403,50918,1.01,Washington
1002,April,2021,Mason,WA,Passenger,191,134,325,48096,48421,0.67,Washington
1003,April,2021,Calvert,MD,Passenger,0,2,2,87,89,2.25,Furthest
1004,April,2021,Frederick,MD,Passenger,1,1,2,70,72,2.78,Furthest
1005,April,2021,Klickitat,WA,Passenger,67,47,114,15186,15300,0.75,Washington
1006,April,2021,Ramsey,MN,Passenger,1,0,1,30,31,3.23,Mid-Distance
1007,April,2021,Travis,TX,Passenger,2,3,5,160,165,3.03,Mid-Distance
1008,April,2021,Columbia,WA,Passenger,5,4,9,2478,2487,0.36,Washington
1009,April,2021,Williamson,TX,Passenger,0,2,2,111,113,1.77,Mid-Distance
1010,April,2021,Whitman,WA,Passenger,59,44,103,21991,22094,0.47,Washington
1011,April,2021,Multnomah,OR,Passenger,2,5,7,656,663,1.06,Nearest
1012,April,2021,Sevier,AR,Passenger,0,1,1,0,1,100.0,Mid-Distance
1013,April,2021,Wahkiakum,WA,Truck,0,0,0,1806,1806,0.0,Washington
1014,April,2021,Putnam,TN,Passenger,0,1,1,0,1,100.0,Furthest
1015,April,2021,Wichita,TX,Passenger,1,0,1,41,42,2.38,Mid-Distance
1016,April,2021,Loudoun,VA,Passenger,1,0,1,72,73,1.37,Furthest
1017,April,2021,Montgomery,PA,Passenger,1,0,1,24,25,4.0,Furthest
1018,April,2021,Moore,NC,Passenger,0,1,1,135,136,0.74,Furthest
1019,April,2021,Skamania,WA,Passenger,40,30,70,8366,8436,0.83,Washington
1020,April,2021,Deschutes,OR,Passenger,1,0,1,116,117,0.85,Nearest
1021,April,2021,Douglas,WA,Truck,0,0,0,12625,12625,0.0,Washington
1022,April,2021,Erie,NY,Passenger,1,0,1,39,40,2.5,Furthest
1023,April,2021,Cowlitz,WA,Truck,0,0,0,29173,29173,0.0,Washington
1024,April,2021,Kitsap,WA,Passenger,1733,814,2547,180539,183086,1.39,Washington
1025,April,2021,Penobscot,ME,Passenger,0,1,1,9,10,10.0,Furthest
1026,April,2021,Grant,WA,Passenger,102,86,188,66806,66994,0.28,Washington
1027,April,2021,Burlington,NJ,Passenger,0,1,1,133,134,0.75,Furthest
1028,April,2021,Lincoln,WA,Truck,0,0,0,4751,4751,0.0,Washington
1029,April,2021,Clallam,WA,Truck,1,0,1,21992,21993,0.0,Washington
1030,April,2021,Garfield,WA,Truck,0,0,0,1007,1007,0.0,Washington
1031,April,2021,Fairbanks North Star,AK,Passenger,0,1,1,82,83,1.2,Nearest
1032,April,2021,Lane,OR,Passenger,0,1,1,127,128,0.78,Nearest
1033,April,2021,Alexandria,VA,Passenger,2,0,2,134,136,1.47,Furthest
1034,April,2021,Stevens,WA,Passenger,40,43,83,30581,30664,0.27,Washington
1035,April,2021,Richmond,GA,Passenger,0,1,1,75,76,1.32,Furthest
1036,April,2021,Pinellas,FL,Passenger,1,1,2,93,95,2.11,Furthest
1037,April,2021,Pacific,WA,Truck,0,0,0,7919,7919,0.0,Washington
1038,April,2021,Goochland,VA,Passenger,4,2,6,232,238,2.52,Furthest
1039,April,2021,Oldham,KY,Passenger,0,1,1,4,5,20.0,Furthest
1040,April,2021,Pierce,WA,Truck,0,0,0,145966,145966,0.0,Washington
1041,April,2021,Spokane,WA,Truck,0,0,0,101932,101932,0.0,Washington
1042,April,2021,Platte,MO,Passenger,1,0,1,18,19,5.26,Furthest
1043,April,2021,Fresno,CA,Passenger,1,0,1,170,171,0.58,Nearest
1044,April,2021,San Juan,WA,Truck,0,0,0,5911,5911,0.0,Washington
1045,April,2021,Lewis,WA,Passenger,146,135,281,59779,60060,0.47,Washington
1046,April,2021,Duval,FL,Passenger,0,2,2,341,343,0.58,Furthest
1047,April,2021,Maui,HI,Passenger,1,0,1,27,28,3.57,Nearest
1048,April,2021,Chelan,WA,Passenger,314,93,407,54673,55080,0.74,Washington
1049,April,2021,Kittitas,WA,Truck,0,0,0,14775,14775,0.0,Washington
1050,April,2021,Dallas,TX,Passenger,1,0,1,163,164,0.61,Mid-Distance
1051,April,2021,Wahkiakum,WA,Passenger,11,6,17,3113,3130,0.54,Washington
1052,April,2021,El Paso,TX,Passenger,3,0,3,377,380,0.79,Mid-Distance
1053,April,2021,Albemarle,VA,Passenger,1,0,1,20,21,4.76,Furthest
1054,April,2021,Suffolk,VA,Passenger,1,0,1,127,128,0.78,Furthest
1055,April,2021,Chesapeake,VA,Passenger,0,3,3,391,394,0.76,Furthest
1056,April,2021,Hawaii,HI,Passenger,1,0,1,48,49,2.04,Nearest
1057,April,2021,Mason,WA,Truck,0,0,0,21291,21291,0.0,Washington
1058,April,2021,Skamania,WA,Truck,0,0,0,4022,4022,0.0,Washington
1059,April,2021,Flathead,MT,Passenger,1,0,1,43,44,2.27,Nearest
1060,April,2021,Clark,NV,Passenger,4,2,6,632,638,0.94,Nearest
1061,April,2021,Randolph,NC,Passenger,1,0,1,7,8,12.5,Furthest
1062,April,2021,Pacific,WA,Passenger,41,41,82,16071,16153,0.51,Washington
1063,April,2021,Williams,ND,Passenger,0,1,1,9,10,10.0,Mid-Distance
1064,April,2021,Kern,CA,Passenger,0,1,1,213,214,0.47,Nearest
1065,April,2021,El Dorado,CA,Passenger,1,0,1,31,32,3.12,Nearest
1066,April,2021,Lincoln,WA,Passenger,5,13,18,7751,7769,0.23,Washington
1067,April,2021,Whitman,WA,Truck,0,0,0,8564,8564,0.0,Washington
1068,April,2021,Broward,FL,Passenger,1,0,1,105,106,0.94,Furthest
1069,April,2021,Clark,WA,Passenger,2681,1330,4011,321630,325641,1.23,Washington
1070,April,2021,Orange,FL,Passenger,1,0,1,112,113,0.88,Furthest
1071,April,2021,Harnett,NC,Passenger,1,1,2,174,176,1.14,Furthest
1072,April,2021,Okanogan,WA,Passenger,60,36,96,26414,26510,0.36,Washington
1073,April,2021,St. Clair,IL,Passenger,1,0,1,135,136,0.74,Mid-Distance
1074,April,2021,Juneau,AK,Passenger,0,1,1,26,27,3.7,Nearest
1075,April,2021,Lake,FL,Passenger,1,0,1,22,23,4.35,Furthest
1076,April,2021,Virginia Beach,VA,Passenger,3,0,3,621,624,0.48,Furthest
1077,April,2021,Bradley,TN,Passenger,1,0,1,0,1,100.0,Furthest
1078,April,2021,Queens,NY,Passenger,2,0,2,49,51,3.92,Furthest
1079,April,2021,Maricopa,AZ,Passenger,5,4,9,1211,1220,0.74,Nearest
1080,April,2021,Fairfax,VA,Passenger,4,4,8,693,701,1.14,Furthest
1081,April,2021,Sumter,SC,Passenger,0,1,1,39,40,2.5,Furthest
1082,April,2021,Santa Cruz,CA,Passenger,1,0,1,26,27,3.7,Nearest
1083,April,2021,Clark,WA,Truck,0,0,0,84198,84198,0.0,Washington
1084,April,2021,Grant,WA,Truck,0,0,0,27879,27879,0.0,Washington
1085,April,2021,Spokane,WA,Passenger,1000,611,1611,324879,326490,0.49,Washington
1086,April,2021,Ray,MO,Passenger,0,1,1,1,2,50.0,Furthest
1087,April,2021,Kitsap,WA,Truck,0,0,0,54575,54575,0.0,Washington
1088,April,2021,Nueces,TX,Passenger,1,0,1,78,79,1.27,Mid-Distance
1089,April,2021,Washington,MD,Passenger,1,0,1,12,13,7.69,Furthest
1090,April,2021,Honolulu,HI,Passenger,5,2,7,402,409,1.71,Nearest
1091,April,2021,Ferry,WA,Truck,0,0,0,3649,3649,0.0,Washington
1092,April,2021,Morris,NJ,Passenger,1,0,1,16,17,5.88,Furthest
1093,April,2021,Arlington,VA,Passenger,0,1,1,138,139,0.72,Furthest
1094,April,2021,Washington,OR,Passenger,1,0,1,394,395,0.25,Nearest
1095,April,2021,Snohomish,WA,Passenger,5588,1967,7555,540438,547993,1.38,Washington
1096,April,2021,Allen,IN,Passenger,1,0,1,15,16,6.25,Furthest
1097,April,2021,Ulster,NY,Passenger,1,0,1,7,8,12.5,Furthest
1098,April,2021,Charles,MD,Passenger,1,1,2,69,71,2.82,Furthest
1099,April,2022,Okaloosa,FL,Passenger,0,1,1,99,100,1.0,Furthest
1100,April,2022,Whitman,WA,Truck,0,0,0,8586,8586,0.0,Washington
1101,April,2022,Moore,NC,Passenger,0,1,1,117,118,0.85,Furthest
1102,April,2022,Prince George's,MD,Passenger,2,1,3,124,127,2.36,Furthest
1103,April,2022,Anchorage,AK,Passenger,1,0,1,123,124,0.81,Nearest
1104,April,2022,Harrison,MS,Passenger,2,0,2,44,46,4.35,Mid-Distance
1105,April,2022,Cowlitz,WA,Truck,0,1,1,28734,28735,0.0,Washington
1106,April,2022,Sedgwick,KS,Passenger,1,1,2,78,80,2.5,Mid-Distance
1107,April,2022,Clackamas,OR,Passenger,2,0,2,146,148,1.35,Nearest
1108,April,2022,Richmond,GA,Passenger,0,1,1,67,68,1.47,Furthest
1109,April,2022,New London,CT,Passenger,2,5,7,197,204,3.43,Furthest
1110,April,2022,Montgomery,AL,Passenger,0,1,1,33,34,2.94,Furthest
1111,April,2022,Wood,OH,Passenger,0,1,1,4,5,20.0,Furthest
1112,April,2022,Wichita,TX,Passenger,1,0,1,39,40,2.5,Mid-Distance
1113,April,2022,Clark,NV,Passenger,4,2,6,529,535,1.12,Nearest
1114,April,2022,El Paso,TX,Passenger,2,0,2,338,340,0.59,Mid-Distance
1115,April,2022,Lincoln,OR,Passenger,0,1,1,30,31,3.23,Nearest
1116,April,2022,Plaquemines,LA,Passenger,1,1,2,16,18,11.11,Mid-Distance
1117,April,2022,Marin,CA,Passenger,0,1,1,30,31,3.23,Nearest
1118,April,2022,Rockingham,NH,Passenger,1,0,1,16,17,5.88,Furthest
1119,April,2022,Fresno,CA,Passenger,1,0,1,142,143,0.7,Nearest
1120,April,2022,Alameda,CA,Passenger,4,0,4,192,196,2.04,Nearest
1121,April,2022,Goochland,VA,Passenger,3,2,5,138,143,3.5,Furthest
1122,April,2022,Hudson,NJ,Passenger,2,0,2,34,36,5.56,Furthest
1123,April,2022,Denton,TX,Passenger,1,0,1,63,64,1.56,Mid-Distance
1124,April,2022,Pierce,WA,Truck,3,0,3,143016,143019,0.0,Washington
1125,April,2022,Camden,NJ,Passenger,0,1,1,13,14,7.14,Furthest
1126,April,2022,Leavenworth,KS,Passenger,0,1,1,102,103,0.97,Mid-Distance
1127,April,2022,St. Mary's,MD,Passenger,1,0,1,192,193,0.52,Furthest
1128,April,2022,Essex,NJ,Passenger,2,0,2,9,11,18.18,Furthest
1129,April,2022,Duval,FL,Passenger,0,2,2,282,284,0.7,Furthest
1130,April,2022,Mason,WA,Passenger,294,178,472,47516,47988,0.98,Washington
1131,April,2022,Walla Walla,WA,Passenger,163,92,255,36040,36295,0.7,Washington
1132,April,2022,Columbia,WA,Truck,0,0,0,1588,1588,0.0,Washington
1133,April,2022,Richmond,NY,Passenger,1,0,1,6,7,14.29,Furthest
1134,April,2022,Wahkiakum,WA,Truck,0,0,0,1817,1817,0.0,Washington
1135,April,2022,Tarrant,TX,Passenger,1,0,1,118,119,0.84,Mid-Distance
1136,April,2022,Santa Cruz,CA,Passenger,1,0,1,24,25,4.0,Nearest
1137,April,2022,Manassas,VA,Passenger,0,1,1,7,8,12.5,Furthest
1138,April,2022,Houston,GA,Passenger,1,0,1,37,38,2.63,Furthest
1139,April,2022,Bexar,TX,Passenger,4,4,8,442,450,1.78,Mid-Distance
1140,April,2022,Pennington,SD,Passenger,2,0,2,28,30,6.67,Mid-Distance
1141,April,2022,Rock Island,IL,Passenger,0,1,1,15,16,6.25,Mid-Distance
1142,April,2022,Skamania,WA,Truck,0,0,0,3981,3981,0.0,Washington
1143,April,2022,Philadelphia,PA,Passenger,1,0,1,35,36,2.78,Furthest
1144,April,2022,Nassau,NY,Passenger,2,0,2,26,28,7.14,Furthest
1145,April,2022,Burlington,NJ,Passenger,0,2,2,109,111,1.8,Furthest
1146,April,2022,Island,WA,Passenger,779,367,1146,62227,63373,1.81,Washington
1147,April,2022,Clark,WA,Truck,3,0,3,83236,83239,0.0,Washington
1148,April,2022,Cumberland,NC,Passenger,1,2,3,369,372,0.81,Furthest
1149,April,2022,Chesapeake,VA,Passenger,2,3,5,346,351,1.42,Furthest
1150,April,2022,Adams,CO,Passenger,1,0,1,37,38,2.63,Mid-Distance
1151,April,2022,Fairbanks North Star,AK,Passenger,0,1,1,77,78,1.28,Nearest
1152,April,2022,King,WA,Truck,26,1,27,181794,181821,0.01,Washington
1153,April,2022,Pinellas,FL,Passenger,0,1,1,77,78,1.28,Furthest
1154,April,2022,Orange,FL,Passenger,1,0,1,94,95,1.05,Furthest
1155,April,2022,Ventura,CA,Passenger,2,1,3,231,234,1.28,Nearest
1156,April,2022,Sonoma,CA,Passenger,0,1,1,72,73,1.37,Nearest
1157,April,2022,Honolulu,HI,Passenger,5,4,9,331,340,2.65,Nearest
1158,April,2022,Columbia,WA,Passenger,7,0,7,2446,2453,0.29,Washington
1159,April,2022,Rogers,OK,Passenger,1,0,1,2,3,33.33,Mid-Distance
1160,April,2022,Randolph,NC,Passenger,1,0,1,5,6,16.67,Furthest
1161,April,2022,Yakima,WA,Truck,0,0,0,61533,61533,0.0,Washington
1162,April,2022,Thurston,WA,Passenger,2073,1015,3088,195014,198102,1.56,Washington
1163,April,2022,Pacific,WA,Truck,0,0,0,7978,7978,0.0,Washington
1164,April,2022,Miami-Dade,FL,Passenger,1,0,1,84,85,1.18,Furthest
1165,April,2022,Ferry,WA,Truck,0,0,0,3568,3568,0.0,Washington
1166,April,2022,San Diego,CA,Passenger,13,8,21,2307,2328,0.9,Nearest
1167,April,2022,Benton,WA,Truck,1,0,1,43588,43589,0.0,Washington
1168,April,2022,Lewis,WA,Truck,0,0,0,26439,26439,0.0,Washington
1169,April,2022,Las Animas,CO,Passenger,1,0,1,1,2,50.0,Mid-Distance
1170,April,2022,Yakima,WA,Passenger,318,183,501,167415,167916,0.3,Washington
1171,April,2022,Chelan,WA,Truck,0,0,0,23067,23067,0.0,Washington
1172,April,2022,Arlington,VA,Passenger,1,0,1,129,130,0.77,Furthest
1173,April,2022,San Juan,WA,Passenger,494,155,649,14128,14777,4.39,Washington
1174,April,2022,San Luis Obispo,CA,Passenger,1,0,1,55,56,1.79,Nearest
1175,April,2022,Skagit,WA,Truck,1,0,1,32485,32486,0.0,Washington
1176,April,2022,Wilson,TX,Passenger,0,1,1,2,3,33.33,Mid-Distance
1177,April,2022,Cowlitz,WA,Passenger,314,172,486,70917,71403,0.68,Washington
1178,April,2022,Queens,NY,Passenger,1,0,1,41,42,2.38,Furthest
1179,April,2022,Stevens,WA,Truck,0,0,0,18994,18994,0.0,Washington
1180,April,2022,DuPage,IL,Passenger,1,0,1,45,46,2.17,Mid-Distance
1181,April,2022,Arapahoe,CO,Passenger,0,1,1,80,81,1.23,Mid-Distance
1182,April,2022,Walla Walla,WA,Truck,0,0,0,14018,14018,0.0,Washington
1183,April,2022,Saratoga,NY,Passenger,1,0,1,38,39,2.56,Furthest
1184,April,2022,Elmore,ID,Passenger,1,0,1,12,13,7.69,Nearest
1185,April,2022,Baltimore,MD,Passenger,1,0,1,73,74,1.35,Furthest
1186,April,2022,Lane,OR,Passenger,0,1,1,98,99,1.01,Nearest
1187,April,2022,Anne Arundel,MD,Passenger,4,3,7,355,362,1.93,Furthest
1188,April,2022,Kittitas,WA,Passenger,236,77,313,29746,30059,1.04,Washington
1189,April,2022,Platte,MO,Passenger,1,0,1,20,21,4.76,Furthest
1190,April,2022,Solano,CA,Passenger,1,0,1,160,161,0.62,Nearest
1191,April,2022,Middlesex,MA,Passenger,1,1,2,80,82,2.44,Furthest
1192,April,2022,Douglas,WA,Passenger,126,57,183,28526,28709,0.64,Washington
1193,April,2022,Boulder,CO,Passenger,1,0,1,34,35,2.86,Mid-Distance
1194,April,2022,Sarpy,NE,Passenger,1,0,1,51,52,1.92,Mid-Distance
1195,April,2022,Hidalgo,TX,Passenger,0,1,1,52,53,1.89,Mid-Distance
1196,April,2022,RÃ­o Grande,PR,Passenger,1,0,1,0,1,100.0,Mid-Distance
1197,April,2022,Virginia Beach,VA,Passenger,2,0,2,523,525,0.38,Furthest
1198,April,2022,Franklin,WA,Passenger,179,105,284,62000,62284,0.46,Washington
1199,April,2022,St. Clair,IL,Passenger,2,0,2,121,123,1.63,Mid-Distance
1200,April,2022,Frederick,MD,Passenger,1,1,2,66,68,2.94,Furthest
1201,April,2022,Grant,WA,Truck,0,0,0,28082,28082,0.0,Washington
1202,April,2022,Loudoun,VA,Passenger,2,1,3,64,67,4.48,Furthest
1203,April,2022,Clallam,WA,Passenger,404,241,645,49821,50466,1.28,Washington
1204,April,2022,Adams,WA,Truck,0,0,0,5481,5481,0.0,Washington
1205,April,2022,Clallam,WA,Truck,1,0,1,21998,21999,0.0,Washington
1206,April,2022,San Joaquin,CA,Passenger,1,1,2,89,91,2.2,Nearest
1207,April,2022,Spokane,WA,Truck,0,0,0,102417,102417,0.0,Washington
1208,April,2022,Carroll,NH,Passenger,0,1,1,5,6,16.67,Furthest
1209,April,2022,Asotin,WA,Truck,0,0,0,6749,6749,0.0,Washington
1210,April,2022,Shelby,OH,Passenger,0,1,1,2,3,33.33,Furthest
1211,April,2022,St. Louis,MO,Passenger,1,0,1,66,67,1.49,Furthest
1212,April,2022,Allen,IN,Passenger,1,0,1,13,14,7.14,Furthest
1213,April,2022,Orange,CA,Passenger,5,2,7,357,364,1.92,Nearest
1214,April,2022,Juneau,AK,Passenger,0,1,1,29,30,3.33,Nearest
1215,April,2022,Fairfax,VA,Passenger,5,3,8,612,620,1.29,Furthest
1216,April,2022,Albemarle,VA,Passenger,1,0,1,17,18,5.56,Furthest
1217,April,2022,Wahkiakum,WA,Passenger,20,11,31,3079,3110,1.0,Washington
1218,April,2022,Wilson,NC,Passenger,1,0,1,0,1,100.0,Furthest
1219,April,2022,Kittitas,WA,Truck,0,0,0,14715,14715,0.0,Washington
1220,April,2022,Dorchester,SC,Passenger,1,0,1,57,58,1.72,Furthest
1221,April,2022,Broward,FL,Passenger,2,0,2,81,83,2.41,Furthest
1222,April,2022,Whatcom,WA,Truck,4,0,4,43460,43464,0.01,Washington
1223,April,2022,Spokane,WA,Passenger,1511,810,2321,325760,328081,0.71,Washington
1224,April,2022,Sumter,SC,Passenger,0,1,1,31,32,3.12,Furthest
1225,April,2022,Yellowstone,MT,Passenger,0,1,1,26,27,3.7,Nearest
1226,April,2022,San Mateo,CA,Passenger,2,0,2,78,80,2.5,Nearest
1227,April,2022,Sevier,AR,Passenger,0,1,1,0,1,100.0,Mid-Distance
1228,April,2022,Thurston,WA,Truck,3,0,3,55595,55598,0.01,Washington
1229,April,2022,Montgomery,PA,Passenger,2,0,2,21,23,8.7,Furthest
1230,April,2022,Kauai,HI,Passenger,1,0,1,18,19,5.26,Nearest
1231,April,2022,Bell,TX,Passenger,1,0,1,322,323,0.31,Mid-Distance
1232,April,2022,Oldham,KY,Passenger,0,1,1,4,5,20.0,Furthest
1233,April,2022,Hawaii,HI,Passenger,1,0,1,36,37,2.7,Nearest
1234,April,2022,Lincoln,WA,Passenger,7,18,25,7670,7695,0.32,Washington
1235,April,2022,Collin,TX,Passenger,2,0,2,92,94,2.13,Mid-Distance
1236,April,2022,Lewis,WA,Passenger,232,171,403,59518,59921,0.67,Washington
1237,April,2022,Santa Clara,CA,Passenger,9,1,10,217,227,4.41,Nearest
1238,April,2022,Ray,MO,Passenger,0,1,1,1,2,50.0,Furthest
1239,April,2022,Chelan,WA,Passenger,447,124,571,54522,55093,1.04,Washington
1240,April,2022,Douglas,CO,Passenger,0,1,1,73,74,1.35,Mid-Distance
1241,April,2022,Kitsap,WA,Passenger,2325,1020,3345,179074,182419,1.83,Washington
1242,April,2022,Lincoln,WA,Truck,0,0,0,4851,4851,0.0,Washington
1243,April,2022,Hamilton,IN,Passenger,1,0,1,21,22,4.55,Furthest
1244,April,2022,Skagit,WA,Passenger,752,328,1080,90318,91398,1.18,Washington
1245,April,2022,Jefferson,WA,Passenger,415,210,625,24734,25359,2.46,Washington
1246,April,2022,San Bernardino,CA,Passenger,1,1,2,335,337,0.59,Nearest
1247,April,2022,Galveston,TX,Passenger,0,1,1,19,20,5.0,Mid-Distance
1248,April,2022,Larimer,CO,Passenger,1,0,1,48,49,2.04,Mid-Distance
1249,April,2022,Williams,ND,Passenger,0,1,1,7,8,12.5,Mid-Distance
1250,April,2022,Greene,MO,Passenger,0,1,1,23,24,4.17,Furthest
1251,April,2022,Alexandria,VA,Passenger,3,0,3,107,110,2.73,Furthest
1252,April,2022,Williamson,TX,Passenger,1,2,3,82,85,3.53,Mid-Distance
1253,April,2022,King,WA,Passenger,39326,10828,50154,1351160,1401314,3.58,Washington
1254,April,2022,Nueces,TX,Passenger,1,1,2,57,59,3.39,Mid-Distance
1255,April,2022,Hennepin,MN,Passenger,3,0,3,57,60,5.0,Mid-Distance
1256,April,2022,Placer,CA,Passenger,2,0,2,69,71,2.82,Nearest
1257,April,2022,Pend Oreille,WA,Passenger,16,10,26,9032,9058,0.29,Washington
1258,April,2022,Franklin,WA,Truck,0,0,0,20942,20942,0.0,Washington
1259,April,2022,Mason,WA,Truck,0,0,0,21131,21131,0.0,Washington
1260,April,2022,New York,NY,Passenger,1,0,1,35,36,2.78,Furthest
1261,April,2022,Sacramento,CA,Passenger,2,0,2,198,200,1.0,Nearest
1262,April,2022,El Paso,CO,Passenger,3,1,4,602,606,0.66,Mid-Distance
1263,April,2022,Fort Bend,TX,Passenger,1,0,1,31,32,3.12,Mid-Distance
1264,April,2022,Clark,WA,Passenger,3864,1692,5556,317894,323450,1.72,Washington
1265,April,2022,Dallas,TX,Passenger,1,0,1,114,115,0.87,Mid-Distance
1266,April,2022,New Haven,CT,Passenger,0,2,2,28,30,6.67,Furthest
1267,April,2022,Kitsap,WA,Truck,1,0,1,53850,53851,0.0,Washington
1268,April,2022,Hillsborough,FL,Passenger,0,2,2,122,124,1.61,Furthest
1269,April,2022,Harris,TX,Passenger,2,0,2,146,148,1.35,Mid-Distance
1270,April,2022,Charleston,SC,Passenger,2,1,3,61,64,4.69,Furthest
1271,April,2022,Onslow,NC,Passenger,0,1,1,159,160,0.62,Furthest
1272,April,2022,Whatcom,WA,Passenger,1775,717,2492,149078,151570,1.64,Washington
1273,April,2022,Douglas,NE,Passenger,1,2,3,43,46,6.52,Mid-Distance
1274,April,2022,Okanogan,WA,Passenger,79,48,127,26465,26592,0.48,Washington
1275,April,2022,Rockdale,GA,Passenger,1,0,1,8,9,11.11,Furthest
1276,April,2022,Kings,NY,Passenger,1,0,1,59,60,1.67,Furthest
1277,April,2022,Whitman,WA,Passenger,83,56,139,22051,22190,0.63,Washington
1278,April,2022,Spartanburg,SC,Passenger,0,1,1,40,41,2.44,Furthest
1279,April,2022,Benton,WA,Passenger,715,446,1161,135499,136660,0.85,Washington
1280,April,2022,District of Columbia,DC,Passenger,4,0,4,180,184,2.17,Furthest
1281,April,2022,Stafford,VA,Passenger,2,1,3,89,92,3.26,Furthest
1282,April,2022,Owyhee,ID,Passenger,1,0,1,2,3,33.33,Nearest
1283,April,2022,Charles,MD,Passenger,0,1,1,56,57,1.75,Furthest
1284,April,2022,Danville,VA,Passenger,1,0,1,0,1,100.0,Furthest
1285,April,2022,Pima,AZ,Passenger,1,1,2,224,226,0.88,Nearest
1286,April,2022,Pierce,WA,Passenger,4836,2264,7100,548921,556021,1.28,Washington
1287,April,2022,Allegheny,PA,Passenger,1,1,2,53,55,3.64,Furthest
1288,April,2022,Travis,TX,Passenger,1,0,1,110,111,0.9,Mid-Distance
1289,April,2022,Grant,WA,Passenger,159,98,257,66893,67150,0.38,Washington
1290,April,2022,Cape May,NJ,Passenger,0,1,1,7,8,12.5,Furthest
1291,April,2022,Washington,MD,Passenger,2,0,2,14,16,12.5,Furthest
1292,April,2022,Klickitat,WA,Truck,0,0,0,8281,8281,0.0,Washington
1293,April,2022,Stevens,WA,Passenger,64,52,116,30125,30241,0.38,Washington
1294,April,2022,Howard,IN,Passenger,0,1,1,5,6,16.67,Furthest
1295,April,2022,Ulster,NY,Passenger,1,0,1,8,9,11.11,Furthest
1296,April,2022,Suffolk,VA,Passenger,1,0,1,121,122,0.82,Furthest
1297,April,2022,St. Tammany,LA,Passenger,1,0,1,36,37,2.7,Mid-Distance
1298,April,2022,Lake,FL,Passenger,1,0,1,20,21,4.76,Furthest
1299,April,2022,Boone,MO,Passenger,0,1,1,9,10,10.0,Furthest
1300,April,2022,Norfolk,VA,Passenger,3,3,6,294,300,2.0,Furthest
1301,April,2022,Howard,MD,Passenger,0,1,1,56,57,1.75,Furthest
1302,April,2022,Gwinnett,GA,Passenger,1,0,1,50,51,1.96,Furthest
1303,April,2022,Lee,FL,Passenger,1,0,1,28,29,3.45,Furthest
1304,April,2022,Sarasota,FL,Passenger,2,0,2,25,27,7.41,Furthest
1305,April,2022,Maricopa,AZ,Passenger,7,2,9,942,951,0.95,Nearest
1306,April,2022,Okanogan,WA,Truck,0,0,0,16687,16687,0.0,Washington
1307,April,2022,Garfield,WA,Truck,0,0,0,990,990,0.0,Washington
1308,April,2022,Carroll,MD,Passenger,0,1,1,15,16,6.25,Furthest
1309,April,2022,Snohomish,WA,Passenger,7965,2418,10383,534060,544443,1.91,Washington
1310,April,2022,Bartow,GA,Passenger,0,1,1,3,4,25.0,Furthest
1311,April,2022,Skamania,WA,Passenger,67,46,113,8227,8340,1.35,Washington
1312,April,2022,Grays Harbor,WA,Passenger,200,158,358,49216,49574,0.72,Washington
1313,April,2022,Ferry,WA,Passenger,19,4,23,4406,4429,0.52,Washington
1315,April,2022,Kern,CA,Passenger,0,1,1,191,192,0.52,Nearest
1316,April,2022,Coryell,TX,Passenger,1,0,1,100,101,0.99,Mid-Distance
1317,April,2022,Prince William,VA,Passenger,0,1,1,196,197,0.51,Furthest
1318,April,2022,Multnomah,OR,Passenger,0,4,4,546,550,0.73,Nearest
1319,April,2022,Montgomery,MD,Passenger,4,2,6,193,199,3.02,Furthest
1320,April,2022,Portsmouth,VA,Passenger,0,1,1,74,75,1.33,Furthest
1321,April,2022,Los Angeles,CA,Passenger,8,7,15,777,792,1.89,Nearest
1322,April,2022,Wake,NC,Passenger,1,0,1,90,91,1.1,Furthest
1323,April,2022,Grays Harbor,WA,Truck,0,0,0,21346,21346,0.0,Washington
1324,April,2022,Island,WA,Truck,1,0,1,21467,21468,0.0,Washington
1325,April,2022,Harnett,NC,Passenger,2,0,2,140,142,1.41,Furthest
1326,April,2022,Suffolk,MA,Passenger,0,1,1,22,23,4.35,Furthest
1327,April,2022,Calvert,MD,Passenger,0,2,2,77,79,2.53,Furthest
1328,April,2022,Cook,IL,Passenger,3,0,3,187,190,1.58,Mid-Distance
1329,April,2022,Asotin,WA,Passenger,24,19,43,12707,12750,0.34,Washington
1330,April,2022,Hamilton,OH,Passenger,1,0,1,28,29,3.45,Furthest
1331,April,2022,Jefferson,NY,Passenger,0,1,1,203,204,0.49,Furthest
1332,April,2022,Riverside,CA,Passenger,7,1,8,471,479,1.67,Nearest
1333,April,2022,Douglas,WA,Truck,0,0,0,12748,12748,0.0,Washington
1334,April,2022,Pend Oreille,WA,Truck,0,0,0,5657,5657,0.0,Washington
1335,April,2022,Lake,IL,Passenger,3,0,3,140,143,2.1,Mid-Distance
1336,April,2022,DeKalb,GA,Passenger,1,0,1,48,49,2.04,Furthest
1337,April,2022,Richland,SC,Passenger,0,1,1,127,128,0.78,Furthest
1338,April,2022,Powhatan,VA,Passenger,1,0,1,1,2,50.0,Furthest
1339,April,2022,Montgomery,TX,Passenger,1,0,1,31,32,3.12,Mid-Distance
1340,April,2022,Penobscot,ME,Passenger,0,1,1,6,7,14.29,Furthest
1341,April,2022,Klickitat,WA,Passenger,100,55,155,15247,15402,1.01,Washington
1342,April,2022,Kings,CA,Passenger,2,1,3,304,307,0.98,Nearest
1343,April,2022,Contra Costa,CA,Passenger,0,3,3,255,258,1.16,Nearest
1344,April,2022,Carson City,NV,Passenger,1,0,1,8,9,11.11,Nearest
1345,April,2022,Escambia,FL,Passenger,0,1,1,132,133,0.75,Furthest
1346,April,2022,Salt Lake,UT,Passenger,1,1,2,131,133,1.5,Nearest
1347,April,2022,Adams,WA,Passenger,16,10,26,12985,13011,0.2,Washington
1348,April,2022,Snohomish,WA,Truck,4,0,4,124628,124632,0.0,Washington
1349,April,2022,Pacific,WA,Passenger,60,68,128,15938,16066,0.8,Washington
1350,April,2022,Jefferson,WA,Truck,0,0,0,9522,9522,0.0,Washington
1351,April,2022,Geary,KS,Passenger,1,0,1,86,87,1.15,Mid-Distance
1352,April,2022,Monterey,CA,Passenger,1,1,2,127,129,1.55,Nearest
1353,April,2022,Garfield,WA,Passenger,0,3,3,1332,1335,0.22,Washington
1354,April,2022,San Juan,WA,Truck,1,0,1,5986,5987,0.02,Washington
1355,April,2023,Hamilton,OH,Truck,1,0,1,2,3,33.33,Furthest
1356,April,2023,Kings,CA,Passenger,2,1,3,264,267,1.12,Nearest
1357,April,2023,Madison,IL,Passenger,1,0,1,16,17,5.88,Mid-Distance
1358,April,2023,Frederick,MD,Passenger,1,0,1,52,53,1.89,Furthest
1359,April,2023,Arlington,VA,Passenger,1,0,1,98,99,1.01,Furthest
1360,April,2023,Mason,WA,Passenger,417,204,621,46162,46783,1.33,Washington
1361,April,2023,Sedgwick,KS,Passenger,1,0,1,52,53,1.89,Mid-Distance
1362,April,2023,Marin,CA,Passenger,0,1,1,26,27,3.7,Nearest
1363,April,2023,Denton,TX,Passenger,1,0,1,44,45,2.22,Mid-Distance
1364,April,2023,Newport News,VA,Passenger,1,0,1,91,92,1.09,Furthest
1365,April,2023,Leavenworth,KS,Passenger,0,1,1,89,90,1.11,Mid-Distance
1366,April,2023,Richmond,GA,Passenger,0,1,1,54,55,1.82,Furthest
1367,April,2023,Sonoma,CA,Passenger,1,1,2,51,53,3.77,Nearest
1368,April,2023,Oldham,KY,Passenger,0,1,1,4,5,20.0,Furthest
1369,April,2023,Kittitas,WA,Passenger,328,95,423,29339,29762,1.42,Washington
1370,April,2023,Okaloosa,FL,Passenger,0,1,1,85,86,1.16,Furthest
1371,April,2023,Richmond,NY,Passenger,1,0,1,6,7,14.29,Furthest
1372,April,2023,Ventura,CA,Passenger,2,1,3,194,197,1.52,Nearest
1373,April,2023,Benton,OR,Passenger,1,0,1,33,34,2.94,Nearest
1374,April,2023,Rock Island,IL,Passenger,0,1,1,14,15,6.67,Mid-Distance
1375,April,2023,Carroll,MD,Passenger,0,1,1,17,18,5.56,Furthest
1376,April,2023,Wichita,TX,Passenger,2,0,2,30,32,6.25,Mid-Distance
1377,April,2023,Contra Costa,CA,Passenger,0,3,3,193,196,1.53,Nearest
1378,April,2023,Wahkiakum,WA,Passenger,27,16,43,3044,3087,1.39,Washington
1379,April,2023,St. Louis,MO,Passenger,1,0,1,50,51,1.96,Furthest
1380,April,2023,King,WA,Passenger,53639,13733,67372,1318485,1385857,4.86,Washington
1381,April,2023,Elmore,ID,Passenger,1,0,1,9,10,10.0,Nearest
1382,April,2023,Polk,OR,Passenger,0,1,1,15,16,6.25,Nearest
1383,April,2023,Asotin,WA,Passenger,33,21,54,12339,12393,0.44,Washington
1384,April,2023,Montgomery,PA,Passenger,1,0,1,14,15,6.67,Furthest
1385,April,2023,Essex,NJ,Passenger,2,0,2,4,6,33.33,Furthest
1386,April,2023,Grays Harbor,WA,Truck,4,0,4,20911,20915,0.02,Washington
1387,April,2023,Stafford,VA,Passenger,3,1,4,73,77,5.19,Furthest
1388,April,2023,Williamson,TX,Passenger,0,1,1,51,52,1.92,Mid-Distance
1389,April,2023,Broward,FL,Passenger,1,0,1,54,55,1.82,Furthest
1390,April,2023,San Bernardino,CA,Passenger,2,1,3,253,256,1.17,Nearest
1391,April,2023,St. Clair,IL,Passenger,2,0,2,101,103,1.94,Mid-Distance
1392,April,2023,Honolulu,HI,Passenger,2,3,5,240,245,2.04,Nearest
1393,April,2023,Montgomery,MD,Passenger,3,3,6,168,174,3.45,Furthest
1394,April,2023,Adams,CO,Passenger,1,0,1,27,28,3.57,Mid-Distance
1395,April,2023,Walla Walla,WA,Truck,5,0,5,13674,13679,0.04,Washington
1396,April,2023,New London,CT,Passenger,1,4,5,169,174,2.87,Furthest
1397,April,2023,Escambia,FL,Passenger,0,1,1,106,107,0.93,Furthest
1398,April,2023,Kern,CA,Passenger,1,1,2,171,173,1.16,Nearest
1399,April,2023,Klickitat,WA,Truck,8,0,8,8230,8238,0.1,Washington
1400,April,2023,Jefferson,WA,Truck,10,0,10,9292,9302,0.11,Washington
1401,April,2023,Thurston,WA,Truck,55,0,55,53886,53941,0.1,Washington
1402,April,2023,Lane,OR,Passenger,0,1,1,63,64,1.56,Nearest
1403,April,2023,Fairbanks North Star,AK,Passenger,0,1,1,48,49,2.04,Nearest
1404,April,2023,Allen,IN,Passenger,1,0,1,9,10,10.0,Furthest
1405,April,2023,Rockingham,NH,Passenger,1,0,1,10,11,9.09,Furthest
1406,April,2023,Douglas,WA,Truck,7,0,7,12882,12889,0.05,Washington
1407,April,2023,Bell,TX,Passenger,1,0,1,242,243,0.41,Mid-Distance
1408,April,2023,San Juan,WA,Truck,12,0,12,5895,5907,0.2,Washington
1409,April,2023,Cowlitz,WA,Passenger,433,203,636,69749,70385,0.9,Washington
1410,April,2023,Spokane,WA,Truck,34,0,34,101402,101436,0.03,Washington
1411,April,2023,Douglas,NE,Passenger,1,1,2,25,27,7.41,Mid-Distance
1412,April,2023,Wahkiakum,WA,Truck,2,0,2,1779,1781,0.11,Washington
1413,April,2023,St. Tammany,LA,Passenger,1,0,1,30,31,3.23,Mid-Distance
1414,April,2023,Douglas,WA,Passenger,189,61,250,28557,28807,0.87,Washington
1415,April,2023,Hawaii,HI,Passenger,1,0,1,23,24,4.17,Nearest
1416,April,2023,Charleston,SC,Passenger,2,2,4,52,56,7.14,Furthest
1417,April,2023,Washington,MD,Passenger,2,0,2,13,15,13.33,Furthest
1418,April,2023,Calvert,MD,Passenger,1,1,2,72,74,2.7,Furthest
1419,April,2023,Whatcom,WA,Passenger,2323,857,3180,147179,150359,2.11,Washington
1420,April,2023,Mason,WA,Truck,10,0,10,20712,20722,0.05,Washington
1421,April,2023,Lincoln,OR,Passenger,0,1,1,12,13,7.69,Nearest
1422,April,2023,Norfolk,VA,Passenger,3,2,5,254,259,1.93,Furthest
1423,April,2023,Multnomah,OR,Passenger,0,2,2,404,406,0.49,Nearest
1424,April,2023,Santa Barbara,CA,Passenger,1,0,1,61,62,1.61,Nearest
1425,April,2023,Yakima,WA,Passenger,468,242,710,165211,165921,0.43,Washington
1426,April,2023,Suffolk,VA,Passenger,1,0,1,101,102,0.98,Furthest
1427,April,2023,Travis,TX,Passenger,1,0,1,76,77,1.3,Mid-Distance
1428,April,2023,Ray,MO,Passenger,0,1,1,0,1,100.0,Furthest
1429,April,2023,Champaign,IL,Passenger,1,0,1,7,8,12.5,Mid-Distance
1430,April,2023,Rockdale,GA,Passenger,1,0,1,3,4,25.0,Furthest
1431,April,2023,Kauai,HI,Passenger,1,1,2,13,15,13.33,Nearest
1432,April,2023,Solano,CA,Passenger,5,0,5,134,139,3.6,Nearest
1433,April,2023,Clark,WA,Passenger,5444,2212,7656,312447,320103,2.39,Washington
1434,April,2023,Jefferson,NY,Passenger,1,1,2,167,169,1.18,Furthest
1435,April,2023,Coryell,TX,Passenger,1,0,1,72,73,1.37,Mid-Distance
1436,April,2023,Placer,CA,Passenger,1,0,1,51,52,1.92,Nearest
1437,April,2023,Bexar,TX,Passenger,3,3,6,340,346,1.73,Mid-Distance
1438,April,2023,Hidalgo,TX,Passenger,0,1,1,45,46,2.17,Mid-Distance
1439,April,2023,Howard,MD,Passenger,0,1,1,42,43,2.33,Furthest
1440,April,2023,Lake,IL,Passenger,2,0,2,110,112,1.79,Mid-Distance
1441,April,2023,Chesapeake,VA,Passenger,2,3,5,272,277,1.81,Furthest
1442,April,2023,Snohomish,WA,Passenger,11666,2925,14591,526766,541357,2.7,Washington
1443,April,2023,Stevens,WA,Passenger,108,62,170,29693,29863,0.57,Washington
1444,April,2023,Okanogan,WA,Truck,3,0,3,16397,16400,0.02,Washington
1445,April,2023,Nassau,NY,Passenger,1,0,1,21,22,4.55,Furthest
1446,April,2023,District of Columbia,DC,Passenger,4,0,4,147,151,2.65,Furthest
1447,April,2023,Pacific,WA,Truck,3,0,3,7787,7790,0.04,Washington
1448,April,2023,Cowlitz,WA,Truck,8,0,8,28099,28107,0.03,Washington
1449,April,2023,Beaufort,SC,Passenger,1,0,1,18,19,5.26,Furthest
1450,April,2023,Island,WA,Passenger,1012,423,1435,61224,62659,2.29,Washington
1451,April,2023,Adams,WA,Truck,2,0,2,5293,5295,0.04,Washington
1452,April,2023,Ferry,WA,Passenger,19,4,23,4330,4353,0.53,Washington
1453,April,2023,Monterey,CA,Passenger,1,1,2,108,110,1.82,Nearest
1454,April,2023,DeKalb,GA,Passenger,1,0,1,38,39,2.56,Furthest
1455,April,2023,Walla Walla,WA,Passenger,213,115,328,35303,35631,0.92,Washington
1456,April,2023,Orange,CA,Passenger,7,2,9,269,278,3.24,Nearest
1457,April,2023,Moore,NC,Passenger,0,1,1,102,103,0.97,Furthest
1459,April,2023,Hamilton,OH,Passenger,1,0,1,24,25,4.0,Furthest
1460,April,2023,Skamania,WA,Passenger,99,53,152,8037,8189,1.86,Washington
1461,April,2023,Prince George's,MD,Passenger,2,1,3,104,107,2.8,Furthest
1462,April,2023,Pulaski,AR,Passenger,3,0,3,21,24,12.5,Mid-Distance
1463,April,2023,Dallas,TX,Passenger,1,0,1,73,74,1.35,Mid-Distance
1464,April,2023,Chelan,WA,Passenger,605,154,759,54000,54759,1.39,Washington
1465,April,2023,Clark,WA,Truck,82,0,82,81044,81126,0.1,Washington
1466,April,2023,Galveston,TX,Passenger,0,1,1,15,16,6.25,Mid-Distance
1467,April,2023,Virginia Beach,VA,Passenger,2,0,2,419,421,0.48,Furthest
1468,April,2023,Hoke,NC,Passenger,1,0,1,55,56,1.79,Furthest
1469,April,2023,Salt Lake,UT,Passenger,0,1,1,88,89,1.12,Nearest
1470,April,2023,Clark,NV,Passenger,4,2,6,375,381,1.57,Nearest
1471,April,2023,Larimer,CO,Passenger,1,0,1,36,37,2.7,Mid-Distance
1472,April,2023,Randolph,NC,Passenger,1,0,1,3,4,25.0,Furthest
1473,April,2023,Vernon,LA,Passenger,1,0,1,68,69,1.45,Mid-Distance
1474,April,2023,Harnett,NC,Passenger,4,0,4,120,124,3.23,Furthest
1475,April,2023,Hillsborough,FL,Passenger,0,1,1,100,101,0.99,Furthest
1476,April,2023,Ferry,WA,Truck,0,0,0,3556,3556,0.0,Washington
1477,April,2023,Skagit,WA,Passenger,1055,389,1444,88585,90029,1.6,Washington
1478,April,2023,Grant,WA,Truck,10,0,10,27865,27875,0.04,Washington
1479,April,2023,San Juan,WA,Passenger,605,173,778,13782,14560,5.34,Washington
1480,April,2023,Lincoln,WA,Passenger,18,16,34,7641,7675,0.44,Washington
1481,April,2023,New Haven,CT,Passenger,0,2,2,21,23,8.7,Furthest
1482,April,2023,Lee,AL,Passenger,1,0,1,11,12,8.33,Furthest
1483,April,2023,Goochland,VA,Passenger,0,1,1,39,40,2.5,Furthest
1484,April,2023,Anne Arundel,MD,Passenger,4,4,8,287,295,2.71,Furthest
1485,April,2023,Kootenai,ID,Truck,1,0,1,27,28,3.57,Nearest
1486,April,2023,Grant,WA,Passenger,265,114,379,66651,67030,0.57,Washington
1487,April,2023,San Diego,CA,Passenger,16,9,25,1874,1899,1.32,Nearest
1488,April,2023,Las Animas,CO,Passenger,1,0,1,0,1,100.0,Mid-Distance
1489,April,2023,Pend Oreille,WA,Passenger,31,13,44,8881,8925,0.49,Washington
1490,April,2023,Yavapai,AZ,Passenger,1,0,1,20,21,4.76,Nearest
1491,April,2023,Boulder,CO,Passenger,1,0,1,24,25,4.0,Mid-Distance
1492,April,2023,Camden,NJ,Passenger,0,1,1,12,13,7.69,Furthest
1493,April,2023,Clallam,WA,Truck,18,0,18,21654,21672,0.08,Washington
1494,April,2023,Emmet,MI,Passenger,0,1,1,0,1,100.0,Furthest
1495,April,2023,Hennepin,MN,Passenger,1,0,1,30,31,3.23,Mid-Distance
1496,April,2023,Pacific,WA,Passenger,76,89,165,15580,15745,1.05,Washington
1497,April,2023,Nueces,TX,Passenger,0,1,1,49,50,2.0,Mid-Distance
1498,April,2023,Skagit,WA,Truck,18,0,18,31863,31881,0.06,Washington
1499,April,2023,Collin,TX,Passenger,2,0,2,39,41,4.88,Mid-Distance
1500,April,2023,Pierce,WA,Truck,139,0,139,137180,137319,0.1,Washington
1501,April,2023,Maricopa,AZ,Passenger,7,3,10,578,588,1.7,Nearest
1502,April,2023,Santa Clara,CA,Passenger,8,2,10,146,156,6.41,Nearest
1503,April,2023,Berkeley,SC,Passenger,0,1,1,99,100,1.0,Furthest
1504,April,2023,Gwinnett,GA,Passenger,1,0,1,41,42,2.38,Furthest
1505,April,2023,Fairfax,VA,Passenger,4,3,7,529,536,1.31,Furthest
1506,April,2023,King,WA,Truck,634,2,636,175590,176226,0.36,Washington
1507,April,2023,Hudson,NJ,Passenger,1,0,1,16,17,5.88,Furthest
1508,April,2023,Columbia,WA,Truck,0,0,0,1552,1552,0.0,Washington
1509,April,2023,Alexandria,VA,Passenger,3,1,4,87,91,4.4,Furthest
1510,April,2023,Harrison,MS,Passenger,1,0,1,29,30,3.33,Mid-Distance
1511,April,2023,Loudoun,VA,Passenger,3,0,3,56,59,5.08,Furthest
1512,April,2023,Whatcom,WA,Truck,52,0,52,42622,42674,0.12,Washington
1513,April,2023,Pierce,WA,Passenger,7128,2668,9796,530958,540754,1.81,Washington
1514,April,2023,Clallam,WA,Passenger,518,278,796,48898,49694,1.6,Washington
1515,April,2023,Franklin,WA,Passenger,298,132,430,61650,62080,0.69,Washington
1516,April,2023,Fairfax,VA,Truck,1,0,1,86,87,1.15,Furthest
1517,April,2023,El Paso,CO,Passenger,3,1,4,475,479,0.84,Mid-Distance
1518,April,2023,Portsmouth,VA,Passenger,0,1,1,61,62,1.61,Furthest
1519,April,2023,Whitman,WA,Truck,4,0,4,8571,8575,0.05,Washington
1520,April,2023,Duval,FL,Passenger,1,0,1,221,222,0.45,Furthest
1521,April,2023,Douglas,CO,Passenger,0,1,1,50,51,1.96,Mid-Distance
1522,April,2023,Lewis,WA,Truck,6,0,6,26003,26009,0.02,Washington
1523,April,2023,Cape May,NJ,Passenger,0,1,1,7,8,12.5,Furthest
1524,April,2023,Lincoln,WA,Truck,0,0,0,4841,4841,0.0,Washington
1525,April,2023,Platte,MO,Passenger,1,0,1,16,17,5.88,Furthest
1526,April,2023,Snohomish,WA,Truck,145,0,145,121227,121372,0.12,Washington
1527,April,2023,Chelan,WA,Truck,26,0,26,23050,23076,0.11,Washington
1528,April,2023,Arapahoe,CO,Passenger,1,1,2,66,68,2.94,Mid-Distance
1529,April,2023,Grays Harbor,WA,Passenger,286,182,468,48238,48706,0.96,Washington
1530,April,2023,Los Angeles,CA,Passenger,4,5,9,585,594,1.52,Nearest
1531,April,2023,Stevens,WA,Truck,1,0,1,18709,18710,0.01,Washington
1532,April,2023,El Paso,TX,Passenger,2,0,2,258,260,0.77,Mid-Distance
1533,April,2023,Dorchester,SC,Passenger,1,0,1,39,40,2.5,Furthest
1534,April,2023,Alameda,CA,Passenger,3,0,3,149,152,1.97,Nearest
1535,April,2023,Kittitas,WA,Truck,8,0,8,14470,14478,0.06,Washington
1536,April,2023,Jefferson,WA,Passenger,531,253,784,24161,24945,3.14,Washington
1537,April,2023,Geary,KS,Passenger,1,0,1,69,70,1.43,Mid-Distance
1538,April,2023,Cook,IL,Passenger,2,0,2,142,144,1.39,Mid-Distance
1539,April,2023,St. Mary's,MD,Passenger,1,0,1,163,164,0.61,Furthest
1540,April,2023,Saratoga,NY,Passenger,1,1,2,30,32,6.25,Furthest
1541,April,2023,Jackson,OK,Passenger,0,1,1,30,31,3.23,Mid-Distance
1542,April,2023,Cumberland,PA,Passenger,1,0,1,31,32,3.12,Furthest
1543,April,2023,Sacramento,CA,Passenger,4,0,4,134,138,2.9,Nearest
1544,April,2023,Sheridan,WY,Passenger,1,0,1,5,6,16.67,Nearest
1545,April,2023,Columbia,WA,Passenger,8,1,9,2407,2416,0.37,Washington
1546,April,2023,Yellowstone,MT,Passenger,0,1,1,16,17,5.88,Nearest
1547,April,2023,Wilson,TX,Passenger,0,1,1,2,3,33.33,Mid-Distance
1548,April,2023,Whitman,WA,Passenger,138,73,211,21935,22146,0.95,Washington
1549,April,2023,Spokane,WA,Passenger,2159,1032,3191,321308,324499,0.98,Washington
1550,April,2023,Kitsap,WA,Passenger,3049,1231,4280,175820,180100,2.38,Washington
1551,April,2023,Yakima,WA,Truck,11,0,11,60803,60814,0.02,Washington
1552,April,2023,Plaquemines,LA,Passenger,1,1,2,14,16,12.5,Mid-Distance
1553,April,2023,Klickitat,WA,Passenger,139,59,198,15114,15312,1.29,Washington
1554,April,2023,Island,WA,Truck,28,0,28,21017,21045,0.13,Washington
1555,April,2023,Garfield,WA,Truck,0,0,0,976,976,0.0,Washington
1556,April,2023,Santa Cruz,CA,Passenger,1,0,1,13,14,7.14,Nearest
1557,April,2023,Adams,WA,Passenger,24,12,36,12970,13006,0.28,Washington
1558,April,2023,Kent,DE,Passenger,1,0,1,44,45,2.22,Furthest
1559,April,2023,Cumberland,NC,Passenger,1,2,3,285,288,1.04,Furthest
1560,April,2023,Pend Oreille,WA,Truck,0,0,0,5600,5600,0.0,Washington
1561,April,2023,Asotin,WA,Truck,0,0,0,6607,6607,0.0,Washington
1562,April,2023,Ulster,NY,Passenger,1,0,1,4,5,20.0,Furthest
1563,April,2023,Skamania,WA,Truck,1,0,1,3828,3829,0.03,Washington
1564,April,2023,Riverside,CA,Passenger,6,1,7,357,364,1.92,Nearest
1565,April,2023,Benton,WA,Passenger,1089,545,1634,135049,136683,1.2,Washington
1566,April,2023,Miami-Dade,FL,Passenger,1,0,1,54,55,1.82,Furthest
1567,April,2023,Napa,CA,Passenger,0,1,1,10,11,9.09,Nearest
1568,April,2023,Thurston,WA,Passenger,2918,1188,4106,190129,194235,2.11,Washington
1569,April,2023,Sarpy,NE,Passenger,1,0,1,45,46,2.17,Mid-Distance
1570,April,2023,Kitsap,WA,Truck,64,0,64,52364,52428,0.12,Washington
1571,April,2023,Burlington,NJ,Passenger,0,2,2,89,91,2.2,Furthest
1572,April,2023,Lewis,WA,Passenger,302,195,497,58597,59094,0.84,Washington
1573,April,2023,Franklin,WA,Truck,4,0,4,20798,20802,0.02,Washington
1574,April,2023,Garfield,WA,Passenger,1,3,4,1316,1320,0.3,Washington
1575,April,2023,Okanogan,WA,Passenger,119,58,177,25969,26146,0.68,Washington
1576,April,2023,Charles,MD,Passenger,1,1,2,49,51,3.92,Furthest
1577,April,2023,Sarasota,FL,Passenger,1,0,1,14,15,6.67,Furthest
1578,April,2023,Houston,GA,Passenger,1,0,1,26,27,3.7,Furthest
1579,April,2023,Benton,WA,Truck,19,0,19,43089,43108,0.04,Washington
1580,April,2023,Middlesex,MA,Passenger,2,1,3,57,60,5.0,Furthest
1581,April,2023,Onslow,NC,Passenger,0,1,1,136,137,0.73,Furthest
1582,August,2017,Tuolumne,CA,Passenger,0,1,1,14,15,6.67,Nearest
1583,August,2017,Lincoln,WA,Passenger,1,5,6,7571,7577,0.08,Washington
1584,August,2017,Asotin,WA,Passenger,8,5,13,12444,12457,0.1,Washington
1585,August,2017,Thurston,WA,Truck,0,0,0,53429,53429,0.0,Washington
1586,August,2017,Hawaii,HI,Passenger,1,0,1,77,78,1.28,Nearest
1587,August,2017,Essex,NJ,Passenger,1,0,1,13,14,7.14,Furthest
1588,August,2017,Kitsap,WA,Passenger,637,336,973,173831,174804,0.56,Washington
1589,August,2017,Twin Falls,ID,Passenger,0,1,1,22,23,4.35,Nearest
1590,August,2017,Walla Walla,WA,Truck,0,0,0,13188,13188,0.0,Washington
1591,August,2017,Saratoga,NY,Passenger,1,1,2,72,74,2.7,Furthest
1592,August,2017,Manatee,FL,Passenger,1,0,1,42,43,2.33,Furthest
1593,August,2017,Jefferson,NY,Passenger,1,0,1,245,246,0.41,Furthest
1594,August,2017,Lane,OR,Passenger,0,1,1,223,224,0.45,Nearest
1595,August,2017,Sacramento,CA,Passenger,1,0,1,345,346,0.29,Nearest
1596,August,2017,Lewis,WA,Truck,0,0,0,25013,25013,0.0,Washington
1597,August,2017,Palm Beach,FL,Passenger,0,1,1,98,99,1.01,Furthest
1598,August,2017,Los Angeles,CA,Passenger,3,2,5,1251,1256,0.4,Nearest
1599,August,2017,Franklin,WA,Truck,0,0,0,18234,18234,0.0,Washington
1600,August,2017,Ferry,WA,Truck,0,0,0,3532,3532,0.0,Washington
1601,August,2017,Asotin,WA,Truck,0,0,0,6515,6515,0.0,Washington
1602,August,2017,Lee,AL,Passenger,1,0,1,36,37,2.7,Furthest
1603,August,2017,Santa Clara,CA,Passenger,5,2,7,393,400,1.75,Nearest
1604,August,2017,Fairfax,VA,Passenger,2,2,4,841,845,0.47,Furthest
1605,August,2017,Grays Harbor,WA,Passenger,37,37,74,44965,45039,0.16,Washington
1606,August,2017,Snohomish,WA,Passenger,1847,942,2789,513730,516519,0.54,Washington
1607,August,2017,Wahkiakum,WA,Passenger,0,2,2,2834,2836,0.07,Washington
1608,August,2017,Missoula,MT,Passenger,1,0,1,70,71,1.41,Nearest
1609,August,2017,Skamania,WA,Passenger,10,7,17,8571,8588,0.2,Washington
1610,August,2017,Gwinnett,GA,Passenger,0,1,1,84,85,1.18,Furthest
1611,August,2017,Garfield,WA,Truck,0,0,0,932,932,0.0,Washington
1612,August,2017,Orange,FL,Passenger,1,1,2,144,146,1.37,Furthest
1613,August,2017,Columbia,WA,Truck,0,0,0,1541,1541,0.0,Washington
1614,August,2017,Kittitas,WA,Passenger,27,21,48,27891,27939,0.17,Washington
1615,August,2017,Pinal,AZ,Passenger,2,0,2,227,229,0.87,Nearest
1616,August,2017,Albemarle,VA,Passenger,0,1,1,32,33,3.03,Furthest
1617,August,2017,Ferry,WA,Passenger,1,1,2,4396,4398,0.05,Washington
1618,August,2017,Howard,MD,Passenger,0,2,2,89,91,2.2,Furthest
1619,August,2017,Chelan,WA,Passenger,72,36,108,52309,52417,0.21,Washington
1620,August,2017,Duval,FL,Passenger,1,1,2,377,379,0.53,Furthest
1621,August,2017,Virginia Beach,VA,Passenger,2,1,3,646,649,0.46,Furthest
1622,August,2017,Sedgwick,KS,Passenger,0,1,1,104,105,0.95,Mid-Distance
1623,August,2017,Pierce,WA,Truck,0,0,0,137231,137231,0.0,Washington
1624,August,2017,Clark,WA,Passenger,794,528,1322,300774,302096,0.44,Washington
1625,August,2017,DeKalb,GA,Passenger,1,0,1,86,87,1.15,Furthest
1626,August,2017,Skamania,WA,Truck,0,0,0,3876,3876,0.0,Washington
1627,August,2017,Whitman,WA,Truck,0,0,0,8451,8451,0.0,Washington
1628,August,2017,Hamilton,TN,Passenger,1,0,1,20,21,4.76,Furthest
1630,August,2017,Fulton,GA,Passenger,1,0,1,109,110,0.91,Furthest
1631,August,2017,Arlington,VA,Passenger,1,2,3,166,169,1.78,Furthest
1632,August,2017,Jefferson,WA,Passenger,112,64,176,23954,24130,0.73,Washington
1633,August,2017,Pend Oreille,WA,Passenger,3,4,7,9358,9365,0.07,Washington
1634,August,2017,Franklin,WA,Passenger,27,48,75,55929,56004,0.13,Washington
1635,August,2017,Tarrant,TX,Passenger,1,0,1,233,234,0.43,Mid-Distance
1636,August,2017,Montgomery,PA,Passenger,1,0,1,40,41,2.44,Furthest
1637,August,2017,Ramsey,MN,Passenger,1,0,1,39,40,2.5,Mid-Distance
1638,August,2017,Chelan,WA,Truck,0,0,0,21363,21363,0.0,Washington
1639,August,2017,Alameda,CA,Passenger,0,1,1,358,359,0.28,Nearest
1640,August,2017,Kitsap,WA,Truck,1,0,1,52562,52563,0.0,Washington
1641,August,2017,Travis,TX,Passenger,0,1,1,194,195,0.51,Mid-Distance
1642,August,2017,Riverside,CA,Passenger,1,2,3,769,772,0.39,Nearest
1643,August,2017,Montgomery,TX,Passenger,1,0,1,60,61,1.64,Mid-Distance
1644,August,2017,Utah,UT,Passenger,0,1,1,147,148,0.68,Nearest
1645,August,2017,Grant,WA,Truck,0,0,0,25352,25352,0.0,Washington
1646,August,2017,Adams,WA,Passenger,3,3,6,12183,12189,0.05,Washington
1647,August,2017,Tulare,CA,Passenger,1,0,1,197,198,0.51,Nearest
1648,August,2017,El Paso,CO,Passenger,2,0,2,777,779,0.26,Mid-Distance
1649,August,2017,Stevens,WA,Passenger,8,22,30,31514,31544,0.1,Washington
1650,August,2017,Cape May,NJ,Passenger,0,1,1,18,19,5.26,Furthest
1651,August,2017,DeKalb,IN,Passenger,1,0,1,1,2,50.0,Furthest
1652,August,2017,Kent,MI,Passenger,0,1,1,38,39,2.56,Furthest
1653,August,2017,Hardin,KY,Passenger,0,1,1,122,123,0.81,Furthest
1654,August,2017,Shelby,TN,Passenger,0,1,1,103,104,0.96,Furthest
1655,August,2017,Lewis,WA,Passenger,55,38,93,55794,55887,0.17,Washington
1656,August,2017,Clark,WA,Truck,0,0,0,77898,77898,0.0,Washington
1657,August,2017,Pacific,WA,Passenger,10,9,19,15248,15267,0.12,Washington
1658,August,2017,Klickitat,WA,Truck,0,0,0,7970,7970,0.0,Washington
1659,August,2017,St. Clair,IL,Passenger,0,1,1,168,169,0.59,Mid-Distance
1660,August,2017,Montgomery,TN,Passenger,1,0,1,281,282,0.35,Furthest
1661,August,2017,Morris,NJ,Passenger,1,0,1,23,24,4.17,Furthest
1662,August,2017,Dakota,MN,Passenger,0,2,2,36,38,5.26,Mid-Distance
1663,August,2017,Cowlitz,WA,Truck,0,0,0,27992,27992,0.0,Washington
1664,August,2017,Pacific,WA,Truck,0,0,0,7515,7515,0.0,Washington
1665,August,2017,Madison,ID,Passenger,1,0,1,37,38,2.63,Nearest
1666,August,2017,Benton,WA,Truck,0,0,0,40164,40164,0.0,Washington
1667,August,2017,Whatcom,WA,Passenger,481,182,663,143561,144224,0.46,Washington
1668,August,2017,Wayne,MI,Passenger,0,1,1,67,68,1.47,Furthest
1669,August,2017,Prince William,VA,Passenger,0,3,3,267,270,1.11,Furthest
1670,August,2017,Moore,NC,Passenger,0,1,1,200,201,0.5,Furthest
1671,August,2017,Yakima,WA,Passenger,54,67,121,160149,160270,0.08,Washington
1672,August,2017,Frederick,MD,Passenger,0,1,1,83,84,1.19,Furthest
1673,August,2017,San Juan,WA,Passenger,113,39,152,13645,13797,1.1,Washington
1674,August,2017,Snohomish,WA,Truck,1,0,1,121668,121669,0.0,Washington
1675,August,2017,Northampton,PA,Passenger,0,1,1,97,98,1.02,Furthest
1676,August,2017,Nueces,TX,Passenger,0,1,1,94,95,1.05,Mid-Distance
1677,August,2017,Santa Fe,NM,Passenger,0,1,1,43,44,2.27,Mid-Distance
1678,August,2017,Juneau,AK,Passenger,0,1,1,43,44,2.27,Nearest
1679,August,2017,Wahkiakum,WA,Truck,0,0,0,1655,1655,0.0,Washington
1680,August,2017,Garfield,WA,Passenger,1,0,1,1302,1303,0.08,Washington
1681,August,2017,Montgomery,MD,Passenger,1,0,1,307,308,0.32,Furthest
1682,August,2017,Monterey,CA,Passenger,0,2,2,195,197,1.02,Nearest
1683,August,2017,Canyon,ID,Passenger,0,1,1,97,98,1.02,Nearest
1684,August,2017,Polk,FL,Passenger,1,0,1,64,65,1.54,Furthest
1685,August,2017,Thurston,WA,Passenger,421,359,780,187775,188555,0.41,Washington
1686,August,2017,Flathead,MT,Passenger,1,0,1,59,60,1.67,Nearest
1687,August,2017,Portsmouth,VA,Passenger,0,1,1,65,66,1.52,Furthest
1688,August,2017,Stevens,WA,Truck,0,0,0,18218,18218,0.0,Washington
1689,August,2017,Charles,MD,Passenger,0,1,1,85,86,1.16,Furthest
1690,August,2017,Dale,AL,Passenger,0,1,1,63,64,1.56,Furthest
1691,August,2017,New Haven,CT,Passenger,0,1,1,57,58,1.72,Furthest
1692,August,2017,Walla Walla,WA,Passenger,27,27,54,34981,35035,0.15,Washington
1693,August,2017,Jefferson,WA,Truck,0,0,0,9427,9427,0.0,Washington
1694,August,2017,Kittitas,WA,Truck,0,0,0,13610,13610,0.0,Washington
1695,August,2017,Pierce,WA,Passenger,999,866,1865,524926,526791,0.35,Washington
1696,August,2017,Spokane,WA,Passenger,268,220,488,297411,297899,0.16,Washington
1697,August,2017,Skagit,WA,Passenger,140,112,252,88466,88718,0.28,Washington
1698,August,2017,Carroll,NH,Passenger,0,1,1,1,2,50.0,Furthest
1699,August,2017,Norfolk,VA,Passenger,1,1,2,313,315,0.63,Furthest
1700,August,2017,Maui,HI,Passenger,1,0,1,69,70,1.43,Nearest
1701,August,2017,Benton,WA,Passenger,161,147,308,129043,129351,0.24,Washington
1702,August,2017,Adams,WA,Truck,0,0,0,5097,5097,0.0,Washington
1703,August,2017,Orange,CA,Passenger,3,1,4,611,615,0.65,Nearest
1704,August,2017,Okaloosa,FL,Passenger,1,0,1,184,185,0.54,Furthest
1705,August,2017,Clark,NV,Passenger,1,2,3,795,798,0.38,Nearest
1706,August,2017,King,WA,Truck,7,1,8,186770,186778,0.0,Washington
1707,August,2017,District of Columbia,DC,Passenger,0,2,2,206,208,0.96,Furthest
1708,August,2017,Pend Oreille,WA,Truck,0,0,0,5552,5552,0.0,Washington
1709,August,2017,Pima,AZ,Passenger,1,2,3,418,421,0.71,Nearest
1710,August,2017,Douglas,WA,Truck,0,0,0,11570,11570,0.0,Washington
1711,August,2017,Clallam,WA,Passenger,96,79,175,48546,48721,0.36,Washington
1712,August,2017,Sangamon,IL,Passenger,1,0,1,11,12,8.33,Mid-Distance
1713,August,2017,Nantucket,MA,Passenger,1,0,1,3,4,25.0,Furthest
1714,August,2017,Latah,ID,Passenger,0,1,1,92,93,1.08,Nearest
1715,August,2017,Whatcom,WA,Truck,2,0,2,41764,41766,0.0,Washington
1716,August,2017,Spokane,WA,Truck,1,0,1,90996,90997,0.0,Washington
1717,August,2017,Okanogan,WA,Passenger,4,18,22,25673,25695,0.09,Washington
1718,August,2017,Lincoln,WA,Truck,0,0,0,4457,4457,0.0,Washington
1719,August,2017,New London,CT,Passenger,1,1,2,255,257,0.78,Furthest
1720,August,2017,Okanogan,WA,Truck,0,0,0,16242,16242,0.0,Washington
1721,August,2017,Santa Rosa,FL,Passenger,1,0,1,110,111,0.9,Furthest
1722,August,2017,Grant,WA,Passenger,19,32,51,61193,61244,0.08,Washington
1723,August,2017,Multnomah,OR,Passenger,1,3,4,937,941,0.43,Nearest
1724,August,2017,Allegheny,PA,Passenger,1,0,1,89,90,1.11,Furthest
1725,August,2017,Douglas,WA,Passenger,35,27,62,26835,26897,0.23,Washington
1726,August,2017,Cowlitz,WA,Passenger,50,62,112,70013,70125,0.16,Washington
1727,August,2017,San Mateo,CA,Passenger,0,1,1,150,151,0.66,Nearest
1728,August,2017,Anne Arundel,MD,Passenger,0,1,1,496,497,0.2,Furthest
1729,August,2017,Jackson,MO,Passenger,1,0,1,57,58,1.72,Furthest
1730,August,2017,Grays Harbor,WA,Truck,0,0,0,19935,19935,0.0,Washington
1731,August,2017,San Juan,WA,Truck,0,0,0,5549,5549,0.0,Washington
1732,August,2017,King,WA,Passenger,10441,4267,14708,1372396,1387104,1.06,Washington
1733,August,2017,Manassas,VA,Passenger,0,1,1,9,10,10.0,Furthest
1734,August,2017,Maricopa,AZ,Passenger,2,0,2,1690,1692,0.12,Nearest
1735,August,2017,Deschutes,OR,Passenger,1,0,1,194,195,0.51,Nearest
1736,August,2017,Norfolk,MA,Passenger,1,0,1,38,39,2.56,Furthest
1737,August,2017,Marin,CA,Passenger,1,0,1,58,59,1.69,Nearest
1738,August,2017,Franklin,MA,Passenger,0,1,1,4,5,20.0,Furthest
1739,August,2017,Island,WA,Passenger,124,149,273,60582,60855,0.45,Washington
1740,August,2017,Richmond,GA,Passenger,0,1,1,88,89,1.12,Furthest
1741,August,2017,Mason,WA,Truck,0,0,0,19333,19333,0.0,Washington
1742,August,2017,Mason,WA,Passenger,59,73,132,43923,44055,0.3,Washington
1743,August,2017,Dallas,TX,Passenger,0,1,1,181,182,0.55,Mid-Distance
1744,August,2017,Prince George's,MD,Passenger,0,1,1,187,188,0.53,Furthest
1745,August,2017,Columbia,WA,Passenger,1,1,2,2352,2354,0.08,Washington
1746,August,2017,Nassau,NY,Passenger,1,1,2,39,41,4.88,Furthest
1747,August,2017,St. Lucie,FL,Passenger,1,0,1,28,29,3.45,Furthest
1748,August,2017,Orleans,LA,Passenger,0,1,1,44,45,2.22,Mid-Distance
1749,August,2017,Richland,SC,Passenger,0,1,1,188,189,0.53,Furthest
1750,August,2017,Bexar,TX,Passenger,1,1,2,852,854,0.23,Mid-Distance
1751,August,2017,Cobb,GA,Passenger,0,1,1,73,74,1.35,Furthest
1752,August,2017,Volusia,FL,Passenger,0,1,1,46,47,2.13,Furthest
1753,August,2017,Franklin,OH,Passenger,0,1,1,115,116,0.86,Furthest
1754,August,2017,Island,WA,Truck,0,0,0,20519,20519,0.0,Washington
1755,August,2017,Clallam,WA,Truck,0,0,0,21059,21059,0.0,Washington
1756,August,2017,Yakima,WA,Truck,0,0,0,57643,57643,0.0,Washington
1757,August,2017,Sumter,FL,Passenger,0,1,1,10,11,9.09,Furthest
1758,August,2017,Skagit,WA,Truck,1,0,1,31515,31516,0.0,Washington
1759,August,2017,Hamilton,IN,Passenger,1,0,1,58,59,1.69,Furthest
1760,August,2017,Klickitat,WA,Passenger,21,24,45,14782,14827,0.3,Washington
1761,August,2017,San Diego,CA,Passenger,6,1,7,2660,2667,0.26,Nearest
1762,August,2017,Lumpkin,GA,Passenger,1,0,1,9,10,10.0,Furthest
1763,August,2017,Whitman,WA,Passenger,11,22,33,22128,22161,0.15,Washington
1764,August,2017,Bergen,NJ,Passenger,0,2,2,30,32,6.25,Furthest
1765,August,2017,Honolulu,HI,Passenger,3,2,5,561,566,0.88,Nearest
1766,August,2018,Garfield,WA,Passenger,1,1,2,1318,1320,0.15,Washington
1767,August,2018,Whatcom,WA,Passenger,653,321,974,148265,149239,0.65,Washington
1768,August,2018,Marion,OR,Passenger,1,0,1,122,123,0.81,Nearest
1769,August,2018,Bexar,TX,Passenger,3,4,7,737,744,0.94,Mid-Distance
1770,August,2018,Douglas,NE,Passenger,0,1,1,70,71,1.41,Mid-Distance
1771,August,2018,Maui,HI,Passenger,1,0,1,55,56,1.79,Nearest
1772,August,2018,Snohomish,WA,Passenger,2471,1311,3782,523635,527417,0.72,Washington
1773,August,2018,Jefferson,WA,Truck,0,0,0,9623,9623,0.0,Washington
1774,August,2018,El Paso,TX,Passenger,1,0,1,507,508,0.2,Mid-Distance
1775,August,2018,Los Angeles,CA,Passenger,7,4,11,1136,1147,0.96,Nearest
1776,August,2018,Douglas,WA,Passenger,45,31,76,27791,27867,0.27,Washington
1777,August,2018,Prince George's,MD,Passenger,1,1,2,181,183,1.09,Furthest
1778,August,2018,DeKalb,GA,Passenger,1,0,1,79,80,1.25,Furthest
1779,August,2018,Virginia Beach,VA,Passenger,2,1,3,697,700,0.43,Furthest
1780,August,2018,St. Lucie,FL,Passenger,1,0,1,30,31,3.23,Furthest
1781,August,2018,Fulton,GA,Passenger,1,2,3,106,109,2.75,Furthest
1782,August,2018,Carson City,NV,Passenger,1,0,1,14,15,6.67,Nearest
1783,August,2018,Travis,TX,Passenger,0,1,1,195,196,0.51,Mid-Distance
1784,August,2018,Whitman,WA,Passenger,20,30,50,22680,22730,0.22,Washington
1785,August,2018,Moore,NC,Passenger,0,1,1,198,199,0.5,Furthest
1786,August,2018,DuPage,IL,Passenger,1,0,1,56,57,1.75,Mid-Distance
1788,August,2018,Benton,WA,Truck,0,0,0,41231,41231,0.0,Washington
1789,August,2018,Madison,ID,Passenger,1,0,1,36,37,2.7,Nearest
1790,August,2018,Whitman,WA,Truck,0,0,0,8505,8505,0.0,Washington
1791,August,2018,Stevens,WA,Truck,0,0,0,18676,18676,0.0,Washington
1792,August,2018,Ferry,WA,Passenger,2,2,4,4420,4424,0.09,Washington
1793,August,2018,Essex,NJ,Passenger,1,0,1,11,12,8.33,Furthest
1794,August,2018,Columbia,WA,Truck,0,0,0,1535,1535,0.0,Washington
1795,August,2018,Wahkiakum,WA,Passenger,1,1,2,2961,2963,0.07,Washington
1796,August,2018,Garfield,WA,Truck,0,0,0,956,956,0.0,Washington
1797,August,2018,Cape May,NJ,Passenger,0,1,1,22,23,4.35,Furthest
1798,August,2018,Okanogan,WA,Passenger,10,20,30,26065,26095,0.11,Washington
1799,August,2018,Clallam,WA,Passenger,128,115,243,50115,50358,0.48,Washington
1800,August,2018,Monroe,IL,Passenger,1,0,1,5,6,16.67,Mid-Distance
1801,August,2018,Allegheny,PA,Passenger,1,0,1,78,79,1.27,Furthest
1802,August,2018,Pacific,WA,Passenger,19,22,41,15677,15718,0.26,Washington
1803,August,2018,Carroll,NH,Passenger,0,1,1,1,2,50.0,Furthest
1804,August,2018,Hawaii,HI,Passenger,1,0,1,71,72,1.39,Nearest
1805,August,2018,Lewis,WA,Truck,0,0,0,25605,25605,0.0,Washington
1806,August,2018,Franklin,WA,Truck,0,0,0,18794,18794,0.0,Washington
1807,August,2018,Cumberland,NC,Passenger,0,1,1,534,535,0.19,Furthest
1808,August,2018,Clay,FL,Passenger,0,1,1,93,94,1.06,Furthest
1809,August,2018,Juneau,AK,Passenger,0,1,1,44,45,2.22,Nearest
1810,August,2018,Yakima,WA,Truck,0,0,0,58619,58619,0.0,Washington
1811,August,2018,Washington,OR,Passenger,0,1,1,472,473,0.21,Nearest
1812,August,2018,Kent,MI,Passenger,0,1,1,27,28,3.57,Furthest
1813,August,2018,Norfolk,VA,Passenger,2,2,4,334,338,1.18,Furthest
1814,August,2018,San Juan,PR,Passenger,0,1,1,4,5,20.0,Mid-Distance
1815,August,2018,Williamson,TX,Passenger,0,1,1,162,163,0.61,Mid-Distance
1816,August,2018,Ramsey,MN,Passenger,1,0,1,40,41,2.44,Mid-Distance
1817,August,2018,Kitsap,WA,Truck,1,0,1,53439,53440,0.0,Washington
1818,August,2018,Kittitas,WA,Truck,0,0,0,14113,14113,0.0,Washington
1819,August,2018,Dallas,TX,Passenger,0,1,1,196,197,0.51,Mid-Distance
1820,August,2018,Lee,FL,Passenger,1,0,1,58,59,1.69,Furthest
1821,August,2018,Cowlitz,WA,Passenger,62,81,143,71989,72132,0.2,Washington
1822,August,2018,Clackamas,OR,Passenger,0,1,1,219,220,0.45,Nearest
1823,August,2018,Clark,WA,Truck,0,0,0,79303,79303,0.0,Washington
1824,August,2018,Cochise,AZ,Passenger,0,1,1,117,118,0.85,Nearest
1825,August,2018,Manassas,VA,Passenger,0,1,1,9,10,10.0,Furthest
1826,August,2018,Skagit,WA,Truck,1,0,1,32229,32230,0.0,Washington
1827,August,2018,Suffolk,MA,Passenger,0,1,1,42,43,2.33,Furthest
1828,August,2018,Sangamon,IL,Passenger,1,0,1,11,12,8.33,Mid-Distance
1829,August,2018,Collin,TX,Passenger,1,0,1,149,150,0.67,Mid-Distance
1830,August,2018,Orange,CA,Passenger,4,1,5,553,558,0.9,Nearest
1831,August,2018,Spokane,WA,Passenger,360,336,696,304743,305439,0.23,Washington
1832,August,2018,Duval,FL,Passenger,1,2,3,380,383,0.78,Furthest
1833,August,2018,Walla Walla,WA,Truck,0,0,0,13497,13497,0.0,Washington
1834,August,2018,Tarrant,TX,Passenger,1,0,1,213,214,0.47,Mid-Distance
1835,August,2018,Lane,OR,Passenger,0,1,1,181,182,0.55,Nearest
1836,August,2018,San Mateo,CA,Passenger,1,1,2,133,135,1.48,Nearest
1837,August,2018,Portsmouth,VA,Passenger,0,1,1,75,76,1.32,Furthest
1838,August,2018,Riverside,CA,Passenger,2,2,4,692,696,0.57,Nearest
1839,August,2018,Larimer,CO,Passenger,1,0,1,63,64,1.56,Mid-Distance
1840,August,2018,Pierce,WA,Truck,0,0,0,138304,138304,0.0,Washington
1841,August,2018,Jefferson,NY,Passenger,0,1,1,225,226,0.44,Furthest
1842,August,2018,Prince George,VA,Passenger,0,1,1,78,79,1.27,Furthest
1843,August,2018,King,WA,Passenger,13801,5938,19739,1373749,1393488,1.42,Washington
1844,August,2018,Richmond,GA,Passenger,0,1,1,92,93,1.08,Furthest
1845,August,2018,Wahkiakum,WA,Truck,0,0,0,1691,1691,0.0,Washington
1846,August,2018,Kitsap,WA,Passenger,828,488,1316,179328,180644,0.73,Washington
1847,August,2018,Cowlitz,WA,Truck,0,0,0,28606,28606,0.0,Washington
1848,August,2018,Jefferson,WA,Passenger,152,101,253,24679,24932,1.01,Washington
1849,August,2018,Arlington,VA,Passenger,1,1,2,173,175,1.14,Furthest
1850,August,2018,New Haven,CT,Passenger,0,1,1,48,49,2.04,Furthest
1851,August,2018,Klamath,OR,Passenger,1,0,1,35,36,2.78,Nearest
1852,August,2018,Manatee,FL,Passenger,1,0,1,37,38,2.63,Furthest
1853,August,2018,Santa Rosa,FL,Passenger,1,0,1,92,93,1.08,Furthest
1854,August,2018,Clark,NV,Passenger,1,2,3,734,737,0.41,Nearest
1855,August,2018,San Juan,WA,Truck,0,0,0,5755,5755,0.0,Washington
1856,August,2018,Palm Beach,FL,Passenger,0,1,1,86,87,1.15,Furthest
1857,August,2018,Clark,WA,Passenger,1069,765,1834,309220,311054,0.59,Washington
1858,August,2018,Pacific,WA,Truck,0,0,0,7624,7624,0.0,Washington
1859,August,2018,Washoe,NV,Passenger,1,0,1,113,114,0.88,Nearest
1860,August,2018,Whatcom,WA,Truck,2,0,2,42393,42395,0.0,Washington
1861,August,2018,Ventura,CA,Passenger,0,2,2,315,317,0.63,Nearest
1862,August,2018,Prince William,VA,Passenger,0,4,4,260,264,1.52,Furthest
1863,August,2018,St. Mary's,MD,Passenger,1,0,1,218,219,0.46,Furthest
1864,August,2018,DeKalb,IN,Passenger,1,0,1,1,2,50.0,Furthest
1865,August,2018,Pierce,WA,Passenger,1303,1224,2527,534848,537375,0.47,Washington
1866,August,2018,Hennepin,MN,Passenger,1,0,1,110,111,0.9,Mid-Distance
1867,August,2018,Twin Falls,ID,Passenger,0,1,1,23,24,4.17,Nearest
1868,August,2018,Richland,SC,Passenger,0,1,1,171,172,0.58,Furthest
1869,August,2018,Thurston,WA,Passenger,603,517,1120,194254,195374,0.57,Washington
1870,August,2018,Thurston,WA,Truck,0,0,0,54562,54562,0.0,Washington
1871,August,2018,Orange,FL,Passenger,2,1,3,167,170,1.76,Furthest
1872,August,2018,Gwinnett,GA,Passenger,0,1,1,82,83,1.2,Furthest
1873,August,2018,Caddo,LA,Passenger,0,1,1,23,24,4.17,Mid-Distance
1874,August,2018,Columbia,WA,Passenger,2,2,4,2415,2419,0.17,Washington
1875,August,2018,Maricopa,AZ,Passenger,2,1,3,1562,1565,0.19,Nearest
1876,August,2018,Honolulu,HI,Passenger,1,2,3,526,529,0.57,Nearest
1877,August,2018,Mason,WA,Truck,0,0,0,20084,20084,0.0,Washington
1878,August,2018,New London,CT,Passenger,0,1,1,254,255,0.39,Furthest
1879,August,2018,Middlesex,MA,Passenger,0,1,1,139,140,0.71,Furthest
1880,August,2018,Grant,WA,Truck,0,0,0,26008,26008,0.0,Washington
1881,August,2018,Lincoln,WA,Passenger,3,6,9,7748,7757,0.12,Washington
1882,August,2018,Chelan,WA,Passenger,114,55,169,53723,53892,0.31,Washington
1883,August,2018,Pend Oreille,WA,Truck,0,0,0,5718,5718,0.0,Washington
1884,August,2018,District of Columbia,DC,Passenger,0,3,3,192,195,1.54,Furthest
1885,August,2018,Benton,WA,Passenger,189,198,387,132209,132596,0.29,Washington
1886,August,2018,Washtenaw,MI,Passenger,1,0,1,38,39,2.56,Furthest
1887,August,2018,Island,WA,Passenger,216,204,420,62724,63144,0.67,Washington
1888,August,2018,Latah,ID,Passenger,0,1,1,75,76,1.32,Nearest
1889,August,2018,Asotin,WA,Truck,0,0,0,6649,6649,0.0,Washington
1890,August,2018,Tulsa,OK,Passenger,1,1,2,47,49,4.08,Mid-Distance
1891,August,2018,Howard,MD,Passenger,0,1,1,86,87,1.15,Furthest
1892,August,2018,Adams,WA,Passenger,5,5,10,12682,12692,0.08,Washington
1893,August,2018,Marion,IN,Passenger,1,0,1,119,120,0.83,Furthest
1894,August,2018,Dakota,MN,Passenger,0,2,2,35,37,5.41,Mid-Distance
1895,August,2018,Camden,NJ,Passenger,0,1,1,32,33,3.03,Furthest
1896,August,2018,Ada,ID,Passenger,0,2,2,314,316,0.63,Nearest
1897,August,2018,Asotin,WA,Passenger,11,8,19,12663,12682,0.15,Washington
1898,August,2018,Klickitat,WA,Passenger,24,32,56,15283,15339,0.37,Washington
1899,August,2018,Skagit,WA,Passenger,220,169,389,90837,91226,0.43,Washington
1900,August,2018,Fairfax,VA,Passenger,2,2,4,814,818,0.49,Furthest
1901,August,2018,Houston,GA,Passenger,1,0,1,54,55,1.82,Furthest
1902,August,2018,Lee,AL,Passenger,1,0,1,37,38,2.63,Furthest
1903,August,2018,Skamania,WA,Truck,0,0,0,3948,3948,0.0,Washington
1904,August,2018,Sumter,FL,Passenger,0,1,1,10,11,9.09,Furthest
1905,August,2018,Skamania,WA,Passenger,14,10,24,8670,8694,0.28,Washington
1906,August,2018,Grays Harbor,WA,Passenger,54,65,119,46989,47108,0.25,Washington
1907,August,2018,St. Clair,IL,Passenger,0,1,1,156,157,0.64,Mid-Distance
1908,August,2018,Snohomish,WA,Truck,1,0,1,121713,121714,0.0,Washington
1909,August,2018,Fresno,CA,Passenger,1,0,1,195,196,0.51,Nearest
1910,August,2018,Douglas,WA,Truck,0,0,0,12028,12028,0.0,Washington
1911,August,2018,Polk,FL,Passenger,1,0,1,64,65,1.54,Furthest
1912,August,2018,Volusia,FL,Passenger,0,1,1,34,35,2.86,Furthest
1913,August,2018,Yakima,WA,Passenger,67,92,159,164210,164369,0.1,Washington
1914,August,2018,Chelan,WA,Truck,0,0,0,21983,21983,0.0,Washington
1915,August,2018,Hamilton,IN,Passenger,1,0,1,46,47,2.13,Furthest
1916,August,2018,Cook,IL,Passenger,1,0,1,252,253,0.4,Mid-Distance
1917,August,2018,Grant,WA,Passenger,34,49,83,63544,63627,0.13,Washington
1918,August,2018,Pend Oreille,WA,Passenger,5,5,10,9583,9593,0.1,Washington
1919,August,2018,Charles,MD,Passenger,0,1,1,82,83,1.2,Furthest
1920,August,2018,San Diego,CA,Passenger,7,2,9,2568,2577,0.35,Nearest
1921,August,2018,Tuolumne,CA,Passenger,0,1,1,12,13,7.69,Nearest
1922,August,2018,Utah,UT,Passenger,0,1,1,137,138,0.72,Nearest
1923,August,2018,Franklin,MA,Passenger,0,1,1,1,2,50.0,Furthest
1924,August,2018,Nueces,TX,Passenger,1,1,2,88,90,2.22,Mid-Distance
1925,August,2018,Sedgwick,KS,Passenger,0,1,1,100,101,0.99,Mid-Distance
1926,August,2018,Adams,WA,Truck,0,0,0,5174,5174,0.0,Washington
1927,August,2018,Dale,AL,Passenger,0,1,1,57,58,1.72,Furthest
1928,August,2018,Mason,WA,Passenger,92,97,189,46050,46239,0.41,Washington
1929,August,2018,Lumpkin,GA,Passenger,1,0,1,7,8,12.5,Furthest
1930,August,2018,Multnomah,OR,Passenger,3,5,8,777,785,1.02,Nearest
1931,August,2018,Klickitat,WA,Truck,0,0,0,8158,8158,0.0,Washington
1932,August,2018,Okanogan,WA,Truck,0,0,0,16469,16469,0.0,Washington
1933,August,2018,Frederick,MD,Passenger,0,1,1,85,86,1.16,Furthest
1934,August,2018,Pinal,AZ,Passenger,2,0,2,203,205,0.98,Nearest
1935,August,2018,Franklin,WA,Passenger,36,65,101,58372,58473,0.17,Washington
1936,August,2018,Charleston,SC,Passenger,1,0,1,128,129,0.78,Furthest
1937,August,2018,Queens,NY,Passenger,1,0,1,61,62,1.61,Furthest
1938,August,2018,Norfolk,MA,Passenger,1,0,1,36,37,2.7,Furthest
1939,August,2018,Kittitas,WA,Passenger,51,34,85,29121,29206,0.29,Washington
1940,August,2018,Santa Fe,NM,Passenger,0,1,1,45,46,2.17,Mid-Distance
1941,August,2018,Lincoln,WA,Truck,0,0,0,4572,4572,0.0,Washington
1942,August,2018,Alameda,CA,Passenger,0,1,1,340,341,0.29,Nearest
1943,August,2018,Ferry,WA,Truck,0,0,0,3550,3550,0.0,Washington
1944,August,2018,Nantucket,MA,Passenger,1,0,1,4,5,20.0,Furthest
1945,August,2018,El Paso,CO,Passenger,3,1,4,756,760,0.53,Mid-Distance
1946,August,2018,Anne Arundel,MD,Passenger,0,1,1,452,453,0.22,Furthest
1947,August,2018,Hardin,KY,Passenger,0,1,1,120,121,0.83,Furthest
1948,August,2018,Lewis,WA,Passenger,83,62,145,57867,58012,0.25,Washington
1949,August,2018,Montgomery,PA,Passenger,2,0,2,36,38,5.26,Furthest
1950,August,2018,Deschutes,OR,Passenger,2,0,2,163,165,1.21,Nearest
1951,August,2018,Brevard,FL,Passenger,0,1,1,92,93,1.08,Furthest
1952,August,2018,Monterey,CA,Passenger,0,1,1,186,187,0.53,Nearest
1953,August,2018,Clallam,WA,Truck,0,0,0,21476,21476,0.0,Washington
1954,August,2018,Garfield,OK,Passenger,1,0,1,16,17,5.88,Mid-Distance
1955,August,2018,Montgomery,TX,Passenger,2,0,2,61,63,3.17,Mid-Distance
1956,August,2018,Pima,AZ,Passenger,1,1,2,413,415,0.48,Nearest
1957,August,2018,Broward,FL,Passenger,1,1,2,134,136,1.47,Furthest
1958,August,2018,Contra Costa,CA,Passenger,0,1,1,440,441,0.23,Nearest
1959,August,2018,Island,WA,Truck,0,0,0,21052,21052,0.0,Washington
1960,August,2018,Jefferson,CO,Passenger,0,1,1,65,66,1.52,Mid-Distance
1961,August,2018,Morris,NJ,Passenger,1,0,1,16,17,5.88,Furthest
1962,August,2018,Flathead,MT,Passenger,1,0,1,53,54,1.85,Nearest
1963,August,2018,Stevens,WA,Passenger,12,26,38,31687,31725,0.12,Washington
1964,August,2018,San Juan,WA,Passenger,152,66,218,14152,14370,1.52,Washington
1965,August,2018,Nassau,NY,Passenger,2,0,2,36,38,5.26,Furthest
1966,August,2018,Shelby,TN,Passenger,0,1,1,101,102,0.98,Furthest
1967,August,2018,King,WA,Truck,7,1,8,182994,183002,0.0,Washington
1968,August,2018,San Francisco,CA,Passenger,1,1,2,121,123,1.63,Nearest
1969,August,2018,Montgomery,MD,Passenger,1,0,1,283,284,0.35,Furthest
1970,August,2018,Kootenai,ID,Passenger,0,1,1,220,221,0.45,Nearest
1971,August,2018,Saratoga,NY,Passenger,1,0,1,63,64,1.56,Furthest
1972,August,2018,Grays Harbor,WA,Truck,0,0,0,20309,20309,0.0,Washington
1973,August,2018,Santa Clara,CA,Passenger,8,0,8,376,384,2.08,Nearest
1974,August,2018,Spokane,WA,Truck,1,0,1,93029,93030,0.0,Washington
1975,August,2018,Beaufort,SC,Passenger,1,0,1,38,39,2.56,Furthest
1976,August,2018,Walla Walla,WA,Passenger,34,48,82,35872,35954,0.23,Washington
1977,August,2019,Grays Harbor,WA,Truck,0,0,0,20570,20570,0.0,Washington
1978,August,2019,Mason,WA,Passenger,130,127,257,47429,47686,0.54,Washington
1979,August,2019,Stevens,WA,Passenger,22,29,51,31707,31758,0.16,Washington
1980,August,2019,Lake,FL,Passenger,1,0,1,20,21,4.76,Furthest
1981,August,2019,Fulton,GA,Passenger,0,2,2,102,104,1.92,Furthest
1982,August,2019,Multnomah,OR,Passenger,5,6,11,744,755,1.46,Nearest
1983,August,2019,Portsmouth,VA,Passenger,0,1,1,79,80,1.25,Furthest
1984,August,2019,Carson City,NV,Passenger,1,0,1,11,12,8.33,Nearest
1985,August,2019,Cascade,MT,Passenger,0,1,1,60,61,1.64,Nearest
1986,August,2019,Franklin,WA,Truck,0,0,0,19494,19494,0.0,Washington
1987,August,2019,Brevard,FL,Passenger,0,1,1,84,85,1.18,Furthest
1988,August,2019,Clark,NV,Passenger,4,2,6,691,697,0.86,Nearest
1989,August,2019,Montgomery,PA,Passenger,2,0,2,37,39,5.13,Furthest
1990,August,2019,Norfolk,MA,Passenger,1,0,1,38,39,2.56,Furthest
1991,August,2019,New Haven,CT,Passenger,0,2,2,48,50,4.0,Furthest
1992,August,2019,Randolph,NC,Passenger,1,0,1,6,7,14.29,Furthest
1993,August,2019,Chelan,WA,Passenger,165,70,235,54453,54688,0.43,Washington
1994,August,2019,San Juan,WA,Passenger,225,73,298,14441,14739,2.02,Washington
1995,August,2019,Volusia,FL,Passenger,0,1,1,38,39,2.56,Furthest
1996,August,2019,Williamson,TX,Passenger,0,2,2,145,147,1.36,Mid-Distance
1997,August,2019,Whitman,WA,Truck,0,0,0,8627,8627,0.0,Washington
1998,August,2019,Ferry,WA,Truck,0,0,0,3579,3579,0.0,Washington
1999,August,2019,Monroe,IL,Passenger,1,0,1,5,6,16.67,Mid-Distance
2000,August,2019,Garfield,WA,Passenger,0,1,1,1306,1307,0.08,Washington
2001,August,2019,Whatcom,WA,Passenger,902,450,1352,151212,152564,0.89,Washington
2002,August,2019,Alexandria,VA,Passenger,1,0,1,147,148,0.68,Furthest
2003,August,2019,Collin,TX,Passenger,1,1,2,129,131,1.53,Mid-Distance
2004,August,2019,Adams,WA,Truck,0,0,0,5138,5138,0.0,Washington
2005,August,2019,Powhatan,VA,Passenger,1,0,1,0,1,100.0,Furthest
2006,August,2019,Adams,WA,Passenger,5,5,10,12843,12853,0.08,Washington
2007,August,2019,Solano,CA,Passenger,1,0,1,208,209,0.48,Nearest
2008,August,2019,Fresno,CA,Passenger,1,0,1,193,194,0.52,Nearest
2009,August,2019,Houston,GA,Passenger,1,0,1,55,56,1.79,Furthest
2010,August,2019,Dale,AL,Passenger,0,1,1,56,57,1.75,Furthest
2011,August,2019,Charleston,SC,Passenger,1,0,1,114,115,0.87,Furthest
2012,August,2019,Riverside,CA,Passenger,3,2,5,653,658,0.76,Nearest
2013,August,2019,Charles,MD,Passenger,0,1,1,87,88,1.14,Furthest
2014,August,2019,Pend Oreille,WA,Passenger,5,6,11,9495,9506,0.12,Washington
2015,August,2019,Palm Beach,FL,Passenger,0,1,1,86,87,1.15,Furthest
2016,August,2019,Juneau,AK,Passenger,0,2,2,31,33,6.06,Nearest
2017,August,2019,Thurston,WA,Passenger,927,661,1588,198371,199959,0.79,Washington
2018,August,2019,Cumberland,NC,Passenger,0,2,2,492,494,0.4,Furthest
2019,August,2019,Hawaii,HI,Passenger,1,0,1,57,58,1.72,Nearest
2020,August,2019,Carroll,NH,Passenger,0,1,1,3,4,25.0,Furthest
2021,August,2019,Lincoln,WA,Truck,0,0,0,4683,4683,0.0,Washington
2023,August,2019,Moore,NC,Passenger,0,1,1,182,183,0.55,Furthest
2024,August,2019,San Diego,CA,Passenger,10,3,13,2757,2770,0.47,Nearest
2025,August,2019,Lewis,WA,Truck,0,0,0,25986,25986,0.0,Washington
2026,August,2019,Dakota,MN,Passenger,0,1,1,38,39,2.56,Mid-Distance
2027,August,2019,Spartanburg,SC,Passenger,0,1,1,38,39,2.56,Furthest
2028,August,2019,Jones,GA,Passenger,1,0,1,1,2,50.0,Furthest
2029,August,2019,Pima,AZ,Passenger,1,1,2,389,391,0.51,Nearest
2030,August,2019,Travis,TX,Passenger,2,1,3,200,203,1.48,Mid-Distance
2031,August,2019,Valencia,NM,Passenger,1,0,1,6,7,14.29,Mid-Distance
2032,August,2019,Lee,FL,Passenger,1,0,1,51,52,1.92,Furthest
2033,August,2019,Jefferson,NY,Passenger,0,2,2,214,216,0.93,Furthest
2034,August,2019,Okanogan,WA,Truck,0,0,0,16479,16479,0.0,Washington
2035,August,2019,Asotin,WA,Truck,0,0,0,6684,6684,0.0,Washington
2036,August,2019,Greene,MO,Passenger,0,1,1,33,34,2.94,Furthest
2037,August,2019,Snohomish,WA,Truck,0,0,0,122863,122863,0.0,Washington
2038,August,2019,Bexar,TX,Passenger,2,5,7,650,657,1.07,Mid-Distance
2039,August,2019,Broward,FL,Passenger,2,1,3,128,131,2.29,Furthest
2040,August,2019,Yakima,WA,Truck,0,0,0,59390,59390,0.0,Washington
2041,August,2019,Rogers,OK,Passenger,1,0,1,5,6,16.67,Mid-Distance
2042,August,2019,Benton,WA,Passenger,280,291,571,134343,134914,0.42,Washington
2043,August,2019,Deschutes,OR,Passenger,2,0,2,154,156,1.28,Nearest
2044,August,2019,Pacific,WA,Passenger,23,29,52,16045,16097,0.32,Washington
2045,August,2019,Allegheny,PA,Passenger,1,0,1,79,80,1.25,Furthest
2046,August,2019,Kent,MI,Passenger,0,1,1,23,24,4.17,Furthest
2047,August,2019,Sangamon,IL,Passenger,1,0,1,6,7,14.29,Mid-Distance
2048,August,2019,Grant,WA,Passenger,45,61,106,65169,65275,0.16,Washington
2049,August,2019,Lake,IL,Passenger,1,0,1,165,166,0.6,Mid-Distance
2050,August,2019,Goochland,VA,Passenger,1,1,2,259,261,0.77,Furthest
2051,August,2019,Kitsap,WA,Truck,1,0,1,54161,54162,0.0,Washington
2052,August,2019,Santa Cruz,CA,Passenger,1,0,1,38,39,2.56,Nearest
2053,August,2019,Spokane,WA,Truck,1,0,1,95528,95529,0.0,Washington
2054,August,2019,Oklahoma,OK,Passenger,0,1,1,125,126,0.79,Mid-Distance
2055,August,2019,Skamania,WA,Passenger,25,18,43,8755,8798,0.49,Washington
2056,August,2019,El Paso,TX,Passenger,3,0,3,480,483,0.62,Mid-Distance
2057,August,2019,Virginia Beach,VA,Passenger,1,0,1,701,702,0.14,Furthest
2058,August,2019,Anne Arundel,MD,Passenger,1,2,3,438,441,0.68,Furthest
2059,August,2019,El Paso,CO,Passenger,2,1,3,737,740,0.41,Mid-Distance
2060,August,2019,District of Columbia,DC,Passenger,1,1,2,210,212,0.94,Furthest
2061,August,2019,Franklin,WA,Passenger,51,72,123,60233,60356,0.2,Washington
2062,August,2019,Prince George's,MD,Passenger,1,1,2,179,181,1.1,Furthest
2063,August,2019,Harris,TX,Passenger,1,1,2,249,251,0.8,Mid-Distance
2064,August,2019,Spokane,WA,Passenger,575,439,1014,313142,314156,0.32,Washington
2065,August,2019,Bergen,NJ,Passenger,1,0,1,26,27,3.7,Furthest
2066,August,2019,Walla Walla,WA,Truck,0,0,0,13652,13652,0.0,Washington
2067,August,2019,Cochise,AZ,Passenger,0,1,1,107,108,0.93,Nearest
2068,August,2019,Grant,WA,Truck,0,0,0,26739,26739,0.0,Washington
2069,August,2019,Kittitas,WA,Truck,0,0,0,14523,14523,0.0,Washington
2070,August,2019,Osceola,FL,Passenger,1,0,1,41,42,2.38,Furthest
2071,August,2019,Prince William,VA,Passenger,1,3,4,251,255,1.57,Furthest
2072,August,2019,St. Mary's,MD,Passenger,1,0,1,217,218,0.46,Furthest
2073,August,2019,Asotin,WA,Passenger,12,7,19,12642,12661,0.15,Washington
2074,August,2019,Sumter,FL,Passenger,0,1,1,9,10,10.0,Furthest
2075,August,2019,Saratoga,NY,Passenger,1,0,1,52,53,1.89,Furthest
2076,August,2019,Stafford,VA,Passenger,1,1,2,98,100,2.0,Furthest
2077,August,2019,Sedgwick,KS,Passenger,1,1,2,98,100,2.0,Mid-Distance
2078,August,2019,Vigo,IN,Passenger,1,0,1,6,7,14.29,Furthest
2079,August,2019,Nantucket,MA,Passenger,1,0,1,2,3,33.33,Furthest
2080,August,2019,Yakima,WA,Passenger,112,108,220,165635,165855,0.13,Washington
2081,August,2019,Santa Rosa,FL,Passenger,1,0,1,87,88,1.14,Furthest
2082,August,2019,Pinal,AZ,Passenger,2,0,2,192,194,1.03,Nearest
2083,August,2019,Kern,CA,Passenger,0,1,1,223,224,0.45,Nearest
2084,August,2019,Franklin,MA,Passenger,0,1,1,1,2,50.0,Furthest
2085,August,2019,Caddo,LA,Passenger,0,1,1,19,20,5.0,Mid-Distance
2086,August,2019,Maui,HI,Passenger,1,0,1,43,44,2.27,Nearest
2087,August,2019,Tarrant,TX,Passenger,2,0,2,201,203,0.99,Mid-Distance
2088,August,2019,Cowlitz,WA,Passenger,107,108,215,73286,73501,0.29,Washington
2089,August,2019,Albemarle,VA,Passenger,1,0,1,21,22,4.55,Furthest
2090,August,2019,Camden,NJ,Passenger,0,1,1,24,25,4.0,Furthest
2091,August,2019,San Joaquin,CA,Passenger,1,0,1,131,132,0.76,Nearest
2092,August,2019,Snohomish,WA,Passenger,3641,1640,5281,533107,538388,0.98,Washington
2093,August,2019,Suffolk,MA,Passenger,0,1,1,37,38,2.63,Furthest
2094,August,2019,Douglas,WA,Passenger,61,36,97,28181,28278,0.34,Washington
2095,August,2019,Garfield,WA,Truck,0,0,0,959,959,0.0,Washington
2096,August,2019,Fairbanks North Star,AK,Passenger,0,1,1,98,99,1.01,Nearest
2097,August,2019,Shelby,OH,Passenger,0,1,1,1,2,50.0,Furthest
2098,August,2019,DuPage,IL,Passenger,3,0,3,59,62,4.84,Mid-Distance
2099,August,2019,Kittitas,WA,Passenger,79,44,123,29744,29867,0.41,Washington
2100,August,2019,Penobscot,ME,Passenger,0,1,1,13,14,7.14,Furthest
2101,August,2019,Alameda,CA,Passenger,4,1,5,294,299,1.67,Nearest
2102,August,2019,Pacific,WA,Truck,0,0,0,7681,7681,0.0,Washington
2103,August,2019,Montgomery,TX,Passenger,1,0,1,60,61,1.64,Mid-Distance
2104,August,2019,Boone,MO,Passenger,0,1,1,10,11,9.09,Furthest
2105,August,2019,Clallam,WA,Truck,1,0,1,21824,21825,0.0,Washington
2106,August,2019,Island,WA,Truck,0,0,0,21275,21275,0.0,Washington
2107,August,2019,Jefferson,CO,Passenger,0,2,2,59,61,3.28,Mid-Distance
2108,August,2019,Sarasota,FL,Passenger,1,0,1,27,28,3.57,Furthest
2109,August,2019,Norfolk,VA,Passenger,2,2,4,347,351,1.14,Furthest
2110,August,2019,Middlesex,MA,Passenger,1,1,2,113,115,1.74,Furthest
2111,August,2019,San Mateo,CA,Passenger,2,1,3,115,118,2.54,Nearest
2112,August,2019,Duval,FL,Passenger,1,2,3,374,377,0.8,Furthest
2113,August,2019,Clackamas,OR,Passenger,1,1,2,215,217,0.92,Nearest
2114,August,2019,DeKalb,IN,Passenger,1,0,1,1,2,50.0,Furthest
2115,August,2019,New London,CT,Passenger,0,2,2,241,243,0.82,Furthest
2116,August,2019,Frederick,MD,Passenger,1,1,2,80,82,2.44,Furthest
2117,August,2019,Ramsey,MN,Passenger,1,0,1,38,39,2.56,Mid-Distance
2118,August,2019,Island,WA,Passenger,335,244,579,63461,64040,0.9,Washington
2119,August,2019,Ada,ID,Passenger,0,2,2,305,307,0.65,Nearest
2120,August,2019,Cape May,NJ,Passenger,0,1,1,14,15,6.67,Furthest
2121,August,2019,Shasta,CA,Passenger,1,0,1,40,41,2.44,Nearest
2122,August,2019,Clallam,WA,Passenger,184,148,332,50729,51061,0.65,Washington
2123,August,2019,Pinellas,FL,Passenger,1,1,2,115,117,1.71,Furthest
2124,August,2019,Wayne,MI,Passenger,0,1,1,64,65,1.54,Furthest
2125,August,2019,Tulsa,OK,Passenger,1,1,2,47,49,4.08,Mid-Distance
2126,August,2019,Walla Walla,WA,Passenger,56,63,119,36230,36349,0.33,Washington
2127,August,2019,Columbia,WA,Passenger,2,2,4,2455,2459,0.16,Washington
2128,August,2019,Kitsap,WA,Passenger,1114,633,1747,181513,183260,0.95,Washington
2129,August,2019,Stevens,WA,Truck,0,0,0,18717,18717,0.0,Washington
2130,August,2019,DeKalb,GA,Passenger,1,0,1,78,79,1.27,Furthest
2131,August,2019,Santa Fe,NM,Passenger,0,1,1,39,40,2.5,Mid-Distance
2132,August,2019,Honolulu,HI,Passenger,4,2,6,487,493,1.22,Nearest
2133,August,2019,Flathead,MT,Passenger,1,0,1,65,66,1.52,Nearest
2134,August,2019,Skagit,WA,Passenger,310,209,519,92306,92825,0.56,Washington
2135,August,2019,Santa Clara,CA,Passenger,4,2,6,365,371,1.62,Nearest
2136,August,2019,Lincoln,WA,Passenger,2,10,12,7786,7798,0.15,Washington
2137,August,2019,Cowlitz,WA,Truck,0,0,0,28900,28900,0.0,Washington
2138,August,2019,Richmond,GA,Passenger,0,1,1,93,94,1.06,Furthest
2139,August,2019,Manatee,FL,Passenger,1,0,1,34,35,2.86,Furthest
2140,August,2019,Bucks,PA,Passenger,1,0,1,23,24,4.17,Furthest
2141,August,2019,Dallas,TX,Passenger,1,0,1,207,208,0.48,Mid-Distance
2142,August,2019,Whitman,WA,Passenger,34,44,78,22711,22789,0.34,Washington
2143,August,2019,Wahkiakum,WA,Truck,0,0,0,1763,1763,0.0,Washington
2144,August,2019,Pierce,WA,Truck,0,0,0,140335,140335,0.0,Washington
2145,August,2019,Skagit,WA,Truck,1,0,1,32553,32554,0.0,Washington
2146,August,2019,Ventura,CA,Passenger,0,2,2,309,311,0.64,Nearest
2147,August,2019,Okanogan,WA,Passenger,25,26,51,26190,26241,0.19,Washington
2148,August,2019,Guadalupe,TX,Passenger,1,0,1,70,71,1.41,Mid-Distance
2149,August,2019,Maricopa,AZ,Passenger,7,4,11,1531,1542,0.71,Nearest
2150,August,2019,San Juan,WA,Truck,0,0,0,5891,5891,0.0,Washington
2151,August,2019,Klickitat,WA,Passenger,37,35,72,15624,15696,0.46,Washington
2152,August,2019,Contra Costa,CA,Passenger,2,2,4,368,372,1.08,Nearest
2153,August,2019,Chelan,WA,Truck,0,0,0,22366,22366,0.0,Washington
2154,August,2019,Harrison,MS,Passenger,1,0,1,62,63,1.59,Mid-Distance
2155,August,2019,Howard,MD,Passenger,0,1,1,74,75,1.33,Furthest
2156,August,2019,King,WA,Passenger,20005,7202,27207,1393126,1420333,1.92,Washington
2157,August,2019,Douglas,NE,Passenger,0,1,1,59,60,1.67,Mid-Distance
2158,August,2019,Calvert,MD,Passenger,0,2,2,89,91,2.2,Furthest
2159,August,2019,Clark,WA,Truck,0,0,0,80861,80861,0.0,Washington
2160,August,2019,Pend Oreille,WA,Truck,0,0,0,5721,5721,0.0,Washington
2161,August,2019,Whatcom,WA,Truck,2,0,2,42997,42999,0.0,Washington
2162,August,2019,Putnam,TN,Passenger,0,1,1,3,4,25.0,Furthest
2163,August,2019,Grays Harbor,WA,Passenger,88,85,173,48116,48289,0.36,Washington
2164,August,2019,Wahkiakum,WA,Passenger,2,2,4,3026,3030,0.13,Washington
2165,August,2019,Oldham,KY,Passenger,0,1,1,5,6,16.67,Furthest
2166,August,2019,Larimer,CO,Passenger,1,0,1,58,59,1.69,Mid-Distance
2167,August,2019,Hennepin,MN,Passenger,3,1,4,105,109,3.67,Mid-Distance
2168,August,2019,Clay,FL,Passenger,0,1,1,84,85,1.18,Furthest
2169,August,2019,Manassas,VA,Passenger,0,1,1,8,9,11.11,Furthest
2170,August,2019,Saginaw,MI,Passenger,1,0,1,12,13,7.69,Furthest
2171,August,2019,Nueces,TX,Passenger,1,1,2,92,94,2.13,Mid-Distance
2172,August,2019,Arlington,VA,Passenger,0,2,2,155,157,1.27,Furthest
2173,August,2019,Columbia,WA,Truck,0,0,0,1531,1531,0.0,Washington
2174,August,2019,Fairfax,VA,Passenger,3,2,5,761,766,0.65,Furthest
2175,August,2019,Denver,CO,Passenger,1,0,1,128,129,0.78,Mid-Distance
2176,August,2019,Kootenai,ID,Passenger,1,1,2,220,222,0.9,Nearest
2177,August,2019,King,WA,Truck,6,1,7,182265,182272,0.0,Washington
2178,August,2019,Polk,FL,Passenger,1,0,1,68,69,1.45,Furthest
2179,August,2019,Thurston,WA,Truck,0,0,0,55440,55440,0.0,Washington
2180,August,2019,Washoe,NV,Passenger,2,0,2,109,111,1.8,Nearest
2181,August,2019,Skamania,WA,Truck,0,0,0,4075,4075,0.0,Washington
2182,August,2019,Berkshire,MA,Passenger,0,1,1,4,5,20.0,Furthest
2183,August,2019,San Francisco,CA,Passenger,2,1,3,106,109,2.75,Nearest
2184,August,2019,Ferry,WA,Passenger,5,2,7,4414,4421,0.16,Washington
2185,August,2019,Jefferson,WA,Truck,0,0,0,9675,9675,0.0,Washington
2186,August,2019,Pierce,WA,Passenger,1930,1584,3514,544791,548305,0.64,Washington
2187,August,2019,Los Angeles,CA,Passenger,8,6,14,1104,1118,1.25,Nearest
2188,August,2019,Lewis,WA,Passenger,105,96,201,59363,59564,0.34,Washington
2189,August,2019,Mason,WA,Truck,0,0,0,20413,20413,0.0,Washington
2190,August,2019,Richland,SC,Passenger,0,1,1,159,160,0.62,Furthest
2191,August,2019,Loudoun,VA,Passenger,1,0,1,94,95,1.05,Furthest
2192,August,2019,Montgomery,AL,Passenger,0,1,1,41,42,2.38,Furthest
2193,August,2019,Douglas,WA,Truck,0,0,0,12264,12264,0.0,Washington
2194,August,2019,Jefferson,WA,Passenger,205,122,327,25074,25401,1.29,Washington
2195,August,2019,Wilson,TX,Passenger,0,1,1,6,7,14.29,Mid-Distance
2196,August,2019,Cook,IL,Passenger,1,0,1,240,241,0.41,Mid-Distance
2197,August,2019,Shelby,TN,Passenger,0,1,1,92,93,1.08,Furthest
2198,August,2019,Benton,WA,Truck,0,0,0,42177,42177,0.0,Washington
2199,August,2019,Orange,CA,Passenger,6,3,9,523,532,1.69,Nearest
2200,August,2019,Klickitat,WA,Truck,0,0,0,8292,8292,0.0,Washington
2201,August,2019,Owyhee,ID,Passenger,1,0,1,4,5,20.0,Nearest
2202,August,2019,Nassau,NY,Passenger,4,0,4,38,42,9.52,Furthest
2203,August,2019,Clark,WA,Passenger,1647,959,2606,315547,318153,0.82,Washington
2204,August,2019,Twin Falls,ID,Passenger,0,1,1,26,27,3.7,Nearest
2205,August,2019,RÃ­o Grande,PR,Passenger,1,0,1,1,2,50.0,Mid-Distance
2206,August,2019,Klamath,OR,Passenger,1,0,1,39,40,2.5,Nearest
2207,August,2019,Tuolumne,CA,Passenger,0,1,1,11,12,8.33,Nearest
2208,August,2019,Harnett,NC,Passenger,1,1,2,210,212,0.94,Furthest
2209,August,2019,Washtenaw,MI,Passenger,1,0,1,41,42,2.38,Furthest
2210,August,2019,Placer,CA,Passenger,1,0,1,98,99,1.01,Nearest
2211,August,2020,Kauai,HI,Passenger,1,0,1,13,14,7.14,Nearest
2212,August,2020,Klickitat,WA,Truck,0,0,0,8105,8105,0.0,Washington
2213,August,2020,Alameda,CA,Passenger,2,0,2,266,268,0.75,Nearest
2214,August,2020,Bucks,PA,Passenger,1,0,1,20,21,4.76,Furthest
2215,August,2020,Pacific,WA,Truck,0,0,0,7724,7724,0.0,Washington
2216,August,2020,Howard,MD,Passenger,0,1,1,68,69,1.45,Furthest
2217,August,2020,St. Louis,MO,Passenger,1,0,1,96,97,1.03,Furthest
2218,August,2020,King,WA,Truck,5,1,6,183316,183322,0.0,Washington
2219,August,2020,Okaloosa,FL,Passenger,0,1,1,139,140,0.71,Furthest
2220,August,2020,Yakima,WA,Passenger,146,122,268,166128,166396,0.16,Washington
2221,August,2020,Hudson,NJ,Passenger,1,0,1,38,39,2.56,Furthest
2222,August,2020,Maui,HI,Passenger,1,0,1,30,31,3.23,Nearest
2223,August,2020,Fairfax,VA,Passenger,4,3,7,741,748,0.94,Furthest
2224,August,2020,Collin,TX,Passenger,1,1,2,119,121,1.65,Mid-Distance
2225,August,2020,Richland,SC,Passenger,0,1,1,146,147,0.68,Furthest
2226,August,2020,Allegheny,PA,Passenger,1,0,1,71,72,1.39,Furthest
2227,August,2020,Charleston,SC,Passenger,2,0,2,97,99,2.02,Furthest
2228,August,2020,Harrison,MS,Passenger,1,0,1,52,53,1.89,Mid-Distance
2229,August,2020,Boone,MO,Passenger,0,1,1,10,11,9.09,Furthest
2230,August,2020,Lake,IL,Passenger,1,0,1,161,162,0.62,Mid-Distance
2231,August,2020,Washoe,NV,Passenger,1,0,1,100,101,0.99,Nearest
2232,August,2020,Penobscot,ME,Passenger,0,1,1,14,15,6.67,Furthest
2234,August,2020,Utah,UT,Passenger,0,1,1,128,129,0.78,Nearest
2235,August,2020,DeKalb,IN,Passenger,1,0,1,1,2,50.0,Furthest
2236,August,2020,Klamath,OR,Passenger,1,0,1,32,33,3.03,Nearest
2237,August,2020,Skamania,WA,Passenger,31,22,53,8376,8429,0.63,Washington
2238,August,2020,Rogers,OK,Passenger,1,0,1,4,5,20.0,Mid-Distance
2239,August,2020,Multnomah,OR,Passenger,4,6,10,702,712,1.4,Nearest
2240,August,2020,Grant,WA,Passenger,66,75,141,65404,65545,0.22,Washington
2241,August,2020,Williams,ND,Passenger,0,1,1,11,12,8.33,Mid-Distance
2242,August,2020,Spokane,WA,Truck,1,0,1,99446,99447,0.0,Washington
2243,August,2020,Frederick,MD,Passenger,1,1,2,74,76,2.63,Furthest
2244,August,2020,Harris,TX,Passenger,1,0,1,217,218,0.46,Mid-Distance
2245,August,2020,Vigo,IN,Passenger,1,0,1,5,6,16.67,Furthest
2246,August,2020,RÃ­o Grande,PR,Passenger,1,0,1,1,2,50.0,Mid-Distance
2247,August,2020,Richmond,GA,Passenger,0,1,1,82,83,1.2,Furthest
2248,August,2020,Erie,NY,Passenger,1,0,1,45,46,2.17,Furthest
2249,August,2020,Columbia,WA,Truck,0,0,0,1526,1526,0.0,Washington
2250,August,2020,Albemarle,VA,Passenger,1,0,1,20,21,4.76,Furthest
2251,August,2020,Travis,TX,Passenger,2,1,3,171,174,1.72,Mid-Distance
2252,August,2020,New Haven,CT,Passenger,0,2,2,35,37,5.41,Furthest
2253,August,2020,Lincoln,WA,Passenger,5,11,16,7625,7641,0.21,Washington
2254,August,2020,Hamilton,IN,Passenger,1,0,1,39,40,2.5,Furthest
2255,August,2020,San Diego,CA,Passenger,15,5,20,2745,2765,0.72,Nearest
2256,August,2020,Prince William,VA,Passenger,2,2,4,222,226,1.77,Furthest
2257,August,2020,Santa Clara,CA,Passenger,8,2,10,274,284,3.52,Nearest
2258,August,2020,Cowlitz,WA,Passenger,152,120,272,72131,72403,0.38,Washington
2259,August,2020,Lincoln,WA,Truck,0,0,0,4652,4652,0.0,Washington
2260,August,2020,Calvert,MD,Passenger,0,2,2,87,89,2.25,Furthest
2261,August,2020,Whatcom,WA,Passenger,1111,512,1623,149201,150824,1.08,Washington
2262,August,2020,Whatcom,WA,Truck,3,0,3,43278,43281,0.01,Washington
2263,August,2020,Adams,WA,Truck,0,0,0,5303,5303,0.0,Washington
2264,August,2020,Ulster,NY,Passenger,1,0,1,8,9,11.11,Furthest
2265,August,2020,Stafford,VA,Passenger,1,1,2,91,93,2.15,Furthest
2266,August,2020,Pierce,WA,Truck,0,0,0,143398,143398,0.0,Washington
2267,August,2020,San Juan,WA,Passenger,320,100,420,13928,14348,2.93,Washington
2268,August,2020,Prince George's,MD,Passenger,2,1,3,154,157,1.91,Furthest
2269,August,2020,El Paso,CO,Passenger,2,0,2,706,708,0.28,Mid-Distance
2270,August,2020,Owyhee,ID,Passenger,1,0,1,3,4,25.0,Nearest
2271,August,2020,Franklin,WA,Truck,0,0,0,20187,20187,0.0,Washington
2272,August,2020,Columbia,WA,Passenger,3,3,6,2423,2429,0.25,Washington
2273,August,2020,Clark,NV,Passenger,2,2,4,665,669,0.6,Nearest
2274,August,2020,San Joaquin,CA,Passenger,1,0,1,121,122,0.82,Nearest
2275,August,2020,Grays Harbor,WA,Passenger,111,116,227,48357,48584,0.47,Washington
2276,August,2020,Jefferson,WA,Truck,0,0,0,9539,9539,0.0,Washington
2277,August,2020,Kittitas,WA,Passenger,110,47,157,29764,29921,0.52,Washington
2278,August,2020,Portsmouth,VA,Passenger,0,1,1,75,76,1.32,Furthest
2279,August,2020,Sedgwick,KS,Passenger,1,1,2,89,91,2.2,Mid-Distance
2280,August,2020,Brevard,FL,Passenger,0,1,1,81,82,1.22,Furthest
2281,August,2020,Palm Beach,FL,Passenger,0,1,1,79,80,1.25,Furthest
2282,August,2020,Pima,AZ,Passenger,3,1,4,328,332,1.2,Nearest
2283,August,2020,Douglas,NE,Passenger,0,1,1,49,50,2.0,Mid-Distance
2284,August,2020,Carroll,MD,Passenger,0,1,1,20,21,4.76,Furthest
2285,August,2020,Spartanburg,SC,Passenger,0,1,1,48,49,2.04,Furthest
2286,August,2020,Manassas,VA,Passenger,0,1,1,5,6,16.67,Furthest
2287,August,2020,Okanogan,WA,Passenger,40,34,74,25977,26051,0.28,Washington
2288,August,2020,Shelby,TN,Passenger,0,1,1,84,85,1.18,Furthest
2289,August,2020,Monroe,IL,Passenger,1,0,1,4,5,20.0,Mid-Distance
2290,August,2020,Montgomery,PA,Passenger,1,0,1,27,28,3.57,Furthest
2291,August,2020,Twin Falls,ID,Passenger,0,1,1,22,23,4.35,Nearest
2292,August,2020,Orange,CA,Passenger,6,2,8,474,482,1.66,Nearest
2293,August,2020,Greene,MO,Passenger,0,1,1,33,34,2.94,Furthest
2294,August,2020,Denver,CO,Passenger,1,0,1,114,115,0.87,Mid-Distance
2295,August,2020,Morris,NJ,Passenger,1,0,1,18,19,5.26,Furthest
2296,August,2020,Pinal,AZ,Passenger,1,0,1,177,178,0.56,Nearest
2297,August,2020,Garfield,WA,Truck,0,0,0,994,994,0.0,Washington
2298,August,2020,Monterey,CA,Passenger,0,1,1,161,162,0.62,Nearest
2299,August,2020,Mason,WA,Passenger,162,133,295,47407,47702,0.62,Washington
2300,August,2020,Boulder,CO,Passenger,0,1,1,41,42,2.38,Mid-Distance
2301,August,2020,Houston,GA,Passenger,1,0,1,53,54,1.85,Furthest
2302,August,2020,Gwinnett,GA,Passenger,1,0,1,72,73,1.37,Furthest
2303,August,2020,Adams,WA,Passenger,9,7,16,12868,12884,0.12,Washington
2304,August,2020,Jones,GA,Passenger,1,0,1,1,2,50.0,Furthest
2305,August,2020,Solano,CA,Passenger,1,0,1,207,208,0.48,Nearest
2306,August,2020,Rockingham,NH,Passenger,1,0,1,21,22,4.55,Furthest
2307,August,2020,Powhatan,VA,Passenger,1,0,1,0,1,100.0,Furthest
2308,August,2020,Duval,FL,Passenger,0,2,2,356,358,0.56,Furthest
2309,August,2020,Polk,FL,Passenger,1,0,1,61,62,1.61,Furthest
2310,August,2020,Asotin,WA,Truck,0,0,0,6667,6667,0.0,Washington
2311,August,2020,San Francisco,CA,Passenger,2,1,3,90,93,3.23,Nearest
2312,August,2020,Cascade,MT,Passenger,0,1,1,53,54,1.85,Nearest
2313,August,2020,Kern,CA,Passenger,0,1,1,221,222,0.45,Nearest
2314,August,2020,Thurston,WA,Passenger,1194,752,1946,197105,199051,0.98,Washington
2315,August,2020,Bartow,GA,Passenger,0,1,1,4,5,20.0,Furthest
2316,August,2020,Clackamas,OR,Passenger,2,0,2,184,186,1.08,Nearest
2317,August,2020,Grays Harbor,WA,Truck,0,0,0,21033,21033,0.0,Washington
2318,August,2020,Chelan,WA,Truck,0,0,0,22677,22677,0.0,Washington
2319,August,2020,Kings,NY,Passenger,1,0,1,63,64,1.56,Furthest
2320,August,2020,Charles,MD,Passenger,1,1,2,74,76,2.63,Furthest
2321,August,2020,Anne Arundel,MD,Passenger,0,1,1,400,401,0.25,Furthest
2322,August,2020,Hawaii,HI,Passenger,1,0,1,54,55,1.82,Nearest
2323,August,2020,Carson City,NV,Passenger,1,0,1,10,11,9.09,Nearest
2324,August,2020,King,WA,Passenger,25173,7814,32987,1370893,1403880,2.35,Washington
2325,August,2020,Honolulu,HI,Passenger,4,2,6,433,439,1.37,Nearest
2326,August,2020,Randolph,NC,Passenger,1,0,1,7,8,12.5,Furthest
2327,August,2020,Alexandria,VA,Passenger,2,0,2,134,136,1.47,Furthest
2328,August,2020,Pinellas,FL,Passenger,1,1,2,104,106,1.89,Furthest
2329,August,2020,Benton,WA,Truck,0,0,0,43024,43024,0.0,Washington
2330,August,2020,Fresno,CA,Passenger,1,0,1,172,173,0.58,Nearest
2331,August,2020,Pend Oreille,WA,Truck,0,0,0,5746,5746,0.0,Washington
2332,August,2020,Lake,FL,Passenger,1,0,1,22,23,4.35,Furthest
2333,August,2020,Norfolk,VA,Passenger,2,2,4,343,347,1.15,Furthest
2334,August,2020,Okanogan,WA,Truck,0,0,0,16543,16543,0.0,Washington
2335,August,2020,Lewis,WA,Truck,0,0,0,26362,26362,0.0,Washington
2336,August,2020,District of Columbia,DC,Passenger,2,1,3,200,203,1.48,Furthest
2337,August,2020,Montgomery,AL,Passenger,0,1,1,39,40,2.5,Furthest
2338,August,2020,San Juan,WA,Truck,0,0,0,5838,5838,0.0,Washington
2339,August,2020,Bradley,TN,Passenger,1,0,1,1,2,50.0,Furthest
2340,August,2020,Ada,ID,Passenger,0,1,1,256,257,0.39,Nearest
2341,August,2020,St. Mary's,MD,Passenger,1,0,1,217,218,0.46,Furthest
2342,August,2020,Harnett,NC,Passenger,1,0,1,196,197,0.51,Furthest
2343,August,2020,Franklin,WA,Passenger,66,77,143,60794,60937,0.23,Washington
2344,August,2020,Deschutes,OR,Passenger,1,0,1,128,129,0.78,Nearest
2345,August,2020,Nassau,NY,Passenger,4,0,4,29,33,12.12,Furthest
2346,August,2020,Spokane,WA,Passenger,781,505,1286,317481,318767,0.4,Washington
2347,August,2020,Riverside,CA,Passenger,3,0,3,609,612,0.49,Nearest
2348,August,2020,Middlesex,MA,Passenger,1,1,2,91,93,2.15,Furthest
2349,August,2020,Snohomish,WA,Truck,0,0,0,124595,124595,0.0,Washington
2350,August,2020,Sumter,FL,Passenger,0,1,1,10,11,9.09,Furthest
2351,August,2020,Grant,WA,Truck,0,0,0,27237,27237,0.0,Washington
2352,August,2020,Montgomery,OH,Passenger,0,1,1,47,48,2.08,Furthest
2353,August,2020,Ramsey,MN,Passenger,1,0,1,37,38,2.63,Mid-Distance
2354,August,2020,Asotin,WA,Passenger,17,14,31,12356,12387,0.25,Washington
2355,August,2020,Los Angeles,CA,Passenger,8,11,19,981,1000,1.9,Nearest
2356,August,2020,Nueces,TX,Passenger,1,0,1,83,84,1.19,Mid-Distance
2357,August,2020,Pacific,WA,Passenger,32,33,65,15709,15774,0.41,Washington
2358,August,2020,Shelby,OH,Passenger,0,1,1,1,2,50.0,Furthest
2359,August,2020,Benton,WA,Passenger,380,322,702,134321,135023,0.52,Washington
2360,August,2020,Arapahoe,CO,Passenger,1,0,1,129,130,0.77,Mid-Distance
2361,August,2020,Dakota,MN,Passenger,0,1,1,34,35,2.86,Mid-Distance
2362,August,2020,New London,CT,Passenger,1,2,3,239,242,1.24,Furthest
2363,August,2020,Washington,OR,Passenger,1,0,1,432,433,0.23,Nearest
2364,August,2020,Stevens,WA,Truck,0,0,0,18653,18653,0.0,Washington
2365,August,2020,Shasta,CA,Passenger,1,0,1,36,37,2.7,Nearest
2366,August,2020,Thurston,WA,Truck,0,0,0,55974,55974,0.0,Washington
2367,August,2020,Contra Costa,CA,Passenger,4,3,7,302,309,2.27,Nearest
2368,August,2020,Sarasota,FL,Passenger,2,0,2,22,24,8.33,Furthest
2369,August,2020,Klickitat,WA,Passenger,57,42,99,15043,15142,0.65,Washington
2370,August,2020,Kitsap,WA,Truck,0,0,0,54174,54174,0.0,Washington
2371,August,2020,Kittitas,WA,Truck,0,0,0,14559,14559,0.0,Washington
2372,August,2020,Whitman,WA,Truck,0,0,0,8480,8480,0.0,Washington
2373,August,2020,San Mateo,CA,Passenger,0,1,1,105,106,0.94,Nearest
2374,August,2020,Skagit,WA,Truck,1,0,1,32634,32635,0.0,Washington
2375,August,2020,Clark,WA,Passenger,2135,1076,3211,318235,321446,1.0,Washington
2376,August,2020,Clallam,WA,Passenger,239,171,410,49948,50358,0.81,Washington
2377,August,2020,Juneau,AK,Passenger,0,1,1,27,28,3.57,Nearest
2378,August,2020,Howard,IN,Passenger,0,1,1,3,4,25.0,Furthest
2379,August,2020,Lewis,WA,Passenger,112,117,229,58206,58435,0.39,Washington
2380,August,2020,Lee,FL,Passenger,1,0,1,48,49,2.04,Furthest
2381,August,2020,Skamania,WA,Truck,0,0,0,4023,4023,0.0,Washington
2382,August,2020,Douglas,WA,Truck,0,0,0,12339,12339,0.0,Washington
2383,August,2020,Fort Bend,TX,Passenger,1,0,1,45,46,2.17,Mid-Distance
2384,August,2020,Ventura,CA,Passenger,1,2,3,278,281,1.07,Nearest
2385,August,2020,Kootenai,ID,Passenger,1,0,1,216,217,0.46,Nearest
2386,August,2020,Jefferson,WA,Passenger,249,144,393,24652,25045,1.57,Washington
2387,August,2020,Camden,NJ,Passenger,0,1,1,22,23,4.35,Furthest
2388,August,2020,St. Clair,IL,Passenger,1,0,1,140,141,0.71,Mid-Distance
2389,August,2020,Carroll,NH,Passenger,0,1,1,5,6,16.67,Furthest
2390,August,2020,Chelan,WA,Passenger,248,80,328,54176,54504,0.6,Washington
2391,August,2020,Maricopa,AZ,Passenger,5,7,12,1363,1375,0.87,Nearest
2392,August,2020,Stevens,WA,Passenger,35,36,71,30494,30565,0.23,Washington
2393,August,2020,Pierce,WA,Passenger,2519,1704,4223,552476,556699,0.76,Washington
2394,August,2020,Saginaw,MI,Passenger,1,0,1,9,10,10.0,Furthest
2395,August,2020,DuPage,IL,Passenger,3,0,3,57,60,5.0,Mid-Distance
2396,August,2020,Jefferson,NY,Passenger,0,1,1,210,211,0.47,Furthest
2397,August,2020,Loudoun,VA,Passenger,1,0,1,82,83,1.2,Furthest
2398,August,2020,Fulton,GA,Passenger,1,2,3,100,103,2.91,Furthest
2399,August,2020,Dallas,TX,Passenger,1,0,1,186,187,0.53,Mid-Distance
2400,August,2020,Island,WA,Passenger,434,273,707,62809,63516,1.11,Washington
2401,August,2020,Putnam,TN,Passenger,0,1,1,3,4,25.0,Furthest
2402,August,2020,Kitsap,WA,Passenger,1400,699,2099,179638,181737,1.15,Washington
2403,August,2020,Mason,WA,Truck,0,0,0,20779,20779,0.0,Washington
2404,August,2020,Suffolk,VA,Passenger,1,0,1,125,126,0.79,Furthest
2405,August,2020,Walla Walla,WA,Truck,0,0,0,13750,13750,0.0,Washington
2406,August,2020,Douglas,CO,Passenger,0,1,1,79,80,1.25,Mid-Distance
2407,August,2020,Santa Cruz,CA,Passenger,1,0,1,32,33,3.03,Nearest
2408,August,2020,Arlington,VA,Passenger,0,2,2,148,150,1.33,Furthest
2409,August,2020,DeKalb,GA,Passenger,1,0,1,77,78,1.28,Furthest
2410,August,2020,Cape May,NJ,Passenger,0,1,1,13,14,7.14,Furthest
2411,August,2020,Garfield,WA,Passenger,0,1,1,1350,1351,0.07,Washington
2412,August,2020,Whitman,WA,Passenger,46,48,94,22021,22115,0.43,Washington
2413,August,2020,Kent,MI,Passenger,0,1,1,24,25,4.0,Furthest
2414,August,2020,Williamson,TX,Passenger,0,2,2,129,131,1.53,Mid-Distance
2415,August,2020,Ferry,WA,Passenger,7,3,10,4309,4319,0.23,Washington
2416,August,2020,Island,WA,Truck,1,0,1,21228,21229,0.0,Washington
2417,August,2020,Pend Oreille,WA,Passenger,8,5,13,9230,9243,0.14,Washington
2418,August,2020,Yakima,WA,Truck,0,0,0,60420,60420,0.0,Washington
2419,August,2020,Skagit,WA,Passenger,432,222,654,91256,91910,0.71,Washington
2420,August,2020,Placer,CA,Passenger,2,0,2,84,86,2.33,Nearest
2421,August,2020,Clark,WA,Truck,0,0,0,82716,82716,0.0,Washington
2422,August,2020,Montgomery,TX,Passenger,1,0,1,49,50,2.0,Mid-Distance
2423,August,2020,Wahkiakum,WA,Passenger,6,6,12,3028,3040,0.39,Washington
2424,August,2020,Ferry,WA,Truck,0,0,0,3582,3582,0.0,Washington
2425,August,2020,Hennepin,MN,Passenger,3,0,3,88,91,3.3,Mid-Distance
2426,August,2020,Sacramento,CA,Passenger,1,0,1,255,256,0.39,Nearest
2427,August,2020,Snohomish,WA,Passenger,4645,1782,6427,536082,542509,1.18,Washington
2428,August,2020,Larimer,CO,Passenger,1,0,1,51,52,1.92,Mid-Distance
2429,August,2020,Clallam,WA,Truck,1,0,1,21704,21705,0.0,Washington
2430,August,2020,Denton,TX,Passenger,1,0,1,89,90,1.11,Mid-Distance
2431,August,2020,El Paso,TX,Passenger,3,0,3,414,417,0.72,Mid-Distance
2432,August,2020,Queens,NY,Passenger,1,0,1,50,51,1.96,Furthest
2433,August,2020,Fairbanks North Star,AK,Passenger,0,1,1,95,96,1.04,Nearest
2434,August,2020,Chesapeake,VA,Passenger,0,2,2,415,417,0.48,Furthest
2435,August,2020,Moore,NC,Passenger,0,2,2,154,156,1.28,Furthest
2436,August,2020,Valencia,NM,Passenger,1,0,1,6,7,14.29,Mid-Distance
2437,August,2020,Bexar,TX,Passenger,4,5,9,589,598,1.51,Mid-Distance
2438,August,2020,Wilson,TX,Passenger,0,1,1,5,6,16.67,Mid-Distance
2439,August,2020,Tulsa,OK,Passenger,1,1,2,42,44,4.55,Mid-Distance
2440,August,2020,Suffolk,MA,Passenger,0,2,2,35,37,5.41,Furthest
2441,August,2020,Cowlitz,WA,Truck,0,0,0,28911,28911,0.0,Washington
2442,August,2020,Flathead,MT,Passenger,1,0,1,55,56,1.79,Nearest
2443,August,2020,Broward,FL,Passenger,2,1,3,108,111,2.7,Furthest
2444,August,2020,Douglas,WA,Passenger,77,41,118,28010,28128,0.42,Washington
2445,August,2020,Walla Walla,WA,Passenger,81,65,146,35891,36037,0.41,Washington
2446,August,2020,Virginia Beach,VA,Passenger,1,0,1,659,660,0.15,Furthest
2447,August,2020,Goochland,VA,Passenger,3,2,5,250,255,1.96,Furthest
2448,August,2020,Washtenaw,MI,Passenger,1,0,1,36,37,2.7,Furthest
2449,August,2020,Cumberland,NC,Passenger,0,3,3,454,457,0.66,Furthest
2450,August,2020,Clay,FL,Passenger,0,1,1,81,82,1.22,Furthest
2451,August,2020,Wahkiakum,WA,Truck,0,0,0,1745,1745,0.0,Washington
2452,August,2020,Jefferson,CO,Passenger,0,1,1,56,57,1.75,Mid-Distance
2453,August,2020,Oldham,KY,Passenger,0,1,1,4,5,20.0,Furthest
2454,August,2020,Nassau,FL,Passenger,1,0,1,36,37,2.7,Furthest
2455,August,2020,Guadalupe,TX,Passenger,1,0,1,60,61,1.64,Mid-Distance
2456,August,2020,Salt Lake,UT,Passenger,0,1,1,183,184,0.54,Nearest
2457,August,2020,New York,NY,Passenger,1,0,1,56,57,1.75,Furthest
2458,August,2021,Richmond,NY,Passenger,1,0,1,8,9,11.11,Furthest
2459,August,2021,Fort Bend,TX,Passenger,1,0,1,35,36,2.78,Mid-Distance
2460,August,2021,Lake,IL,Passenger,2,0,2,156,158,1.27,Mid-Distance
2461,August,2021,San Diego,CA,Passenger,17,7,24,2518,2542,0.94,Nearest
2462,August,2021,Owyhee,ID,Passenger,1,0,1,2,3,33.33,Nearest
2463,August,2021,Island,WA,Truck,0,0,0,21590,21590,0.0,Washington
2464,August,2021,Columbia,WA,Truck,0,0,0,1539,1539,0.0,Washington
2465,August,2021,Pennington,SD,Passenger,1,0,1,31,32,3.12,Mid-Distance
2466,August,2021,Norfolk,VA,Passenger,3,3,6,310,316,1.9,Furthest
2467,August,2021,Geary,KS,Passenger,1,0,1,95,96,1.04,Mid-Distance
2468,August,2021,San Francisco,CA,Passenger,0,1,1,84,85,1.18,Nearest
2469,August,2021,Snohomish,WA,Passenger,6310,2137,8447,539419,547866,1.54,Washington
2470,August,2021,Hidalgo,TX,Passenger,0,1,1,52,53,1.89,Mid-Distance
2471,August,2021,Kings,NY,Passenger,1,0,1,67,68,1.47,Furthest
2472,August,2021,Hampshire,MA,Passenger,1,0,1,6,7,14.29,Furthest
2473,August,2021,Portsmouth,VA,Passenger,0,1,1,76,77,1.3,Furthest
2474,August,2021,Miami-Dade,FL,Passenger,1,0,1,95,96,1.04,Furthest
2475,August,2021,Chelan,WA,Passenger,364,102,466,54718,55184,0.84,Washington
2476,August,2021,Houston,GA,Passenger,1,0,1,46,47,2.13,Furthest
2477,August,2021,Lewis,WA,Passenger,181,151,332,59647,59979,0.55,Washington
2478,August,2021,Sonoma,CA,Passenger,0,1,1,82,83,1.2,Nearest
2479,August,2021,Suffolk,MA,Passenger,0,2,2,28,30,6.67,Furthest
2480,August,2021,Santa Clara,CA,Passenger,8,2,10,243,253,3.95,Nearest
2481,August,2021,Sevier,AR,Passenger,0,1,1,0,1,100.0,Mid-Distance
2482,August,2021,Thurston,WA,Truck,0,0,0,56421,56421,0.0,Washington
2483,August,2021,Queens,NY,Passenger,2,0,2,48,50,4.0,Furthest
2484,August,2021,Carroll,NH,Passenger,0,1,1,5,6,16.67,Furthest
2485,August,2021,New Haven,CT,Passenger,0,2,2,28,30,6.67,Furthest
2486,August,2021,Skamania,WA,Passenger,52,38,90,8389,8479,1.06,Washington
2487,August,2021,Albemarle,VA,Passenger,1,0,1,20,21,4.76,Furthest
2488,August,2021,Wichita,TX,Passenger,1,0,1,41,42,2.38,Mid-Distance
2489,August,2021,Sacramento,CA,Passenger,2,0,2,212,214,0.93,Nearest
2490,August,2021,Moore,NC,Passenger,0,1,1,123,124,0.81,Furthest
2491,August,2021,Greene,MO,Passenger,0,1,1,28,29,3.45,Furthest
2492,August,2021,Boulder,CO,Passenger,0,1,1,39,40,2.5,Mid-Distance
2493,August,2021,Wahkiakum,WA,Passenger,16,8,24,3079,3103,0.77,Washington
2494,August,2021,Garfield,WA,Truck,0,0,0,1003,1003,0.0,Washington
2495,August,2021,Kern,CA,Passenger,0,1,1,203,204,0.49,Nearest
2496,August,2021,Pierce,WA,Truck,0,0,0,145668,145668,0.0,Washington
2497,August,2021,Walla Walla,WA,Truck,0,0,0,14079,14079,0.0,Washington
2498,August,2021,Philadelphia,PA,Passenger,1,0,1,44,45,2.22,Furthest
2499,August,2021,Arlington,VA,Passenger,0,1,1,133,134,0.75,Furthest
2500,August,2021,Calvert,MD,Passenger,0,2,2,86,88,2.27,Furthest
2501,August,2021,Prince William,VA,Passenger,1,1,2,203,205,0.98,Furthest
2502,August,2021,Anne Arundel,MD,Passenger,4,3,7,374,381,1.84,Furthest
2503,August,2021,Grant,WA,Truck,0,0,0,27997,27997,0.0,Washington
2504,August,2021,Wilson,NC,Passenger,1,0,1,0,1,100.0,Furthest
2505,August,2021,Missoula,MT,Passenger,1,0,1,52,53,1.89,Nearest
2506,August,2021,Wahkiakum,WA,Truck,0,0,0,1801,1801,0.0,Washington
2507,August,2021,Baltimore,MD,Passenger,1,0,1,93,94,1.06,Furthest
2508,August,2021,Cowlitz,WA,Passenger,237,152,389,72118,72507,0.54,Washington
2509,August,2021,Klickitat,WA,Truck,0,0,0,8331,8331,0.0,Washington
2510,August,2021,Montgomery,PA,Passenger,2,0,2,22,24,8.33,Furthest
2511,August,2021,Randolph,NC,Passenger,1,0,1,5,6,16.67,Furthest
2512,August,2021,Stafford,VA,Passenger,2,1,3,98,101,2.97,Furthest
2513,August,2021,Whatcom,WA,Truck,4,0,4,43867,43871,0.01,Washington
2514,August,2021,King,WA,Truck,5,1,6,184053,184059,0.0,Washington
2515,August,2021,Juneau,AK,Passenger,0,1,1,26,27,3.7,Nearest
2516,August,2021,Whitman,WA,Passenger,63,52,115,21930,22045,0.52,Washington
2517,August,2021,Santa Cruz,CA,Passenger,1,0,1,25,26,3.85,Nearest
2518,August,2021,Hudson,NJ,Passenger,1,0,1,41,42,2.38,Furthest
2519,August,2021,Wilson,TX,Passenger,0,1,1,3,4,25.0,Mid-Distance
2520,August,2021,San Juan,WA,Truck,0,0,0,5976,5976,0.0,Washington
2521,August,2021,Polk,FL,Passenger,1,0,1,56,57,1.75,Furthest
2522,August,2021,Virginia Beach,VA,Passenger,2,0,2,602,604,0.33,Furthest
2523,August,2021,Garfield,WA,Passenger,0,3,3,1369,1372,0.22,Washington
2524,August,2021,Snohomish,WA,Truck,1,0,1,126015,126016,0.0,Washington
2525,August,2021,Clackamas,OR,Passenger,2,0,2,167,169,1.18,Nearest
2526,August,2021,Onslow,NC,Passenger,0,1,1,178,179,0.56,Furthest
2527,August,2021,Erie,NY,Passenger,1,0,1,36,37,2.7,Furthest
2528,August,2021,New London,CT,Passenger,1,3,4,214,218,1.83,Furthest
2529,August,2021,Champaign,IL,Passenger,1,0,1,10,11,9.09,Mid-Distance
2530,August,2021,Clallam,WA,Truck,1,0,1,22024,22025,0.0,Washington
2531,August,2021,Flathead,MT,Passenger,1,0,1,42,43,2.33,Nearest
2532,August,2021,Whatcom,WA,Passenger,1520,628,2148,150496,152644,1.41,Washington
2533,August,2021,Carroll,MD,Passenger,0,1,1,17,18,5.56,Furthest
2534,August,2021,Burlington,NJ,Passenger,0,1,1,124,125,0.8,Furthest
2535,August,2021,Spokane,WA,Truck,0,0,0,102463,102463,0.0,Washington
2536,August,2021,Montgomery,OH,Passenger,0,1,1,55,56,1.79,Furthest
2537,August,2021,Skagit,WA,Passenger,620,287,907,91723,92630,0.98,Washington
2538,August,2021,Howard,IN,Passenger,0,1,1,5,6,16.67,Furthest
2539,August,2021,Howard,MD,Passenger,0,1,1,58,59,1.69,Furthest
2540,August,2021,Collin,TX,Passenger,1,1,2,105,107,1.87,Mid-Distance
2541,August,2021,Spokane,WA,Passenger,1158,684,1842,326045,327887,0.56,Washington
2542,August,2021,Franklin,WA,Truck,0,0,0,20720,20720,0.0,Washington
2543,August,2021,Larimer,CO,Passenger,1,0,1,48,49,2.04,Mid-Distance
2544,August,2021,Pacific,WA,Truck,0,0,0,7973,7973,0.0,Washington
2545,August,2021,Yakima,WA,Truck,0,0,0,61772,61772,0.0,Washington
2546,August,2021,Jefferson,NY,Passenger,0,1,1,210,211,0.47,Furthest
2547,August,2021,Montgomery,MD,Passenger,3,1,4,207,211,1.9,Furthest
2548,August,2021,Fairbanks North Star,AK,Passenger,0,1,1,79,80,1.25,Nearest
2549,August,2021,El Paso,TX,Passenger,3,0,3,358,361,0.83,Mid-Distance
2550,August,2021,Kittitas,WA,Truck,0,0,0,14782,14782,0.0,Washington
2551,August,2021,Walla Walla,WA,Passenger,121,82,203,36479,36682,0.55,Washington
2552,August,2021,San Luis Obispo,CA,Passenger,1,0,1,58,59,1.69,Nearest
2553,August,2021,Mason,WA,Passenger,227,147,374,48071,48445,0.77,Washington
2554,August,2021,Dallas,TX,Passenger,1,0,1,144,145,0.69,Mid-Distance
2555,August,2021,Sarasota,FL,Passenger,2,0,2,28,30,6.67,Furthest
2556,August,2021,Clallam,WA,Passenger,350,220,570,50504,51074,1.12,Washington
2557,August,2021,Anchorage,AK,Passenger,1,0,1,132,133,0.75,Nearest
2558,August,2021,Fresno,CA,Passenger,1,0,1,161,162,0.62,Nearest
2559,August,2021,New York,NY,Passenger,1,0,1,39,40,2.5,Furthest
2560,August,2021,Okaloosa,FL,Passenger,0,1,1,111,112,0.89,Furthest
2561,August,2021,Hennepin,MN,Passenger,3,0,3,72,75,4.0,Mid-Distance
2562,August,2021,Okanogan,WA,Passenger,66,45,111,26473,26584,0.42,Washington
2563,August,2021,Travis,TX,Passenger,3,3,6,141,147,4.08,Mid-Distance
2564,August,2021,Maricopa,AZ,Passenger,6,2,8,1098,1106,0.72,Nearest
2565,August,2021,Riverside,CA,Passenger,5,1,6,530,536,1.12,Nearest
2566,August,2021,Gwinnett,GA,Passenger,1,0,1,58,59,1.69,Furthest
2567,August,2021,Louisa,VA,Passenger,0,1,1,1,2,50.0,Furthest
2569,August,2021,Los Angeles,CA,Passenger,10,9,19,849,868,2.19,Nearest
2570,August,2021,Rogers,OK,Passenger,1,0,1,3,4,25.0,Mid-Distance
2571,August,2021,Klamath,OR,Passenger,1,0,1,28,29,3.45,Nearest
2572,August,2021,Salt Lake,UT,Passenger,0,1,1,158,159,0.63,Nearest
2573,August,2021,Las Animas,CO,Passenger,1,0,1,0,1,100.0,Mid-Distance
2574,August,2021,DuPage,IL,Passenger,1,0,1,51,52,1.92,Mid-Distance
2575,August,2021,Kitsap,WA,Passenger,1952,888,2840,180672,183512,1.55,Washington
2576,August,2021,Adams,WA,Passenger,16,14,30,13041,13071,0.23,Washington
2577,August,2021,Skamania,WA,Truck,0,0,0,4036,4036,0.0,Washington
2578,August,2021,Alexandria,VA,Passenger,2,0,2,122,124,1.61,Furthest
2579,August,2021,Grays Harbor,WA,Passenger,177,147,324,49506,49830,0.65,Washington
2580,August,2021,Stevens,WA,Passenger,48,44,92,30285,30377,0.3,Washington
2581,August,2021,San Mateo,CA,Passenger,1,0,1,93,94,1.06,Nearest
2582,August,2021,Rockdale,GA,Passenger,1,0,1,8,9,11.11,Furthest
2583,August,2021,Williamson,TX,Passenger,0,2,2,100,102,1.96,Mid-Distance
2584,August,2021,Pend Oreille,WA,Truck,0,0,0,5726,5726,0.0,Washington
2585,August,2021,Honolulu,HI,Passenger,5,3,8,365,373,2.14,Nearest
2586,August,2021,Klickitat,WA,Passenger,82,51,133,15361,15494,0.86,Washington
2587,August,2021,Multnomah,OR,Passenger,2,7,9,626,635,1.42,Nearest
2588,August,2021,Chelan,WA,Truck,0,0,0,23088,23088,0.0,Washington
2589,August,2021,Denver,CO,Passenger,1,0,1,116,117,0.85,Mid-Distance
2590,August,2021,Leavenworth,KS,Passenger,0,1,1,114,115,0.87,Mid-Distance
2591,August,2021,Broward,FL,Passenger,2,0,2,104,106,1.89,Furthest
2592,August,2021,Plaquemines,LA,Passenger,0,1,1,16,17,5.88,Mid-Distance
2593,August,2021,DeKalb,GA,Passenger,1,0,1,59,60,1.67,Furthest
2594,August,2021,Penobscot,ME,Passenger,0,1,1,8,9,11.11,Furthest
2595,August,2021,Camden,NJ,Passenger,0,1,1,14,15,6.67,Furthest
2596,August,2021,Milwaukee,WI,Passenger,1,0,1,38,39,2.56,Mid-Distance
2597,August,2021,King,WA,Passenger,32289,9551,41840,1365924,1407764,2.97,Washington
2598,August,2021,Yakima,WA,Passenger,248,163,411,168910,169321,0.24,Washington
2599,August,2021,Frederick,MD,Passenger,1,1,2,68,70,2.86,Furthest
2600,August,2021,Powhatan,VA,Passenger,1,0,1,1,2,50.0,Furthest
2601,August,2021,Williams,ND,Passenger,0,1,1,7,8,12.5,Mid-Distance
2602,August,2021,Skagit,WA,Truck,1,0,1,32973,32974,0.0,Washington
2603,August,2021,San Joaquin,CA,Passenger,1,0,1,100,101,0.99,Nearest
2604,August,2021,Lake,FL,Passenger,1,0,1,22,23,4.35,Furthest
2605,August,2021,Harnett,NC,Passenger,1,1,2,162,164,1.22,Furthest
2606,August,2021,Monterey,CA,Passenger,0,1,1,144,145,0.69,Nearest
2607,August,2021,Goochland,VA,Passenger,4,2,6,210,216,2.78,Furthest
2608,August,2021,Ferry,WA,Passenger,9,3,12,4389,4401,0.27,Washington
2609,August,2021,Thurston,WA,Passenger,1715,906,2621,197780,200401,1.31,Washington
2610,August,2021,Yamhill,OR,Passenger,1,0,1,33,34,2.94,Nearest
2611,August,2021,Grant,WA,Passenger,123,96,219,66857,67076,0.33,Washington
2612,August,2021,San Juan,WA,Passenger,452,141,593,14207,14800,4.01,Washington
2613,August,2021,Alameda,CA,Passenger,4,0,4,227,231,1.73,Nearest
2614,August,2021,Sumter,SC,Passenger,0,1,1,36,37,2.7,Furthest
2615,August,2021,Clark,WA,Truck,0,0,0,84180,84180,0.0,Washington
2616,August,2021,Hamilton,IN,Passenger,2,0,2,29,31,6.45,Furthest
2617,August,2021,Clark,NV,Passenger,4,2,6,593,599,1.0,Nearest
2618,August,2021,Lewis,WA,Truck,0,0,0,26748,26748,0.0,Washington
2619,August,2021,El Paso,CO,Passenger,3,0,3,660,663,0.45,Mid-Distance
2620,August,2021,Suffolk,VA,Passenger,1,0,1,124,125,0.8,Furthest
2621,August,2021,Island,WA,Passenger,645,318,963,63236,64199,1.5,Washington
2622,August,2021,Pierce,WA,Passenger,3774,2031,5805,559092,564897,1.03,Washington
2623,August,2021,Harris,TX,Passenger,1,1,2,179,181,1.1,Mid-Distance
2624,August,2021,Ulster,NY,Passenger,1,0,1,8,9,11.11,Furthest
2625,August,2021,Placer,CA,Passenger,2,0,2,70,72,2.78,Nearest
2626,August,2021,Rockingham,NH,Passenger,1,0,1,19,20,5.0,Furthest
2627,August,2021,Denton,TX,Passenger,1,0,1,77,78,1.28,Mid-Distance
2628,August,2021,Saratoga,NY,Passenger,1,0,1,42,43,2.33,Furthest
2629,August,2021,Orange,CA,Passenger,5,2,7,402,409,1.71,Nearest
2630,August,2021,Charles,MD,Passenger,1,1,2,69,71,2.82,Furthest
2631,August,2021,Columbia,WA,Passenger,7,2,9,2458,2467,0.36,Washington
2632,August,2021,St. Louis,MO,Passenger,1,0,1,78,79,1.27,Furthest
2633,August,2021,Cumberland,NC,Passenger,0,2,2,414,416,0.48,Furthest
2634,August,2021,Stevens,WA,Truck,0,0,0,18913,18913,0.0,Washington
2635,August,2021,Jefferson,WA,Truck,0,0,0,9611,9611,0.0,Washington
2636,August,2021,Nassau,NY,Passenger,2,0,2,26,28,7.14,Furthest
2637,August,2021,Clark,WA,Passenger,3072,1473,4545,322091,326636,1.39,Washington
2638,August,2021,District of Columbia,DC,Passenger,5,1,6,198,204,2.94,Furthest
2639,August,2021,Whitman,WA,Truck,0,0,0,8572,8572,0.0,Washington
2640,August,2021,Asotin,WA,Passenger,21,17,38,12728,12766,0.3,Washington
2641,August,2021,Douglas,WA,Truck,0,0,0,12682,12682,0.0,Washington
2642,August,2021,Kittitas,WA,Passenger,173,72,245,29872,30117,0.81,Washington
2643,August,2021,Carson City,NV,Passenger,1,0,1,10,11,9.09,Nearest
2644,August,2021,Cook,IL,Passenger,1,0,1,201,202,0.5,Mid-Distance
2645,August,2021,Danville,VA,Passenger,1,0,1,0,1,100.0,Furthest
2646,August,2021,Washington,MD,Passenger,2,0,2,13,15,13.33,Furthest
2647,August,2021,Essex,NJ,Passenger,2,0,2,10,12,16.67,Furthest
2648,August,2021,Harrison,MS,Passenger,2,0,2,51,53,3.77,Mid-Distance
2649,August,2021,Loudoun,VA,Passenger,1,0,1,72,73,1.37,Furthest
2650,August,2021,Richmond,GA,Passenger,0,1,1,73,74,1.35,Furthest
2651,August,2021,Lincoln,WA,Truck,0,0,0,4773,4773,0.0,Washington
2652,August,2021,Shelby,OH,Passenger,0,1,1,2,3,33.33,Furthest
2653,August,2021,Richland,SC,Passenger,0,1,1,132,133,0.75,Furthest
2654,August,2021,Cowlitz,WA,Truck,0,1,1,29085,29086,0.0,Washington
2655,August,2021,Lincoln,WA,Passenger,7,15,22,7695,7717,0.29,Washington
2656,August,2021,Spartanburg,SC,Passenger,0,1,1,49,50,2.0,Furthest
2657,August,2021,Chesapeake,VA,Passenger,0,4,4,384,388,1.03,Furthest
2658,August,2021,Nueces,TX,Passenger,1,0,1,67,68,1.47,Mid-Distance
2659,August,2021,Ferry,WA,Truck,0,0,0,3632,3632,0.0,Washington
2660,August,2021,Sedgwick,KS,Passenger,1,1,2,79,81,2.47,Mid-Distance
2661,August,2021,Washington,OR,Passenger,1,0,1,368,369,0.27,Nearest
2662,August,2021,Fairfax,VA,Passenger,5,4,9,676,685,1.31,Furthest
2663,August,2021,Contra Costa,CA,Passenger,2,4,6,260,266,2.26,Nearest
2664,August,2021,Middlesex,MA,Passenger,1,1,2,91,93,2.15,Furthest
2665,August,2021,Bartow,GA,Passenger,0,1,1,3,4,25.0,Furthest
2666,August,2021,Pend Oreille,WA,Passenger,16,7,23,9243,9266,0.25,Washington
2667,August,2021,Oldham,KY,Passenger,0,1,1,4,5,20.0,Furthest
2668,August,2021,Hillsborough,FL,Passenger,0,1,1,143,144,0.69,Furthest
2669,August,2021,Kings,CA,Passenger,1,0,1,321,322,0.31,Nearest
2670,August,2021,Douglas,NE,Passenger,1,1,2,50,52,3.85,Mid-Distance
2671,August,2021,Vigo,IN,Passenger,1,0,1,5,6,16.67,Furthest
2672,August,2021,Orange,FL,Passenger,1,0,1,109,110,0.91,Furthest
2673,August,2021,St. Clair,IL,Passenger,2,0,2,131,133,1.5,Mid-Distance
2674,August,2021,Hawaii,HI,Passenger,1,0,1,44,45,2.22,Nearest
2675,August,2021,Lee,FL,Passenger,1,0,1,34,35,2.86,Furthest
2676,August,2021,Boone,MO,Passenger,0,1,1,10,11,9.09,Furthest
2677,August,2021,Kauai,HI,Passenger,1,0,1,18,19,5.26,Nearest
2678,August,2021,Ray,MO,Passenger,0,1,1,1,2,50.0,Furthest
2679,August,2021,Cape May,NJ,Passenger,0,1,1,8,9,11.11,Furthest
2680,August,2021,Manassas,VA,Passenger,0,1,1,7,8,12.5,Furthest
2681,August,2021,Platte,MO,Passenger,1,0,1,16,17,5.88,Furthest
2682,August,2021,Franklin,WA,Passenger,139,99,238,61954,62192,0.38,Washington
2683,August,2021,Adams,WA,Truck,0,0,0,5413,5413,0.0,Washington
2684,August,2021,Pima,AZ,Passenger,1,1,2,259,261,0.77,Nearest
2685,August,2021,Saginaw,MI,Passenger,1,0,1,6,7,14.29,Furthest
2686,August,2021,Allen,IN,Passenger,1,0,1,15,16,6.25,Furthest
2687,August,2021,Asotin,WA,Truck,0,0,0,6755,6755,0.0,Washington
2688,August,2021,Charleston,SC,Passenger,1,1,2,80,82,2.44,Furthest
2689,August,2021,Kitsap,WA,Truck,0,0,0,54394,54394,0.0,Washington
2690,August,2021,Duval,FL,Passenger,0,2,2,329,331,0.6,Furthest
2691,August,2021,Ventura,CA,Passenger,1,2,3,251,254,1.18,Nearest
2692,August,2021,Escambia,FL,Passenger,0,1,1,143,144,0.69,Furthest
2693,August,2021,Douglas,WA,Passenger,103,51,154,28575,28729,0.54,Washington
2694,August,2021,Grays Harbor,WA,Truck,0,0,0,21395,21395,0.0,Washington
2695,August,2021,Bucks,PA,Passenger,1,0,1,14,15,6.67,Furthest
2696,August,2021,Arapahoe,CO,Passenger,1,0,1,104,105,0.95,Mid-Distance
2697,August,2021,RÃ­o Grande,PR,Passenger,1,0,1,0,1,100.0,Mid-Distance
2698,August,2021,Jefferson,WA,Passenger,350,183,533,24858,25391,2.1,Washington
2699,August,2021,Allegheny,PA,Passenger,1,1,2,61,63,3.17,Furthest
2700,August,2021,Wake,NC,Passenger,1,0,1,119,120,0.83,Furthest
2701,August,2021,Montgomery,TX,Passenger,1,1,2,38,40,5.0,Mid-Distance
2702,August,2021,Mason,WA,Truck,0,0,0,21324,21324,0.0,Washington
2703,August,2021,Lane,OR,Passenger,0,1,1,119,120,0.83,Nearest
2704,August,2021,Benton,WA,Passenger,567,409,976,136208,137184,0.71,Washington
2705,August,2021,Okanogan,WA,Truck,0,0,0,16752,16752,0.0,Washington
2706,August,2021,St. Mary's,MD,Passenger,1,0,1,203,204,0.49,Furthest
2707,August,2021,Prince George's,MD,Passenger,2,1,3,137,140,2.14,Furthest
2708,August,2021,Pacific,WA,Passenger,48,54,102,16069,16171,0.63,Washington
2709,August,2021,Douglas,CO,Passenger,0,1,1,75,76,1.32,Mid-Distance
2710,August,2021,Pinellas,FL,Passenger,0,1,1,90,91,1.1,Furthest
2711,August,2021,Benton,WA,Truck,0,0,0,43605,43605,0.0,Washington
2712,August,2021,Bexar,TX,Passenger,3,4,7,506,513,1.36,Mid-Distance
2713,August,2022,Hudson,NJ,Passenger,2,0,2,31,33,6.06,Furthest
2714,August,2022,Pierce,WA,Truck,34,0,34,140861,140895,0.02,Washington
2715,August,2022,Jefferson,NY,Passenger,0,1,1,196,197,0.51,Furthest
2716,August,2022,Virginia Beach,VA,Passenger,2,0,2,490,492,0.41,Furthest
2717,August,2022,Cook,IL,Passenger,2,0,2,175,177,1.13,Mid-Distance
2718,August,2022,Arapahoe,CO,Passenger,0,1,1,72,73,1.37,Mid-Distance
2719,August,2022,Thurston,WA,Truck,17,0,17,55162,55179,0.03,Washington
2720,August,2022,Douglas,NE,Passenger,1,2,3,35,38,7.89,Mid-Distance
2721,August,2022,Coryell,TX,Passenger,1,0,1,89,90,1.11,Mid-Distance
2722,August,2022,Philadelphia,PA,Passenger,1,0,1,35,36,2.78,Furthest
2723,August,2022,Wilson,TX,Passenger,0,1,1,2,3,33.33,Mid-Distance
2724,August,2022,Lake,IL,Passenger,2,0,2,123,125,1.6,Mid-Distance
2725,August,2022,Oldham,KY,Passenger,0,1,1,4,5,20.0,Furthest
2726,August,2022,Orange,FL,Passenger,1,0,1,79,80,1.25,Furthest
2727,August,2022,Yakima,WA,Truck,1,0,1,61393,61394,0.0,Washington
2728,August,2022,Bartow,GA,Passenger,0,1,1,3,4,25.0,Furthest
2729,August,2022,Montgomery,PA,Passenger,1,0,1,20,21,4.76,Furthest
2730,August,2022,Honolulu,HI,Passenger,3,3,6,309,315,1.9,Nearest
2731,August,2022,Sumter,SC,Passenger,0,1,1,32,33,3.03,Furthest
2732,August,2022,Penobscot,ME,Passenger,0,1,1,8,9,11.11,Furthest
2733,August,2022,Santa Clara,CA,Passenger,10,2,12,203,215,5.58,Nearest
2734,August,2022,Ferry,WA,Truck,0,0,0,3585,3585,0.0,Washington
2735,August,2022,Juneau,AK,Passenger,0,1,1,28,29,3.45,Nearest
2736,August,2022,Bexar,TX,Passenger,5,3,8,412,420,1.9,Mid-Distance
2737,August,2022,Williamson,TX,Passenger,0,2,2,76,78,2.56,Mid-Distance
2738,August,2022,Marin,CA,Passenger,0,1,1,27,28,3.57,Nearest
2739,August,2022,Spokane,WA,Truck,10,0,10,102018,102028,0.01,Washington
2740,August,2022,Richmond,NY,Passenger,1,0,1,6,7,14.29,Furthest
2741,August,2022,Lewis,WA,Truck,0,0,0,26330,26330,0.0,Washington
2742,August,2022,Snohomish,WA,Passenger,8928,2595,11523,531276,542799,2.12,Washington
2743,August,2022,Okanogan,WA,Passenger,88,48,136,26317,26453,0.51,Washington
2744,August,2022,District of Columbia,DC,Passenger,4,0,4,162,166,2.41,Furthest
2745,August,2022,Douglas,WA,Passenger,141,60,201,28384,28585,0.7,Washington
2746,August,2022,Pend Oreille,WA,Truck,0,0,0,5635,5635,0.0,Washington
2747,August,2022,Anne Arundel,MD,Passenger,4,4,8,324,332,2.41,Furthest
2748,August,2022,Lincoln,OR,Passenger,0,1,1,22,23,4.35,Nearest
2749,August,2022,Garfield,WA,Passenger,1,3,4,1322,1326,0.3,Washington
2750,August,2022,Tarrant,TX,Passenger,1,0,1,99,100,1.0,Mid-Distance
2751,August,2022,Yellowstone,MT,Passenger,0,1,1,20,21,4.76,Nearest
2752,August,2022,Garfield,WA,Truck,0,0,0,977,977,0.0,Washington
2753,August,2022,Jackson,OK,Passenger,0,1,1,32,33,3.03,Mid-Distance
2754,August,2022,Sonoma,CA,Passenger,0,1,1,69,70,1.43,Nearest
2755,August,2022,Cumberland,PA,Passenger,1,0,1,35,36,2.78,Furthest
2756,August,2022,Walla Walla,WA,Passenger,179,104,283,35818,36101,0.78,Washington
2757,August,2022,Charles,MD,Passenger,1,1,2,53,55,3.64,Furthest
2758,August,2022,Placer,CA,Passenger,2,0,2,63,65,3.08,Nearest
2759,August,2022,Goochland,VA,Passenger,1,1,2,95,97,2.06,Furthest
2760,August,2022,Island,WA,Truck,9,0,9,21330,21339,0.04,Washington
2761,August,2022,Pacific,WA,Passenger,70,72,142,15797,15939,0.89,Washington
2762,August,2022,Albemarle,VA,Passenger,1,0,1,16,17,5.88,Furthest
2763,August,2022,Prince George's,MD,Passenger,3,1,4,113,117,3.42,Furthest
2764,August,2022,Loudoun,VA,Passenger,2,1,3,62,65,4.62,Furthest
2765,August,2022,Ferry,WA,Passenger,20,4,24,4399,4423,0.54,Washington
2766,August,2022,Hawaii,HI,Passenger,1,0,1,31,32,3.12,Nearest
2767,August,2022,Moore,NC,Passenger,0,1,1,107,108,0.93,Furthest
2768,August,2022,Kings,CA,Passenger,2,1,3,290,293,1.02,Nearest
2769,August,2022,Asotin,WA,Truck,0,0,0,6695,6695,0.0,Washington
2770,August,2022,Bell,TX,Passenger,1,0,1,295,296,0.34,Mid-Distance
2771,August,2022,Washington,MD,Passenger,2,0,2,15,17,11.76,Furthest
2772,August,2022,Kittitas,WA,Passenger,284,88,372,29610,29982,1.24,Washington
2773,August,2022,Norfolk,VA,Passenger,2,3,5,274,279,1.79,Furthest
2774,August,2022,Montgomery,AL,Passenger,0,1,1,32,33,3.03,Furthest
2775,August,2022,El Paso,TX,Passenger,2,0,2,309,311,0.64,Mid-Distance
2776,August,2022,Columbia,WA,Truck,0,0,0,1574,1574,0.0,Washington
2777,August,2022,Sarpy,NE,Passenger,1,0,1,49,50,2.0,Mid-Distance
2778,August,2022,Pennington,SD,Passenger,2,0,2,23,25,8.0,Mid-Distance
2779,August,2022,Harnett,NC,Passenger,2,0,2,140,142,1.41,Furthest
2780,August,2022,Multnomah,OR,Passenger,0,3,3,495,498,0.6,Nearest
2781,August,2022,Denton,TX,Passenger,1,0,1,57,58,1.72,Mid-Distance
2782,August,2022,Benton,WA,Passenger,815,471,1286,135382,136668,0.94,Washington
2783,August,2022,Kitsap,WA,Passenger,2523,1093,3616,177977,181593,1.99,Washington
2784,August,2022,Elmore,ID,Passenger,1,0,1,12,13,7.69,Nearest
2785,August,2022,Gwinnett,GA,Passenger,1,0,1,50,51,1.96,Furthest
2786,August,2022,Douglas,WA,Truck,1,0,1,12758,12759,0.01,Washington
2787,August,2022,Rockdale,GA,Passenger,1,0,1,6,7,14.29,Furthest
2788,August,2022,Jefferson,WA,Passenger,453,223,676,24508,25184,2.68,Washington
2789,August,2022,Spokane,WA,Passenger,1743,881,2624,324740,327364,0.8,Washington
2790,August,2022,Jefferson,WA,Truck,3,0,3,9424,9427,0.03,Washington
2791,August,2022,Solano,CA,Passenger,2,0,2,151,153,1.31,Nearest
2792,August,2022,Adams,WA,Truck,1,0,1,5434,5435,0.02,Washington
2793,August,2022,San Joaquin,CA,Passenger,1,1,2,80,82,2.44,Nearest
2794,August,2022,Platte,MO,Passenger,1,0,1,21,22,4.55,Furthest
2795,August,2022,Island,WA,Passenger,858,380,1238,61876,63114,1.96,Washington
2796,August,2022,Columbia,WA,Passenger,8,0,8,2437,2445,0.33,Washington
2797,August,2022,Hoke,NC,Passenger,1,0,1,62,63,1.59,Furthest
2798,August,2022,Lincoln,WA,Truck,0,0,0,4846,4846,0.0,Washington
2799,August,2022,King,WA,Passenger,42950,11640,54590,1346237,1400827,3.9,Washington
2800,August,2022,Pulaski,AR,Passenger,1,0,1,27,28,3.57,Mid-Distance
2801,August,2022,Hennepin,MN,Passenger,1,0,1,45,46,2.17,Mid-Distance
2802,August,2022,Harris,TX,Passenger,1,0,1,125,126,0.79,Mid-Distance
2803,August,2022,New London,CT,Passenger,2,5,7,186,193,3.63,Furthest
2804,August,2022,Burlington,NJ,Passenger,0,2,2,101,103,1.94,Furthest
2805,August,2022,Lake,FL,Passenger,1,0,1,16,17,5.88,Furthest
2806,August,2022,Montgomery,MD,Passenger,4,2,6,184,190,3.16,Furthest
2807,August,2022,Allen,IN,Passenger,1,0,1,12,13,7.69,Furthest
2808,August,2022,Douglas,CO,Passenger,0,1,1,63,64,1.56,Mid-Distance
2809,August,2022,Klickitat,WA,Passenger,106,54,160,15196,15356,1.04,Washington
2810,August,2022,San Juan,WA,Passenger,530,162,692,13993,14685,4.71,Washington
2811,August,2022,Frederick,MD,Passenger,1,0,1,57,58,1.72,Furthest
2812,August,2022,Grays Harbor,WA,Passenger,218,163,381,48843,49224,0.77,Washington
2813,August,2022,Sheridan,WY,Passenger,1,0,1,6,7,14.29,Nearest
2814,August,2022,Cumberland,NC,Passenger,1,2,3,334,337,0.89,Furthest
2815,August,2022,Travis,TX,Passenger,1,0,1,93,94,1.06,Mid-Distance
2816,August,2022,Hidalgo,TX,Passenger,0,1,1,53,54,1.85,Mid-Distance
2817,August,2022,Suffolk,VA,Passenger,1,0,1,118,119,0.84,Furthest
2818,August,2022,Carroll,MD,Passenger,0,1,1,16,17,5.88,Furthest
2819,August,2022,Sevier,AR,Passenger,0,1,1,0,1,100.0,Mid-Distance
2820,August,2022,Cape May,NJ,Passenger,0,1,1,7,8,12.5,Furthest
2821,August,2022,Kittitas,WA,Truck,3,0,3,14621,14624,0.02,Washington
2822,August,2022,Pierce,WA,Passenger,5429,2399,7828,542983,550811,1.42,Washington
2823,August,2022,St. Mary's,MD,Passenger,1,0,1,180,181,0.55,Furthest
2824,August,2022,Adams,WA,Passenger,21,9,30,12974,13004,0.23,Washington
2825,August,2022,Grant,WA,Passenger,198,106,304,66772,67076,0.45,Washington
2826,August,2022,Fort Bend,TX,Passenger,1,0,1,24,25,4.0,Mid-Distance
2827,August,2022,Riverside,CA,Passenger,7,1,8,426,434,1.84,Nearest
2828,August,2022,Alexandria,VA,Passenger,3,0,3,102,105,2.86,Furthest
2829,August,2022,San Bernardino,CA,Passenger,1,1,2,302,304,0.66,Nearest
2830,August,2022,Escambia,FL,Passenger,0,1,1,124,125,0.8,Furthest
2831,August,2022,Rogers,OK,Passenger,1,0,1,1,2,50.0,Mid-Distance
2832,August,2022,Sedgwick,KS,Passenger,1,1,2,65,67,2.99,Mid-Distance
2833,August,2022,Wahkiakum,WA,Truck,1,0,1,1802,1803,0.06,Washington
2834,August,2022,Miami-Dade,FL,Passenger,1,0,1,72,73,1.37,Furthest
2835,August,2022,Contra Costa,CA,Passenger,0,4,4,227,231,1.73,Nearest
2836,August,2022,Sacramento,CA,Passenger,3,0,3,184,187,1.6,Nearest
2837,August,2022,Klickitat,WA,Truck,2,0,2,8267,8269,0.02,Washington
2838,August,2022,Okanogan,WA,Truck,1,0,1,16543,16544,0.01,Washington
2839,August,2022,Boulder,CO,Passenger,1,0,1,31,32,3.12,Mid-Distance
2840,August,2022,Adams,CO,Passenger,1,0,1,38,39,2.56,Mid-Distance
2841,August,2022,Clark,WA,Truck,17,0,17,82407,82424,0.02,Washington
2842,August,2022,Franklin,WA,Passenger,224,113,337,61955,62292,0.54,Washington
2843,August,2022,Lewis,WA,Passenger,243,177,420,59723,60143,0.7,Washington
2844,August,2022,Wood,OH,Passenger,0,1,1,3,4,25.0,Furthest
2845,August,2022,Clackamas,OR,Passenger,2,0,2,128,130,1.54,Nearest
2846,August,2022,Kauai,HI,Passenger,1,0,1,14,15,6.67,Nearest
2847,August,2022,Stevens,WA,Passenger,76,56,132,30060,30192,0.44,Washington
2848,August,2022,San Juan,WA,Truck,5,0,5,5953,5958,0.08,Washington
2849,August,2022,King,WA,Truck,204,2,206,180057,180263,0.11,Washington
2850,August,2022,Randolph,NC,Passenger,1,0,1,5,6,16.67,Furthest
2851,August,2022,Las Animas,CO,Passenger,1,0,1,1,2,50.0,Mid-Distance
2852,August,2022,Wahkiakum,WA,Passenger,24,12,36,3080,3116,1.16,Washington
2853,August,2022,Camden,NJ,Passenger,0,1,1,12,13,7.69,Furthest
2854,August,2022,Skagit,WA,Passenger,855,348,1203,89814,91017,1.32,Washington
2855,August,2022,Middlesex,MA,Passenger,2,1,3,66,69,4.35,Furthest
2856,August,2022,St. Louis,MO,Passenger,1,0,1,57,58,1.72,Furthest
2857,August,2022,Kootenai,ID,Truck,1,0,1,33,34,2.94,Nearest
2858,August,2022,Ray,MO,Passenger,0,1,1,1,2,50.0,Furthest
2859,August,2022,Asotin,WA,Passenger,24,18,42,12617,12659,0.33,Washington
2860,August,2022,Essex,NJ,Passenger,2,0,2,8,10,20.0,Furthest
2861,August,2022,Carroll,NH,Passenger,0,1,1,5,6,16.67,Furthest
2862,August,2022,El Paso,CO,Passenger,3,1,4,561,565,0.71,Mid-Distance
2863,August,2022,Rockingham,NH,Passenger,1,0,1,14,15,6.67,Furthest
2864,August,2022,Clallam,WA,Truck,4,0,4,21879,21883,0.02,Washington
2865,August,2022,Alameda,CA,Passenger,4,0,4,174,178,2.25,Nearest
2866,August,2022,Franklin,WA,Truck,2,0,2,20905,20907,0.01,Washington
2867,August,2022,San Mateo,CA,Passenger,1,0,1,70,71,1.41,Nearest
2868,August,2022,Skamania,WA,Truck,0,0,0,3906,3906,0.0,Washington
2869,August,2022,Nueces,TX,Passenger,1,1,2,50,52,3.85,Mid-Distance
2870,August,2022,Orange,CA,Passenger,6,2,8,321,329,2.43,Nearest
2871,August,2022,Cowlitz,WA,Passenger,353,172,525,70460,70985,0.74,Washington
2872,August,2022,Mason,WA,Passenger,330,177,507,47021,47528,1.07,Washington
2873,August,2022,Thurston,WA,Passenger,2326,1086,3412,193178,196590,1.74,Washington
2874,August,2022,Dorchester,SC,Passenger,1,0,1,48,49,2.04,Furthest
2875,August,2022,Bryan,GA,Passenger,0,1,1,36,37,2.7,Furthest
2876,August,2022,Broward,FL,Passenger,1,0,1,68,69,1.45,Furthest
2877,August,2022,Grays Harbor,WA,Truck,2,0,2,21214,21216,0.01,Washington
2878,August,2022,Berkeley,SC,Passenger,0,1,1,112,113,0.88,Furthest
2879,August,2022,Pacific,WA,Truck,0,0,0,7860,7860,0.0,Washington
2880,August,2022,Hillsborough,FL,Passenger,0,1,1,113,114,0.88,Furthest
2881,August,2022,Fairbanks North Star,AK,Passenger,0,1,1,67,68,1.47,Nearest
2882,August,2022,Spartanburg,SC,Passenger,0,1,1,35,36,2.78,Furthest
2883,August,2022,St. Tammany,LA,Passenger,1,0,1,33,34,2.94,Mid-Distance
2884,August,2022,Stevens,WA,Truck,1,0,1,18926,18927,0.01,Washington
2885,August,2022,Saratoga,NY,Passenger,1,0,1,39,40,2.5,Furthest
2886,August,2022,Whatcom,WA,Truck,13,0,13,43149,43162,0.03,Washington
2887,August,2022,Houston,GA,Passenger,1,0,1,31,32,3.12,Furthest
2888,August,2022,Owyhee,ID,Passenger,1,0,1,2,3,33.33,Nearest
2889,August,2022,Leavenworth,KS,Passenger,0,1,1,93,94,1.06,Mid-Distance
2890,August,2022,Chelan,WA,Truck,5,0,5,23065,23070,0.02,Washington
2891,August,2022,St. Clair,IL,Passenger,2,0,2,113,115,1.74,Mid-Distance
2892,August,2022,Pend Oreille,WA,Passenger,18,12,30,9031,9061,0.33,Washington
2893,August,2022,Portsmouth,VA,Passenger,0,1,1,73,74,1.35,Furthest
2894,August,2022,Anchorage,AK,Passenger,1,0,1,111,112,0.89,Nearest
2895,August,2022,New Haven,CT,Passenger,0,2,2,25,27,7.41,Furthest
2896,August,2022,Queens,NY,Passenger,1,0,1,37,38,2.63,Furthest
2897,August,2022,Geary,KS,Passenger,1,0,1,81,82,1.22,Mid-Distance
2898,August,2022,Whitman,WA,Truck,2,0,2,8568,8570,0.02,Washington
2899,August,2022,Stafford,VA,Passenger,2,1,3,83,86,3.49,Furthest
2900,August,2022,Chesapeake,VA,Passenger,3,3,6,312,318,1.89,Furthest
2901,August,2022,Collin,TX,Passenger,2,0,2,72,74,2.7,Mid-Distance
2902,August,2022,Plaquemines,LA,Passenger,1,1,2,16,18,11.11,Mid-Distance
2903,August,2022,Cowlitz,WA,Truck,2,0,2,28458,28460,0.01,Washington
2904,August,2022,Fairfax,VA,Passenger,6,3,9,585,594,1.52,Furthest
2905,August,2022,Lee,FL,Passenger,1,0,1,25,26,3.85,Furthest
2906,August,2022,Howard,MD,Passenger,0,1,1,51,52,1.92,Furthest
2907,August,2022,Galveston,TX,Passenger,0,1,1,18,19,5.26,Mid-Distance
2908,August,2022,Snohomish,WA,Truck,45,0,45,123227,123272,0.04,Washington
2909,August,2022,Los Angeles,CA,Passenger,7,7,14,717,731,1.92,Nearest
2910,August,2022,Clark,NV,Passenger,4,2,6,464,470,1.28,Nearest
2911,August,2022,Arlington,VA,Passenger,1,0,1,120,121,0.83,Furthest
2912,August,2022,Whitman,WA,Passenger,94,62,156,22009,22165,0.7,Washington
2913,August,2022,Manassas,VA,Passenger,0,1,1,8,9,11.11,Furthest
2914,August,2022,Harrison,MS,Passenger,1,0,1,36,37,2.7,Mid-Distance
2915,August,2022,Onslow,NC,Passenger,0,1,1,157,158,0.63,Furthest
2916,August,2022,Kern,CA,Passenger,0,1,1,187,188,0.53,Nearest
2917,August,2022,Danville,VA,Passenger,1,0,1,0,1,100.0,Furthest
2918,August,2022,Santa Cruz,CA,Passenger,1,0,1,20,21,4.76,Nearest
2919,August,2022,Lincoln,WA,Passenger,9,16,25,7697,7722,0.32,Washington
2920,August,2022,San Diego,CA,Passenger,18,10,28,2167,2195,1.28,Nearest
2921,August,2022,Monterey,CA,Passenger,1,1,2,125,127,1.57,Nearest
2922,August,2022,Rock Island,IL,Passenger,0,1,1,15,16,6.25,Mid-Distance
2923,August,2022,Calvert,MD,Passenger,0,2,2,74,76,2.63,Furthest
2924,August,2022,Whatcom,WA,Passenger,1915,766,2681,148907,151588,1.77,Washington
2926,August,2022,Fairfax,VA,Truck,1,0,1,109,110,0.91,Furthest
2927,August,2022,Allegheny,PA,Passenger,1,1,2,50,52,3.85,Furthest
2928,August,2022,Salt Lake,UT,Passenger,1,1,2,115,117,1.71,Nearest
2929,August,2022,Louisa,VA,Passenger,0,1,1,1,2,50.0,Furthest
2930,August,2022,Maricopa,AZ,Passenger,7,1,8,808,816,0.98,Nearest
2931,August,2022,Okaloosa,FL,Passenger,0,1,1,94,95,1.05,Furthest
2932,August,2022,Wichita,TX,Passenger,2,0,2,37,39,5.13,Mid-Distance
2933,August,2022,Hamilton,IN,Passenger,1,0,1,16,17,5.88,Furthest
2934,August,2022,Walla Walla,WA,Truck,2,0,2,13914,13916,0.01,Washington
2935,August,2022,Clark,WA,Passenger,4348,1852,6200,315595,321795,1.93,Washington
2936,August,2022,Charleston,SC,Passenger,2,2,4,59,63,6.35,Furthest
2937,August,2022,Ventura,CA,Passenger,2,1,3,221,224,1.34,Nearest
2938,August,2022,Chelan,WA,Passenger,487,134,621,54190,54811,1.13,Washington
2939,August,2022,Hamilton,OH,Passenger,1,0,1,27,28,3.57,Furthest
2940,August,2022,Nassau,NY,Passenger,2,0,2,23,25,8.0,Furthest
2941,August,2022,Skagit,WA,Truck,5,0,5,32237,32242,0.02,Washington
2942,August,2022,Skamania,WA,Passenger,82,50,132,8155,8287,1.59,Washington
2943,August,2022,Sarasota,FL,Passenger,2,0,2,22,24,8.33,Furthest
2944,August,2022,Grant,WA,Truck,1,0,1,27998,27999,0.0,Washington
2945,August,2022,DeKalb,GA,Passenger,1,0,1,44,45,2.22,Furthest
2946,August,2022,Yakima,WA,Passenger,364,204,568,166544,167112,0.34,Washington
2947,August,2022,Kitsap,WA,Truck,19,0,19,53291,53310,0.04,Washington
2948,August,2022,Richmond,GA,Passenger,0,1,1,59,60,1.67,Furthest
2949,August,2022,Ulster,NY,Passenger,1,0,1,7,8,12.5,Furthest
2950,August,2022,Mason,WA,Truck,4,0,4,20986,20990,0.02,Washington
2951,August,2022,Lane,OR,Passenger,0,1,1,84,85,1.18,Nearest
2952,August,2022,Clallam,WA,Passenger,435,247,682,49540,50222,1.36,Washington
2953,August,2022,Duval,FL,Passenger,1,2,3,258,261,1.15,Furthest
2954,August,2022,Williams,ND,Passenger,0,1,1,5,6,16.67,Mid-Distance
2955,August,2022,Benton,WA,Truck,5,0,5,43422,43427,0.01,Washington
2956,December,2017,Wahkiakum,WA,Passenger,0,2,2,2860,2862,0.07,Washington
2957,December,2017,Sangamon,IL,Passenger,1,0,1,10,11,9.09,Mid-Distance
2958,December,2017,Franklin,WA,Truck,0,0,0,18492,18492,0.0,Washington
2959,December,2017,San Juan,WA,Passenger,132,43,175,13853,14028,1.25,Washington
2960,December,2017,Jefferson,WA,Truck,0,0,0,9475,9475,0.0,Washington
2961,December,2017,DuPage,IL,Passenger,1,0,1,61,62,1.61,Mid-Distance
2962,December,2017,Lincoln,WA,Passenger,2,5,7,7569,7576,0.09,Washington
2963,December,2017,Montgomery,TN,Passenger,1,0,1,269,270,0.37,Furthest
2964,December,2017,Okanogan,WA,Passenger,7,18,25,25740,25765,0.1,Washington
2965,December,2017,Marin,CA,Passenger,1,0,1,58,59,1.69,Nearest
2966,December,2017,Tarrant,TX,Passenger,1,0,1,228,229,0.44,Mid-Distance
2967,December,2017,Orange,CA,Passenger,3,1,4,576,580,0.69,Nearest
2968,December,2017,Richmond,GA,Passenger,0,1,1,93,94,1.06,Furthest
2969,December,2017,Whitman,WA,Passenger,17,20,37,22426,22463,0.16,Washington
2970,December,2017,Kittitas,WA,Passenger,35,26,61,28449,28510,0.21,Washington
2971,December,2017,Duval,FL,Passenger,1,2,3,370,373,0.8,Furthest
2972,December,2017,Alameda,CA,Passenger,0,1,1,352,353,0.28,Nearest
2973,December,2017,Stevens,WA,Truck,0,0,0,18379,18379,0.0,Washington
2974,December,2017,Santa Rosa,FL,Passenger,1,0,1,103,104,0.96,Furthest
2975,December,2017,Palm Beach,FL,Passenger,0,1,1,90,91,1.1,Furthest
2976,December,2017,Multnomah,OR,Passenger,3,3,6,879,885,0.68,Nearest
2977,December,2017,Hamilton,IN,Passenger,1,0,1,54,55,1.82,Furthest
2978,December,2017,Lewis,WA,Passenger,54,40,94,56571,56665,0.17,Washington
2979,December,2017,Yakima,WA,Passenger,59,75,134,162075,162209,0.08,Washington
2980,December,2017,Stevens,WA,Passenger,10,21,31,31533,31564,0.1,Washington
2981,December,2017,Deschutes,OR,Passenger,1,0,1,178,179,0.56,Nearest
2982,December,2017,Columbia,WA,Truck,0,0,0,1540,1540,0.0,Washington
2983,December,2017,King,WA,Truck,8,1,9,185056,185065,0.0,Washington
2984,December,2017,Polk,FL,Passenger,1,0,1,61,62,1.61,Furthest
2985,December,2017,Pend Oreille,WA,Truck,0,0,0,5618,5618,0.0,Washington
2986,December,2017,Twin Falls,ID,Passenger,0,1,1,24,25,4.0,Nearest
2987,December,2017,Canyon,ID,Passenger,0,1,1,92,93,1.08,Nearest
2988,December,2017,Asotin,WA,Truck,0,0,0,6543,6543,0.0,Washington
2989,December,2017,Fulton,GA,Passenger,1,0,1,106,107,0.93,Furthest
2990,December,2017,Moore,NC,Passenger,0,1,1,199,200,0.5,Furthest
2991,December,2017,Manatee,FL,Passenger,1,0,1,39,40,2.5,Furthest
2992,December,2017,Clallam,WA,Passenger,99,91,190,49056,49246,0.39,Washington
2993,December,2017,Columbia,WA,Passenger,2,1,3,2403,2406,0.12,Washington
2994,December,2017,Garfield,WA,Truck,0,0,0,943,943,0.0,Washington
2995,December,2017,Kitsap,WA,Truck,1,0,1,52687,52688,0.0,Washington
2996,December,2017,Klickitat,WA,Truck,0,0,0,8003,8003,0.0,Washington
2997,December,2017,Hardin,KY,Passenger,0,1,1,119,120,0.83,Furthest
2998,December,2017,Snohomish,WA,Passenger,2016,1051,3067,516915,519982,0.59,Washington
2999,December,2017,Sacramento,CA,Passenger,1,0,1,311,312,0.32,Nearest
3000,December,2017,Pacific,WA,Truck,0,0,0,7545,7545,0.0,Washington
3001,December,2017,Whatcom,WA,Passenger,532,227,759,145194,145953,0.52,Washington
3002,December,2017,Clark,WA,Truck,0,0,0,78388,78388,0.0,Washington
3003,December,2017,Gwinnett,GA,Passenger,0,1,1,83,84,1.19,Furthest
3004,December,2017,Prince William,VA,Passenger,0,3,3,271,274,1.09,Furthest
3005,December,2017,Howard,MD,Passenger,0,2,2,87,89,2.25,Furthest
3006,December,2017,Okaloosa,FL,Passenger,1,0,1,184,185,0.54,Furthest
3007,December,2017,Norfolk,MA,Passenger,1,0,1,38,39,2.56,Furthest
3008,December,2017,Grays Harbor,WA,Truck,0,0,0,20064,20064,0.0,Washington
3009,December,2017,Lee,AL,Passenger,1,0,1,37,38,2.63,Furthest
3010,December,2017,Contra Costa,CA,Passenger,0,1,1,467,468,0.21,Nearest
3011,December,2017,Monterey,CA,Passenger,0,2,2,191,193,1.04,Nearest
3012,December,2017,Albemarle,VA,Passenger,0,1,1,32,33,3.03,Furthest
3013,December,2017,Santa Clara,CA,Passenger,7,1,8,383,391,2.05,Nearest
3014,December,2017,Ramsey,MN,Passenger,1,0,1,38,39,2.56,Mid-Distance
3015,December,2017,Benton,WA,Passenger,172,168,340,130229,130569,0.26,Washington
3016,December,2017,Travis,TX,Passenger,0,1,1,188,189,0.53,Mid-Distance
3017,December,2017,Douglas,WA,Truck,0,0,0,11757,11757,0.0,Washington
3018,December,2017,Douglas,WA,Passenger,38,33,71,27171,27242,0.26,Washington
3019,December,2017,Maui,HI,Passenger,1,0,1,67,68,1.47,Nearest
3020,December,2017,DeKalb,IN,Passenger,1,0,1,1,2,50.0,Furthest
3021,December,2017,Jefferson,WA,Passenger,121,74,195,24283,24478,0.8,Washington
3022,December,2017,Spokane,WA,Truck,1,0,1,91580,91581,0.0,Washington
3023,December,2017,Grant,WA,Passenger,26,35,61,62097,62158,0.1,Washington
3024,December,2017,Madison,ID,Passenger,1,0,1,39,40,2.5,Nearest
3025,December,2017,Pima,AZ,Passenger,1,1,2,409,411,0.49,Nearest
3027,December,2017,Pierce,WA,Truck,0,0,0,137028,137028,0.0,Washington
3028,December,2017,Ada,ID,Passenger,0,1,1,349,350,0.29,Nearest
3029,December,2017,Whatcom,WA,Truck,1,0,1,42016,42017,0.0,Washington
3030,December,2017,DeKalb,GA,Passenger,1,0,1,87,88,1.14,Furthest
3031,December,2017,Nassau,NY,Passenger,1,1,2,38,40,5.0,Furthest
3032,December,2017,Prince George's,MD,Passenger,0,1,1,177,178,0.56,Furthest
3033,December,2017,Thurston,WA,Passenger,470,391,861,190046,190907,0.45,Washington
3034,December,2017,Cowlitz,WA,Truck,0,0,0,28150,28150,0.0,Washington
3035,December,2017,Bexar,TX,Passenger,1,2,3,822,825,0.36,Mid-Distance
3036,December,2017,Skagit,WA,Passenger,167,138,305,89553,89858,0.34,Washington
3037,December,2017,Pierce,WA,Passenger,1071,963,2034,526446,528480,0.38,Washington
3038,December,2017,Mason,WA,Truck,0,0,0,19593,19593,0.0,Washington
3039,December,2017,Portsmouth,VA,Passenger,0,1,1,67,68,1.47,Furthest
3040,December,2017,Dakota,MN,Passenger,0,2,2,38,40,5.0,Mid-Distance
3041,December,2017,Norfolk,VA,Passenger,1,1,2,308,310,0.65,Furthest
3042,December,2017,Island,WA,Truck,0,0,0,20753,20753,0.0,Washington
3043,December,2017,Okanogan,WA,Truck,0,0,0,16269,16269,0.0,Washington
3044,December,2017,Shelby,TN,Passenger,0,1,1,104,105,0.95,Furthest
3045,December,2017,Skamania,WA,Passenger,10,7,17,8589,8606,0.2,Washington
3046,December,2017,Orange,FL,Passenger,1,1,2,139,141,1.42,Furthest
3047,December,2017,Kittitas,WA,Truck,0,0,0,13805,13805,0.0,Washington
3048,December,2017,Montgomery,PA,Passenger,1,0,1,39,40,2.5,Furthest
3049,December,2017,El Paso,TX,Passenger,1,0,1,522,523,0.19,Mid-Distance
3050,December,2017,Walla Walla,WA,Truck,0,0,0,13292,13292,0.0,Washington
3051,December,2017,Yakima,WA,Truck,0,0,0,58011,58011,0.0,Washington
3052,December,2017,Virginia Beach,VA,Passenger,2,1,3,669,672,0.45,Furthest
3053,December,2017,Garfield,WA,Passenger,1,0,1,1321,1322,0.08,Washington
3054,December,2017,Clark,NV,Passenger,1,2,3,752,755,0.4,Nearest
3055,December,2017,Dale,AL,Passenger,0,1,1,64,65,1.54,Furthest
3056,December,2017,Los Angeles,CA,Passenger,5,2,7,1209,1216,0.58,Nearest
3057,December,2017,Sumter,FL,Passenger,0,1,1,10,11,9.09,Furthest
3058,December,2017,Manassas,VA,Passenger,0,1,1,9,10,10.0,Furthest
3059,December,2017,Northampton,PA,Passenger,0,1,1,67,68,1.47,Furthest
3060,December,2017,Wahkiakum,WA,Truck,0,0,0,1670,1670,0.0,Washington
3061,December,2017,Spokane,WA,Passenger,297,240,537,300106,300643,0.18,Washington
3062,December,2017,Richland,SC,Passenger,0,1,1,171,172,0.58,Furthest
3063,December,2017,Island,WA,Passenger,155,165,320,61576,61896,0.52,Washington
3064,December,2017,Fairfax,VA,Passenger,2,2,4,828,832,0.48,Furthest
3065,December,2017,Snohomish,WA,Truck,1,0,1,121405,121406,0.0,Washington
3066,December,2017,Cowlitz,WA,Passenger,54,67,121,70747,70868,0.17,Washington
3067,December,2017,Kitsap,WA,Passenger,693,377,1070,175868,176938,0.6,Washington
3068,December,2017,Lane,OR,Passenger,0,1,1,208,209,0.48,Nearest
3069,December,2017,Clay,FL,Passenger,0,1,1,106,107,0.93,Furthest
3070,December,2017,Utah,UT,Passenger,0,1,1,134,135,0.74,Nearest
3071,December,2017,Hamilton,TN,Passenger,1,0,1,21,22,4.55,Furthest
3072,December,2017,Asotin,WA,Passenger,8,5,13,12519,12532,0.1,Washington
3073,December,2017,Queens,NY,Passenger,1,0,1,61,62,1.61,Furthest
3074,December,2017,Dallas,TX,Passenger,0,1,1,182,183,0.55,Mid-Distance
3075,December,2017,Adams,WA,Passenger,4,5,9,12408,12417,0.07,Washington
3076,December,2017,Benton,WA,Truck,0,0,0,40573,40573,0.0,Washington
3077,December,2017,Nantucket,MA,Passenger,1,0,1,3,4,25.0,Furthest
3078,December,2017,Flathead,MT,Passenger,1,0,1,55,56,1.79,Nearest
3079,December,2017,Montgomery,TX,Passenger,1,0,1,62,63,1.59,Mid-Distance
3080,December,2017,Clark,WA,Passenger,851,573,1424,304270,305694,0.47,Washington
3081,December,2017,Honolulu,HI,Passenger,2,2,4,556,560,0.71,Nearest
3082,December,2017,Adams,WA,Truck,0,0,0,5128,5128,0.0,Washington
3083,December,2017,Nueces,TX,Passenger,1,1,2,92,94,2.13,Mid-Distance
3084,December,2017,Arlington,VA,Passenger,1,2,3,172,175,1.71,Furthest
3085,December,2017,Latah,ID,Passenger,0,1,1,77,78,1.28,Nearest
3086,December,2017,New Haven,CT,Passenger,0,1,1,54,55,1.82,Furthest
3087,December,2017,Ferry,WA,Truck,0,0,0,3523,3523,0.0,Washington
3088,December,2017,San Juan,WA,Truck,0,0,0,5604,5604,0.0,Washington
3089,December,2017,Thurston,WA,Truck,0,0,0,53761,53761,0.0,Washington
3090,December,2017,Allegheny,PA,Passenger,1,0,1,84,85,1.18,Furthest
3091,December,2017,Morris,NJ,Passenger,1,0,1,21,22,4.55,Furthest
3092,December,2017,Tuolumne,CA,Passenger,0,1,1,14,15,6.67,Nearest
3093,December,2017,Carroll,NH,Passenger,0,1,1,1,2,50.0,Furthest
3094,December,2017,King,WA,Passenger,11277,4684,15961,1370800,1386761,1.15,Washington
3095,December,2017,District of Columbia,DC,Passenger,0,3,3,201,204,1.47,Furthest
3096,December,2017,Prince George,VA,Passenger,0,1,1,74,75,1.33,Furthest
3097,December,2017,Franklin,OH,Passenger,0,1,1,108,109,0.92,Furthest
3098,December,2017,Missoula,MT,Passenger,1,0,1,69,70,1.43,Nearest
3099,December,2017,San Mateo,CA,Passenger,0,1,1,147,148,0.68,Nearest
3100,December,2017,New London,CT,Passenger,1,1,2,249,251,0.8,Furthest
3101,December,2017,Pend Oreille,WA,Passenger,3,4,7,9440,9447,0.07,Washington
3102,December,2017,Juneau,AK,Passenger,0,1,1,46,47,2.13,Nearest
3103,December,2017,Ferry,WA,Passenger,1,3,4,4402,4406,0.09,Washington
3104,December,2017,Ventura,CA,Passenger,0,1,1,328,329,0.3,Nearest
3105,December,2017,Grant,WA,Truck,0,0,0,25587,25587,0.0,Washington
3106,December,2017,Chelan,WA,Truck,0,0,0,21619,21619,0.0,Washington
3107,December,2017,Anne Arundel,MD,Passenger,0,1,1,474,475,0.21,Furthest
3108,December,2017,St. Clair,IL,Passenger,0,1,1,159,160,0.62,Mid-Distance
3109,December,2017,Pacific,WA,Passenger,15,13,28,15404,15432,0.18,Washington
3110,December,2017,Santa Fe,NM,Passenger,0,1,1,43,44,2.27,Mid-Distance
3111,December,2017,Skamania,WA,Truck,0,0,0,3896,3896,0.0,Washington
3112,December,2017,Lewis,WA,Truck,0,0,0,25311,25311,0.0,Washington
3113,December,2017,Kent,MI,Passenger,0,1,1,34,35,2.86,Furthest
3114,December,2017,St. Lucie,FL,Passenger,1,0,1,26,27,3.7,Furthest
3115,December,2017,Riverside,CA,Passenger,1,2,3,739,742,0.4,Nearest
3116,December,2017,Whitman,WA,Truck,0,0,0,8450,8450,0.0,Washington
3117,December,2017,Lumpkin,GA,Passenger,1,0,1,9,10,10.0,Furthest
3118,December,2017,Klickitat,WA,Passenger,23,26,49,14902,14951,0.33,Washington
3119,December,2017,Franklin,MA,Passenger,0,1,1,4,5,20.0,Furthest
3120,December,2017,San Diego,CA,Passenger,6,1,7,2563,2570,0.27,Nearest
3121,December,2017,Walla Walla,WA,Passenger,29,32,61,35287,35348,0.17,Washington
3122,December,2017,Mason,WA,Passenger,66,75,141,44844,44985,0.31,Washington
3123,December,2017,Maricopa,AZ,Passenger,2,0,2,1621,1623,0.12,Nearest
3124,December,2017,Hawaii,HI,Passenger,1,0,1,78,79,1.27,Nearest
3125,December,2017,Grays Harbor,WA,Passenger,42,41,83,45821,45904,0.18,Washington
3126,December,2017,Brevard,FL,Passenger,0,1,1,101,102,0.98,Furthest
3127,December,2017,Lincoln,WA,Truck,0,0,0,4493,4493,0.0,Washington
3128,December,2017,Chelan,WA,Passenger,86,38,124,53028,53152,0.23,Washington
3129,December,2017,Clallam,WA,Truck,0,0,0,21218,21218,0.0,Washington
3130,December,2017,Jefferson,NY,Passenger,1,0,1,232,233,0.43,Furthest
3131,December,2017,Charles,MD,Passenger,0,1,1,85,86,1.16,Furthest
3132,December,2017,Sedgwick,KS,Passenger,0,1,1,106,107,0.93,Mid-Distance
3133,December,2017,Saratoga,NY,Passenger,1,1,2,69,71,2.82,Furthest
3134,December,2017,Montgomery,MD,Passenger,1,0,1,300,301,0.33,Furthest
3135,December,2017,Essex,NJ,Passenger,1,0,1,10,11,9.09,Furthest
3136,December,2017,El Paso,CO,Passenger,2,0,2,764,766,0.26,Mid-Distance
3137,December,2017,Franklin,WA,Passenger,30,50,80,56860,56940,0.14,Washington
3138,December,2017,Orleans,LA,Passenger,0,1,1,47,48,2.08,Mid-Distance
3139,December,2017,Frederick,MD,Passenger,0,1,1,88,89,1.12,Furthest
3140,December,2017,Volusia,FL,Passenger,0,1,1,37,38,2.63,Furthest
3141,December,2017,Pinal,AZ,Passenger,2,0,2,213,215,0.93,Nearest
3142,December,2017,Skagit,WA,Truck,1,0,1,31731,31732,0.0,Washington
3143,December,2017,Cape May,NJ,Passenger,0,1,1,22,23,4.35,Furthest
3144,December,2018,Franklin,WA,Truck,0,0,0,19057,19057,0.0,Washington
3145,December,2018,Arlington,VA,Passenger,1,1,2,165,167,1.2,Furthest
3146,December,2018,Franklin,MA,Passenger,0,1,1,1,2,50.0,Furthest
3147,December,2018,Carroll,NH,Passenger,0,1,1,1,2,50.0,Furthest
3148,December,2018,Snohomish,WA,Truck,1,0,1,121967,121968,0.0,Washington
3149,December,2018,Skamania,WA,Passenger,16,13,29,8731,8760,0.33,Washington
3150,December,2018,Wahkiakum,WA,Passenger,1,1,2,2979,2981,0.07,Washington
3151,December,2018,Kitsap,WA,Passenger,946,544,1490,179830,181320,0.82,Washington
3152,December,2018,Pacific,WA,Passenger,21,25,46,15834,15880,0.29,Washington
3153,December,2018,Grays Harbor,WA,Passenger,62,72,134,47465,47599,0.28,Washington
3154,December,2018,Tuolumne,CA,Passenger,0,1,1,13,14,7.14,Nearest
3155,December,2018,Asotin,WA,Passenger,12,9,21,12724,12745,0.16,Washington
3156,December,2018,Caddo,LA,Passenger,0,1,1,21,22,4.55,Mid-Distance
3157,December,2018,Chelan,WA,Passenger,140,61,201,54138,54339,0.37,Washington
3158,December,2018,Fulton,GA,Passenger,1,2,3,108,111,2.7,Furthest
3159,December,2018,Cowlitz,WA,Passenger,72,94,166,72436,72602,0.23,Washington
3160,December,2018,Walla Walla,WA,Passenger,41,52,93,36097,36190,0.26,Washington
3161,December,2018,Pacific,WA,Truck,0,0,0,7614,7614,0.0,Washington
3162,December,2018,Twin Falls,ID,Passenger,0,1,1,23,24,4.17,Nearest
3163,December,2018,Monroe,IL,Passenger,1,0,1,4,5,20.0,Mid-Distance
3164,December,2018,Lane,OR,Passenger,0,1,1,169,170,0.59,Nearest
3165,December,2018,District of Columbia,DC,Passenger,1,3,4,197,201,1.99,Furthest
3166,December,2018,New London,CT,Passenger,0,2,2,252,254,0.79,Furthest
3167,December,2018,Cumberland,NC,Passenger,0,1,1,522,523,0.19,Furthest
3169,December,2018,El Paso,CO,Passenger,3,1,4,763,767,0.52,Mid-Distance
3170,December,2018,Nantucket,MA,Passenger,1,0,1,4,5,20.0,Furthest
3171,December,2018,Jefferson,WA,Passenger,168,106,274,24838,25112,1.09,Washington
3172,December,2018,Fairfax,VA,Passenger,3,2,5,808,813,0.62,Furthest
3173,December,2018,DeKalb,GA,Passenger,1,0,1,77,78,1.28,Furthest
3174,December,2018,Pend Oreille,WA,Truck,0,0,0,5738,5738,0.0,Washington
3175,December,2018,Jefferson,WA,Truck,0,0,0,9606,9606,0.0,Washington
3176,December,2018,Bexar,TX,Passenger,3,4,7,711,718,0.97,Mid-Distance
3177,December,2018,Prince William,VA,Passenger,0,4,4,254,258,1.55,Furthest
3178,December,2018,Snohomish,WA,Passenger,2915,1437,4352,527237,531589,0.82,Washington
3179,December,2018,Chelan,WA,Truck,0,0,0,22052,22052,0.0,Washington
3180,December,2018,Richland,SC,Passenger,0,1,1,162,163,0.61,Furthest
3181,December,2018,Tarrant,TX,Passenger,1,0,1,204,205,0.49,Mid-Distance
3182,December,2018,Harnett,NC,Passenger,1,0,1,228,229,0.44,Furthest
3183,December,2018,El Paso,TX,Passenger,1,0,1,495,496,0.2,Mid-Distance
3184,December,2018,Jefferson,NY,Passenger,0,1,1,228,229,0.44,Furthest
3185,December,2018,Fresno,CA,Passenger,1,0,1,190,191,0.52,Nearest
3186,December,2018,Clay,FL,Passenger,0,1,1,87,88,1.14,Furthest
3187,December,2018,Grant,WA,Passenger,32,52,84,64196,64280,0.13,Washington
3188,December,2018,Nueces,TX,Passenger,1,1,2,93,95,2.11,Mid-Distance
3189,December,2018,Multnomah,OR,Passenger,3,5,8,764,772,1.04,Nearest
3190,December,2018,Marion,IN,Passenger,1,0,1,119,120,0.83,Furthest
3191,December,2018,Cowlitz,WA,Truck,0,0,0,28739,28739,0.0,Washington
3192,December,2018,Cochise,AZ,Passenger,0,1,1,119,120,0.83,Nearest
3193,December,2018,Richmond,GA,Passenger,0,1,1,90,91,1.1,Furthest
3194,December,2018,Klickitat,WA,Passenger,28,32,60,15431,15491,0.39,Washington
3195,December,2018,Franklin,WA,Passenger,45,66,111,59124,59235,0.19,Washington
3196,December,2018,Grays Harbor,WA,Truck,0,0,0,20356,20356,0.0,Washington
3197,December,2018,Kittitas,WA,Passenger,66,37,103,29339,29442,0.35,Washington
3198,December,2018,Skagit,WA,Truck,1,0,1,32318,32319,0.0,Washington
3199,December,2018,Middlesex,MA,Passenger,1,1,2,128,130,1.54,Furthest
3200,December,2018,Maui,HI,Passenger,1,0,1,51,52,1.92,Nearest
3201,December,2018,Beaufort,SC,Passenger,1,0,1,34,35,2.86,Furthest
3202,December,2018,Lincoln,WA,Truck,0,0,0,4639,4639,0.0,Washington
3203,December,2018,Sedgwick,KS,Passenger,0,1,1,98,99,1.01,Mid-Distance
3204,December,2018,Santa Rosa,FL,Passenger,1,0,1,88,89,1.12,Furthest
3205,December,2018,Ferry,WA,Truck,0,0,0,3585,3585,0.0,Washington
3206,December,2018,Skamania,WA,Truck,0,0,0,4008,4008,0.0,Washington
3207,December,2018,Garfield,WA,Passenger,1,1,2,1329,1331,0.15,Washington
3208,December,2018,Manassas,VA,Passenger,0,1,1,9,10,10.0,Furthest
3209,December,2018,Kent,MI,Passenger,0,1,1,23,24,4.17,Furthest
3210,December,2018,St. Lucie,FL,Passenger,1,0,1,30,31,3.23,Furthest
3211,December,2018,Clallam,WA,Passenger,150,124,274,50353,50627,0.54,Washington
3212,December,2018,Flathead,MT,Passenger,1,0,1,56,57,1.75,Nearest
3213,December,2018,Yakima,WA,Truck,0,0,0,58848,58848,0.0,Washington
3214,December,2018,Clallam,WA,Truck,0,0,0,21642,21642,0.0,Washington
3215,December,2018,Douglas,WA,Truck,0,0,0,12160,12160,0.0,Washington
3216,December,2018,Sumter,FL,Passenger,0,1,1,10,11,9.09,Furthest
3217,December,2018,St. Clair,IL,Passenger,0,1,1,165,166,0.6,Mid-Distance
3218,December,2018,Nassau,NY,Passenger,3,0,3,35,38,7.89,Furthest
3219,December,2018,Columbia,WA,Truck,0,0,0,1517,1517,0.0,Washington
3220,December,2018,Howard,MD,Passenger,0,1,1,84,85,1.18,Furthest
3221,December,2018,Montgomery,TX,Passenger,2,0,2,61,63,3.17,Mid-Distance
3222,December,2018,Benton,WA,Passenger,227,235,462,132930,133392,0.35,Washington
3223,December,2018,Washtenaw,MI,Passenger,1,0,1,40,41,2.44,Furthest
3224,December,2018,San Juan,WA,Truck,0,0,0,5818,5818,0.0,Washington
3225,December,2018,Thurston,WA,Passenger,739,572,1311,195602,196913,0.67,Washington
3226,December,2018,Maricopa,AZ,Passenger,3,2,5,1544,1549,0.32,Nearest
3227,December,2018,Los Angeles,CA,Passenger,7,5,12,1105,1117,1.07,Nearest
3228,December,2018,Duval,FL,Passenger,1,2,3,381,384,0.78,Furthest
3229,December,2018,Bucks,PA,Passenger,1,0,1,16,17,5.88,Furthest
3230,December,2018,Hawaii,HI,Passenger,1,0,1,62,63,1.59,Nearest
3231,December,2018,Santa Cruz,CA,Passenger,1,0,1,41,42,2.38,Nearest
3232,December,2018,Cape May,NJ,Passenger,0,1,1,21,22,4.55,Furthest
3233,December,2018,Guadalupe,TX,Passenger,1,0,1,79,80,1.25,Mid-Distance
3234,December,2018,Kittitas,WA,Truck,0,0,0,14196,14196,0.0,Washington
3235,December,2018,Riverside,CA,Passenger,2,2,4,677,681,0.59,Nearest
3236,December,2018,Houston,GA,Passenger,1,0,1,51,52,1.92,Furthest
3237,December,2018,Dakota,MN,Passenger,0,2,2,34,36,5.56,Mid-Distance
3238,December,2018,San Juan,WA,Passenger,183,69,252,14224,14476,1.74,Washington
3239,December,2018,Tulsa,OK,Passenger,1,1,2,47,49,4.08,Mid-Distance
3240,December,2018,Albemarle,VA,Passenger,1,0,1,25,26,3.85,Furthest
3241,December,2018,Adams,WA,Truck,0,0,0,5149,5149,0.0,Washington
3242,December,2018,Charles,MD,Passenger,0,1,1,76,77,1.3,Furthest
3243,December,2018,Suffolk,MA,Passenger,0,1,1,42,43,2.33,Furthest
3244,December,2018,Orange,FL,Passenger,2,0,2,166,168,1.19,Furthest
3245,December,2018,Whatcom,WA,Truck,2,0,2,42664,42666,0.0,Washington
3246,December,2018,Polk,FL,Passenger,1,0,1,64,65,1.54,Furthest
3247,December,2018,Pima,AZ,Passenger,1,1,2,399,401,0.5,Nearest
3248,December,2018,Douglas,NE,Passenger,0,1,1,67,68,1.47,Mid-Distance
3249,December,2018,Deschutes,OR,Passenger,2,0,2,165,167,1.2,Nearest
3250,December,2018,Lewis,WA,Passenger,93,77,170,58326,58496,0.29,Washington
3251,December,2018,Clackamas,OR,Passenger,1,1,2,214,216,0.93,Nearest
3252,December,2018,Whatcom,WA,Passenger,757,371,1128,149448,150576,0.75,Washington
3253,December,2018,Washoe,NV,Passenger,2,0,2,110,112,1.79,Nearest
3254,December,2018,Bergen,NJ,Passenger,1,0,1,27,28,3.57,Furthest
3255,December,2018,Mason,WA,Passenger,107,110,217,46462,46679,0.46,Washington
3256,December,2018,Mason,WA,Truck,0,0,0,20192,20192,0.0,Washington
3257,December,2018,San Francisco,CA,Passenger,2,1,3,115,118,2.54,Nearest
3258,December,2018,Cook,IL,Passenger,1,0,1,247,248,0.4,Mid-Distance
3259,December,2018,Larimer,CO,Passenger,1,0,1,60,61,1.64,Mid-Distance
3260,December,2018,Virginia Beach,VA,Passenger,2,1,3,695,698,0.43,Furthest
3261,December,2018,Goochland,VA,Passenger,0,1,1,243,244,0.41,Furthest
3262,December,2018,Thurston,WA,Truck,0,0,0,54873,54873,0.0,Washington
3263,December,2018,Jefferson,CO,Passenger,0,2,2,61,63,3.17,Mid-Distance
3264,December,2018,Island,WA,Truck,0,0,0,21185,21185,0.0,Washington
3265,December,2018,Garfield,WA,Truck,0,0,0,965,965,0.0,Washington
3266,December,2018,Rogers,OK,Passenger,1,0,1,5,6,16.67,Mid-Distance
3267,December,2018,Lewis,WA,Truck,0,0,0,25634,25634,0.0,Washington
3268,December,2018,Yakima,WA,Passenger,82,99,181,164762,164943,0.11,Washington
3269,December,2018,Sangamon,IL,Passenger,1,0,1,9,10,10.0,Mid-Distance
3270,December,2018,Frederick,MD,Passenger,0,1,1,79,80,1.25,Furthest
3271,December,2018,Benton,WA,Truck,0,0,0,41561,41561,0.0,Washington
3272,December,2018,Manatee,FL,Passenger,1,0,1,37,38,2.63,Furthest
3273,December,2018,Marion,OR,Passenger,1,0,1,117,118,0.85,Nearest
3274,December,2018,St. Mary's,MD,Passenger,1,0,1,214,215,0.47,Furthest
3275,December,2018,Ventura,CA,Passenger,0,2,2,319,321,0.62,Nearest
3276,December,2018,Pierce,WA,Truck,0,0,0,139122,139122,0.0,Washington
3277,December,2018,Pinal,AZ,Passenger,2,0,2,200,202,0.99,Nearest
3278,December,2018,Clark,NV,Passenger,2,2,4,719,723,0.55,Nearest
3279,December,2018,Kootenai,ID,Passenger,1,1,2,218,220,0.91,Nearest
3280,December,2018,Dale,AL,Passenger,0,1,1,56,57,1.75,Furthest
3281,December,2018,Travis,TX,Passenger,1,1,2,197,199,1.01,Mid-Distance
3282,December,2018,Hennepin,MN,Passenger,2,0,2,105,107,1.87,Mid-Distance
3283,December,2018,Grant,WA,Truck,0,0,0,26258,26258,0.0,Washington
3284,December,2018,Honolulu,HI,Passenger,1,3,4,516,520,0.77,Nearest
3285,December,2018,Denver,CO,Passenger,1,0,1,128,129,0.78,Mid-Distance
3286,December,2018,Ferry,WA,Passenger,3,2,5,4383,4388,0.11,Washington
3287,December,2018,Norfolk,VA,Passenger,2,2,4,341,345,1.16,Furthest
3288,December,2018,Garfield,OK,Passenger,1,0,1,13,14,7.14,Mid-Distance
3289,December,2018,Norfolk,MA,Passenger,1,0,1,36,37,2.7,Furthest
3290,December,2018,Camden,NJ,Passenger,0,1,1,28,29,3.45,Furthest
3291,December,2018,Ada,ID,Passenger,0,2,2,312,314,0.64,Nearest
3292,December,2018,Spokane,WA,Truck,1,0,1,93762,93763,0.0,Washington
3293,December,2018,Hardin,KY,Passenger,0,1,1,107,108,0.93,Furthest
3294,December,2018,Asotin,WA,Truck,0,0,0,6635,6635,0.0,Washington
3295,December,2018,Madison,ID,Passenger,1,0,1,35,36,2.78,Nearest
3296,December,2018,Valencia,NM,Passenger,1,0,1,10,11,9.09,Mid-Distance
3297,December,2018,Carson City,NV,Passenger,1,0,1,15,16,6.25,Nearest
3298,December,2018,Montgomery,PA,Passenger,2,0,2,35,37,5.41,Furthest
3299,December,2018,Adams,WA,Passenger,5,6,11,12744,12755,0.09,Washington
3300,December,2018,San Juan,PR,Passenger,0,1,1,5,6,16.67,Mid-Distance
3301,December,2018,DuPage,IL,Passenger,1,0,1,59,60,1.67,Mid-Distance
3302,December,2018,King,WA,Truck,6,1,7,182653,182660,0.0,Washington
3303,December,2018,Santa Fe,NM,Passenger,0,1,1,41,42,2.38,Mid-Distance
3304,December,2018,New Haven,CT,Passenger,0,1,1,49,50,2.0,Furthest
3305,December,2018,DeKalb,IN,Passenger,1,0,1,1,2,50.0,Furthest
3306,December,2018,Clark,WA,Passenger,1246,841,2087,311394,313481,0.67,Washington
3307,December,2018,Washington,OR,Passenger,0,1,1,471,472,0.21,Nearest
3308,December,2018,Kitsap,WA,Truck,1,0,1,53636,53637,0.0,Washington
3309,December,2018,Douglas,WA,Passenger,50,34,84,28009,28093,0.3,Washington
3310,December,2018,San Mateo,CA,Passenger,2,1,3,128,131,2.29,Nearest
3311,December,2018,Collin,TX,Passenger,1,1,2,145,147,1.36,Mid-Distance
3312,December,2018,Shasta,CA,Passenger,1,0,1,42,43,2.33,Nearest
3313,December,2018,Island,WA,Passenger,276,225,501,63178,63679,0.79,Washington
3314,December,2018,Saratoga,NY,Passenger,1,0,1,62,63,1.59,Furthest
3315,December,2018,Lee,AL,Passenger,1,0,1,36,37,2.7,Furthest
3316,December,2018,Williamson,TX,Passenger,0,1,1,147,148,0.68,Mid-Distance
3317,December,2018,Ramsey,MN,Passenger,1,0,1,39,40,2.5,Mid-Distance
3318,December,2018,Brevard,FL,Passenger,0,1,1,94,95,1.05,Furthest
3319,December,2018,Skagit,WA,Passenger,259,187,446,91196,91642,0.49,Washington
3320,December,2018,Portsmouth,VA,Passenger,0,1,1,81,82,1.22,Furthest
3321,December,2018,Lumpkin,GA,Passenger,1,0,1,7,8,12.5,Furthest
3322,December,2018,Charleston,SC,Passenger,1,0,1,123,124,0.81,Furthest
3323,December,2018,Gwinnett,GA,Passenger,0,1,1,78,79,1.27,Furthest
3324,December,2018,Randolph,NC,Passenger,1,0,1,6,7,14.29,Furthest
3325,December,2018,Santa Clara,CA,Passenger,8,1,9,372,381,2.36,Nearest
3326,December,2018,Klickitat,WA,Truck,0,0,0,8209,8209,0.0,Washington
3327,December,2018,Lincoln,WA,Passenger,2,5,7,7780,7787,0.09,Washington
3328,December,2018,Volusia,FL,Passenger,0,1,1,37,38,2.63,Furthest
3329,December,2018,Pierce,WA,Passenger,1509,1373,2882,538890,541772,0.53,Washington
3330,December,2018,Walla Walla,WA,Truck,0,0,0,13523,13523,0.0,Washington
3331,December,2018,Juneau,AK,Passenger,0,1,1,43,44,2.27,Nearest
3332,December,2018,Prince George's,MD,Passenger,1,1,2,183,185,1.08,Furthest
3333,December,2018,Oldham,KY,Passenger,0,1,1,5,6,16.67,Furthest
3334,December,2018,Spokane,WA,Passenger,439,373,812,307178,307990,0.26,Washington
3335,December,2018,Allegheny,PA,Passenger,1,0,1,81,82,1.22,Furthest
3336,December,2018,Stevens,WA,Truck,0,0,0,18764,18764,0.0,Washington
3337,December,2018,Moore,NC,Passenger,0,1,1,191,192,0.52,Furthest
3338,December,2018,Montgomery,AL,Passenger,0,1,1,46,47,2.13,Furthest
3339,December,2018,Palm Beach,FL,Passenger,0,1,1,94,95,1.05,Furthest
3340,December,2018,Clark,WA,Truck,0,0,0,79840,79840,0.0,Washington
3341,December,2018,Orange,CA,Passenger,6,2,8,539,547,1.46,Nearest
3342,December,2018,Montgomery,MD,Passenger,1,0,1,275,276,0.36,Furthest
3343,December,2018,Okanogan,WA,Truck,0,0,0,16487,16487,0.0,Washington
3344,December,2018,King,WA,Passenger,16280,6530,22810,1378186,1400996,1.63,Washington
3345,December,2018,Mecklenburg,NC,Passenger,1,0,1,79,80,1.25,Furthest
3346,December,2018,Okanogan,WA,Passenger,16,22,38,26070,26108,0.15,Washington
3347,December,2018,Contra Costa,CA,Passenger,0,2,2,408,410,0.49,Nearest
3348,December,2018,Pend Oreille,WA,Passenger,5,5,10,9533,9543,0.1,Washington
3349,December,2018,Columbia,WA,Passenger,2,2,4,2421,2425,0.16,Washington
3350,December,2018,Alameda,CA,Passenger,0,2,2,323,325,0.62,Nearest
3351,December,2018,San Diego,CA,Passenger,8,2,10,2569,2579,0.39,Nearest
3352,December,2018,Shelby,TN,Passenger,0,1,1,98,99,1.01,Furthest
3353,December,2018,Broward,FL,Passenger,2,1,3,128,131,2.29,Furthest
3354,December,2018,Klamath,OR,Passenger,1,0,1,37,38,2.63,Nearest
3355,December,2018,Whitman,WA,Passenger,24,38,62,22811,22873,0.27,Washington
3356,December,2018,Lee,FL,Passenger,1,0,1,52,53,1.89,Furthest
3357,December,2018,Stevens,WA,Passenger,16,27,43,31786,31829,0.14,Washington
3358,December,2018,Wahkiakum,WA,Truck,0,0,0,1722,1722,0.0,Washington
3359,December,2018,Anne Arundel,MD,Passenger,0,2,2,452,454,0.44,Furthest
3360,December,2018,Whitman,WA,Truck,0,0,0,8542,8542,0.0,Washington
3361,December,2018,Dallas,TX,Passenger,0,1,1,203,204,0.49,Mid-Distance
3362,December,2019,Charleston,SC,Passenger,1,0,1,109,110,0.91,Furthest
3363,December,2019,Asotin,WA,Passenger,14,9,23,12679,12702,0.18,Washington
3364,December,2019,Hennepin,MN,Passenger,3,1,4,101,105,3.81,Mid-Distance
3365,December,2019,Jefferson,WA,Truck,0,0,0,9647,9647,0.0,Washington
3366,December,2019,Howard,MD,Passenger,0,1,1,74,75,1.33,Furthest
3367,December,2019,Clallam,WA,Passenger,196,157,353,50869,51222,0.69,Washington
3368,December,2019,Lee,FL,Passenger,1,0,1,53,54,1.85,Furthest
3369,December,2019,Grant,WA,Truck,0,0,0,27002,27002,0.0,Washington
3370,December,2019,Washtenaw,MI,Passenger,1,0,1,42,43,2.33,Furthest
3371,December,2019,Montgomery,TX,Passenger,1,0,1,55,56,1.79,Mid-Distance
3372,December,2019,Douglas,WA,Passenger,67,38,105,28299,28404,0.37,Washington
3373,December,2019,Houston,GA,Passenger,1,0,1,60,61,1.64,Furthest
3374,December,2019,Fulton,GA,Passenger,0,2,2,104,106,1.89,Furthest
3375,December,2019,Whitman,WA,Truck,0,0,0,8579,8579,0.0,Washington
3376,December,2019,Honolulu,HI,Passenger,4,2,6,479,485,1.24,Nearest
3377,December,2019,Columbia,WA,Passenger,3,3,6,2449,2455,0.24,Washington
3378,December,2019,Boone,MO,Passenger,0,1,1,11,12,8.33,Furthest
3379,December,2019,Bexar,TX,Passenger,1,5,6,646,652,0.92,Mid-Distance
3380,December,2019,Calvert,MD,Passenger,0,2,2,91,93,2.15,Furthest
3381,December,2019,Dakota,MN,Passenger,0,1,1,33,34,2.94,Mid-Distance
3382,December,2019,Clark,WA,Passenger,1843,1043,2886,317733,320619,0.9,Washington
3383,December,2019,Cowlitz,WA,Passenger,118,107,225,73644,73869,0.3,Washington
3384,December,2019,Kent,MI,Passenger,0,1,1,24,25,4.0,Furthest
3385,December,2019,Ada,ID,Passenger,0,1,1,290,291,0.34,Nearest
3386,December,2019,Carson City,NV,Passenger,1,0,1,10,11,9.09,Nearest
3387,December,2019,Wahkiakum,WA,Passenger,4,3,7,3041,3048,0.23,Washington
3388,December,2019,Klickitat,WA,Passenger,46,38,84,15674,15758,0.53,Washington
3389,December,2019,Wahkiakum,WA,Truck,0,0,0,1754,1754,0.0,Washington
3390,December,2019,San Juan,WA,Truck,0,0,0,5935,5935,0.0,Washington
3391,December,2019,Solano,CA,Passenger,1,0,1,207,208,0.48,Nearest
3392,December,2019,Clark,NV,Passenger,3,2,5,680,685,0.73,Nearest
3393,December,2019,Valencia,NM,Passenger,1,0,1,5,6,16.67,Mid-Distance
3394,December,2019,DeKalb,GA,Passenger,1,0,1,81,82,1.22,Furthest
3395,December,2019,Columbia,WA,Truck,0,0,0,1537,1537,0.0,Washington
3396,December,2019,Berkshire,MA,Passenger,0,1,1,5,6,16.67,Furthest
3397,December,2019,Juneau,AK,Passenger,0,2,2,29,31,6.45,Nearest
3398,December,2019,Wayne,MI,Passenger,0,1,1,59,60,1.67,Furthest
3399,December,2019,Oldham,KY,Passenger,0,1,1,4,5,20.0,Furthest
3400,December,2019,Pend Oreille,WA,Truck,0,0,0,5771,5771,0.0,Washington
3401,December,2019,Cape May,NJ,Passenger,0,1,1,13,14,7.14,Furthest
3402,December,2019,Cowlitz,WA,Truck,0,0,0,29035,29035,0.0,Washington
3403,December,2019,Skagit,WA,Passenger,363,213,576,92637,93213,0.62,Washington
3404,December,2019,San Diego,CA,Passenger,9,3,12,2797,2809,0.43,Nearest
3405,December,2019,Lewis,WA,Passenger,106,102,208,59556,59764,0.35,Washington
3406,December,2019,Allegheny,PA,Passenger,1,0,1,74,75,1.33,Furthest
3407,December,2019,Prince George's,MD,Passenger,1,1,2,172,174,1.15,Furthest
3408,December,2019,Montgomery,OH,Passenger,0,1,1,47,48,2.08,Furthest
3409,December,2019,Clark,WA,Truck,0,0,0,81316,81316,0.0,Washington
3410,December,2019,Anne Arundel,MD,Passenger,1,2,3,434,437,0.69,Furthest
3411,December,2019,Oklahoma,OK,Passenger,0,1,1,128,129,0.78,Mid-Distance
3412,December,2019,Garfield,WA,Passenger,0,1,1,1306,1307,0.08,Washington
3413,December,2019,Thurston,WA,Passenger,1052,701,1753,199236,200989,0.87,Washington
3414,December,2019,El Paso,CO,Passenger,2,1,3,742,745,0.4,Mid-Distance
3415,December,2019,Okanogan,WA,Truck,0,0,0,16550,16550,0.0,Washington
3416,December,2019,Chelan,WA,Passenger,201,78,279,54622,54901,0.51,Washington
3417,December,2019,Whatcom,WA,Truck,2,0,2,43188,43190,0.0,Washington
3418,December,2019,Montgomery,AL,Passenger,0,1,1,39,40,2.5,Furthest
3419,December,2019,Ferry,WA,Passenger,5,2,7,4398,4405,0.16,Washington
3420,December,2019,Greene,MO,Passenger,0,1,1,31,32,3.12,Furthest
3421,December,2019,Richland,SC,Passenger,0,1,1,157,158,0.63,Furthest
3422,December,2019,Tulsa,OK,Passenger,1,1,2,48,50,4.0,Mid-Distance
3423,December,2019,Santa Cruz,CA,Passenger,1,0,1,36,37,2.7,Nearest
3424,December,2019,Frederick,MD,Passenger,1,1,2,81,83,2.41,Furthest
3425,December,2019,King,WA,Truck,6,1,7,182216,182223,0.0,Washington
3426,December,2019,Placer,CA,Passenger,1,0,1,95,96,1.04,Nearest
3427,December,2019,Maricopa,AZ,Passenger,7,5,12,1498,1510,0.79,Nearest
3428,December,2019,Duval,FL,Passenger,1,2,3,362,365,0.82,Furthest
3429,December,2019,Lewis,WA,Truck,0,0,0,26087,26087,0.0,Washington
3430,December,2019,Middlesex,MA,Passenger,1,1,2,107,109,1.83,Furthest
3431,December,2019,Williamson,TX,Passenger,0,2,2,144,146,1.37,Mid-Distance
3432,December,2019,Sedgwick,KS,Passenger,1,1,2,96,98,2.04,Mid-Distance
3433,December,2019,Santa Clara,CA,Passenger,7,2,9,351,360,2.5,Nearest
3434,December,2019,Sarasota,FL,Passenger,2,0,2,25,27,7.41,Furthest
3435,December,2019,Kitsap,WA,Passenger,1199,652,1851,182349,184200,1.0,Washington
3436,December,2019,San Joaquin,CA,Passenger,1,0,1,137,138,0.72,Nearest
3437,December,2019,Virginia Beach,VA,Passenger,1,0,1,695,696,0.14,Furthest
3438,December,2019,Asotin,WA,Truck,0,0,0,6709,6709,0.0,Washington
3439,December,2019,Putnam,TN,Passenger,0,1,1,3,4,25.0,Furthest
3440,December,2019,Walla Walla,WA,Truck,0,0,0,13663,13663,0.0,Washington
3441,December,2019,Contra Costa,CA,Passenger,3,2,5,343,348,1.44,Nearest
3442,December,2019,Island,WA,Truck,1,0,1,21356,21357,0.0,Washington
3443,December,2019,Harnett,NC,Passenger,1,1,2,206,208,0.96,Furthest
3444,December,2019,Clallam,WA,Truck,1,0,1,21871,21872,0.0,Washington
3445,December,2019,Pacific,WA,Truck,0,0,0,7721,7721,0.0,Washington
3446,December,2019,Guadalupe,TX,Passenger,1,0,1,66,67,1.49,Mid-Distance
3447,December,2019,Multnomah,OR,Passenger,4,6,10,726,736,1.36,Nearest
3448,December,2019,Spokane,WA,Passenger,643,471,1114,315064,316178,0.35,Washington
3449,December,2019,Chesapeake,VA,Passenger,0,2,2,431,433,0.46,Furthest
3450,December,2019,Pierce,WA,Passenger,2127,1651,3778,547907,551685,0.68,Washington
3451,December,2019,San Mateo,CA,Passenger,1,1,2,119,121,1.65,Nearest
3452,December,2019,Pacific,WA,Passenger,30,30,60,16120,16180,0.37,Washington
3453,December,2019,Pinal,AZ,Passenger,1,0,1,190,191,0.52,Nearest
3454,December,2019,Pierce,WA,Truck,0,0,0,140864,140864,0.0,Washington
3455,December,2019,Harrison,MS,Passenger,1,0,1,57,58,1.72,Mid-Distance
3456,December,2019,Albemarle,VA,Passenger,1,0,1,25,26,3.85,Furthest
3457,December,2019,Stevens,WA,Passenger,31,31,62,31609,31671,0.2,Washington
3458,December,2019,Yakima,WA,Truck,0,0,0,59618,59618,0.0,Washington
3459,December,2019,Fairbanks North Star,AK,Passenger,0,1,1,99,100,1.0,Nearest
3460,December,2019,Jones,GA,Passenger,1,0,1,1,2,50.0,Furthest
3461,December,2019,Saginaw,MI,Passenger,1,0,1,11,12,8.33,Furthest
3462,December,2019,District of Columbia,DC,Passenger,1,1,2,213,215,0.93,Furthest
3463,December,2019,Montgomery,PA,Passenger,2,0,2,35,37,5.41,Furthest
3464,December,2019,Skagit,WA,Truck,1,0,1,32566,32567,0.0,Washington
3465,December,2019,DeKalb,IN,Passenger,1,0,1,1,2,50.0,Furthest
3466,December,2019,Snohomish,WA,Passenger,4021,1709,5730,536109,541839,1.06,Washington
3467,December,2019,Goochland,VA,Passenger,2,1,3,263,266,1.13,Furthest
3468,December,2019,Bucks,PA,Passenger,1,0,1,21,22,4.55,Furthest
3469,December,2019,Los Angeles,CA,Passenger,7,9,16,1062,1078,1.48,Nearest
3470,December,2019,Island,WA,Passenger,375,253,628,63608,64236,0.98,Washington
3471,December,2019,Carroll,NH,Passenger,0,1,1,4,5,20.0,Furthest
3472,December,2019,Polk,FL,Passenger,1,0,1,65,66,1.52,Furthest
3473,December,2019,Ventura,CA,Passenger,0,3,3,299,302,0.99,Nearest
3474,December,2019,Manassas,VA,Passenger,0,1,1,6,7,14.29,Furthest
3475,December,2019,Norfolk,VA,Passenger,1,2,3,348,351,0.85,Furthest
3476,December,2019,Broward,FL,Passenger,2,1,3,125,128,2.34,Furthest
3477,December,2019,Prince William,VA,Passenger,1,3,4,234,238,1.68,Furthest
3478,December,2019,Nueces,TX,Passenger,1,1,2,85,87,2.3,Mid-Distance
3479,December,2019,Deschutes,OR,Passenger,3,0,3,149,152,1.97,Nearest
3480,December,2019,Shelby,TN,Passenger,0,1,1,95,96,1.04,Furthest
3481,December,2019,Arapahoe,CO,Passenger,1,0,1,141,142,0.7,Mid-Distance
3482,December,2019,Fresno,CA,Passenger,1,0,1,188,189,0.53,Nearest
3483,December,2019,Jefferson,WA,Passenger,217,134,351,25187,25538,1.37,Washington
3484,December,2019,Adams,WA,Passenger,6,7,13,12936,12949,0.1,Washington
3485,December,2019,Hudson,NJ,Passenger,1,0,1,38,39,2.56,Furthest
3486,December,2019,Douglas,WA,Truck,0,0,0,12308,12308,0.0,Washington
3487,December,2019,Rogers,OK,Passenger,1,0,1,5,6,16.67,Mid-Distance
3488,December,2019,Okanogan,WA,Passenger,30,30,60,26236,26296,0.23,Washington
3489,December,2019,Vigo,IN,Passenger,1,0,1,6,7,14.29,Furthest
3490,December,2019,Osceola,FL,Passenger,1,0,1,42,43,2.33,Furthest
3491,December,2019,Clay,FL,Passenger,0,1,1,86,87,1.15,Furthest
3492,December,2019,Skamania,WA,Truck,0,0,0,4099,4099,0.0,Washington
3493,December,2019,Suffolk,VA,Passenger,1,0,1,124,125,0.8,Furthest
3494,December,2019,Collin,TX,Passenger,1,1,2,131,133,1.5,Mid-Distance
3495,December,2019,Travis,TX,Passenger,2,1,3,198,201,1.49,Mid-Distance
3496,December,2019,Alameda,CA,Passenger,5,1,6,292,298,2.01,Nearest
3497,December,2019,Randolph,NC,Passenger,1,0,1,7,8,12.5,Furthest
3498,December,2019,Grays Harbor,WA,Passenger,105,100,205,48394,48599,0.42,Washington
3499,December,2019,Boulder,CO,Passenger,0,1,1,50,51,1.96,Mid-Distance
3500,December,2019,Yakima,WA,Passenger,116,114,230,166298,166528,0.14,Washington
3501,December,2019,Washoe,NV,Passenger,1,0,1,108,109,0.92,Nearest
3502,December,2019,Klickitat,WA,Truck,0,0,0,8318,8318,0.0,Washington
3503,December,2019,Norfolk,MA,Passenger,1,0,1,36,37,2.7,Furthest
3504,December,2019,Denver,CO,Passenger,1,0,1,127,128,0.78,Mid-Distance
3505,December,2019,Snohomish,WA,Truck,0,0,0,123277,123277,0.0,Washington
3506,December,2019,Jefferson,CO,Passenger,0,2,2,58,60,3.33,Mid-Distance
3507,December,2019,Thurston,WA,Truck,0,0,0,55729,55729,0.0,Washington
3508,December,2019,Lake,IL,Passenger,1,0,1,162,163,0.61,Mid-Distance
3509,December,2019,Camden,NJ,Passenger,0,2,2,21,23,8.7,Furthest
3510,December,2019,Riverside,CA,Passenger,4,1,5,637,642,0.78,Nearest
3511,December,2019,Penobscot,ME,Passenger,0,1,1,13,14,7.14,Furthest
3512,December,2019,Twin Falls,ID,Passenger,0,1,1,28,29,3.45,Nearest
3513,December,2019,Benton,WA,Truck,0,0,0,42486,42486,0.0,Washington
3514,December,2019,Ferry,WA,Truck,0,0,0,3580,3580,0.0,Washington
3516,December,2019,Lincoln,WA,Truck,0,0,0,4683,4683,0.0,Washington
3517,December,2019,Kittitas,WA,Passenger,90,46,136,30054,30190,0.45,Washington
3518,December,2019,El Paso,TX,Passenger,3,0,3,455,458,0.66,Mid-Distance
3519,December,2019,Santa Rosa,FL,Passenger,1,0,1,86,87,1.15,Furthest
3520,December,2019,Loudoun,VA,Passenger,1,0,1,93,94,1.06,Furthest
3521,December,2019,Jefferson,NY,Passenger,0,2,2,218,220,0.91,Furthest
3522,December,2019,Nassau,NY,Passenger,4,0,4,39,43,9.3,Furthest
3523,December,2019,Cumberland,NC,Passenger,0,2,2,487,489,0.41,Furthest
3524,December,2019,Garfield,WA,Truck,0,0,0,969,969,0.0,Washington
3525,December,2019,Hawaii,HI,Passenger,1,0,1,60,61,1.64,Nearest
3526,December,2019,Flathead,MT,Passenger,1,0,1,63,64,1.56,Nearest
3527,December,2019,Adams,WA,Truck,0,0,0,5198,5198,0.0,Washington
3528,December,2019,Shasta,CA,Passenger,1,0,1,37,38,2.63,Nearest
3529,December,2019,Queens,NY,Passenger,1,0,1,52,53,1.89,Furthest
3530,December,2019,RÃ­o Grande,PR,Passenger,1,0,1,1,2,50.0,Mid-Distance
3531,December,2019,Larimer,CO,Passenger,1,0,1,55,56,1.79,Mid-Distance
3532,December,2019,Spokane,WA,Truck,1,0,1,96378,96379,0.0,Washington
3533,December,2019,Spartanburg,SC,Passenger,0,1,1,43,44,2.27,Furthest
3534,December,2019,Grant,WA,Passenger,55,68,123,65625,65748,0.19,Washington
3535,December,2019,King,WA,Passenger,21951,7543,29494,1394823,1424317,2.07,Washington
3536,December,2019,Mason,WA,Truck,0,0,0,20527,20527,0.0,Washington
3537,December,2019,Sumter,FL,Passenger,0,1,1,9,10,10.0,Furthest
3538,December,2019,Franklin,WA,Passenger,54,76,130,60982,61112,0.21,Washington
3539,December,2019,Kootenai,ID,Passenger,1,1,2,226,228,0.88,Nearest
3540,December,2019,Washington,OR,Passenger,1,0,1,454,455,0.22,Nearest
3541,December,2019,Maui,HI,Passenger,1,0,1,38,39,2.56,Nearest
3542,December,2019,Tarrant,TX,Passenger,2,0,2,192,194,1.03,Mid-Distance
3543,December,2019,Kittitas,WA,Truck,0,0,0,14624,14624,0.0,Washington
3544,December,2019,San Francisco,CA,Passenger,2,1,3,100,103,2.91,Nearest
3545,December,2019,Harris,TX,Passenger,1,0,1,240,241,0.41,Mid-Distance
3546,December,2019,Wilson,TX,Passenger,0,1,1,8,9,11.11,Mid-Distance
3547,December,2019,Moore,NC,Passenger,0,1,1,164,165,0.61,Furthest
3548,December,2019,Stafford,VA,Passenger,1,1,2,94,96,2.08,Furthest
3549,December,2019,Mason,WA,Passenger,142,135,277,47637,47914,0.58,Washington
3550,December,2019,San Juan,WA,Passenger,253,79,332,14407,14739,2.25,Washington
3551,December,2019,Cochise,AZ,Passenger,0,1,1,105,106,0.94,Nearest
3552,December,2019,DuPage,IL,Passenger,3,0,3,63,66,4.55,Mid-Distance
3553,December,2019,Benton,WA,Passenger,315,308,623,135242,135865,0.46,Washington
3554,December,2019,New Haven,CT,Passenger,0,2,2,46,48,4.17,Furthest
3555,December,2019,Walla Walla,WA,Passenger,63,60,123,36306,36429,0.34,Washington
3556,December,2019,Arlington,VA,Passenger,0,2,2,152,154,1.3,Furthest
3557,December,2019,Owyhee,ID,Passenger,1,0,1,3,4,25.0,Nearest
3558,December,2019,Fairfax,VA,Passenger,4,2,6,753,759,0.79,Furthest
3559,December,2019,Shelby,OH,Passenger,0,1,1,1,2,50.0,Furthest
3560,December,2019,Richmond,GA,Passenger,0,1,1,91,92,1.09,Furthest
3561,December,2019,Brevard,FL,Passenger,0,1,1,88,89,1.12,Furthest
3562,December,2019,Fort Bend,TX,Passenger,1,0,1,47,48,2.08,Mid-Distance
3563,December,2019,Cascade,MT,Passenger,0,1,1,55,56,1.79,Nearest
3564,December,2019,Orange,CA,Passenger,7,2,9,504,513,1.75,Nearest
3565,December,2019,Monroe,IL,Passenger,1,0,1,4,5,20.0,Mid-Distance
3566,December,2019,Lincoln,WA,Passenger,1,11,12,7804,7816,0.15,Washington
3567,December,2019,Dallas,TX,Passenger,1,0,1,207,208,0.48,Mid-Distance
3568,December,2019,Klamath,OR,Passenger,1,0,1,37,38,2.63,Nearest
3569,December,2019,Douglas,NE,Passenger,0,1,1,57,58,1.72,Mid-Distance
3570,December,2019,Whatcom,WA,Passenger,987,477,1464,151703,153167,0.96,Washington
3571,December,2019,Kern,CA,Passenger,0,1,1,222,223,0.45,Nearest
3572,December,2019,New London,CT,Passenger,0,2,2,246,248,0.81,Furthest
3573,December,2019,Whitman,WA,Passenger,42,46,88,22678,22766,0.39,Washington
3574,December,2019,Palm Beach,FL,Passenger,0,1,1,83,84,1.19,Furthest
3575,December,2019,Pend Oreille,WA,Passenger,7,7,14,9514,9528,0.15,Washington
3576,December,2019,Charles,MD,Passenger,0,1,1,83,84,1.19,Furthest
3577,December,2019,Lake,FL,Passenger,1,0,1,21,22,4.55,Furthest
3578,December,2019,Tuolumne,CA,Passenger,0,1,1,11,12,8.33,Nearest
3579,December,2019,Clackamas,OR,Passenger,2,1,3,210,213,1.41,Nearest
3580,December,2019,Portsmouth,VA,Passenger,0,1,1,81,82,1.22,Furthest
3581,December,2019,Kitsap,WA,Truck,1,0,1,54446,54447,0.0,Washington
3582,December,2019,Stevens,WA,Truck,0,0,0,18761,18761,0.0,Washington
3583,December,2019,Skamania,WA,Passenger,26,19,45,8767,8812,0.51,Washington
3584,December,2019,Ramsey,MN,Passenger,1,0,1,39,40,2.5,Mid-Distance
3585,December,2019,Alexandria,VA,Passenger,1,0,1,147,148,0.68,Furthest
3586,December,2019,Pinellas,FL,Passenger,1,1,2,108,110,1.82,Furthest
3587,December,2019,Powhatan,VA,Passenger,1,0,1,0,1,100.0,Furthest
3588,December,2019,St. Mary's,MD,Passenger,1,0,1,217,218,0.46,Furthest
3589,December,2019,Suffolk,MA,Passenger,0,1,1,34,35,2.86,Furthest
3590,December,2019,Franklin,WA,Truck,0,0,0,19779,19779,0.0,Washington
3591,December,2019,Grays Harbor,WA,Truck,0,0,0,20770,20770,0.0,Washington
3592,December,2019,Chelan,WA,Truck,0,0,0,22549,22549,0.0,Washington
3593,December,2019,Pima,AZ,Passenger,3,1,4,369,373,1.07,Nearest
3594,December,2020,DeKalb,IN,Passenger,1,0,1,0,1,100.0,Furthest
3595,December,2020,Lincoln,WA,Truck,0,0,0,4673,4673,0.0,Washington
3596,December,2020,Clallam,WA,Truck,1,0,1,21831,21832,0.0,Washington
3597,December,2020,Columbia,WA,Truck,0,0,0,1543,1543,0.0,Washington
3598,December,2020,Broward,FL,Passenger,2,1,3,107,110,2.73,Furthest
3599,December,2020,Benton,WA,Truck,0,0,0,43207,43207,0.0,Washington
3600,December,2020,Chelan,WA,Passenger,278,88,366,54504,54870,0.67,Washington
3601,December,2020,Montgomery,MD,Passenger,1,0,1,227,228,0.44,Furthest
3602,December,2020,Cascade,MT,Passenger,0,1,1,54,55,1.82,Nearest
3603,December,2020,Charleston,SC,Passenger,2,0,2,89,91,2.2,Furthest
3604,December,2020,Hudson,NJ,Passenger,1,0,1,39,40,2.5,Furthest
3605,December,2020,Whitman,WA,Truck,0,0,0,8508,8508,0.0,Washington
3606,December,2020,Hampshire,MA,Passenger,1,0,1,6,7,14.29,Furthest
3607,December,2020,Harrison,MS,Passenger,2,0,2,52,54,3.7,Mid-Distance
3608,December,2020,Cumberland,NC,Passenger,0,3,3,442,445,0.67,Furthest
3609,December,2020,Collin,TX,Passenger,1,1,2,116,118,1.69,Mid-Distance
3610,December,2020,Nassau,NY,Passenger,4,0,4,28,32,12.5,Furthest
3611,December,2020,Whitman,WA,Passenger,51,44,95,21905,22000,0.43,Washington
3612,December,2020,Pierce,WA,Truck,0,0,0,144789,144789,0.0,Washington
3613,December,2020,Larimer,CO,Passenger,1,0,1,54,55,1.82,Mid-Distance
3614,December,2020,Duval,FL,Passenger,0,2,2,353,355,0.56,Furthest
3615,December,2020,Douglas,WA,Truck,0,0,0,12494,12494,0.0,Washington
3616,December,2020,Vigo,IN,Passenger,1,0,1,6,7,14.29,Furthest
3617,December,2020,Kitsap,WA,Passenger,1556,756,2312,179832,182144,1.27,Washington
3618,December,2020,Honolulu,HI,Passenger,5,2,7,416,423,1.65,Nearest
3619,December,2020,Franklin,WA,Passenger,85,83,168,61368,61536,0.27,Washington
3620,December,2020,Kauai,HI,Passenger,1,0,1,15,16,6.25,Nearest
3621,December,2020,Boulder,CO,Passenger,0,1,1,44,45,2.22,Mid-Distance
3622,December,2020,St. Clair,IL,Passenger,1,0,1,137,138,0.72,Mid-Distance
3623,December,2020,Klickitat,WA,Truck,0,0,0,8088,8088,0.0,Washington
3624,December,2020,Stevens,WA,Truck,0,0,0,18716,18716,0.0,Washington
3625,December,2020,DuPage,IL,Passenger,2,0,2,53,55,3.64,Mid-Distance
3626,December,2020,Denton,TX,Passenger,1,0,1,85,86,1.16,Mid-Distance
3627,December,2020,San Francisco,CA,Passenger,1,1,2,90,92,2.17,Nearest
3628,December,2020,Bradley,TN,Passenger,1,0,1,0,1,100.0,Furthest
3629,December,2020,Skagit,WA,Passenger,497,238,735,91428,92163,0.8,Washington
3630,December,2020,Douglas,NE,Passenger,0,1,1,51,52,1.92,Mid-Distance
3631,December,2020,Dallas,TX,Passenger,1,0,1,171,172,0.58,Mid-Distance
3632,December,2020,Kitsap,WA,Truck,0,0,0,54371,54371,0.0,Washington
3633,December,2020,Santa Clara,CA,Passenger,7,2,9,267,276,3.26,Nearest
3634,December,2020,Lewis,WA,Passenger,123,122,245,58843,59088,0.41,Washington
3635,December,2020,Portsmouth,VA,Passenger,0,1,1,77,78,1.28,Furthest
3636,December,2020,Los Angeles,CA,Passenger,10,11,21,939,960,2.19,Nearest
3637,December,2020,Columbia,WA,Passenger,5,3,8,2441,2449,0.33,Washington
3638,December,2020,Grant,WA,Truck,0,0,0,27505,27505,0.0,Washington
3639,December,2020,Maui,HI,Passenger,1,0,1,27,28,3.57,Nearest
3640,December,2020,Lewis,WA,Truck,0,0,0,26622,26622,0.0,Washington
3641,December,2020,Dakota,MN,Passenger,0,1,1,26,27,3.7,Mid-Distance
3642,December,2020,Lake,FL,Passenger,1,0,1,22,23,4.35,Furthest
3643,December,2020,Sacramento,CA,Passenger,2,0,2,234,236,0.85,Nearest
3644,December,2020,Lincoln,WA,Passenger,5,12,17,7644,7661,0.22,Washington
3645,December,2020,San Mateo,CA,Passenger,1,1,2,107,109,1.83,Nearest
3646,December,2020,Carson City,NV,Passenger,1,0,1,12,13,7.69,Nearest
3647,December,2020,Shelby,OH,Passenger,0,1,1,1,2,50.0,Furthest
3648,December,2020,Plaquemines,LA,Passenger,0,1,1,13,14,7.14,Mid-Distance
3649,December,2020,Mason,WA,Truck,0,0,0,20948,20948,0.0,Washington
3650,December,2020,Clark,WA,Passenger,2356,1180,3536,319513,323049,1.09,Washington
3651,December,2020,Anne Arundel,MD,Passenger,1,1,2,399,401,0.5,Furthest
3652,December,2020,Williams,ND,Passenger,0,1,1,10,11,9.09,Mid-Distance
3653,December,2020,Bartow,GA,Passenger,0,1,1,4,5,20.0,Furthest
3654,December,2020,Wahkiakum,WA,Passenger,6,7,13,3036,3049,0.43,Washington
3655,December,2020,Harris,TX,Passenger,1,1,2,214,216,0.93,Mid-Distance
3656,December,2020,Flathead,MT,Passenger,1,0,1,50,51,1.96,Nearest
3657,December,2020,Garfield,WA,Passenger,0,2,2,1367,1369,0.15,Washington
3658,December,2020,Yakima,WA,Passenger,170,128,298,167294,167592,0.18,Washington
3659,December,2020,Sarasota,FL,Passenger,2,0,2,26,28,7.14,Furthest
3660,December,2020,Santa Cruz,CA,Passenger,1,0,1,27,28,3.57,Nearest
3661,December,2020,Kittitas,WA,Truck,0,0,0,14646,14646,0.0,Washington
3662,December,2020,Charles,MD,Passenger,1,1,2,70,72,2.78,Furthest
3663,December,2020,Powhatan,VA,Passenger,1,0,1,1,2,50.0,Furthest
3664,December,2020,Thurston,WA,Truck,0,0,0,56389,56389,0.0,Washington
3665,December,2020,Erie,NY,Passenger,1,0,1,42,43,2.33,Furthest
3666,December,2020,San Juan,WA,Passenger,365,111,476,14021,14497,3.28,Washington
3667,December,2020,Richland,SC,Passenger,0,1,1,139,140,0.71,Furthest
3668,December,2020,Ada,ID,Passenger,0,1,1,243,244,0.41,Nearest
3669,December,2020,Walla Walla,WA,Truck,0,0,0,13871,13871,0.0,Washington
3670,December,2020,Albemarle,VA,Passenger,1,0,1,21,22,4.55,Furthest
3671,December,2020,Anchorage,AK,Passenger,1,0,1,144,145,0.69,Nearest
3672,December,2020,Bexar,TX,Passenger,3,5,8,567,575,1.39,Mid-Distance
3674,December,2020,Juneau,AK,Passenger,0,1,1,25,26,3.85,Nearest
3675,December,2020,Houston,GA,Passenger,1,0,1,51,52,1.92,Furthest
3676,December,2020,Deschutes,OR,Passenger,1,0,1,117,118,0.85,Nearest
3677,December,2020,Ferry,WA,Passenger,9,3,12,4361,4373,0.27,Washington
3678,December,2020,Moore,NC,Passenger,0,1,1,147,148,0.68,Furthest
3679,December,2020,Jefferson,WA,Passenger,285,155,440,24813,25253,1.74,Washington
3680,December,2020,Sumter,FL,Passenger,0,1,1,10,11,9.09,Furthest
3681,December,2020,Norfolk,VA,Passenger,2,3,5,338,343,1.46,Furthest
3682,December,2020,Kittitas,WA,Passenger,127,51,178,29824,30002,0.59,Washington
3683,December,2020,Manassas,VA,Passenger,0,1,1,5,6,16.67,Furthest
3684,December,2020,Okanogan,WA,Passenger,55,36,91,26069,26160,0.35,Washington
3685,December,2020,Rockingham,NH,Passenger,1,0,1,21,22,4.55,Furthest
3686,December,2020,Harnett,NC,Passenger,1,0,1,185,186,0.54,Furthest
3687,December,2020,Asotin,WA,Passenger,16,13,29,12413,12442,0.23,Washington
3688,December,2020,Skamania,WA,Passenger,33,22,55,8352,8407,0.65,Washington
3689,December,2020,Grays Harbor,WA,Truck,0,0,0,21205,21205,0.0,Washington
3690,December,2020,King,WA,Passenger,26917,8171,35088,1370135,1405223,2.5,Washington
3691,December,2020,Leavenworth,KS,Passenger,0,1,1,124,125,0.8,Mid-Distance
3692,December,2020,San Diego,CA,Passenger,13,4,17,2708,2725,0.62,Nearest
3693,December,2020,Thurston,WA,Passenger,1321,780,2101,197406,199507,1.05,Washington
3694,December,2020,Riverside,CA,Passenger,4,1,5,592,597,0.84,Nearest
3695,December,2020,Allegheny,PA,Passenger,1,1,2,66,68,2.94,Furthest
3696,December,2020,Cowlitz,WA,Passenger,177,127,304,72118,72422,0.42,Washington
3697,December,2020,Sedgwick,KS,Passenger,1,1,2,89,91,2.2,Mid-Distance
3698,December,2020,Okanogan,WA,Truck,0,0,0,16607,16607,0.0,Washington
3699,December,2020,New London,CT,Passenger,1,2,3,232,235,1.28,Furthest
3700,December,2020,Maricopa,AZ,Passenger,6,6,12,1306,1318,0.91,Nearest
3701,December,2020,Okaloosa,FL,Passenger,0,1,1,132,133,0.75,Furthest
3702,December,2020,Placer,CA,Passenger,2,0,2,83,85,2.35,Nearest
3703,December,2020,Twin Falls,ID,Passenger,0,1,1,24,25,4.0,Nearest
3704,December,2020,Hawaii,HI,Passenger,1,0,1,53,54,1.85,Nearest
3705,December,2020,Rogers,OK,Passenger,1,0,1,3,4,25.0,Mid-Distance
3706,December,2020,Oldham,KY,Passenger,0,1,1,4,5,20.0,Furthest
3707,December,2020,Jefferson,WA,Truck,0,0,0,9588,9588,0.0,Washington
3708,December,2020,Miami-Dade,FL,Passenger,1,0,1,97,98,1.02,Furthest
3709,December,2020,Ventura,CA,Passenger,1,1,2,272,274,0.73,Nearest
3710,December,2020,Wichita,TX,Passenger,1,0,1,41,42,2.38,Mid-Distance
3711,December,2020,Clark,WA,Truck,0,0,0,83498,83498,0.0,Washington
3712,December,2020,Penobscot,ME,Passenger,0,1,1,9,10,10.0,Furthest
3713,December,2020,Kern,CA,Passenger,0,1,1,216,217,0.46,Nearest
3714,December,2020,Contra Costa,CA,Passenger,3,3,6,278,284,2.11,Nearest
3715,December,2020,Snohomish,WA,Truck,0,0,0,125700,125700,0.0,Washington
3716,December,2020,San Joaquin,CA,Passenger,1,0,1,108,109,0.92,Nearest
3717,December,2020,Denver,CO,Passenger,1,0,1,115,116,0.86,Mid-Distance
3718,December,2020,Kings,NY,Passenger,1,0,1,62,63,1.59,Furthest
3719,December,2020,Stevens,WA,Passenger,36,40,76,30234,30310,0.25,Washington
3720,December,2020,Pennington,SD,Passenger,1,0,1,34,35,2.86,Mid-Distance
3721,December,2020,Spartanburg,SC,Passenger,0,1,1,49,50,2.0,Furthest
3722,December,2020,Grays Harbor,WA,Passenger,127,122,249,48651,48900,0.51,Washington
3723,December,2020,Douglas,CO,Passenger,0,1,1,78,79,1.27,Mid-Distance
3724,December,2020,Pacific,WA,Truck,0,0,0,7792,7792,0.0,Washington
3725,December,2020,Spokane,WA,Truck,0,0,0,100712,100712,0.0,Washington
3726,December,2020,Fresno,CA,Passenger,1,0,1,169,170,0.59,Nearest
3727,December,2020,Queens,NY,Passenger,1,0,1,52,53,1.89,Furthest
3728,December,2020,Whatcom,WA,Passenger,1218,550,1768,150033,151801,1.16,Washington
3729,December,2020,Adams,WA,Truck,0,0,0,5337,5337,0.0,Washington
3730,December,2020,Prince George's,MD,Passenger,2,1,3,145,148,2.03,Furthest
3731,December,2020,Orange,CA,Passenger,4,3,7,446,453,1.55,Nearest
3732,December,2020,El Dorado,CA,Passenger,1,0,1,33,34,2.94,Nearest
3733,December,2020,Camden,NJ,Passenger,0,1,1,19,20,5.0,Furthest
3734,December,2020,Morris,NJ,Passenger,1,0,1,16,17,5.88,Furthest
3735,December,2020,Yakima,WA,Truck,0,0,0,60982,60982,0.0,Washington
3736,December,2020,Pierce,WA,Passenger,2825,1771,4596,555647,560243,0.82,Washington
3737,December,2020,Frederick,MD,Passenger,1,1,2,72,74,2.7,Furthest
3738,December,2020,Monroe,IL,Passenger,1,0,1,3,4,25.0,Mid-Distance
3739,December,2020,Lee,FL,Passenger,1,0,1,43,44,2.27,Furthest
3740,December,2020,Howard,MD,Passenger,0,1,1,64,65,1.54,Furthest
3741,December,2020,Gwinnett,GA,Passenger,1,0,1,67,68,1.47,Furthest
3742,December,2020,Lake,IL,Passenger,2,0,2,158,160,1.25,Mid-Distance
3743,December,2020,Ulster,NY,Passenger,1,0,1,8,9,11.11,Furthest
3744,December,2020,New Haven,CT,Passenger,0,2,2,36,38,5.26,Furthest
3745,December,2020,Garfield,WA,Truck,0,0,0,996,996,0.0,Washington
3746,December,2020,Skagit,WA,Truck,1,0,1,32781,32782,0.0,Washington
3747,December,2020,Suffolk,MA,Passenger,0,2,2,33,35,5.71,Furthest
3748,December,2020,Pinellas,FL,Passenger,1,1,2,97,99,2.02,Furthest
3749,December,2020,Ramsey,MN,Passenger,1,0,1,34,35,2.86,Mid-Distance
3750,December,2020,Snohomish,WA,Passenger,5036,1848,6884,538610,545494,1.26,Washington
3751,December,2020,Klamath,OR,Passenger,1,0,1,30,31,3.23,Nearest
3752,December,2020,Saginaw,MI,Passenger,2,0,2,9,11,18.18,Furthest
3753,December,2020,Fairbanks North Star,AK,Passenger,0,1,1,90,91,1.1,Nearest
3754,December,2020,Middlesex,MA,Passenger,1,1,2,94,96,2.08,Furthest
3755,December,2020,Kent,MI,Passenger,0,1,1,23,24,4.17,Furthest
3756,December,2020,Randolph,NC,Passenger,1,0,1,6,7,14.29,Furthest
3757,December,2020,Owyhee,ID,Passenger,1,0,1,3,4,25.0,Nearest
3758,December,2020,Island,WA,Truck,0,0,0,21369,21369,0.0,Washington
3759,December,2020,Cowlitz,WA,Truck,0,0,0,28933,28933,0.0,Washington
3760,December,2020,Pacific,WA,Passenger,34,35,69,15727,15796,0.44,Washington
3761,December,2020,Salt Lake,UT,Passenger,0,1,1,172,173,0.58,Nearest
3762,December,2020,Montgomery,PA,Passenger,1,0,1,25,26,3.85,Furthest
3763,December,2020,Williamson,TX,Passenger,0,2,2,122,124,1.61,Mid-Distance
3764,December,2020,El Paso,CO,Passenger,2,0,2,698,700,0.29,Mid-Distance
3765,December,2020,San Juan,WA,Truck,0,0,0,5874,5874,0.0,Washington
3766,December,2020,Orange,FL,Passenger,1,0,1,114,115,0.87,Furthest
3767,December,2020,Klickitat,WA,Passenger,62,43,105,14980,15085,0.7,Washington
3768,December,2020,Palm Beach,FL,Passenger,0,1,1,73,74,1.35,Furthest
3769,December,2020,Virginia Beach,VA,Passenger,2,0,2,637,639,0.31,Furthest
3770,December,2020,Stafford,VA,Passenger,2,1,3,92,95,3.16,Furthest
3771,December,2020,District of Columbia,DC,Passenger,3,1,4,201,205,1.95,Furthest
3772,December,2020,St. Louis,MO,Passenger,1,0,1,96,97,1.03,Furthest
3773,December,2020,Calvert,MD,Passenger,0,2,2,85,87,2.3,Furthest
3774,December,2020,Arapahoe,CO,Passenger,1,0,1,120,121,0.83,Mid-Distance
3775,December,2020,El Paso,TX,Passenger,3,0,3,396,399,0.75,Mid-Distance
3776,December,2020,Solano,CA,Passenger,1,0,1,205,206,0.49,Nearest
3777,December,2020,Missoula,MT,Passenger,1,0,1,64,65,1.54,Nearest
3778,December,2020,Prince William,VA,Passenger,1,2,3,217,220,1.36,Furthest
3779,December,2020,Nueces,TX,Passenger,1,0,1,82,83,1.2,Mid-Distance
3780,December,2020,Carroll,NH,Passenger,0,1,1,5,6,16.67,Furthest
3781,December,2020,Washtenaw,MI,Passenger,1,0,1,31,32,3.12,Furthest
3782,December,2020,Island,WA,Passenger,507,289,796,63011,63807,1.25,Washington
3783,December,2020,Asotin,WA,Truck,0,0,0,6675,6675,0.0,Washington
3784,December,2020,Bucks,PA,Passenger,1,0,1,18,19,5.26,Furthest
3785,December,2020,Montgomery,OH,Passenger,0,1,1,52,53,1.89,Furthest
3786,December,2020,Ferry,WA,Truck,0,0,0,3607,3607,0.0,Washington
3787,December,2020,Philadelphia,PA,Passenger,1,0,1,60,61,1.64,Furthest
3788,December,2020,Washington,OR,Passenger,1,0,1,410,411,0.24,Nearest
3789,December,2020,Whatcom,WA,Truck,3,0,3,43545,43548,0.01,Washington
3790,December,2020,Boone,MO,Passenger,0,1,1,10,11,9.09,Furthest
3791,December,2020,Chesapeake,VA,Passenger,0,3,3,404,407,0.74,Furthest
3792,December,2020,Fulton,GA,Passenger,1,2,3,89,92,3.26,Furthest
3793,December,2020,Jefferson,NY,Passenger,0,1,1,208,209,0.48,Furthest
3794,December,2020,St. Mary's,MD,Passenger,1,0,1,210,211,0.47,Furthest
3795,December,2020,Hamilton,IN,Passenger,2,0,2,34,36,5.56,Furthest
3796,December,2020,Fort Bend,TX,Passenger,1,0,1,42,43,2.33,Mid-Distance
3797,December,2020,Utah,UT,Passenger,0,1,1,126,127,0.79,Nearest
3798,December,2020,Mason,WA,Passenger,173,133,306,47648,47954,0.64,Washington
3799,December,2020,Hennepin,MN,Passenger,2,0,2,82,84,2.38,Mid-Distance
3800,December,2020,Clark,NV,Passenger,3,2,5,649,654,0.76,Nearest
3801,December,2020,Grant,WA,Passenger,80,81,161,65927,66088,0.24,Washington
3802,December,2020,Douglas,WA,Passenger,86,44,130,28191,28321,0.46,Washington
3803,December,2020,Nassau,FL,Passenger,1,0,1,35,36,2.78,Furthest
3804,December,2020,Clallam,WA,Passenger,273,185,458,49921,50379,0.91,Washington
3805,December,2020,Wilson,TX,Passenger,0,1,1,5,6,16.67,Mid-Distance
3806,December,2020,Walla Walla,WA,Passenger,98,67,165,36134,36299,0.45,Washington
3807,December,2020,Pend Oreille,WA,Truck,0,0,0,5715,5715,0.0,Washington
3808,December,2020,Benton,WA,Passenger,440,355,795,134989,135784,0.59,Washington
3809,December,2020,Skamania,WA,Truck,0,0,0,4004,4004,0.0,Washington
3810,December,2020,RÃ­o Grande,PR,Passenger,1,0,1,1,2,50.0,Mid-Distance
3811,December,2020,Chelan,WA,Truck,0,0,0,22804,22804,0.0,Washington
3812,December,2020,Platte,MO,Passenger,1,0,1,17,18,5.56,Furthest
3813,December,2020,Cape May,NJ,Passenger,0,1,1,10,11,9.09,Furthest
3814,December,2020,Putnam,TN,Passenger,0,1,1,2,3,33.33,Furthest
3815,December,2020,Clackamas,OR,Passenger,3,0,3,180,183,1.64,Nearest
3816,December,2020,Pend Oreille,WA,Passenger,12,4,16,9171,9187,0.17,Washington
3817,December,2020,Loudoun,VA,Passenger,1,0,1,75,76,1.32,Furthest
3818,December,2020,Travis,TX,Passenger,2,1,3,168,171,1.75,Mid-Distance
3819,December,2020,Howard,IN,Passenger,0,1,1,3,4,25.0,Furthest
3820,December,2020,Goochland,VA,Passenger,4,3,7,245,252,2.78,Furthest
3821,December,2020,Montgomery,TX,Passenger,1,0,1,46,47,2.13,Mid-Distance
3822,December,2020,Wahkiakum,WA,Truck,0,0,0,1770,1770,0.0,Washington
3823,December,2020,Monterey,CA,Passenger,0,1,1,156,157,0.64,Nearest
3824,December,2020,New York,NY,Passenger,1,0,1,54,55,1.82,Furthest
3825,December,2020,Tulsa,OK,Passenger,1,1,2,39,41,4.88,Mid-Distance
3826,December,2020,Pima,AZ,Passenger,2,1,3,320,323,0.93,Nearest
3827,December,2020,Franklin,WA,Truck,0,0,0,20434,20434,0.0,Washington
3828,December,2020,Adams,WA,Passenger,10,7,17,12960,12977,0.13,Washington
3829,December,2020,Alexandria,VA,Passenger,2,0,2,134,136,1.47,Furthest
3830,December,2020,King,WA,Truck,6,1,7,184370,184377,0.0,Washington
3831,December,2020,Multnomah,OR,Passenger,3,6,9,685,694,1.3,Nearest
3832,December,2020,Fairfax,VA,Passenger,4,3,7,704,711,0.98,Furthest
3833,December,2020,Alameda,CA,Passenger,3,0,3,260,263,1.14,Nearest
3834,December,2020,Jones,GA,Passenger,1,0,1,1,2,50.0,Furthest
3835,December,2020,Washoe,NV,Passenger,1,0,1,101,102,0.98,Nearest
3836,December,2020,Arlington,VA,Passenger,0,2,2,140,142,1.41,Furthest
3837,December,2020,Richmond,GA,Passenger,0,1,1,77,78,1.28,Furthest
3838,December,2020,Carroll,MD,Passenger,0,1,1,21,22,4.55,Furthest
3839,December,2020,Polk,FL,Passenger,1,0,1,56,57,1.75,Furthest
3840,December,2020,DeKalb,GA,Passenger,1,0,1,69,70,1.43,Furthest
3841,December,2020,Spokane,WA,Passenger,886,547,1433,321109,322542,0.44,Washington
3842,December,2020,Suffolk,VA,Passenger,1,0,1,124,125,0.8,Furthest
3843,December,2020,Greene,MO,Passenger,0,1,1,32,33,3.03,Furthest
3844,December,2021,Benton,WA,Truck,0,0,0,43707,43707,0.0,Washington
3845,December,2021,Bartow,GA,Passenger,0,1,1,3,4,25.0,Furthest
3846,December,2021,Lewis,WA,Passenger,206,164,370,59615,59985,0.62,Washington
3847,December,2021,Geary,KS,Passenger,1,0,1,94,95,1.05,Mid-Distance
3848,December,2021,Pend Oreille,WA,Truck,0,0,0,5703,5703,0.0,Washington
3849,December,2021,Denton,TX,Passenger,1,0,1,74,75,1.33,Mid-Distance
3850,December,2021,Wilson,NC,Passenger,1,0,1,0,1,100.0,Furthest
3851,December,2021,Hamilton,OH,Passenger,1,0,1,32,33,3.03,Furthest
3852,December,2021,El Paso,TX,Passenger,2,0,2,344,346,0.58,Mid-Distance
3853,December,2021,Moore,NC,Passenger,0,1,1,120,121,0.83,Furthest
3854,December,2021,Elmore,ID,Passenger,1,0,1,16,17,5.88,Nearest
3855,December,2021,Williamson,TX,Passenger,1,2,3,90,93,3.23,Mid-Distance
3856,December,2021,Lincoln,WA,Truck,0,0,0,4823,4823,0.0,Washington
3857,December,2021,Williams,ND,Passenger,0,1,1,8,9,11.11,Mid-Distance
3858,December,2021,Benton,WA,Passenger,639,445,1084,136113,137197,0.79,Washington
3859,December,2021,Grant,WA,Truck,0,0,0,27999,27999,0.0,Washington
3860,December,2021,Alexandria,VA,Passenger,2,0,2,115,117,1.71,Furthest
3861,December,2021,Erie,NY,Passenger,1,0,1,31,32,3.12,Furthest
3862,December,2021,Coryell,TX,Passenger,1,0,1,106,107,0.93,Mid-Distance
3863,December,2021,Fresno,CA,Passenger,1,0,1,155,156,0.64,Nearest
3864,December,2021,Clallam,WA,Truck,1,0,1,22124,22125,0.0,Washington
3865,December,2021,Wahkiakum,WA,Passenger,17,10,27,3082,3109,0.87,Washington
3866,December,2021,Spokane,WA,Truck,0,0,0,102792,102792,0.0,Washington
3867,December,2021,Asotin,WA,Truck,0,0,0,6755,6755,0.0,Washington
3868,December,2021,Penobscot,ME,Passenger,0,1,1,8,9,11.11,Furthest
3869,December,2021,Grant,WA,Passenger,137,98,235,66973,67208,0.35,Washington
3870,December,2021,Greene,MO,Passenger,0,1,1,24,25,4.0,Furthest
3871,December,2021,Adams,WA,Truck,0,0,0,5419,5419,0.0,Washington
3872,December,2021,Fairfax,VA,Passenger,3,4,7,645,652,1.07,Furthest
3873,December,2021,Howard,IN,Passenger,0,1,1,6,7,14.29,Furthest
3874,December,2021,Larimer,CO,Passenger,1,0,1,50,51,1.96,Mid-Distance
3875,December,2021,Monterey,CA,Passenger,0,1,1,136,137,0.73,Nearest
3876,December,2021,Stevens,WA,Truck,0,0,0,18940,18940,0.0,Washington
3877,December,2021,Asotin,WA,Passenger,22,17,39,12718,12757,0.31,Washington
3878,December,2021,Boulder,CO,Passenger,1,1,2,38,40,5.0,Mid-Distance
3879,December,2021,Island,WA,Passenger,714,340,1054,62768,63822,1.65,Washington
3881,December,2021,Charleston,SC,Passenger,2,1,3,75,78,3.85,Furthest
3882,December,2021,Santa Cruz,CA,Passenger,1,0,1,23,24,4.17,Nearest
3883,December,2021,Adams,WA,Passenger,17,14,31,13083,13114,0.24,Washington
3884,December,2021,Whatcom,WA,Truck,4,0,4,43696,43700,0.01,Washington
3885,December,2021,St. Clair,IL,Passenger,2,0,2,120,122,1.64,Mid-Distance
3886,December,2021,Solano,CA,Passenger,1,0,1,173,174,0.57,Nearest
3887,December,2021,Pend Oreille,WA,Passenger,18,9,27,9129,9156,0.29,Washington
3888,December,2021,Jefferson,WA,Truck,0,0,0,9599,9599,0.0,Washington
3889,December,2021,Santa Clara,CA,Passenger,7,1,8,227,235,3.4,Nearest
3890,December,2021,Rogers,OK,Passenger,1,0,1,3,4,25.0,Mid-Distance
3891,December,2021,Jefferson,WA,Passenger,382,194,576,24756,25332,2.27,Washington
3892,December,2021,Ferry,WA,Passenger,14,3,17,4442,4459,0.38,Washington
3893,December,2021,Thurston,WA,Truck,0,0,0,56065,56065,0.0,Washington
3894,December,2021,Powhatan,VA,Passenger,1,0,1,1,2,50.0,Furthest
3895,December,2021,Honolulu,HI,Passenger,4,4,8,346,354,2.26,Nearest
3896,December,2021,Alameda,CA,Passenger,4,0,4,210,214,1.87,Nearest
3897,December,2021,Kittitas,WA,Truck,0,0,0,14794,14794,0.0,Washington
3898,December,2021,Ulster,NY,Passenger,1,0,1,9,10,10.0,Furthest
3899,December,2021,Whitman,WA,Passenger,67,59,126,21978,22104,0.57,Washington
3900,December,2021,Suffolk,VA,Passenger,1,0,1,124,125,0.8,Furthest
3901,December,2021,Juneau,AK,Passenger,0,1,1,27,28,3.57,Nearest
3902,December,2021,Houston,GA,Passenger,1,0,1,43,44,2.27,Furthest
3903,December,2021,Clallam,WA,Passenger,383,239,622,50384,51006,1.22,Washington
3904,December,2021,Klickitat,WA,Passenger,89,53,142,15347,15489,0.92,Washington
3905,December,2021,Sarpy,NE,Passenger,1,0,1,58,59,1.69,Mid-Distance
3906,December,2021,Wahkiakum,WA,Truck,0,0,0,1824,1824,0.0,Washington
3907,December,2021,Carroll,MD,Passenger,0,1,1,16,17,5.88,Furthest
3908,December,2021,Franklin,WA,Passenger,162,104,266,62306,62572,0.43,Washington
3909,December,2021,Pacific,WA,Passenger,51,64,115,16068,16183,0.71,Washington
3910,December,2021,Clark,WA,Truck,1,0,1,83996,83997,0.0,Washington
3911,December,2021,Plaquemines,LA,Passenger,0,1,1,17,18,5.56,Mid-Distance
3912,December,2021,Flathead,MT,Passenger,1,0,1,38,39,2.56,Nearest
3913,December,2021,Okaloosa,FL,Passenger,0,1,1,108,109,0.92,Furthest
3914,December,2021,Carroll,NH,Passenger,0,1,1,5,6,16.67,Furthest
3915,December,2021,Manassas,VA,Passenger,0,1,1,7,8,12.5,Furthest
3916,December,2021,King,WA,Passenger,35480,10222,45702,1359266,1404968,3.25,Washington
3917,December,2021,Grays Harbor,WA,Truck,0,0,0,21388,21388,0.0,Washington
3918,December,2021,Collin,TX,Passenger,1,0,1,102,103,0.97,Mid-Distance
3919,December,2021,Richmond,NY,Passenger,1,0,1,6,7,14.29,Furthest
3920,December,2021,Nueces,TX,Passenger,1,1,2,64,66,3.03,Mid-Distance
3921,December,2021,Yakima,WA,Truck,0,0,0,61785,61785,0.0,Washington
3922,December,2021,Salt Lake,UT,Passenger,1,1,2,150,152,1.32,Nearest
3923,December,2021,Platte,MO,Passenger,1,0,1,17,18,5.56,Furthest
3924,December,2021,Boone,MO,Passenger,0,1,1,9,10,10.0,Furthest
3925,December,2021,Lincoln,WA,Passenger,7,16,23,7719,7742,0.3,Washington
3926,December,2021,Klickitat,WA,Truck,0,0,0,8333,8333,0.0,Washington
3927,December,2021,Island,WA,Truck,0,0,0,21524,21524,0.0,Washington
3928,December,2021,DeKalb,GA,Passenger,1,0,1,56,57,1.75,Furthest
3929,December,2021,Shelby,OH,Passenger,0,1,1,2,3,33.33,Furthest
3930,December,2021,Allegheny,PA,Passenger,1,1,2,55,57,3.51,Furthest
3931,December,2021,Ventura,CA,Passenger,2,1,3,242,245,1.22,Nearest
3932,December,2021,San Juan,WA,Passenger,478,149,627,14189,14816,4.23,Washington
3933,December,2021,Essex,NJ,Passenger,2,0,2,10,12,16.67,Furthest
3934,December,2021,Gwinnett,GA,Passenger,1,0,1,57,58,1.72,Furthest
3935,December,2021,Kings,NY,Passenger,1,0,1,66,67,1.49,Furthest
3936,December,2021,Baltimore,MD,Passenger,1,0,1,80,81,1.23,Furthest
3937,December,2021,Snohomish,WA,Passenger,7024,2235,9259,537474,546733,1.69,Washington
3938,December,2021,Cowlitz,WA,Truck,0,1,1,28998,28999,0.0,Washington
3939,December,2021,Placer,CA,Passenger,2,0,2,71,73,2.74,Nearest
3940,December,2021,Douglas,WA,Truck,0,0,0,12700,12700,0.0,Washington
3941,December,2021,Bexar,TX,Passenger,3,4,7,481,488,1.43,Mid-Distance
3942,December,2021,Onslow,NC,Passenger,0,1,1,167,168,0.6,Furthest
3943,December,2021,Carson City,NV,Passenger,1,0,1,8,9,11.11,Nearest
3944,December,2021,Queens,NY,Passenger,1,0,1,49,50,2.0,Furthest
3945,December,2021,Montgomery,MD,Passenger,3,2,5,203,208,2.4,Furthest
3946,December,2021,Mason,WA,Passenger,266,158,424,47764,48188,0.88,Washington
3947,December,2021,Wichita,TX,Passenger,1,0,1,42,43,2.33,Mid-Distance
3948,December,2021,Charles,MD,Passenger,1,1,2,67,69,2.9,Furthest
3949,December,2021,Owyhee,ID,Passenger,1,0,1,2,3,33.33,Nearest
3950,December,2021,Orange,FL,Passenger,1,0,1,103,104,0.96,Furthest
3951,December,2021,Ray,MO,Passenger,0,1,1,1,2,50.0,Furthest
3952,December,2021,Burlington,NJ,Passenger,0,1,1,118,119,0.84,Furthest
3953,December,2021,Lewis,WA,Truck,0,0,0,26677,26677,0.0,Washington
3954,December,2021,Riverside,CA,Passenger,5,1,6,494,500,1.2,Nearest
3955,December,2021,Multnomah,OR,Passenger,2,5,7,599,606,1.16,Nearest
3956,December,2021,Columbia,WA,Passenger,6,2,8,2452,2460,0.33,Washington
3957,December,2021,Oldham,KY,Passenger,0,1,1,4,5,20.0,Furthest
3958,December,2021,Lake,IL,Passenger,3,0,3,149,152,1.97,Mid-Distance
3959,December,2021,Virginia Beach,VA,Passenger,2,0,2,558,560,0.36,Furthest
3960,December,2021,Kern,CA,Passenger,0,1,1,198,199,0.5,Nearest
3961,December,2021,Clark,WA,Passenger,3474,1562,5036,320347,325383,1.55,Washington
3962,December,2021,Harris,TX,Passenger,1,0,1,160,161,0.62,Mid-Distance
3963,December,2021,Calvert,MD,Passenger,0,2,2,80,82,2.44,Furthest
3964,December,2021,St. Mary's,MD,Passenger,1,0,1,202,203,0.49,Furthest
3965,December,2021,Travis,TX,Passenger,2,0,2,130,132,1.52,Mid-Distance
3966,December,2021,Clackamas,OR,Passenger,2,0,2,159,161,1.24,Nearest
3967,December,2021,Nassau,NY,Passenger,2,0,2,25,27,7.41,Furthest
3968,December,2021,Jefferson,NY,Passenger,0,1,1,205,206,0.49,Furthest
3969,December,2021,Yamhill,OR,Passenger,1,0,1,31,32,3.12,Nearest
3970,December,2021,Frederick,MD,Passenger,1,1,2,68,70,2.86,Furthest
3971,December,2021,Rockdale,GA,Passenger,1,0,1,7,8,12.5,Furthest
3972,December,2021,Okanogan,WA,Truck,0,0,0,16688,16688,0.0,Washington
3973,December,2021,Whitman,WA,Truck,0,0,0,8559,8559,0.0,Washington
3974,December,2021,San Bernardino,CA,Passenger,0,1,1,357,358,0.28,Nearest
3975,December,2021,Escambia,FL,Passenger,0,1,1,136,137,0.73,Furthest
3976,December,2021,Cowlitz,WA,Passenger,274,163,437,71563,72000,0.61,Washington
3977,December,2021,Rockingham,NH,Passenger,1,0,1,17,18,5.56,Furthest
3978,December,2021,Pinellas,FL,Passenger,0,1,1,85,86,1.16,Furthest
3979,December,2021,Randolph,NC,Passenger,1,0,1,5,6,16.67,Furthest
3980,December,2021,Whatcom,WA,Passenger,1643,673,2316,149995,152311,1.52,Washington
3981,December,2021,Loudoun,VA,Passenger,1,0,1,66,67,1.49,Furthest
3982,December,2021,Yakima,WA,Passenger,286,173,459,168770,169229,0.27,Washington
3983,December,2021,Los Angeles,CA,Passenger,8,7,15,825,840,1.79,Nearest
3984,December,2021,Sonoma,CA,Passenger,0,1,1,80,81,1.23,Nearest
3985,December,2021,Lee,FL,Passenger,1,0,1,29,30,3.33,Furthest
3986,December,2021,Prince William,VA,Passenger,1,1,2,199,201,1.0,Furthest
3987,December,2021,Hillsborough,FL,Passenger,0,1,1,134,135,0.74,Furthest
3988,December,2021,Columbia,WA,Truck,0,0,0,1555,1555,0.0,Washington
3989,December,2021,Wake,NC,Passenger,1,0,1,106,107,0.93,Furthest
3990,December,2021,Montgomery,PA,Passenger,2,0,2,21,23,8.7,Furthest
3991,December,2021,Cumberland,NC,Passenger,1,2,3,393,396,0.76,Furthest
3992,December,2021,El Paso,CO,Passenger,3,0,3,644,647,0.46,Mid-Distance
3993,December,2021,Skamania,WA,Passenger,60,42,102,8323,8425,1.21,Washington
3994,December,2021,Kauai,HI,Passenger,1,0,1,17,18,5.56,Nearest
3995,December,2021,Fairbanks North Star,AK,Passenger,0,1,1,77,78,1.28,Nearest
3996,December,2021,Stafford,VA,Passenger,2,1,3,92,95,3.16,Furthest
3997,December,2021,Contra Costa,CA,Passenger,1,4,5,260,265,1.89,Nearest
3998,December,2021,Kitsap,WA,Truck,0,0,0,54199,54199,0.0,Washington
3999,December,2021,Wood,OH,Passenger,0,1,1,5,6,16.67,Furthest
4000,December,2021,Arlington,VA,Passenger,1,0,1,127,128,0.78,Furthest
4001,December,2021,Cook,IL,Passenger,2,0,2,191,193,1.04,Mid-Distance
4002,December,2021,Hennepin,MN,Passenger,3,0,3,63,66,4.55,Mid-Distance
4003,December,2021,San Joaquin,CA,Passenger,1,1,2,94,96,2.08,Nearest
4004,December,2021,Albemarle,VA,Passenger,1,0,1,18,19,5.26,Furthest
4005,December,2021,Cape May,NJ,Passenger,0,1,1,8,9,11.11,Furthest
4006,December,2021,Grays Harbor,WA,Passenger,192,157,349,49447,49796,0.7,Washington
4007,December,2021,Lake,FL,Passenger,1,0,1,22,23,4.35,Furthest
4008,December,2021,Garfield,WA,Truck,0,0,0,1001,1001,0.0,Washington
4009,December,2021,Harnett,NC,Passenger,1,1,2,150,152,1.32,Furthest
4010,December,2021,Tarrant,TX,Passenger,1,0,1,127,128,0.78,Mid-Distance
4011,December,2021,Danville,VA,Passenger,1,0,1,0,1,100.0,Furthest
4012,December,2021,Prince George's,MD,Passenger,2,1,3,140,143,2.1,Furthest
4013,December,2021,Miami-Dade,FL,Passenger,1,0,1,90,91,1.1,Furthest
4014,December,2021,Snohomish,WA,Truck,2,0,2,125446,125448,0.0,Washington
4015,December,2021,Middlesex,MA,Passenger,0,1,1,85,86,1.16,Furthest
4016,December,2021,Sedgwick,KS,Passenger,1,1,2,81,83,2.41,Mid-Distance
4017,December,2021,San Juan,WA,Truck,0,0,0,6002,6002,0.0,Washington
4018,December,2021,Fort Bend,TX,Passenger,1,0,1,31,32,3.12,Mid-Distance
4019,December,2021,Douglas,NE,Passenger,1,2,3,46,49,6.12,Mid-Distance
4020,December,2021,Norfolk,VA,Passenger,3,3,6,304,310,1.94,Furthest
4021,December,2021,Hudson,NJ,Passenger,2,0,2,38,40,5.0,Furthest
4022,December,2021,Chesapeake,VA,Passenger,2,3,5,372,377,1.33,Furthest
4023,December,2021,DuPage,IL,Passenger,1,0,1,48,49,2.04,Mid-Distance
4024,December,2021,Garfield,WA,Passenger,0,3,3,1350,1353,0.22,Washington
4025,December,2021,Sacramento,CA,Passenger,2,0,2,207,209,0.96,Nearest
4026,December,2021,Maricopa,AZ,Passenger,8,2,10,1035,1045,0.96,Nearest
4027,December,2021,Walla Walla,WA,Truck,0,0,0,14090,14090,0.0,Washington
4028,December,2021,Dallas,TX,Passenger,1,0,1,136,137,0.73,Mid-Distance
4029,December,2021,Mason,WA,Truck,0,0,0,21219,21219,0.0,Washington
4030,December,2021,San Luis Obispo,CA,Passenger,1,0,1,56,57,1.75,Nearest
4031,December,2021,Saratoga,NY,Passenger,1,0,1,39,40,2.5,Furthest
4032,December,2021,Broward,FL,Passenger,2,0,2,93,95,2.11,Furthest
4033,December,2021,Douglas,CO,Passenger,0,1,1,75,76,1.32,Mid-Distance
4034,December,2021,Camden,NJ,Passenger,0,1,1,14,15,6.67,Furthest
4035,December,2021,Hawaii,HI,Passenger,1,0,1,40,41,2.44,Nearest
4036,December,2021,Pierce,WA,Passenger,4236,2127,6363,555764,562127,1.13,Washington
4037,December,2021,Goochland,VA,Passenger,3,2,5,179,184,2.72,Furthest
4038,December,2021,Marin,CA,Passenger,0,1,1,32,33,3.03,Nearest
4039,December,2021,Duval,FL,Passenger,0,2,2,314,316,0.63,Furthest
4040,December,2021,Clark,NV,Passenger,4,2,6,557,563,1.07,Nearest
4041,December,2021,Chelan,WA,Truck,0,0,0,23108,23108,0.0,Washington
4042,December,2021,Douglas,WA,Passenger,116,56,172,28610,28782,0.6,Washington
4043,December,2021,Walla Walla,WA,Passenger,143,87,230,36378,36608,0.63,Washington
4044,December,2021,Richmond,GA,Passenger,0,1,1,70,71,1.41,Furthest
4045,December,2021,Washington,MD,Passenger,2,0,2,14,16,12.5,Furthest
4046,December,2021,Hamilton,IN,Passenger,2,0,2,24,26,7.69,Furthest
4047,December,2021,Okanogan,WA,Passenger,69,45,114,26600,26714,0.43,Washington
4048,December,2021,Skagit,WA,Passenger,695,302,997,91135,92132,1.08,Washington
4049,December,2021,Wilson,TX,Passenger,0,1,1,2,3,33.33,Mid-Distance
4050,December,2021,Orange,CA,Passenger,5,2,7,376,383,1.83,Nearest
4051,December,2021,Ferry,WA,Truck,0,0,0,3596,3596,0.0,Washington
4052,December,2021,Skamania,WA,Truck,0,0,0,4002,4002,0.0,Washington
4053,December,2021,San Francisco,CA,Passenger,0,1,1,81,82,1.22,Nearest
4054,December,2021,Stevens,WA,Passenger,55,44,99,30290,30389,0.33,Washington
4055,December,2021,Pennington,SD,Passenger,1,0,1,31,32,3.12,Mid-Distance
4056,December,2021,New London,CT,Passenger,1,4,5,210,215,2.33,Furthest
4057,December,2021,Pacific,WA,Truck,0,0,0,8019,8019,0.0,Washington
4058,December,2021,District of Columbia,DC,Passenger,5,0,5,188,193,2.59,Furthest
4059,December,2021,Anchorage,AK,Passenger,1,0,1,122,123,0.81,Nearest
4060,December,2021,Lane,OR,Passenger,0,1,1,108,109,0.92,Nearest
4061,December,2021,Kittitas,WA,Passenger,207,75,282,29844,30126,0.94,Washington
4062,December,2021,Sevier,AR,Passenger,0,1,1,0,1,100.0,Mid-Distance
4063,December,2021,Champaign,IL,Passenger,1,0,1,9,10,10.0,Mid-Distance
4064,December,2021,Louisa,VA,Passenger,0,1,1,1,2,50.0,Furthest
4065,December,2021,King,WA,Truck,6,1,7,183027,183034,0.0,Washington
4066,December,2021,Harrison,MS,Passenger,2,0,2,44,46,4.35,Mid-Distance
4067,December,2021,Sumter,SC,Passenger,0,1,1,34,35,2.86,Furthest
4068,December,2021,Suffolk,MA,Passenger,0,2,2,25,27,7.41,Furthest
4069,December,2021,Hidalgo,TX,Passenger,0,1,1,53,54,1.85,Mid-Distance
4070,December,2021,Lincoln,OR,Passenger,0,1,1,32,33,3.03,Nearest
4071,December,2021,Franklin,WA,Truck,0,0,0,20851,20851,0.0,Washington
4072,December,2021,Philadelphia,PA,Passenger,1,0,1,36,37,2.7,Furthest
4073,December,2021,San Mateo,CA,Passenger,2,0,2,78,80,2.5,Nearest
4074,December,2021,Sarasota,FL,Passenger,2,0,2,30,32,6.25,Furthest
4075,December,2021,Thurston,WA,Passenger,1867,964,2831,196824,199655,1.42,Washington
4076,December,2021,Kings,CA,Passenger,2,1,3,321,324,0.93,Nearest
4077,December,2021,San Diego,CA,Passenger,15,8,23,2410,2433,0.95,Nearest
4078,December,2021,Dorchester,SC,Passenger,1,0,1,62,63,1.59,Furthest
4079,December,2021,Klamath,OR,Passenger,1,0,1,28,29,3.45,Nearest
4080,December,2021,Howard,MD,Passenger,0,1,1,54,55,1.82,Furthest
4081,December,2021,Spokane,WA,Passenger,1310,758,2068,327386,329454,0.63,Washington
4082,December,2021,Pierce,WA,Truck,0,0,0,144818,144818,0.0,Washington
4083,December,2021,Pima,AZ,Passenger,1,1,2,247,249,0.8,Nearest
4084,December,2021,Kitsap,WA,Passenger,2129,958,3087,180142,183229,1.68,Washington
4085,December,2021,Leavenworth,KS,Passenger,0,1,1,107,108,0.93,Mid-Distance
4086,December,2021,Las Animas,CO,Passenger,1,0,1,0,1,100.0,Mid-Distance
4087,December,2021,Allen,IN,Passenger,1,0,1,14,15,6.67,Furthest
4088,December,2021,Anne Arundel,MD,Passenger,4,3,7,354,361,1.94,Furthest
4089,December,2021,Spartanburg,SC,Passenger,0,1,1,47,48,2.08,Furthest
4090,December,2021,New York,NY,Passenger,1,0,1,36,37,2.7,Furthest
4091,December,2021,Portsmouth,VA,Passenger,0,1,1,76,77,1.3,Furthest
4092,December,2021,New Haven,CT,Passenger,0,2,2,27,29,6.9,Furthest
4093,December,2021,RÃ­o Grande,PR,Passenger,1,0,1,0,1,100.0,Mid-Distance
4094,December,2021,Montgomery,TX,Passenger,1,1,2,35,37,5.41,Mid-Distance
4095,December,2021,Vigo,IN,Passenger,1,0,1,5,6,16.67,Furthest
4096,December,2021,Richland,SC,Passenger,0,1,1,130,131,0.76,Furthest
4097,December,2021,St. Louis,MO,Passenger,1,0,1,73,74,1.35,Furthest
4098,December,2021,Chelan,WA,Passenger,408,114,522,54685,55207,0.95,Washington
4099,December,2021,Skagit,WA,Truck,1,0,1,32702,32703,0.0,Washington
4100,December,2022,San Joaquin,CA,Passenger,1,0,1,75,76,1.32,Nearest
4101,December,2022,Stevens,WA,Truck,2,0,2,18846,18848,0.01,Washington
4102,December,2022,Snohomish,WA,Passenger,10174,2763,12937,530310,543247,2.38,Washington
4103,December,2022,Lewis,WA,Truck,1,0,1,26311,26312,0.0,Washington
4104,December,2022,Stevens,WA,Passenger,90,56,146,30021,30167,0.48,Washington
4105,December,2022,Napa,CA,Passenger,0,1,1,9,10,10.0,Nearest
4106,December,2022,Danville,VA,Passenger,1,0,1,0,1,100.0,Furthest
4107,December,2022,Pacific,WA,Passenger,74,80,154,15740,15894,0.97,Washington
4108,December,2022,Duval,FL,Passenger,1,0,1,240,241,0.41,Furthest
4109,December,2022,Beaufort,SC,Passenger,1,0,1,20,21,4.76,Furthest
4110,December,2022,Wahkiakum,WA,Passenger,26,13,39,3037,3076,1.27,Washington
4111,December,2022,Middlesex,MA,Passenger,2,1,3,60,63,4.76,Furthest
4112,December,2022,Ferry,WA,Passenger,24,4,28,4344,4372,0.64,Washington
4113,December,2022,St. Clair,IL,Passenger,2,0,2,108,110,1.82,Mid-Distance
4114,December,2022,St. Tammany,LA,Passenger,1,0,1,31,32,3.12,Mid-Distance
4115,December,2022,Moore,NC,Passenger,0,1,1,103,104,0.96,Furthest
4116,December,2022,Cumberland,NC,Passenger,1,2,3,313,316,0.95,Furthest
4117,December,2022,Fairfax,VA,Passenger,5,3,8,569,577,1.39,Furthest
4118,December,2022,Sumter,SC,Passenger,0,1,1,31,32,3.12,Furthest
4119,December,2022,Harnett,NC,Passenger,2,0,2,131,133,1.5,Furthest
4120,December,2022,Columbia,WA,Truck,0,0,0,1587,1587,0.0,Washington
4121,December,2022,Garfield,WA,Passenger,1,3,4,1313,1317,0.3,Washington
4122,December,2022,Nueces,TX,Passenger,0,1,1,49,50,2.0,Mid-Distance
4123,December,2022,Sarpy,NE,Passenger,1,0,1,46,47,2.13,Mid-Distance
4124,December,2022,Dallas,TX,Passenger,1,0,1,83,84,1.19,Mid-Distance
4125,December,2022,Skamania,WA,Passenger,89,52,141,8114,8255,1.71,Washington
4126,December,2022,Lee,FL,Passenger,1,0,1,24,25,4.0,Furthest
4127,December,2022,El Paso,TX,Passenger,2,0,2,287,289,0.69,Mid-Distance
4128,December,2022,Lake,FL,Passenger,1,0,1,16,17,5.88,Furthest
4129,December,2022,Hoke,NC,Passenger,1,0,1,58,59,1.69,Furthest
4130,December,2022,Cowlitz,WA,Passenger,405,190,595,70330,70925,0.84,Washington
4131,December,2022,Frederick,MD,Passenger,1,0,1,57,58,1.72,Furthest
4132,December,2022,Hennepin,MN,Passenger,1,0,1,37,38,2.63,Mid-Distance
4133,December,2022,Columbia,WA,Passenger,7,1,8,2441,2449,0.33,Washington
4134,December,2022,Douglas,CO,Passenger,0,1,1,58,59,1.69,Mid-Distance
4135,December,2022,San Juan,WA,Passenger,561,170,731,13907,14638,4.99,Washington
4136,December,2022,Allen,IN,Passenger,1,0,1,11,12,8.33,Furthest
4137,December,2022,Skamania,WA,Truck,0,0,0,3884,3884,0.0,Washington
4138,December,2022,Island,WA,Passenger,930,398,1328,61576,62904,2.11,Washington
4139,December,2022,Portsmouth,VA,Passenger,0,1,1,64,65,1.54,Furthest
4140,December,2022,Mason,WA,Truck,6,0,6,20861,20867,0.03,Washington
4141,December,2022,Jackson,OK,Passenger,0,1,1,32,33,3.03,Mid-Distance
4142,December,2022,Adams,WA,Passenger,23,11,34,13019,13053,0.26,Washington
4143,December,2022,Walla Walla,WA,Passenger,201,106,307,35691,35998,0.85,Washington
4144,December,2022,San Bernardino,CA,Passenger,1,1,2,282,284,0.7,Nearest
4145,December,2022,Harris,TX,Passenger,1,0,1,123,124,0.81,Mid-Distance
4146,December,2022,Collin,TX,Passenger,2,0,2,48,50,4.0,Mid-Distance
4147,December,2022,Santa Cruz,CA,Passenger,1,0,1,15,16,6.25,Nearest
4148,December,2022,Sarasota,FL,Passenger,1,0,1,17,18,5.56,Furthest
4149,December,2022,Pierce,WA,Truck,82,0,82,139604,139686,0.06,Washington
4150,December,2022,Rock Island,IL,Passenger,0,1,1,15,16,6.25,Mid-Distance
4151,December,2022,New Haven,CT,Passenger,0,2,2,22,24,8.33,Furthest
4152,December,2022,Sheridan,WY,Passenger,1,0,1,5,6,16.67,Nearest
4153,December,2022,Broward,FL,Passenger,1,0,1,63,64,1.56,Furthest
4154,December,2022,Okaloosa,FL,Passenger,0,1,1,90,91,1.1,Furthest
4155,December,2022,Spokane,WA,Truck,20,0,20,101929,101949,0.02,Washington
4156,December,2022,Bartow,GA,Passenger,0,1,1,3,4,25.0,Furthest
4157,December,2022,Spokane,WA,Passenger,1943,932,2875,324633,327508,0.88,Washington
4158,December,2022,Wilson,TX,Passenger,0,1,1,2,3,33.33,Mid-Distance
4159,December,2022,St. Louis,MO,Passenger,1,0,1,53,54,1.85,Furthest
4160,December,2022,Hamilton,OH,Truck,1,0,1,2,3,33.33,Furthest
4161,December,2022,Pend Oreille,WA,Passenger,21,13,34,8969,9003,0.38,Washington
4162,December,2022,Whatcom,WA,Passenger,2110,809,2919,148844,151763,1.92,Washington
4163,December,2022,Orange,CA,Passenger,7,2,9,301,310,2.9,Nearest
4164,December,2022,Fairfax,VA,Truck,1,0,1,99,100,1.0,Furthest
4165,December,2022,Whatcom,WA,Truck,26,0,26,43084,43110,0.06,Washington
4166,December,2022,Stafford,VA,Passenger,3,1,4,80,84,4.76,Furthest
4167,December,2022,Williamson,TX,Passenger,0,2,2,61,63,3.17,Mid-Distance
4168,December,2022,Yellowstone,MT,Passenger,0,1,1,17,18,5.56,Nearest
4169,December,2022,Ventura,CA,Passenger,2,1,3,205,208,1.44,Nearest
4170,December,2022,Garfield,WA,Truck,0,0,0,976,976,0.0,Washington
4171,December,2022,Larimer,CO,Passenger,1,0,1,40,41,2.44,Mid-Distance
4172,December,2022,Salt Lake,UT,Passenger,0,1,1,105,106,0.94,Nearest
4173,December,2022,Montgomery,MD,Passenger,3,2,5,173,178,2.81,Furthest
4174,December,2022,Placer,CA,Passenger,2,0,2,57,59,3.39,Nearest
4175,December,2022,Norfolk,VA,Passenger,3,3,6,271,277,2.17,Furthest
4176,December,2022,Escambia,FL,Passenger,0,1,1,113,114,0.88,Furthest
4177,December,2022,Kittitas,WA,Truck,5,0,5,14570,14575,0.03,Washington
4178,December,2022,Walla Walla,WA,Truck,3,0,3,13871,13874,0.02,Washington
4179,December,2022,Virginia Beach,VA,Passenger,2,0,2,454,456,0.44,Furthest
4180,December,2022,Calvert,MD,Passenger,0,2,2,77,79,2.53,Furthest
4181,December,2022,Gwinnett,GA,Passenger,1,0,1,41,42,2.38,Furthest
4182,December,2022,Grays Harbor,WA,Truck,2,0,2,21093,21095,0.01,Washington
4183,December,2022,Essex,NJ,Passenger,2,0,2,8,10,20.0,Furthest
4184,December,2022,Jefferson,WA,Passenger,480,230,710,24301,25011,2.84,Washington
4185,December,2022,Klickitat,WA,Truck,4,0,4,8233,8237,0.05,Washington
4186,December,2022,Douglas,WA,Truck,3,0,3,12825,12828,0.02,Washington
4187,December,2022,Clark,NV,Passenger,4,2,6,414,420,1.43,Nearest
4188,December,2022,Clark,WA,Passenger,4917,2031,6948,314946,321894,2.16,Washington
4189,December,2022,Okanogan,WA,Truck,2,0,2,16442,16444,0.01,Washington
4190,December,2022,Cook,IL,Passenger,2,0,2,156,158,1.27,Mid-Distance
4191,December,2022,Cumberland,PA,Passenger,1,0,1,31,32,3.12,Furthest
4192,December,2022,Sacramento,CA,Passenger,4,0,4,165,169,2.37,Nearest
4193,December,2022,Bryan,GA,Passenger,0,1,1,38,39,2.56,Furthest
4194,December,2022,Dorchester,SC,Passenger,1,0,1,42,43,2.33,Furthest
4195,December,2022,Charleston,SC,Passenger,2,2,4,54,58,6.9,Furthest
4196,December,2022,Yavapai,AZ,Passenger,1,0,1,22,23,4.35,Nearest
4197,December,2022,Solano,CA,Passenger,2,0,2,142,144,1.39,Nearest
4198,December,2022,St. Mary's,MD,Passenger,1,0,1,170,171,0.58,Furthest
4199,December,2022,King,WA,Truck,386,2,388,178383,178771,0.22,Washington
4200,December,2022,Prince George's,MD,Passenger,3,1,4,111,115,3.48,Furthest
4201,December,2022,Burlington,NJ,Passenger,0,2,2,97,99,2.02,Furthest
4202,December,2022,Clark,WA,Truck,51,0,51,81917,81968,0.06,Washington
4203,December,2022,Lincoln,WA,Truck,0,0,0,4848,4848,0.0,Washington
4204,December,2022,DeKalb,GA,Passenger,1,0,1,39,40,2.5,Furthest
4205,December,2022,Boulder,CO,Passenger,1,0,1,28,29,3.45,Mid-Distance
4206,December,2022,Skagit,WA,Passenger,924,355,1279,89464,90743,1.41,Washington
4207,December,2022,Champaign,IL,Passenger,1,0,1,7,8,12.5,Mid-Distance
4208,December,2022,Clallam,WA,Truck,8,0,8,21879,21887,0.04,Washington
4209,December,2022,Benton,WA,Passenger,933,500,1433,135784,137217,1.04,Washington
4210,December,2022,Lincoln,WA,Passenger,12,18,30,7769,7799,0.38,Washington
4211,December,2022,Ferry,WA,Truck,0,0,0,3548,3548,0.0,Washington
4212,December,2022,Maricopa,AZ,Passenger,6,3,9,690,699,1.29,Nearest
4213,December,2022,Lane,OR,Passenger,0,1,1,73,74,1.35,Nearest
4214,December,2022,Goochland,VA,Passenger,0,1,1,64,65,1.54,Furthest
4215,December,2022,Hudson,NJ,Passenger,1,0,1,28,29,3.45,Furthest
4216,December,2022,Adams,CO,Passenger,1,0,1,33,34,2.94,Mid-Distance
4217,December,2022,Owyhee,ID,Passenger,1,0,1,3,4,25.0,Nearest
4218,December,2022,Pend Oreille,WA,Truck,0,0,0,5582,5582,0.0,Washington
4219,December,2022,Santa Barbara,CA,Passenger,1,0,1,65,66,1.52,Nearest
4220,December,2022,Skagit,WA,Truck,11,0,11,32151,32162,0.03,Washington
4221,December,2022,Wahkiakum,WA,Truck,1,0,1,1790,1791,0.06,Washington
4222,December,2022,Okanogan,WA,Passenger,97,52,149,26171,26320,0.57,Washington
4223,December,2022,Marin,CA,Passenger,0,1,1,29,30,3.33,Nearest
4224,December,2022,Lee,AL,Passenger,1,0,1,11,12,8.33,Furthest
4225,December,2022,Thurston,WA,Truck,38,0,38,54686,54724,0.07,Washington
4226,December,2022,Lincoln,OR,Passenger,0,1,1,15,16,6.25,Nearest
4227,December,2022,Plaquemines,LA,Passenger,1,1,2,16,18,11.11,Mid-Distance
4228,December,2022,El Paso,CO,Passenger,3,1,4,517,521,0.77,Mid-Distance
4229,December,2022,Alexandria,VA,Passenger,3,1,4,93,97,4.12,Furthest
4230,December,2022,Asotin,WA,Passenger,29,20,49,12492,12541,0.39,Washington
4231,December,2022,Hawaii,HI,Passenger,1,0,1,25,26,3.85,Nearest
4232,December,2022,King,WA,Passenger,48110,12252,60362,1337864,1398226,4.32,Washington
4233,December,2022,District of Columbia,DC,Passenger,4,0,4,152,156,2.56,Furthest
4234,December,2022,Hamilton,OH,Passenger,1,0,1,25,26,3.85,Furthest
4235,December,2022,Sedgwick,KS,Passenger,1,1,2,65,67,2.99,Mid-Distance
4236,December,2022,Rockingham,NH,Passenger,1,0,1,12,13,7.69,Furthest
4237,December,2022,Benton,WA,Truck,10,0,10,43344,43354,0.02,Washington
4238,December,2022,Adams,WA,Truck,1,0,1,5387,5388,0.02,Washington
4239,December,2022,Vernon,LA,Passenger,1,0,1,74,75,1.33,Mid-Distance
4240,December,2022,Rockdale,GA,Passenger,1,0,1,6,7,14.29,Furthest
4241,December,2022,Nassau,NY,Passenger,1,0,1,21,22,4.55,Furthest
4242,December,2022,San Juan,WA,Truck,8,0,8,5913,5921,0.14,Washington
4243,December,2022,Hillsborough,FL,Passenger,0,1,1,104,105,0.95,Furthest
4244,December,2022,Houston,GA,Passenger,1,0,1,24,25,4.0,Furthest
4245,December,2022,Carroll,NH,Passenger,0,1,1,5,6,16.67,Furthest
4246,December,2022,Galveston,TX,Passenger,0,1,1,16,17,5.88,Mid-Distance
4247,December,2022,Lewis,WA,Passenger,268,182,450,59910,60360,0.75,Washington
4248,December,2022,Charles,MD,Passenger,1,1,2,48,50,4.0,Furthest
4249,December,2022,Yakima,WA,Truck,6,0,6,61209,61215,0.01,Washington
4250,December,2022,Lake,IL,Passenger,1,0,1,118,119,0.84,Mid-Distance
4251,December,2022,Fairbanks North Star,AK,Passenger,0,1,1,58,59,1.69,Nearest
4252,December,2022,Kent,DE,Passenger,1,0,1,49,50,2.0,Furthest
4253,December,2022,Arapahoe,CO,Passenger,0,1,1,67,68,1.47,Mid-Distance
4254,December,2022,Jefferson,WA,Truck,6,0,6,9367,9373,0.06,Washington
4255,December,2022,Saratoga,NY,Passenger,1,0,1,36,37,2.7,Furthest
4256,December,2022,Grays Harbor,WA,Passenger,246,160,406,48674,49080,0.83,Washington
4257,December,2022,Newport News,VA,Passenger,1,0,1,94,95,1.05,Furthest
4258,December,2022,Snohomish,WA,Truck,92,0,92,122549,122641,0.08,Washington
4260,December,2022,Grant,WA,Truck,4,0,4,28064,28068,0.01,Washington
4261,December,2022,San Diego,CA,Passenger,17,9,26,2033,2059,1.26,Nearest
4262,December,2022,Miami-Dade,FL,Passenger,1,0,1,63,64,1.56,Furthest
4263,December,2022,Jefferson,NY,Passenger,1,1,2,186,188,1.06,Furthest
4264,December,2022,Las Animas,CO,Passenger,1,0,1,1,2,50.0,Mid-Distance
4265,December,2022,Louisa,VA,Passenger,0,1,1,1,2,50.0,Furthest
4266,December,2022,Kootenai,ID,Truck,1,0,1,29,30,3.33,Nearest
4267,December,2022,Anne Arundel,MD,Passenger,4,4,8,300,308,2.6,Furthest
4268,December,2022,Travis,TX,Passenger,1,0,1,78,79,1.27,Mid-Distance
4269,December,2022,Cowlitz,WA,Truck,4,0,4,28376,28380,0.01,Washington
4270,December,2022,Whitman,WA,Passenger,110,67,177,21969,22146,0.8,Washington
4271,December,2022,Allegheny,PA,Passenger,1,0,1,48,49,2.04,Furthest
4272,December,2022,Island,WA,Truck,17,0,17,21235,21252,0.08,Washington
4273,December,2022,Douglas,WA,Passenger,169,59,228,28513,28741,0.79,Washington
4274,December,2022,Whitman,WA,Truck,3,0,3,8661,8664,0.03,Washington
4275,December,2022,Penobscot,ME,Passenger,0,1,1,8,9,11.11,Furthest
4276,December,2022,Bell,TX,Passenger,1,0,1,269,270,0.37,Mid-Distance
4277,December,2022,Harrison,MS,Passenger,1,0,1,33,34,2.94,Mid-Distance
4278,December,2022,Franklin,WA,Truck,4,0,4,20986,20990,0.02,Washington
4279,December,2022,Alameda,CA,Passenger,3,0,3,158,161,1.86,Nearest
4280,December,2022,Polk,OR,Passenger,0,1,1,19,20,5.0,Nearest
4281,December,2022,Montgomery,PA,Passenger,1,0,1,17,18,5.56,Furthest
4282,December,2022,Kittitas,WA,Passenger,301,93,394,29550,29944,1.32,Washington
4283,December,2022,Washington,MD,Passenger,2,0,2,14,16,12.5,Furthest
4284,December,2022,Chelan,WA,Passenger,536,143,679,54270,54949,1.24,Washington
4285,December,2022,Thurston,WA,Passenger,2627,1134,3761,192301,196062,1.92,Washington
4286,December,2022,Asotin,WA,Truck,0,0,0,6686,6686,0.0,Washington
4287,December,2022,Mason,WA,Passenger,370,191,561,46879,47440,1.18,Washington
4288,December,2022,Contra Costa,CA,Passenger,0,3,3,209,212,1.42,Nearest
4289,December,2022,Franklin,WA,Passenger,252,120,372,61769,62141,0.6,Washington
4290,December,2022,Kern,CA,Passenger,1,1,2,187,189,1.06,Nearest
4291,December,2022,Ray,MO,Passenger,0,1,1,1,2,50.0,Furthest
4292,December,2022,Klickitat,WA,Passenger,123,51,174,15155,15329,1.14,Washington
4293,December,2022,Los Angeles,CA,Passenger,5,6,11,655,666,1.65,Nearest
4294,December,2022,Platte,MO,Passenger,1,0,1,19,20,5.0,Furthest
4295,December,2022,Suffolk,VA,Passenger,1,0,1,113,114,0.88,Furthest
4296,December,2022,Ulster,NY,Passenger,1,0,1,4,5,20.0,Furthest
4297,December,2022,Richmond,NY,Passenger,1,0,1,6,7,14.29,Furthest
4298,December,2022,Kitsap,WA,Passenger,2765,1146,3911,177328,181239,2.16,Washington
4299,December,2022,Yakima,WA,Passenger,425,218,643,166458,167101,0.38,Washington
4300,December,2022,Cape May,NJ,Passenger,0,1,1,7,8,12.5,Furthest
4301,December,2022,Riverside,CA,Passenger,7,0,7,390,397,1.76,Nearest
4302,December,2022,Grant,WA,Passenger,230,112,342,66890,67232,0.51,Washington
4303,December,2022,Kings,CA,Passenger,2,1,3,276,279,1.08,Nearest
4304,December,2022,Denton,TX,Passenger,1,0,1,50,51,1.96,Mid-Distance
4305,December,2022,Pacific,WA,Truck,2,0,2,7838,7840,0.03,Washington
4306,December,2022,Howard,MD,Passenger,0,1,1,43,44,2.27,Furthest
4307,December,2022,Carroll,MD,Passenger,0,1,1,17,18,5.56,Furthest
4308,December,2022,Camden,NJ,Passenger,0,1,1,12,13,7.69,Furthest
4309,December,2022,Monterey,CA,Passenger,1,1,2,117,119,1.68,Nearest
4310,December,2022,Berkeley,SC,Passenger,0,1,1,110,111,0.9,Furthest
4311,December,2022,Clallam,WA,Passenger,482,262,744,49422,50166,1.48,Washington
4312,December,2022,Chesapeake,VA,Passenger,2,3,5,291,296,1.69,Furthest
4313,December,2022,Honolulu,HI,Passenger,3,3,6,283,289,2.08,Nearest
4314,December,2022,Richmond,GA,Passenger,0,1,1,59,60,1.67,Furthest
4315,December,2022,Loudoun,VA,Passenger,3,1,4,60,64,6.25,Furthest
4316,December,2022,Kauai,HI,Passenger,1,1,2,13,15,13.33,Nearest
4317,December,2022,New London,CT,Passenger,2,4,6,179,185,3.24,Furthest
4318,December,2022,Emmet,MI,Passenger,0,1,1,0,1,100.0,Furthest
4319,December,2022,Pierce,WA,Passenger,6159,2513,8672,539032,547704,1.58,Washington
4320,December,2022,Queens,NY,Passenger,1,0,1,29,30,3.33,Furthest
4321,December,2022,Bexar,TX,Passenger,4,3,7,374,381,1.84,Mid-Distance
4322,December,2022,Douglas,NE,Passenger,2,1,3,29,32,9.38,Mid-Distance
4323,December,2022,Onslow,NC,Passenger,0,1,1,145,146,0.68,Furthest
4324,December,2022,Pulaski,AR,Passenger,3,0,3,24,27,11.11,Mid-Distance
4325,December,2022,Arlington,VA,Passenger,1,0,1,104,105,0.95,Furthest
4326,December,2022,Multnomah,OR,Passenger,0,2,2,443,445,0.45,Nearest
4327,December,2022,Montgomery,AL,Passenger,0,1,1,29,30,3.33,Furthest
4328,December,2022,Hidalgo,TX,Passenger,0,1,1,47,48,2.08,Mid-Distance
4329,December,2022,Chelan,WA,Truck,13,0,13,23093,23106,0.06,Washington
4330,December,2022,Randolph,NC,Passenger,1,0,1,4,5,20.0,Furthest
4331,December,2022,Sonoma,CA,Passenger,1,1,2,61,63,3.17,Nearest
4332,December,2022,Kitsap,WA,Truck,34,0,34,52973,53007,0.06,Washington
4333,December,2022,Oldham,KY,Passenger,0,1,1,4,5,20.0,Furthest
4334,December,2022,Wichita,TX,Passenger,2,0,2,37,39,5.13,Mid-Distance
4335,December,2022,Elmore,ID,Passenger,1,0,1,12,13,7.69,Nearest
4336,December,2022,Leavenworth,KS,Passenger,0,1,1,92,93,1.08,Mid-Distance
4337,December,2022,Geary,KS,Passenger,1,0,1,75,76,1.32,Mid-Distance
4338,December,2022,Santa Clara,CA,Passenger,9,2,11,170,181,6.08,Nearest
4339,February,2017,Columbia,WA,Passenger,0,1,1,2337,2338,0.04,Washington
4340,February,2017,New London,CT,Passenger,2,1,3,265,268,1.12,Furthest
4341,February,2017,Pacific,WA,Passenger,5,6,11,14997,15008,0.07,Washington
4342,February,2017,Island,WA,Passenger,100,122,222,59448,59670,0.37,Washington
4343,February,2017,Harnett,NC,Passenger,1,0,1,263,264,0.38,Furthest
4344,February,2017,Allegheny,PA,Passenger,1,0,1,92,93,1.08,Furthest
4345,February,2017,Prince William,VA,Passenger,0,3,3,277,280,1.07,Furthest
4346,February,2017,Clark,WA,Truck,0,0,0,77521,77521,0.0,Washington
4347,February,2017,Durham,NC,Passenger,0,1,1,37,38,2.63,Furthest
4348,February,2017,Cowlitz,WA,Passenger,50,46,96,69052,69148,0.14,Washington
4349,February,2017,DeKalb,IN,Passenger,1,0,1,1,2,50.0,Furthest
4350,February,2017,San Mateo,CA,Passenger,0,1,1,165,166,0.6,Nearest
4351,February,2017,Santa Clara,CA,Passenger,5,3,8,424,432,1.85,Nearest
4352,February,2017,Salt Lake,UT,Passenger,0,1,1,332,333,0.3,Nearest
4353,February,2017,Lane,OR,Passenger,0,1,1,258,259,0.39,Nearest
4354,February,2017,Jefferson,NY,Passenger,1,1,2,255,257,0.78,Furthest
4355,February,2017,Virginia Beach,VA,Passenger,2,1,3,651,654,0.46,Furthest
4356,February,2017,Skagit,WA,Truck,1,0,1,31404,31405,0.0,Washington
4357,February,2017,Clark,WA,Passenger,695,434,1129,297935,299064,0.38,Washington
4358,February,2017,Utah,UT,Passenger,0,1,1,169,170,0.59,Nearest
4359,February,2017,Dane,WI,Passenger,1,0,1,168,169,0.59,Mid-Distance
4360,February,2017,Manassas,VA,Passenger,0,1,1,8,9,11.11,Furthest
4361,February,2017,Essex,NJ,Passenger,1,0,1,16,17,5.88,Furthest
4362,February,2017,Adams,WA,Truck,0,0,0,5071,5071,0.0,Washington
4363,February,2017,Benton,WA,Passenger,134,133,267,127653,127920,0.21,Washington
4364,February,2017,Mason,WA,Truck,0,0,0,19196,19196,0.0,Washington
4365,February,2017,Wayne,MI,Passenger,0,2,2,69,71,2.82,Furthest
4366,February,2017,Lee,AL,Passenger,1,0,1,36,37,2.7,Furthest
4367,February,2017,Douglas,WA,Passenger,30,19,49,26547,26596,0.18,Washington
4368,February,2017,Morris,NJ,Passenger,1,0,1,22,23,4.35,Furthest
4369,February,2017,Franklin,WA,Truck,0,0,0,17907,17907,0.0,Washington
4370,February,2017,Richmond,GA,Passenger,0,1,1,99,100,1.0,Furthest
4371,February,2017,Dakota,MN,Passenger,0,1,1,41,42,2.38,Mid-Distance
4372,February,2017,Ferry,WA,Truck,0,0,0,3562,3562,0.0,Washington
4373,February,2017,Guilford,NC,Passenger,1,0,1,32,33,3.03,Furthest
4374,February,2017,Kittitas,WA,Truck,0,0,0,13383,13383,0.0,Washington
4375,February,2017,Prince George's,MD,Passenger,0,1,1,186,187,0.53,Furthest
4376,February,2017,Franklin,WA,Passenger,26,42,68,55221,55289,0.12,Washington
4377,February,2017,Orange,FL,Passenger,1,1,2,153,155,1.29,Furthest
4378,February,2017,Jackson,MO,Passenger,1,0,1,71,72,1.39,Furthest
4379,February,2017,Latah,ID,Passenger,0,1,1,131,132,0.76,Nearest
4380,February,2017,Hidalgo,TX,Passenger,0,1,1,95,96,1.04,Mid-Distance
4381,February,2017,Middlesex,MA,Passenger,1,0,1,158,159,0.63,Furthest
4382,February,2017,Dallas,TX,Passenger,1,0,1,210,211,0.47,Mid-Distance
4383,February,2017,Lincoln,WA,Passenger,2,4,6,7509,7515,0.08,Washington
4384,February,2017,Island,WA,Truck,0,0,0,20499,20499,0.0,Washington
4385,February,2017,Montgomery,TN,Passenger,1,0,1,294,295,0.34,Furthest
4386,February,2017,Cowlitz,WA,Truck,0,0,0,27871,27871,0.0,Washington
4387,February,2017,Spokane,WA,Passenger,226,196,422,295023,295445,0.14,Washington
4388,February,2017,Maui,HI,Passenger,1,0,1,71,72,1.39,Nearest
4389,February,2017,Fairfax,VA,Passenger,2,2,4,877,881,0.45,Furthest
4390,February,2017,Jefferson,WA,Passenger,89,55,144,23601,23745,0.61,Washington
4391,February,2017,Manatee,FL,Passenger,1,0,1,55,56,1.79,Furthest
4392,February,2017,Clallam,WA,Passenger,75,64,139,47981,48120,0.29,Washington
4393,February,2017,Okanogan,WA,Truck,0,0,0,16300,16300,0.0,Washington
4394,February,2017,Wahkiakum,WA,Passenger,0,1,1,2843,2844,0.04,Washington
4395,February,2017,Monterey,CA,Passenger,0,1,1,224,225,0.44,Nearest
4396,February,2017,Honolulu,HI,Passenger,4,2,6,628,634,0.95,Nearest
4397,February,2017,Grant,WA,Truck,0,0,0,24996,24996,0.0,Washington
4398,February,2017,Charles,MD,Passenger,0,1,1,91,92,1.09,Furthest
4399,February,2017,Benton,WA,Truck,0,0,0,39743,39743,0.0,Washington
4400,February,2017,Franklin,MA,Passenger,0,1,1,4,5,20.0,Furthest
4401,February,2017,Lewis,WA,Passenger,45,31,76,54970,55046,0.14,Washington
4402,February,2017,Grant,WA,Passenger,16,21,37,60193,60230,0.06,Washington
4403,February,2017,Cascade,MT,Passenger,0,1,1,59,60,1.67,Nearest
4404,February,2017,King,WA,Passenger,9098,3713,12811,1385263,1398074,0.92,Washington
4405,February,2017,Whatcom,WA,Passenger,401,146,547,141888,142435,0.38,Washington
4406,February,2017,Stevens,WA,Truck,0,0,0,18333,18333,0.0,Washington
4407,February,2017,Whitman,WA,Passenger,8,18,26,21938,21964,0.12,Washington
4408,February,2017,San Juan,WA,Passenger,88,31,119,13403,13522,0.88,Washington
4409,February,2017,Oklahoma,OK,Passenger,0,1,1,187,188,0.53,Mid-Distance
4410,February,2017,Nassau,NY,Passenger,0,1,1,39,40,2.5,Furthest
4411,February,2017,Walla Walla,WA,Passenger,17,21,38,34781,34819,0.11,Washington
4412,February,2017,Pinal,AZ,Passenger,2,0,2,263,265,0.75,Nearest
4413,February,2017,Hardin,KY,Passenger,0,1,1,128,129,0.78,Furthest
4414,February,2017,Dale,AL,Passenger,0,1,1,65,66,1.52,Furthest
4415,February,2017,Bergen,NJ,Passenger,0,2,2,32,34,5.88,Furthest
4416,February,2017,Grays Harbor,WA,Passenger,27,24,51,44252,44303,0.12,Washington
4417,February,2017,Klickitat,WA,Truck,0,0,0,7937,7937,0.0,Washington
4418,February,2017,San Diego,CA,Passenger,4,1,5,2821,2826,0.18,Nearest
4419,February,2017,Madison,ID,Passenger,1,0,1,44,45,2.22,Nearest
4420,February,2017,Klickitat,WA,Passenger,20,22,42,14768,14810,0.28,Washington
4421,February,2017,Asotin,WA,Truck,0,0,0,6475,6475,0.0,Washington
4422,February,2017,King,WA,Truck,8,1,9,190501,190510,0.0,Washington
4423,February,2017,New Haven,CT,Passenger,0,1,1,62,63,1.59,Furthest
4424,February,2017,Ferry,WA,Passenger,2,1,3,4391,4394,0.07,Washington
4425,February,2017,Clackamas,OR,Passenger,1,2,3,361,364,0.82,Nearest
4426,February,2017,Pend Oreille,WA,Truck,0,0,0,5573,5573,0.0,Washington
4427,February,2017,Cape May,NJ,Passenger,0,1,1,19,20,5.0,Furthest
4428,February,2017,Norfolk,MA,Passenger,1,0,1,37,38,2.63,Furthest
4429,February,2017,Whatcom,WA,Truck,2,0,2,41327,41329,0.0,Washington
4430,February,2017,Missoula,MT,Passenger,1,0,1,81,82,1.22,Nearest
4431,February,2017,Orange,CA,Passenger,2,1,3,676,679,0.44,Nearest
4432,February,2017,Polk,FL,Passenger,1,0,1,65,66,1.52,Furthest
4433,February,2017,Walla Walla,WA,Truck,0,0,0,13161,13161,0.0,Washington
4434,February,2017,Los Angeles,CA,Passenger,3,1,4,1376,1380,0.29,Nearest
4435,February,2017,Clark,NV,Passenger,1,3,4,877,881,0.45,Nearest
4436,February,2017,Pend Oreille,WA,Passenger,1,4,5,9300,9305,0.05,Washington
4437,February,2017,Douglas,WA,Truck,0,0,0,11387,11387,0.0,Washington
4438,February,2017,Moore,NC,Passenger,0,1,1,210,211,0.47,Furthest
4439,February,2017,Okanogan,WA,Passenger,3,15,18,25674,25692,0.07,Washington
4440,February,2017,Nantucket,MA,Passenger,1,0,1,3,4,25.0,Furthest
4441,February,2017,Juneau,AK,Passenger,0,1,1,55,56,1.79,Nearest
4442,February,2017,Monroe,NY,Passenger,1,0,1,28,29,3.45,Furthest
4443,February,2017,Saratoga,NY,Passenger,1,1,2,78,80,2.5,Furthest
4444,February,2017,Snohomish,WA,Passenger,1604,824,2428,514072,516500,0.47,Washington
4445,February,2017,Chelan,WA,Passenger,55,29,84,51755,51839,0.16,Washington
4446,February,2017,Lewis,WA,Truck,0,0,0,24783,24783,0.0,Washington
4447,February,2017,Bexar,TX,Passenger,1,2,3,1157,1160,0.26,Mid-Distance
4448,February,2017,Marin,CA,Passenger,1,0,1,59,60,1.67,Nearest
4449,February,2017,Hamilton,TN,Passenger,1,0,1,26,27,3.7,Furthest
4450,February,2017,Montgomery,MD,Passenger,1,0,1,305,306,0.33,Furthest
4451,February,2017,Garfield,WA,Truck,0,0,0,934,934,0.0,Washington
4452,February,2017,Columbia,WA,Truck,0,0,0,1528,1528,0.0,Washington
4453,February,2017,Volusia,FL,Passenger,0,1,1,47,48,2.08,Furthest
4454,February,2017,Carroll,NH,Passenger,0,1,1,0,1,100.0,Furthest
4455,February,2017,Pierce,WA,Truck,0,0,0,138554,138554,0.0,Washington
4456,February,2017,Norfolk,VA,Passenger,1,1,2,303,305,0.66,Furthest
4457,February,2017,Snohomish,WA,Truck,1,0,1,122505,122506,0.0,Washington
4458,February,2017,Travis,TX,Passenger,0,1,1,198,199,0.5,Mid-Distance
4459,February,2017,Santa Fe,NM,Passenger,0,1,1,44,45,2.22,Mid-Distance
4460,February,2017,DeKalb,GA,Passenger,1,0,1,84,85,1.18,Furthest
4461,February,2017,Lincoln,WA,Truck,0,0,0,4463,4463,0.0,Washington
4462,February,2017,Thurston,WA,Truck,0,0,0,53345,53345,0.0,Washington
4463,February,2017,Shoshone,ID,Passenger,0,1,1,82,83,1.2,Nearest
4464,February,2017,Thurston,WA,Passenger,351,309,660,184902,185562,0.36,Washington
4465,February,2017,Howard,MD,Passenger,0,2,2,88,90,2.22,Furthest
4466,February,2017,Hawaii,HI,Passenger,1,0,1,86,87,1.15,Nearest
4467,February,2017,Tulare,CA,Passenger,1,0,1,200,201,0.5,Nearest
4468,February,2017,Whitman,WA,Truck,0,0,0,8399,8399,0.0,Washington
4469,February,2017,Clallam,WA,Truck,0,0,0,21029,21029,0.0,Washington
4470,February,2017,Cobb,GA,Passenger,0,1,1,80,81,1.23,Furthest
4471,February,2017,Northampton,PA,Passenger,2,0,2,231,233,0.86,Furthest
4472,February,2017,Alameda,CA,Passenger,3,1,4,389,393,1.02,Nearest
4473,February,2017,Maricopa,AZ,Passenger,3,0,3,1858,1861,0.16,Nearest
4474,February,2017,Skamania,WA,Truck,0,0,0,3889,3889,0.0,Washington
4475,February,2017,Yakima,WA,Passenger,36,50,86,159126,159212,0.05,Washington
4476,February,2017,Cumberland,NC,Passenger,1,0,1,624,625,0.16,Furthest
4477,February,2017,Douglas,OR,Passenger,0,1,1,79,80,1.25,Nearest
4478,February,2017,Deschutes,OR,Passenger,1,0,1,203,204,0.49,Nearest
4479,February,2017,Anne Arundel,MD,Passenger,0,1,1,511,512,0.2,Furthest
4480,February,2017,Stevens,WA,Passenger,6,21,27,31317,31344,0.09,Washington
4481,February,2017,Lewis,NY,Passenger,0,1,1,10,11,9.09,Furthest
4482,February,2017,Fulton,GA,Passenger,1,1,2,128,130,1.54,Furthest
4483,February,2017,Okaloosa,FL,Passenger,1,0,1,190,191,0.52,Furthest
4484,February,2017,District of Columbia,DC,Passenger,0,3,3,231,234,1.28,Furthest
4485,February,2017,Pacific,WA,Truck,0,0,0,7486,7486,0.0,Washington
4486,February,2017,Skamania,WA,Passenger,7,7,14,8543,8557,0.16,Washington
4487,February,2017,Arlington,VA,Passenger,1,1,2,170,172,1.16,Furthest
4488,February,2017,Shelby,TN,Passenger,0,1,1,108,109,0.92,Furthest
4489,February,2017,Yakima,WA,Truck,0,0,0,57223,57223,0.0,Washington
4490,February,2017,Sumter,FL,Passenger,0,1,1,10,11,9.09,Furthest
4491,February,2017,Orleans,LA,Passenger,0,1,1,51,52,1.92,Mid-Distance
4492,February,2017,Contra Costa,CA,Passenger,1,0,1,653,654,0.15,Nearest
4493,February,2017,Spokane,WA,Truck,1,0,1,90241,90242,0.0,Washington
4494,February,2017,Duval,FL,Passenger,1,1,2,371,373,0.54,Furthest
4495,February,2017,Marion,OR,Passenger,1,0,1,202,203,0.49,Nearest
4496,February,2017,El Paso,CO,Passenger,1,1,2,844,846,0.24,Mid-Distance
4497,February,2017,Canyon,ID,Passenger,0,1,1,108,109,0.92,Nearest
4498,February,2017,Gwinnett,GA,Passenger,0,1,1,87,88,1.14,Furthest
4499,February,2017,Riverside,CA,Passenger,1,1,2,842,844,0.24,Nearest
4500,February,2017,Garfield,WA,Passenger,0,0,0,1290,1290,0.0,Washington
4501,February,2017,Kittitas,WA,Passenger,15,15,30,27062,27092,0.11,Washington
4503,February,2017,Pima,AZ,Passenger,0,2,2,441,443,0.45,Nearest
4504,February,2017,Nueces,TX,Passenger,0,1,1,98,99,1.01,Mid-Distance
4505,February,2017,Skagit,WA,Passenger,113,86,199,87262,87461,0.23,Washington
4506,February,2017,Hamilton,IN,Passenger,1,0,1,67,68,1.47,Furthest
4507,February,2017,Jefferson,WA,Truck,0,0,0,9472,9472,0.0,Washington
4508,February,2017,Pierce,WA,Passenger,862,778,1640,526771,528411,0.31,Washington
4509,February,2017,Portsmouth,VA,Passenger,0,1,1,66,67,1.49,Furthest
4510,February,2017,Ventura,CA,Passenger,0,2,2,376,378,0.53,Nearest
4511,February,2017,Grays Harbor,WA,Truck,0,0,0,19819,19819,0.0,Washington
4512,February,2017,Adams,WA,Passenger,2,2,4,12126,12130,0.03,Washington
4513,February,2017,Kitsap,WA,Truck,1,0,1,52347,52348,0.0,Washington
4514,February,2017,Asotin,WA,Passenger,4,3,7,12324,12331,0.06,Washington
4515,February,2017,Multnomah,OR,Passenger,0,3,3,1150,1153,0.26,Nearest
4516,February,2017,Muscogee,GA,Passenger,0,1,1,256,257,0.39,Furthest
4517,February,2017,San Juan,WA,Truck,0,0,0,5573,5573,0.0,Washington
4518,February,2017,Tarrant,TX,Passenger,0,2,2,304,306,0.65,Mid-Distance
4519,February,2017,St. Lucie,FL,Passenger,1,0,1,31,32,3.12,Furthest
4520,February,2017,Franklin,OH,Passenger,0,1,1,116,117,0.85,Furthest
4521,February,2017,Mason,WA,Passenger,47,63,110,42778,42888,0.26,Washington
4522,February,2017,Kitsap,WA,Passenger,561,280,841,172111,172952,0.49,Washington
4523,February,2017,Chelan,WA,Truck,0,0,0,21250,21250,0.0,Washington
4524,February,2017,Wahkiakum,WA,Truck,0,0,0,1625,1625,0.0,Washington
4525,February,2018,Cape May,NJ,Passenger,0,1,1,22,23,4.35,Furthest
4526,February,2018,Mason,WA,Truck,0,0,0,19725,19725,0.0,Washington
4527,February,2018,Grant,WA,Passenger,31,38,69,62313,62382,0.11,Washington
4528,February,2018,Pacific,WA,Passenger,15,17,32,15463,15495,0.21,Washington
4529,February,2018,Wahkiakum,WA,Truck,0,0,0,1673,1673,0.0,Washington
4530,February,2018,Island,WA,Truck,0,0,0,20828,20828,0.0,Washington
4531,February,2018,San Mateo,CA,Passenger,0,1,1,138,139,0.72,Nearest
4532,February,2018,Skagit,WA,Truck,1,0,1,31814,31815,0.0,Washington
4533,February,2018,Asotin,WA,Passenger,8,5,13,12588,12601,0.1,Washington
4534,February,2018,Franklin,MA,Passenger,0,1,1,3,4,25.0,Furthest
4535,February,2018,Garfield,WA,Truck,0,0,0,942,942,0.0,Washington
4536,February,2018,Walla Walla,WA,Passenger,31,35,66,35386,35452,0.19,Washington
4537,February,2018,Queens,NY,Passenger,1,0,1,61,62,1.61,Furthest
4538,February,2018,Gwinnett,GA,Passenger,0,1,1,78,79,1.27,Furthest
4539,February,2018,Duval,FL,Passenger,1,2,3,368,371,0.81,Furthest
4540,February,2018,Manatee,FL,Passenger,1,0,1,38,39,2.56,Furthest
4541,February,2018,Whitman,WA,Passenger,18,21,39,22530,22569,0.17,Washington
4542,February,2018,Yakima,WA,Truck,0,0,0,58125,58125,0.0,Washington
4543,February,2018,Los Angeles,CA,Passenger,5,3,8,1192,1200,0.67,Nearest
4544,February,2018,Grays Harbor,WA,Truck,0,0,0,20115,20115,0.0,Washington
4545,February,2018,Jefferson,WA,Truck,0,0,0,9511,9511,0.0,Washington
4546,February,2018,Garfield,WA,Passenger,1,0,1,1323,1324,0.08,Washington
4547,February,2018,Adams,WA,Truck,0,0,0,5139,5139,0.0,Washington
4548,February,2018,Fairfax,VA,Passenger,2,2,4,825,829,0.48,Furthest
4549,February,2018,Contra Costa,CA,Passenger,0,1,1,469,470,0.21,Nearest
4550,February,2018,Adams,WA,Passenger,5,4,9,12458,12467,0.07,Washington
4551,February,2018,Maricopa,AZ,Passenger,2,0,2,1598,1600,0.12,Nearest
4552,February,2018,Frederick,MD,Passenger,0,1,1,90,91,1.1,Furthest
4553,February,2018,Portsmouth,VA,Passenger,0,1,1,72,73,1.37,Furthest
4554,February,2018,Multnomah,OR,Passenger,3,4,7,835,842,0.83,Nearest
4555,February,2018,Dallas,TX,Passenger,0,1,1,185,186,0.54,Mid-Distance
4556,February,2018,Clallam,WA,Passenger,109,101,210,49356,49566,0.42,Washington
4557,February,2018,Sumter,FL,Passenger,0,1,1,10,11,9.09,Furthest
4558,February,2018,Norfolk,MA,Passenger,1,0,1,39,40,2.5,Furthest
4559,February,2018,Columbia,WA,Truck,0,0,0,1535,1535,0.0,Washington
4560,February,2018,Latah,ID,Passenger,0,1,1,76,77,1.3,Nearest
4561,February,2018,Garfield,OK,Passenger,1,0,1,21,22,4.55,Mid-Distance
4562,February,2018,Cowlitz,WA,Truck,0,0,0,28183,28183,0.0,Washington
4563,February,2018,Northampton,PA,Passenger,0,1,1,61,62,1.61,Furthest
4564,February,2018,Yakima,WA,Passenger,61,79,140,162333,162473,0.09,Washington
4565,February,2018,Fulton,GA,Passenger,1,0,1,106,107,0.93,Furthest
4566,February,2018,Deschutes,OR,Passenger,1,0,1,177,178,0.56,Nearest
4567,February,2018,Ferry,WA,Truck,0,0,0,3527,3527,0.0,Washington
4568,February,2018,Whatcom,WA,Truck,1,0,1,42039,42040,0.0,Washington
4569,February,2018,Missoula,MT,Passenger,1,0,1,67,68,1.47,Nearest
4570,February,2018,Franklin,WA,Passenger,32,51,83,57008,57091,0.15,Washington
4571,February,2018,District of Columbia,DC,Passenger,0,3,3,194,197,1.52,Furthest
4572,February,2018,Pend Oreille,WA,Truck,0,0,0,5631,5631,0.0,Washington
4573,February,2018,Cook,IL,Passenger,1,0,1,286,287,0.35,Mid-Distance
4574,February,2018,Hardin,KY,Passenger,0,1,1,116,117,0.85,Furthest
4575,February,2018,Montgomery,TN,Passenger,1,0,1,264,265,0.38,Furthest
4576,February,2018,Polk,FL,Passenger,1,0,1,63,64,1.56,Furthest
4577,February,2018,Lincoln,WA,Passenger,2,5,7,7594,7601,0.09,Washington
4578,February,2018,Sacramento,CA,Passenger,1,0,1,297,298,0.34,Nearest
4579,February,2018,Santa Clara,CA,Passenger,7,1,8,380,388,2.06,Nearest
4580,February,2018,Marin,CA,Passenger,1,0,1,56,57,1.75,Nearest
4581,February,2018,Bexar,TX,Passenger,2,2,4,798,802,0.5,Mid-Distance
4582,February,2018,Lane,OR,Passenger,0,1,1,199,200,0.5,Nearest
4583,February,2018,Arlington,VA,Passenger,1,2,3,171,174,1.72,Furthest
4584,February,2018,Caddo,LA,Passenger,0,1,1,22,23,4.35,Mid-Distance
4585,February,2018,Skagit,WA,Passenger,172,145,317,89751,90068,0.35,Washington
4586,February,2018,Thurston,WA,Passenger,492,414,906,190758,191664,0.47,Washington
4587,February,2018,Benton,WA,Passenger,175,179,354,130454,130808,0.27,Washington
4588,February,2018,Broward,FL,Passenger,0,1,1,139,140,0.71,Furthest
4589,February,2018,Santa Rosa,FL,Passenger,1,0,1,99,100,1.0,Furthest
4590,February,2018,Orange,FL,Passenger,2,1,3,169,172,1.74,Furthest
4591,February,2018,Nantucket,MA,Passenger,1,0,1,4,5,20.0,Furthest
4592,February,2018,Kitsap,WA,Passenger,716,418,1134,176380,177514,0.64,Washington
4593,February,2018,Utah,UT,Passenger,0,1,1,133,134,0.75,Nearest
4594,February,2018,Clark,WA,Passenger,888,616,1504,305306,306810,0.49,Washington
4595,February,2018,Travis,TX,Passenger,0,1,1,186,187,0.53,Mid-Distance
4596,February,2018,Flathead,MT,Passenger,1,0,1,53,54,1.85,Nearest
4597,February,2018,Kent,MI,Passenger,0,1,1,35,36,2.78,Furthest
4598,February,2018,Madison,ID,Passenger,1,0,1,39,40,2.5,Nearest
4599,February,2018,Jefferson,WA,Passenger,127,80,207,24312,24519,0.84,Washington
4600,February,2018,Chelan,WA,Passenger,94,39,133,53238,53371,0.25,Washington
4601,February,2018,Palm Beach,FL,Passenger,0,1,1,86,87,1.15,Furthest
4602,February,2018,DuPage,IL,Passenger,1,0,1,65,66,1.52,Mid-Distance
4603,February,2018,Dale,AL,Passenger,0,1,1,64,65,1.54,Furthest
4604,February,2018,Okaloosa,FL,Passenger,1,0,1,178,179,0.56,Furthest
4605,February,2018,Franklin,WA,Truck,0,0,0,18577,18577,0.0,Washington
4606,February,2018,Clay,FL,Passenger,0,1,1,103,104,0.96,Furthest
4607,February,2018,Pierce,WA,Truck,0,0,0,137016,137016,0.0,Washington
4608,February,2018,Alameda,CA,Passenger,0,1,1,357,358,0.28,Nearest
4609,February,2018,Richmond,GA,Passenger,0,1,1,92,93,1.08,Furthest
4610,February,2018,Nueces,TX,Passenger,1,1,2,96,98,2.04,Mid-Distance
4611,February,2018,St. Lucie,FL,Passenger,1,0,1,26,27,3.7,Furthest
4612,February,2018,Spokane,WA,Passenger,306,263,569,300527,301096,0.19,Washington
4613,February,2018,Columbia,WA,Passenger,2,1,3,2407,2410,0.12,Washington
4614,February,2018,Prince George's,MD,Passenger,0,1,1,180,181,0.55,Furthest
4615,February,2018,Howard,MD,Passenger,0,1,1,87,88,1.14,Furthest
4616,February,2018,Riverside,CA,Passenger,2,2,4,723,727,0.55,Nearest
4617,February,2018,Clark,NV,Passenger,1,2,3,739,742,0.4,Nearest
4618,February,2018,Lewis,WA,Truck,0,0,0,25269,25269,0.0,Washington
4619,February,2018,Snohomish,WA,Passenger,2088,1119,3207,517277,520484,0.62,Washington
4620,February,2018,Anne Arundel,MD,Passenger,0,1,1,473,474,0.21,Furthest
4621,February,2018,Allegheny,PA,Passenger,1,0,1,81,82,1.22,Furthest
4622,February,2018,Spokane,WA,Truck,1,0,1,91721,91722,0.0,Washington
4623,February,2018,Whitman,WA,Truck,0,0,0,8453,8453,0.0,Washington
4624,February,2018,Tuolumne,CA,Passenger,0,1,1,14,15,6.67,Nearest
4625,February,2018,Montgomery,MD,Passenger,1,0,1,298,299,0.33,Furthest
4626,February,2018,Manassas,VA,Passenger,0,1,1,9,10,10.0,Furthest
4627,February,2018,Hamilton,TN,Passenger,1,0,1,22,23,4.35,Furthest
4628,February,2018,New Haven,CT,Passenger,0,1,1,52,53,1.89,Furthest
4629,February,2018,Dakota,MN,Passenger,0,2,2,36,38,5.26,Mid-Distance
4630,February,2018,Chelan,WA,Truck,0,0,0,21668,21668,0.0,Washington
4631,February,2018,Sangamon,IL,Passenger,1,0,1,11,12,8.33,Mid-Distance
4632,February,2018,Moore,NC,Passenger,0,1,1,199,200,0.5,Furthest
4633,February,2018,Maui,HI,Passenger,1,0,1,65,66,1.52,Nearest
4634,February,2018,Orange,CA,Passenger,3,1,4,572,576,0.69,Nearest
4635,February,2018,Santa Fe,NM,Passenger,0,1,1,43,44,2.27,Mid-Distance
4636,February,2018,Grant,WA,Truck,0,0,0,25680,25680,0.0,Washington
4637,February,2018,Pacific,WA,Truck,0,0,0,7561,7561,0.0,Washington
4638,February,2018,Jefferson,NY,Passenger,1,0,1,227,228,0.44,Furthest
4639,February,2018,Cowlitz,WA,Passenger,54,70,124,70938,71062,0.17,Washington
4641,February,2018,Juneau,AK,Passenger,0,1,1,43,44,2.27,Nearest
4642,February,2018,Clark,WA,Truck,0,0,0,78570,78570,0.0,Washington
4643,February,2018,Klickitat,WA,Passenger,24,27,51,14944,14995,0.34,Washington
4644,February,2018,Douglas,WA,Passenger,43,33,76,27316,27392,0.28,Washington
4645,February,2018,Mason,WA,Passenger,64,80,144,45049,45193,0.32,Washington
4646,February,2018,Canyon,ID,Passenger,0,1,1,95,96,1.04,Nearest
4647,February,2018,Hawaii,HI,Passenger,1,0,1,81,82,1.22,Nearest
4648,February,2018,DeKalb,IN,Passenger,1,0,1,1,2,50.0,Furthest
4649,February,2018,Benton,WA,Truck,0,0,0,40752,40752,0.0,Washington
4650,February,2018,DeKalb,GA,Passenger,1,0,1,84,85,1.18,Furthest
4651,February,2018,Ramsey,MN,Passenger,1,0,1,37,38,2.63,Mid-Distance
4652,February,2018,Orleans,LA,Passenger,0,1,1,47,48,2.08,Mid-Distance
4653,February,2018,Prince William,VA,Passenger,0,4,4,268,272,1.47,Furthest
4654,February,2018,Okanogan,WA,Truck,0,0,0,16305,16305,0.0,Washington
4655,February,2018,Monterey,CA,Passenger,0,2,2,194,196,1.02,Nearest
4656,February,2018,Thurston,WA,Truck,0,0,0,53921,53921,0.0,Washington
4657,February,2018,Honolulu,HI,Passenger,2,2,4,555,559,0.72,Nearest
4658,February,2018,Whatcom,WA,Passenger,556,249,805,145579,146384,0.55,Washington
4659,February,2018,Pend Oreille,WA,Passenger,4,3,7,9418,9425,0.07,Washington
4660,February,2018,Prince George,VA,Passenger,0,1,1,74,75,1.33,Furthest
4661,February,2018,Wahkiakum,WA,Passenger,0,2,2,2860,2862,0.07,Washington
4662,February,2018,Ferry,WA,Passenger,1,3,4,4396,4400,0.09,Washington
4663,February,2018,Brevard,FL,Passenger,0,1,1,102,103,0.97,Furthest
4664,February,2018,Carroll,NH,Passenger,0,1,1,1,2,50.0,Furthest
4665,February,2018,Montgomery,PA,Passenger,1,0,1,35,36,2.78,Furthest
4666,February,2018,Lincoln,WA,Truck,0,0,0,4511,4511,0.0,Washington
4667,February,2018,Douglas,WA,Truck,0,0,0,11812,11812,0.0,Washington
4668,February,2018,Twin Falls,ID,Passenger,0,1,1,23,24,4.17,Nearest
4669,February,2018,Island,WA,Passenger,165,171,336,61877,62213,0.54,Washington
4670,February,2018,Stevens,WA,Truck,0,0,0,18404,18404,0.0,Washington
4671,February,2018,Shelby,TN,Passenger,0,1,1,105,106,0.94,Furthest
4672,February,2018,Jefferson,CO,Passenger,0,1,1,75,76,1.32,Mid-Distance
4673,February,2018,Essex,NJ,Passenger,1,0,1,10,11,9.09,Furthest
4674,February,2018,El Paso,CO,Passenger,2,0,2,763,765,0.26,Mid-Distance
4675,February,2018,Montgomery,TX,Passenger,1,0,1,62,63,1.59,Mid-Distance
4676,February,2018,Pierce,WA,Passenger,1116,1028,2144,526413,528557,0.41,Washington
4677,February,2018,Okanogan,WA,Passenger,7,19,26,25665,25691,0.1,Washington
4678,February,2018,Virginia Beach,VA,Passenger,2,1,3,680,683,0.44,Furthest
4679,February,2018,San Juan,WA,Truck,0,0,0,5641,5641,0.0,Washington
4680,February,2018,Ventura,CA,Passenger,0,1,1,333,334,0.3,Nearest
4681,February,2018,Kitsap,WA,Truck,1,0,1,52833,52834,0.0,Washington
4682,February,2018,St. Clair,IL,Passenger,0,1,1,157,158,0.63,Mid-Distance
4683,February,2018,Richland,SC,Passenger,0,1,1,172,173,0.58,Furthest
4684,February,2018,Lewis,WA,Passenger,52,45,97,56859,56956,0.17,Washington
4685,February,2018,Ada,ID,Passenger,0,2,2,344,346,0.58,Nearest
4686,February,2018,Lee,AL,Passenger,1,0,1,34,35,2.86,Furthest
4687,February,2018,Sedgwick,KS,Passenger,0,1,1,103,104,0.96,Mid-Distance
4688,February,2018,Morris,NJ,Passenger,1,0,1,19,20,5.0,Furthest
4689,February,2018,Snohomish,WA,Truck,1,0,1,121335,121336,0.0,Washington
4690,February,2018,King,WA,Truck,8,1,9,184086,184095,0.0,Washington
4691,February,2018,Walla Walla,WA,Truck,0,0,0,13323,13323,0.0,Washington
4692,February,2018,San Juan,WA,Passenger,140,48,188,13922,14110,1.33,Washington
4693,February,2018,Saratoga,NY,Passenger,1,1,2,67,69,2.9,Furthest
4694,February,2018,Pinal,AZ,Passenger,2,0,2,210,212,0.94,Nearest
4695,February,2018,Stevens,WA,Passenger,10,21,31,31515,31546,0.1,Washington
4696,February,2018,Tarrant,TX,Passenger,1,0,1,224,225,0.44,Mid-Distance
4697,February,2018,Volusia,FL,Passenger,0,1,1,34,35,2.86,Furthest
4698,February,2018,Pima,AZ,Passenger,1,1,2,412,414,0.48,Nearest
4699,February,2018,Charles,MD,Passenger,0,1,1,81,82,1.22,Furthest
4700,February,2018,King,WA,Passenger,11758,5019,16777,1368249,1385026,1.21,Washington
4701,February,2018,Skamania,WA,Truck,0,0,0,3920,3920,0.0,Washington
4702,February,2018,Asotin,WA,Truck,0,0,0,6580,6580,0.0,Washington
4703,February,2018,Skamania,WA,Passenger,11,8,19,8624,8643,0.22,Washington
4704,February,2018,Kittitas,WA,Truck,0,0,0,13948,13948,0.0,Washington
4705,February,2018,Grays Harbor,WA,Passenger,42,44,86,45889,45975,0.19,Washington
4706,February,2018,El Paso,TX,Passenger,1,0,1,522,523,0.19,Mid-Distance
4707,February,2018,Norfolk,VA,Passenger,1,1,2,319,321,0.62,Furthest
4708,February,2018,Clallam,WA,Truck,0,0,0,21289,21289,0.0,Washington
4709,February,2018,New London,CT,Passenger,1,1,2,252,254,0.79,Furthest
4710,February,2018,Lumpkin,GA,Passenger,1,0,1,7,8,12.5,Furthest
4711,February,2018,Hamilton,IN,Passenger,1,0,1,51,52,1.92,Furthest
4712,February,2018,Nassau,NY,Passenger,1,0,1,37,38,2.63,Furthest
4713,February,2018,San Diego,CA,Passenger,6,1,7,2566,2573,0.27,Nearest
4714,February,2018,Klickitat,WA,Truck,0,0,0,8038,8038,0.0,Washington
4715,February,2018,Kittitas,WA,Passenger,36,27,63,28690,28753,0.22,Washington
4716,February,2019,Grays Harbor,WA,Truck,0,0,0,20318,20318,0.0,Washington
4717,February,2019,Garfield,WA,Truck,0,0,0,961,961,0.0,Washington
4718,February,2019,Larimer,CO,Passenger,1,0,1,57,58,1.72,Mid-Distance
4719,February,2019,Benton,WA,Passenger,233,245,478,132999,133477,0.36,Washington
4720,February,2019,Whatcom,WA,Passenger,785,380,1165,149641,150806,0.77,Washington
4721,February,2019,Richmond,GA,Passenger,0,1,1,89,90,1.11,Furthest
4722,February,2019,Jefferson,NY,Passenger,0,2,2,222,224,0.89,Furthest
4723,February,2019,Juneau,AK,Passenger,0,1,1,38,39,2.56,Nearest
4724,February,2019,Montgomery,AL,Passenger,0,1,1,44,45,2.22,Furthest
4725,February,2019,Calvert,MD,Passenger,0,1,1,87,88,1.14,Furthest
4726,February,2019,Douglas,NE,Passenger,0,1,1,66,67,1.49,Mid-Distance
4727,February,2019,New Haven,CT,Passenger,0,1,1,49,50,2.0,Furthest
4728,February,2019,Benton,WA,Truck,0,0,0,41547,41547,0.0,Washington
4729,February,2019,Howard,MD,Passenger,0,1,1,82,83,1.2,Furthest
4730,February,2019,Cumberland,NC,Passenger,0,2,2,511,513,0.39,Furthest
4731,February,2019,Island,WA,Truck,0,0,0,21171,21171,0.0,Washington
4732,February,2019,Douglas,WA,Truck,0,0,0,12166,12166,0.0,Washington
4733,February,2019,Clackamas,OR,Passenger,1,1,2,211,213,0.94,Nearest
4734,February,2019,Bergen,NJ,Passenger,1,0,1,25,26,3.85,Furthest
4735,February,2019,Okanogan,WA,Truck,0,0,0,16468,16468,0.0,Washington
4736,February,2019,Cape May,NJ,Passenger,0,1,1,19,20,5.0,Furthest
4737,February,2019,Grant,WA,Truck,0,0,0,26315,26315,0.0,Washington
4738,February,2019,Whitman,WA,Passenger,25,40,65,22756,22821,0.28,Washington
4739,February,2019,San Diego,CA,Passenger,9,3,12,2628,2640,0.45,Nearest
4740,February,2019,Manatee,FL,Passenger,1,0,1,35,36,2.78,Furthest
4741,February,2019,Owyhee,ID,Passenger,1,0,1,5,6,16.67,Nearest
4742,February,2019,Tuolumne,CA,Passenger,0,1,1,12,13,7.69,Nearest
4743,February,2019,Brevard,FL,Passenger,0,1,1,89,90,1.11,Furthest
4744,February,2019,Pierce,WA,Truck,0,0,0,138931,138931,0.0,Washington
4745,February,2019,Ada,ID,Passenger,0,2,2,307,309,0.65,Nearest
4746,February,2019,Clay,FL,Passenger,0,1,1,84,85,1.18,Furthest
4747,February,2019,Tarrant,TX,Passenger,1,0,1,206,207,0.48,Mid-Distance
4748,February,2019,Monroe,IL,Passenger,1,0,1,4,5,20.0,Mid-Distance
4749,February,2019,District of Columbia,DC,Passenger,1,1,2,207,209,0.96,Furthest
4750,February,2019,Fresno,CA,Passenger,1,0,1,187,188,0.53,Nearest
4751,February,2019,Yakima,WA,Truck,0,0,0,58797,58797,0.0,Washington
4752,February,2019,Tulsa,OK,Passenger,1,1,2,48,50,4.0,Mid-Distance
4753,February,2019,Island,WA,Passenger,294,231,525,63179,63704,0.82,Washington
4754,February,2019,Spartanburg,SC,Passenger,0,1,1,33,34,2.94,Furthest
4755,February,2019,Kittitas,WA,Passenger,73,37,110,29446,29556,0.37,Washington
4756,February,2019,DeKalb,GA,Passenger,1,0,1,77,78,1.28,Furthest
4757,February,2019,Lewis,WA,Truck,0,0,0,25698,25698,0.0,Washington
4758,February,2019,Montgomery,PA,Passenger,2,0,2,36,38,5.26,Furthest
4759,February,2019,Denver,CO,Passenger,1,0,1,129,130,0.77,Mid-Distance
4760,February,2019,Honolulu,HI,Passenger,2,3,5,502,507,0.99,Nearest
4761,February,2019,Pend Oreille,WA,Passenger,5,5,10,9483,9493,0.11,Washington
4762,February,2019,Asotin,WA,Passenger,12,9,21,12682,12703,0.17,Washington
4764,February,2019,Kootenai,ID,Passenger,1,1,2,210,212,0.94,Nearest
4765,February,2019,DeKalb,IN,Passenger,1,0,1,1,2,50.0,Furthest
4766,February,2019,Lincoln,WA,Truck,0,0,0,4667,4667,0.0,Washington
4767,February,2019,Jefferson,WA,Passenger,179,113,292,24863,25155,1.16,Washington
4768,February,2019,Dale,AL,Passenger,0,1,1,57,58,1.72,Furthest
4769,February,2019,Allegheny,PA,Passenger,1,0,1,84,85,1.18,Furthest
4770,February,2019,San Francisco,CA,Passenger,2,1,3,114,117,2.56,Nearest
4771,February,2019,Jefferson,CO,Passenger,0,2,2,60,62,3.23,Mid-Distance
4772,February,2019,Skamania,WA,Passenger,20,15,35,8715,8750,0.4,Washington
4773,February,2019,San Juan,PR,Passenger,0,1,1,3,4,25.0,Mid-Distance
4774,February,2019,Charles,MD,Passenger,0,1,1,77,78,1.28,Furthest
4775,February,2019,Wahkiakum,WA,Passenger,1,1,2,3020,3022,0.07,Washington
4776,February,2019,El Paso,TX,Passenger,2,0,2,497,499,0.4,Mid-Distance
4777,February,2019,Saratoga,NY,Passenger,1,0,1,62,63,1.59,Furthest
4778,February,2019,Sumter,FL,Passenger,0,1,1,10,11,9.09,Furthest
4779,February,2019,Cowlitz,WA,Truck,0,0,0,28726,28726,0.0,Washington
4780,February,2019,Skagit,WA,Passenger,278,187,465,91208,91673,0.51,Washington
4781,February,2019,Collin,TX,Passenger,1,1,2,137,139,1.44,Mid-Distance
4782,February,2019,Washoe,NV,Passenger,2,0,2,106,108,1.85,Nearest
4783,February,2019,Shasta,CA,Passenger,1,0,1,45,46,2.17,Nearest
4784,February,2019,Harnett,NC,Passenger,1,0,1,217,218,0.46,Furthest
4785,February,2019,Beaufort,SC,Passenger,1,0,1,36,37,2.7,Furthest
4786,February,2019,Clark,NV,Passenger,3,2,5,709,714,0.7,Nearest
4787,February,2019,Broward,FL,Passenger,2,1,3,126,129,2.33,Furthest
4788,February,2019,Yakima,WA,Passenger,86,101,187,164464,164651,0.11,Washington
4789,February,2019,Dakota,MN,Passenger,0,2,2,34,36,5.56,Mid-Distance
4790,February,2019,Snohomish,WA,Passenger,3146,1498,4644,527664,532308,0.87,Washington
4791,February,2019,Stevens,WA,Passenger,18,28,46,31733,31779,0.14,Washington
4792,February,2019,Nassau,NY,Passenger,3,0,3,37,40,7.5,Furthest
4793,February,2019,Montgomery,MD,Passenger,1,0,1,277,278,0.36,Furthest
4794,February,2019,Randolph,NC,Passenger,1,0,1,6,7,14.29,Furthest
4795,February,2019,Franklin,WA,Truck,0,0,0,19115,19115,0.0,Washington
4796,February,2019,Ferry,WA,Truck,0,0,0,3592,3592,0.0,Washington
4797,February,2019,Charleston,SC,Passenger,1,0,1,120,121,0.83,Furthest
4798,February,2019,Sangamon,IL,Passenger,2,0,2,7,9,22.22,Mid-Distance
4799,February,2019,Lee,FL,Passenger,1,0,1,52,53,1.89,Furthest
4800,February,2019,Houston,GA,Passenger,1,0,1,54,55,1.82,Furthest
4801,February,2019,Garfield,WA,Passenger,1,1,2,1324,1326,0.15,Washington
4802,February,2019,Mason,WA,Passenger,109,117,226,46675,46901,0.48,Washington
4803,February,2019,Cochise,AZ,Passenger,0,1,1,117,118,0.85,Nearest
4804,February,2019,Santa Fe,NM,Passenger,0,1,1,41,42,2.38,Mid-Distance
4805,February,2019,Maricopa,AZ,Passenger,6,2,8,1545,1553,0.52,Nearest
4806,February,2019,Fairfax,VA,Passenger,3,2,5,798,803,0.62,Furthest
4807,February,2019,King,WA,Passenger,17528,6762,24290,1379846,1404136,1.73,Washington
4808,February,2019,Ferry,WA,Passenger,3,2,5,4377,4382,0.11,Washington
4809,February,2019,Deschutes,OR,Passenger,2,0,2,163,165,1.21,Nearest
4810,February,2019,Duval,FL,Passenger,1,2,3,381,384,0.78,Furthest
4811,February,2019,DuPage,IL,Passenger,1,0,1,61,62,1.61,Mid-Distance
4812,February,2019,Thurston,WA,Truck,0,0,0,54906,54906,0.0,Washington
4813,February,2019,Clallam,WA,Truck,0,0,0,21577,21577,0.0,Washington
4814,February,2019,Anne Arundel,MD,Passenger,0,2,2,446,448,0.45,Furthest
4815,February,2019,Valencia,NM,Passenger,1,0,1,9,10,10.0,Mid-Distance
4816,February,2019,Harris,TX,Passenger,0,1,1,252,253,0.4,Mid-Distance
4817,February,2019,Skamania,WA,Truck,0,0,0,3990,3990,0.0,Washington
4818,February,2019,St. Mary's,MD,Passenger,1,0,1,210,211,0.47,Furthest
4819,February,2019,Flathead,MT,Passenger,1,0,1,58,59,1.69,Nearest
4820,February,2019,Twin Falls,ID,Passenger,0,1,1,20,21,4.76,Nearest
4821,February,2019,Carroll,NH,Passenger,0,1,1,2,3,33.33,Furthest
4822,February,2019,Pima,AZ,Passenger,1,1,2,401,403,0.5,Nearest
4823,February,2019,Arlington,VA,Passenger,1,2,3,161,164,1.83,Furthest
4824,February,2019,Franklin,WA,Passenger,50,70,120,59299,59419,0.2,Washington
4825,February,2019,Spokane,WA,Truck,1,0,1,93888,93889,0.0,Washington
4826,February,2019,Snohomish,WA,Truck,1,0,1,121877,121878,0.0,Washington
4827,February,2019,Contra Costa,CA,Passenger,1,2,3,393,396,0.76,Nearest
4828,February,2019,Lee,AL,Passenger,1,0,1,34,35,2.86,Furthest
4829,February,2019,Nueces,TX,Passenger,1,1,2,90,92,2.17,Mid-Distance
4830,February,2019,Wahkiakum,WA,Truck,0,0,0,1720,1720,0.0,Washington
4831,February,2019,Klickitat,WA,Passenger,30,32,62,15450,15512,0.4,Washington
4832,February,2019,Frederick,MD,Passenger,1,1,2,80,82,2.44,Furthest
4833,February,2019,Kern,CA,Passenger,0,1,1,233,234,0.43,Nearest
4834,February,2019,Ventura,CA,Passenger,0,2,2,312,314,0.64,Nearest
4835,February,2019,Carson City,NV,Passenger,1,0,1,14,15,6.67,Nearest
4836,February,2019,Richland,SC,Passenger,0,1,1,163,164,0.61,Furthest
4837,February,2019,Suffolk,MA,Passenger,0,1,1,41,42,2.38,Furthest
4838,February,2019,Gwinnett,GA,Passenger,0,1,1,76,77,1.3,Furthest
4839,February,2019,Columbia,WA,Truck,0,0,0,1525,1525,0.0,Washington
4840,February,2019,Clallam,WA,Passenger,153,127,280,50344,50624,0.55,Washington
4841,February,2019,Riverside,CA,Passenger,2,2,4,657,661,0.61,Nearest
4842,February,2019,Klickitat,WA,Truck,0,0,0,8221,8221,0.0,Washington
4843,February,2019,Cascade,MT,Passenger,0,1,1,55,56,1.79,Nearest
4844,February,2019,Los Angeles,CA,Passenger,6,5,11,1086,1097,1.0,Nearest
4845,February,2019,Fulton,GA,Passenger,1,2,3,108,111,2.7,Furthest
4846,February,2019,Klamath,OR,Passenger,1,0,1,37,38,2.63,Nearest
4847,February,2019,Thurston,WA,Passenger,782,594,1376,195890,197266,0.7,Washington
4848,February,2019,Penobscot,ME,Passenger,0,1,1,12,13,7.69,Furthest
4849,February,2019,Lumpkin,GA,Passenger,1,0,1,6,7,14.29,Furthest
4850,February,2019,Prince George's,MD,Passenger,1,1,2,184,186,1.08,Furthest
4851,February,2019,Walla Walla,WA,Truck,0,0,0,13543,13543,0.0,Washington
4852,February,2019,Multnomah,OR,Passenger,4,5,9,759,768,1.17,Nearest
4853,February,2019,Marion,IN,Passenger,1,0,1,112,113,0.88,Furthest
4854,February,2019,Clark,WA,Truck,0,0,0,79977,79977,0.0,Washington
4855,February,2019,Walla Walla,WA,Passenger,43,54,97,36066,36163,0.27,Washington
4856,February,2019,Santa Cruz,CA,Passenger,1,0,1,41,42,2.38,Nearest
4857,February,2019,Mecklenburg,NC,Passenger,1,0,1,79,80,1.25,Furthest
4858,February,2019,San Juan,WA,Truck,0,0,0,5799,5799,0.0,Washington
4859,February,2019,Pacific,WA,Truck,0,0,0,7634,7634,0.0,Washington
4860,February,2019,Rogers,OK,Passenger,1,0,1,4,5,20.0,Mid-Distance
4861,February,2019,Kitsap,WA,Truck,1,0,1,53701,53702,0.0,Washington
4862,February,2019,Jefferson,WA,Truck,0,0,0,9623,9623,0.0,Washington
4863,February,2019,Volusia,FL,Passenger,0,1,1,37,38,2.63,Furthest
4864,February,2019,Nantucket,MA,Passenger,1,0,1,4,5,20.0,Furthest
4865,February,2019,San Mateo,CA,Passenger,2,1,3,125,128,2.34,Nearest
4866,February,2019,Pend Oreille,WA,Truck,0,0,0,5738,5738,0.0,Washington
4867,February,2019,Caddo,LA,Passenger,0,1,1,22,23,4.35,Mid-Distance
4868,February,2019,King,WA,Truck,6,1,7,182021,182028,0.0,Washington
4869,February,2019,Bexar,TX,Passenger,3,4,7,694,701,1.0,Mid-Distance
4870,February,2019,Washington,OR,Passenger,0,1,1,467,468,0.21,Nearest
4871,February,2019,Guadalupe,TX,Passenger,1,0,1,78,79,1.27,Mid-Distance
4872,February,2019,San Juan,WA,Passenger,193,69,262,14274,14536,1.8,Washington
4873,February,2019,Whitman,WA,Truck,0,0,0,8490,8490,0.0,Washington
4874,February,2019,Portsmouth,VA,Passenger,0,1,1,80,81,1.23,Furthest
4875,February,2019,Kittitas,WA,Truck,0,0,0,14260,14260,0.0,Washington
4876,February,2019,Pierce,WA,Passenger,1611,1428,3039,538910,541949,0.56,Washington
4877,February,2019,Adams,WA,Passenger,4,6,10,12671,12681,0.08,Washington
4878,February,2019,Skagit,WA,Truck,1,0,1,32291,32292,0.0,Washington
4879,February,2019,Alameda,CA,Passenger,1,2,3,318,321,0.93,Nearest
4880,February,2019,Cowlitz,WA,Passenger,82,100,182,72440,72622,0.25,Washington
4881,February,2019,Clark,WA,Passenger,1337,866,2203,311844,314047,0.7,Washington
4882,February,2019,Santa Clara,CA,Passenger,8,1,9,367,376,2.39,Nearest
4883,February,2019,Kent,MI,Passenger,0,1,1,22,23,4.35,Furthest
4884,February,2019,Kitsap,WA,Passenger,988,571,1559,179782,181341,0.86,Washington
4885,February,2019,Sedgwick,KS,Passenger,0,1,1,101,102,0.98,Mid-Distance
4886,February,2019,St. Lucie,FL,Passenger,1,0,1,30,31,3.23,Furthest
4887,February,2019,Asotin,WA,Truck,0,0,0,6644,6644,0.0,Washington
4888,February,2019,Washtenaw,MI,Passenger,1,0,1,38,39,2.56,Furthest
4889,February,2019,Lincoln,WA,Passenger,3,5,8,7735,7743,0.1,Washington
4890,February,2019,Pacific,WA,Passenger,22,26,48,15864,15912,0.3,Washington
4891,February,2019,Bucks,PA,Passenger,1,0,1,17,18,5.56,Furthest
4892,February,2019,Albemarle,VA,Passenger,1,0,1,24,25,4.0,Furthest
4893,February,2019,Mason,WA,Truck,0,0,0,20229,20229,0.0,Washington
4894,February,2019,Goochland,VA,Passenger,1,1,2,244,246,0.81,Furthest
4895,February,2019,Hennepin,MN,Passenger,2,0,2,105,107,1.87,Mid-Distance
4896,February,2019,Camden,NJ,Passenger,0,1,1,27,28,3.57,Furthest
4897,February,2019,Montgomery,TX,Passenger,2,0,2,61,63,3.17,Mid-Distance
4898,February,2019,Norfolk,VA,Passenger,2,2,4,346,350,1.14,Furthest
4899,February,2019,Prince William,VA,Passenger,0,4,4,255,259,1.54,Furthest
4900,February,2019,Oldham,KY,Passenger,0,1,1,5,6,16.67,Furthest
4901,February,2019,Norfolk,MA,Passenger,1,0,1,35,36,2.78,Furthest
4902,February,2019,Chelan,WA,Passenger,145,66,211,54157,54368,0.39,Washington
4903,February,2019,Grant,WA,Passenger,33,55,88,64279,64367,0.14,Washington
4904,February,2019,Stevens,WA,Truck,0,0,0,18757,18757,0.0,Washington
4905,February,2019,Manassas,VA,Passenger,0,1,1,9,10,10.0,Furthest
4906,February,2019,Marion,OR,Passenger,1,0,1,115,116,0.86,Nearest
4907,February,2019,Polk,FL,Passenger,1,0,1,65,66,1.52,Furthest
4908,February,2019,Orange,CA,Passenger,5,2,7,533,540,1.3,Nearest
4909,February,2019,New London,CT,Passenger,0,2,2,246,248,0.81,Furthest
4910,February,2019,Virginia Beach,VA,Passenger,2,1,3,698,701,0.43,Furthest
4911,February,2019,Moore,NC,Passenger,0,1,1,183,184,0.54,Furthest
4912,February,2019,Douglas,WA,Passenger,52,35,87,27939,28026,0.31,Washington
4913,February,2019,Ramsey,MN,Passenger,1,0,1,39,40,2.5,Mid-Distance
4914,February,2019,Lewis,WA,Passenger,96,84,180,58309,58489,0.31,Washington
4915,February,2019,Franklin,MA,Passenger,0,1,1,1,2,50.0,Furthest
4916,February,2019,Okanogan,WA,Passenger,19,21,40,25964,26004,0.15,Washington
4917,February,2019,Spokane,WA,Passenger,481,386,867,307236,308103,0.28,Washington
4918,February,2019,Williamson,TX,Passenger,0,1,1,150,151,0.66,Mid-Distance
4919,February,2019,Hawaii,HI,Passenger,1,0,1,62,63,1.59,Nearest
4920,February,2019,St. Clair,IL,Passenger,0,1,1,166,167,0.6,Mid-Distance
4921,February,2019,Hardin,KY,Passenger,0,1,1,105,106,0.94,Furthest
4922,February,2019,Adams,WA,Truck,0,0,0,5109,5109,0.0,Washington
4923,February,2019,Pinal,AZ,Passenger,2,0,2,203,205,0.98,Nearest
4924,February,2019,Shelby,TN,Passenger,0,1,1,96,97,1.03,Furthest
4925,February,2019,Travis,TX,Passenger,2,1,3,200,203,1.48,Mid-Distance
4926,February,2019,Cook,IL,Passenger,1,0,1,240,241,0.41,Mid-Distance
4927,February,2019,Columbia,WA,Passenger,2,2,4,2430,2434,0.16,Washington
4928,February,2019,El Paso,CO,Passenger,3,2,5,757,762,0.66,Mid-Distance
4929,February,2019,Whatcom,WA,Truck,2,0,2,42708,42710,0.0,Washington
4930,February,2019,Santa Rosa,FL,Passenger,1,0,1,89,90,1.11,Furthest
4931,February,2019,Alexandria,VA,Passenger,1,0,1,159,160,0.62,Furthest
4932,February,2019,Palm Beach,FL,Passenger,0,1,1,92,93,1.08,Furthest
4933,February,2019,Middlesex,MA,Passenger,1,1,2,120,122,1.64,Furthest
4934,February,2019,Chelan,WA,Truck,0,0,0,22097,22097,0.0,Washington
4935,February,2019,Grays Harbor,WA,Passenger,66,79,145,47455,47600,0.3,Washington
4936,February,2019,Maui,HI,Passenger,1,0,1,50,51,1.96,Nearest
4937,February,2021,Sedgwick,KS,Passenger,1,1,2,89,91,2.2,Mid-Distance
4938,February,2021,Portsmouth,VA,Passenger,0,1,1,76,77,1.3,Furthest
4939,February,2021,Miami-Dade,FL,Passenger,1,0,1,97,98,1.02,Furthest
4940,February,2021,Hennepin,MN,Passenger,2,0,2,78,80,2.5,Mid-Distance
4941,February,2021,Spartanburg,SC,Passenger,0,1,1,49,50,2.0,Furthest
4942,February,2021,Washtenaw,MI,Passenger,1,0,1,30,31,3.23,Furthest
4943,February,2021,Sumter,FL,Passenger,0,1,1,10,11,9.09,Furthest
4944,February,2021,San Joaquin,CA,Passenger,1,0,1,108,109,0.92,Nearest
4945,February,2021,Saginaw,MI,Passenger,2,0,2,9,11,18.18,Furthest
4946,February,2021,Island,WA,Passenger,546,296,842,62878,63720,1.32,Washington
4947,February,2021,Jefferson,NY,Passenger,0,1,1,212,213,0.47,Furthest
4948,February,2021,Prince George's,MD,Passenger,2,1,3,139,142,2.11,Furthest
4949,February,2021,Spokane,WA,Passenger,923,560,1483,321417,322900,0.46,Washington
4950,February,2021,Juneau,AK,Passenger,0,1,1,25,26,3.85,Nearest
4951,February,2021,Missoula,MT,Passenger,1,0,1,65,66,1.52,Nearest
4952,February,2021,Washoe,NV,Passenger,1,0,1,97,98,1.02,Nearest
4953,February,2021,Williamson,TX,Passenger,0,2,2,115,117,1.71,Mid-Distance
4954,February,2021,Wahkiakum,WA,Passenger,8,6,14,3045,3059,0.46,Washington
4955,February,2021,Kings,NY,Passenger,1,0,1,64,65,1.54,Furthest
4956,February,2021,Montgomery,OH,Passenger,0,1,1,54,55,1.82,Furthest
4957,February,2021,Wichita,TX,Passenger,1,0,1,41,42,2.38,Mid-Distance
4958,February,2021,Wahkiakum,WA,Truck,0,0,0,1782,1782,0.0,Washington
4959,February,2021,Hudson,NJ,Passenger,1,0,1,39,40,2.5,Furthest
4960,February,2021,Manassas,VA,Passenger,0,1,1,6,7,14.29,Furthest
4961,February,2021,Rogers,OK,Passenger,1,0,1,4,5,20.0,Mid-Distance
4962,February,2021,District of Columbia,DC,Passenger,3,1,4,201,205,1.95,Furthest
4963,February,2021,Hampshire,MA,Passenger,1,0,1,6,7,14.29,Furthest
4964,February,2021,El Paso,TX,Passenger,3,0,3,384,387,0.78,Mid-Distance
4965,February,2021,Ramsey,MN,Passenger,1,0,1,34,35,2.86,Mid-Distance
4966,February,2021,Thurston,WA,Truck,0,0,0,56448,56448,0.0,Washington
4967,February,2021,Norfolk,VA,Passenger,2,3,5,330,335,1.49,Furthest
4968,February,2021,Franklin,WA,Truck,0,0,0,20510,20510,0.0,Washington
4969,February,2021,King,WA,Truck,6,1,7,184321,184328,0.0,Washington
4970,February,2021,Erie,NY,Passenger,1,0,1,43,44,2.27,Furthest
4971,February,2021,Dakota,MN,Passenger,0,1,1,25,26,3.85,Mid-Distance
4972,February,2021,Grant,WA,Passenger,90,86,176,66076,66252,0.27,Washington
4973,February,2021,Hamilton,IN,Passenger,2,0,2,34,36,5.56,Furthest
4974,February,2021,San Francisco,CA,Passenger,1,1,2,91,93,2.15,Nearest
4975,February,2021,Palm Beach,FL,Passenger,0,1,1,72,73,1.37,Furthest
4976,February,2021,Moore,NC,Passenger,0,1,1,138,139,0.72,Furthest
4977,February,2021,Carroll,NH,Passenger,0,1,1,5,6,16.67,Furthest
4978,February,2021,Columbia,WA,Truck,0,0,0,1543,1543,0.0,Washington
4979,February,2021,Boulder,CO,Passenger,0,1,1,44,45,2.22,Mid-Distance
4980,February,2021,Kittitas,WA,Passenger,142,53,195,29825,30020,0.65,Washington
4981,February,2021,Charles,MD,Passenger,1,1,2,72,74,2.7,Furthest
4982,February,2021,Suffolk,MA,Passenger,0,2,2,32,34,5.88,Furthest
4983,February,2021,Tulsa,OK,Passenger,1,1,2,40,42,4.76,Mid-Distance
4984,February,2021,Lewis,WA,Truck,0,0,0,26704,26704,0.0,Washington
4985,February,2021,Bradley,TN,Passenger,1,0,1,0,1,100.0,Furthest
4986,February,2021,Pacific,WA,Passenger,37,38,75,15822,15897,0.47,Washington
4987,February,2021,Shelby,OH,Passenger,0,1,1,1,2,50.0,Furthest
4988,February,2021,Okanogan,WA,Passenger,56,35,91,26131,26222,0.35,Washington
4989,February,2021,Okaloosa,FL,Passenger,0,1,1,130,131,0.76,Furthest
4990,February,2021,Duval,FL,Passenger,0,2,2,346,348,0.57,Furthest
4991,February,2021,Walla Walla,WA,Truck,0,0,0,13907,13907,0.0,Washington
4992,February,2021,Grays Harbor,WA,Passenger,142,130,272,48797,49069,0.55,Washington
4993,February,2021,DeKalb,IN,Passenger,1,0,1,0,1,100.0,Furthest
4994,February,2021,Suffolk,VA,Passenger,1,0,1,124,125,0.8,Furthest
4995,February,2021,Gwinnett,GA,Passenger,1,0,1,68,69,1.45,Furthest
4996,February,2021,Howard,MD,Passenger,0,1,1,62,63,1.59,Furthest
4997,February,2021,Douglas,WA,Passenger,86,46,132,28249,28381,0.47,Washington
4998,February,2021,Riverside,CA,Passenger,4,1,5,581,586,0.85,Nearest
4999,February,2021,Sacramento,CA,Passenger,2,0,2,232,234,0.85,Nearest
5000,February,2021,Okanogan,WA,Truck,0,0,0,16631,16631,0.0,Washington
5001,February,2021,Stevens,WA,Truck,0,0,0,18720,18720,0.0,Washington
5002,February,2021,El Dorado,CA,Passenger,1,0,1,32,33,3.03,Nearest
5003,February,2021,Harris,TX,Passenger,1,1,2,204,206,0.97,Mid-Distance
5004,February,2021,Plaquemines,LA,Passenger,0,1,1,14,15,6.67,Mid-Distance
5005,February,2021,Flathead,MT,Passenger,1,0,1,46,47,2.13,Nearest
5006,February,2021,Nueces,TX,Passenger,1,0,1,79,80,1.25,Mid-Distance
5007,February,2021,Kitsap,WA,Passenger,1642,777,2419,179346,181765,1.33,Washington
5008,February,2021,Howard,IN,Passenger,0,1,1,3,4,25.0,Furthest
5009,February,2021,Fort Bend,TX,Passenger,1,0,1,40,41,2.44,Mid-Distance
5010,February,2021,Powhatan,VA,Passenger,1,0,1,1,2,50.0,Furthest
5011,February,2021,Bexar,TX,Passenger,4,5,9,554,563,1.6,Mid-Distance
5012,February,2021,Orange,CA,Passenger,4,3,7,436,443,1.58,Nearest
5013,February,2021,Whatcom,WA,Passenger,1277,572,1849,150039,151888,1.22,Washington
5014,February,2021,Houston,GA,Passenger,1,0,1,50,51,1.96,Furthest
5015,February,2021,Fairfax,VA,Passenger,4,4,8,694,702,1.14,Furthest
5016,February,2021,Ventura,CA,Passenger,1,1,2,266,268,0.75,Nearest
5017,February,2021,Island,WA,Truck,0,0,0,21432,21432,0.0,Washington
5018,February,2021,Nassau,NY,Passenger,4,0,4,27,31,12.9,Furthest
5019,February,2021,Morris,NJ,Passenger,1,0,1,16,17,5.88,Furthest
5020,February,2021,Klickitat,WA,Passenger,65,45,110,14999,15109,0.73,Washington
5021,February,2021,Yakima,WA,Truck,0,0,0,61147,61147,0.0,Washington
5022,February,2021,Jefferson,WA,Truck,0,0,0,9576,9576,0.0,Washington
5023,February,2021,San Mateo,CA,Passenger,1,1,2,103,105,1.9,Nearest
5024,February,2021,San Juan,WA,Passenger,383,118,501,14058,14559,3.44,Washington
5025,February,2021,Travis,TX,Passenger,2,3,5,160,165,3.03,Mid-Distance
5026,February,2021,Multnomah,OR,Passenger,3,5,8,665,673,1.19,Nearest
5027,February,2021,Skamania,WA,Passenger,37,24,61,8292,8353,0.73,Washington
5028,February,2021,Queens,NY,Passenger,2,0,2,49,51,3.92,Furthest
5029,February,2021,Chelan,WA,Truck,0,0,0,22878,22878,0.0,Washington
5031,February,2021,Honolulu,HI,Passenger,5,2,7,409,416,1.68,Nearest
5032,February,2021,Walla Walla,WA,Passenger,105,69,174,36134,36308,0.48,Washington
5033,February,2021,Whitman,WA,Passenger,53,46,99,21854,21953,0.45,Washington
5034,February,2021,Washington,OR,Passenger,1,0,1,399,400,0.25,Nearest
5035,February,2021,Bartow,GA,Passenger,0,1,1,4,5,20.0,Furthest
5036,February,2021,Thurston,WA,Passenger,1383,811,2194,197237,199431,1.1,Washington
5037,February,2021,Rockingham,NH,Passenger,1,0,1,22,23,4.35,Furthest
5038,February,2021,Anchorage,AK,Passenger,1,0,1,140,141,0.71,Nearest
5039,February,2021,Owyhee,ID,Passenger,1,0,1,3,4,25.0,Nearest
5040,February,2021,Anne Arundel,MD,Passenger,3,1,4,395,399,1.0,Furthest
5041,February,2021,Denver,CO,Passenger,1,0,1,114,115,0.87,Mid-Distance
5042,February,2021,Larimer,CO,Passenger,1,0,1,53,54,1.85,Mid-Distance
5043,February,2021,Charleston,SC,Passenger,2,0,2,83,85,2.35,Furthest
5044,February,2021,St. Clair,IL,Passenger,1,0,1,137,138,0.72,Mid-Distance
5045,February,2021,Placer,CA,Passenger,2,0,2,79,81,2.47,Nearest
5046,February,2021,Randolph,NC,Passenger,1,0,1,6,7,14.29,Furthest
5047,February,2021,Vigo,IN,Passenger,1,0,1,5,6,16.67,Furthest
5048,February,2021,Jones,GA,Passenger,1,0,1,1,2,50.0,Furthest
5049,February,2021,Nassau,FL,Passenger,1,0,1,33,34,2.94,Furthest
5050,February,2021,Fairbanks North Star,AK,Passenger,0,1,1,86,87,1.15,Nearest
5051,February,2021,Prince William,VA,Passenger,1,1,2,212,214,0.93,Furthest
5052,February,2021,Clallam,WA,Truck,1,0,1,21901,21902,0.0,Washington
5053,February,2021,Skagit,WA,Passenger,535,247,782,91350,92132,0.85,Washington
5054,February,2021,Klamath,OR,Passenger,1,0,1,29,30,3.33,Nearest
5055,February,2021,Maui,HI,Passenger,1,0,1,27,28,3.57,Nearest
5056,February,2021,Kauai,HI,Passenger,1,0,1,15,16,6.25,Nearest
5057,February,2021,Yakima,WA,Passenger,184,135,319,167503,167822,0.19,Washington
5058,February,2021,Ulster,NY,Passenger,1,0,1,7,8,12.5,Furthest
5059,February,2021,Goochland,VA,Passenger,4,3,7,237,244,2.87,Furthest
5060,February,2021,Santa Clara,CA,Passenger,7,2,9,263,272,3.31,Nearest
5061,February,2021,Sarasota,FL,Passenger,2,0,2,25,27,7.41,Furthest
5062,February,2021,Whatcom,WA,Truck,3,0,3,43636,43639,0.01,Washington
5063,February,2021,Alexandria,VA,Passenger,2,0,2,133,135,1.48,Furthest
5064,February,2021,Whitman,WA,Truck,0,0,0,8514,8514,0.0,Washington
5065,February,2021,Fresno,CA,Passenger,1,0,1,169,170,0.59,Nearest
5066,February,2021,Lake,IL,Passenger,2,0,2,152,154,1.3,Mid-Distance
5067,February,2021,Clark,NV,Passenger,4,2,6,646,652,0.92,Nearest
5068,February,2021,Los Angeles,CA,Passenger,10,10,20,917,937,2.13,Nearest
5069,February,2021,Philadelphia,PA,Passenger,1,0,1,56,57,1.75,Furthest
5070,February,2021,Salt Lake,UT,Passenger,0,1,1,171,172,0.58,Nearest
5071,February,2021,Snohomish,WA,Truck,1,0,1,125733,125734,0.0,Washington
5072,February,2021,Kern,CA,Passenger,0,1,1,217,218,0.46,Nearest
5073,February,2021,Adams,WA,Truck,0,0,0,5344,5344,0.0,Washington
5074,February,2021,Kitsap,WA,Truck,0,0,0,54278,54278,0.0,Washington
5075,February,2021,Fulton,GA,Passenger,0,2,2,85,87,2.3,Furthest
5076,February,2021,Douglas,CO,Passenger,0,1,1,76,77,1.3,Mid-Distance
5077,February,2021,Arlington,VA,Passenger,0,1,1,138,139,0.72,Furthest
5078,February,2021,Dallas,TX,Passenger,1,0,1,166,167,0.6,Mid-Distance
5079,February,2021,Kittitas,WA,Truck,0,0,0,14694,14694,0.0,Washington
5080,February,2021,Stevens,WA,Passenger,38,42,80,30228,30308,0.26,Washington
5081,February,2021,New London,CT,Passenger,1,2,3,225,228,1.32,Furthest
5082,February,2021,Pacific,WA,Truck,0,0,0,7828,7828,0.0,Washington
5083,February,2021,Skagit,WA,Truck,1,0,1,32853,32854,0.0,Washington
5084,February,2021,Deschutes,OR,Passenger,1,0,1,119,120,0.83,Nearest
5085,February,2021,Richland,SC,Passenger,0,1,1,139,140,0.71,Furthest
5086,February,2021,Stafford,VA,Passenger,2,1,3,95,98,3.06,Furthest
5087,February,2021,Cumberland,NC,Passenger,0,2,2,440,442,0.45,Furthest
5088,February,2021,Collin,TX,Passenger,1,1,2,115,117,1.71,Mid-Distance
5089,February,2021,New Haven,CT,Passenger,0,2,2,33,35,5.71,Furthest
5090,February,2021,Bucks,PA,Passenger,1,0,1,18,19,5.26,Furthest
5091,February,2021,Clallam,WA,Passenger,282,195,477,49992,50469,0.95,Washington
5092,February,2021,Oldham,KY,Passenger,0,1,1,4,5,20.0,Furthest
5093,February,2021,Frederick,MD,Passenger,1,1,2,68,70,2.86,Furthest
5094,February,2021,St. Mary's,MD,Passenger,1,0,1,212,213,0.47,Furthest
5095,February,2021,Spokane,WA,Truck,0,0,0,101004,101004,0.0,Washington
5096,February,2021,Asotin,WA,Passenger,17,14,31,12486,12517,0.25,Washington
5097,February,2021,Ray,MO,Passenger,0,1,1,1,2,50.0,Furthest
5098,February,2021,Lincoln,WA,Passenger,6,13,19,7648,7667,0.25,Washington
5099,February,2021,Virginia Beach,VA,Passenger,3,0,3,624,627,0.48,Furthest
5100,February,2021,St. Louis,MO,Passenger,1,0,1,91,92,1.09,Furthest
5101,February,2021,Pend Oreille,WA,Truck,0,0,0,5722,5722,0.0,Washington
5102,February,2021,Contra Costa,CA,Passenger,3,3,6,279,285,2.11,Nearest
5103,February,2021,El Paso,CO,Passenger,2,0,2,686,688,0.29,Mid-Distance
5104,February,2021,Clackamas,OR,Passenger,3,0,3,175,178,1.69,Nearest
5105,February,2021,Orange,FL,Passenger,1,0,1,111,112,0.89,Furthest
5106,February,2021,Columbia,WA,Passenger,5,4,9,2453,2462,0.37,Washington
5107,February,2021,Santa Cruz,CA,Passenger,1,0,1,30,31,3.23,Nearest
5108,February,2021,Putnam,TN,Passenger,0,1,1,2,3,33.33,Furthest
5109,February,2021,Carroll,MD,Passenger,0,1,1,20,21,4.76,Furthest
5110,February,2021,Boone,MO,Passenger,0,1,1,10,11,9.09,Furthest
5111,February,2021,Clark,WA,Truck,0,0,0,83537,83537,0.0,Washington
5112,February,2021,Chelan,WA,Passenger,301,88,389,54492,54881,0.71,Washington
5113,February,2021,Adams,WA,Passenger,10,6,16,12975,12991,0.12,Washington
5114,February,2021,Pima,AZ,Passenger,2,1,3,306,309,0.97,Nearest
5115,February,2021,Kent,MI,Passenger,0,1,1,25,26,3.85,Furthest
5116,February,2021,Klickitat,WA,Truck,0,0,0,8118,8118,0.0,Washington
5117,February,2021,Montgomery,PA,Passenger,1,0,1,25,26,3.85,Furthest
5118,February,2021,Asotin,WA,Truck,0,0,0,6696,6696,0.0,Washington
5119,February,2021,RÃ­o Grande,PR,Passenger,1,0,1,1,2,50.0,Mid-Distance
5120,February,2021,Williams,ND,Passenger,0,1,1,10,11,9.09,Mid-Distance
5121,February,2021,Skamania,WA,Truck,0,0,0,4030,4030,0.0,Washington
5122,February,2021,Hawaii,HI,Passenger,1,0,1,49,50,2.0,Nearest
5123,February,2021,Snohomish,WA,Passenger,5270,1894,7164,538252,545416,1.31,Washington
5124,February,2021,Carson City,NV,Passenger,1,0,1,12,13,7.69,Nearest
5125,February,2021,Alameda,CA,Passenger,3,0,3,253,256,1.17,Nearest
5126,February,2021,Mason,WA,Passenger,177,135,312,47649,47961,0.65,Washington
5127,February,2021,Pend Oreille,WA,Passenger,12,4,16,9194,9210,0.17,Washington
5128,February,2021,Greene,MO,Passenger,0,1,1,31,32,3.12,Furthest
5129,February,2021,Twin Falls,ID,Passenger,0,1,1,22,23,4.35,Nearest
5130,February,2021,Ferry,WA,Truck,0,0,0,3625,3625,0.0,Washington
5131,February,2021,Cowlitz,WA,Passenger,194,130,324,71935,72259,0.45,Washington
5132,February,2021,Albemarle,VA,Passenger,1,0,1,21,22,4.55,Furthest
5133,February,2021,Milwaukee,WI,Passenger,1,0,1,40,41,2.44,Mid-Distance
5134,February,2021,Sevier,AR,Passenger,0,1,1,0,1,100.0,Mid-Distance
5135,February,2021,Grays Harbor,WA,Truck,0,0,0,21251,21251,0.0,Washington
5136,February,2021,Leavenworth,KS,Passenger,0,1,1,120,121,0.83,Mid-Distance
5137,February,2021,San Juan,WA,Truck,0,0,0,5867,5867,0.0,Washington
5138,February,2021,Pierce,WA,Truck,0,0,0,145031,145031,0.0,Washington
5139,February,2021,Middlesex,MA,Passenger,1,1,2,94,96,2.08,Furthest
5140,February,2021,DeKalb,GA,Passenger,1,0,1,65,66,1.52,Furthest
5141,February,2021,San Diego,CA,Passenger,13,5,18,2662,2680,0.67,Nearest
5142,February,2021,Douglas,NE,Passenger,1,1,2,50,52,3.85,Mid-Distance
5143,February,2021,Pennington,SD,Passenger,1,0,1,34,35,2.86,Mid-Distance
5144,February,2021,Washington,MD,Passenger,1,0,1,11,12,8.33,Furthest
5145,February,2021,Allegheny,PA,Passenger,1,1,2,65,67,2.99,Furthest
5146,February,2021,Cape May,NJ,Passenger,0,1,1,9,10,10.0,Furthest
5147,February,2021,Broward,FL,Passenger,2,0,2,107,109,1.83,Furthest
5148,February,2021,Penobscot,ME,Passenger,0,1,1,10,11,9.09,Furthest
5149,February,2021,Cowlitz,WA,Truck,0,0,0,28976,28976,0.0,Washington
5150,February,2021,Harnett,NC,Passenger,1,0,1,180,181,0.55,Furthest
5151,February,2021,DuPage,IL,Passenger,2,0,2,54,56,3.57,Mid-Distance
5152,February,2021,Douglas,WA,Truck,0,0,0,12517,12517,0.0,Washington
5153,February,2021,Lee,FL,Passenger,1,0,1,39,40,2.5,Furthest
5154,February,2021,Garfield,WA,Passenger,0,2,2,1356,1358,0.15,Washington
5155,February,2021,Maricopa,AZ,Passenger,5,5,10,1265,1275,0.78,Nearest
5156,February,2021,Monterey,CA,Passenger,0,1,1,149,150,0.67,Nearest
5157,February,2021,Mason,WA,Truck,0,0,0,21053,21053,0.0,Washington
5158,February,2021,Solano,CA,Passenger,1,0,1,195,196,0.51,Nearest
5159,February,2021,Loudoun,VA,Passenger,1,0,1,72,73,1.37,Furthest
5160,February,2021,Harrison,MS,Passenger,2,0,2,54,56,3.57,Mid-Distance
5161,February,2021,Montgomery,TX,Passenger,1,0,1,45,46,2.17,Mid-Distance
5162,February,2021,Garfield,WA,Truck,0,0,0,1006,1006,0.0,Washington
5163,February,2021,New York,NY,Passenger,1,0,1,51,52,1.92,Furthest
5164,February,2021,Pierce,WA,Passenger,3029,1810,4839,555482,560321,0.86,Washington
5165,February,2021,Benton,WA,Passenger,460,362,822,135084,135906,0.6,Washington
5166,February,2021,Pinellas,FL,Passenger,1,1,2,97,99,2.02,Furthest
5167,February,2021,Franklin,WA,Passenger,92,87,179,61606,61785,0.29,Washington
5168,February,2021,Richmond,GA,Passenger,0,1,1,78,79,1.27,Furthest
5169,February,2021,Utah,UT,Passenger,0,1,1,123,124,0.81,Nearest
5170,February,2021,Camden,NJ,Passenger,0,1,1,16,17,5.88,Furthest
5171,February,2021,Lincoln,WA,Truck,0,0,0,4689,4689,0.0,Washington
5172,February,2021,Arapahoe,CO,Passenger,1,0,1,118,119,0.84,Mid-Distance
5173,February,2021,Platte,MO,Passenger,1,0,1,18,19,5.26,Furthest
5174,February,2021,Calvert,MD,Passenger,0,2,2,85,87,2.3,Furthest
5175,February,2021,Clark,WA,Passenger,2505,1245,3750,318957,322707,1.16,Washington
5176,February,2021,Monroe,IL,Passenger,1,0,1,3,4,25.0,Mid-Distance
5177,February,2021,Polk,FL,Passenger,1,0,1,53,54,1.85,Furthest
5178,February,2021,Benton,WA,Truck,0,0,0,43381,43381,0.0,Washington
5179,February,2021,Jefferson,WA,Passenger,295,168,463,24790,25253,1.83,Washington
5180,February,2021,Lake,FL,Passenger,1,0,1,21,22,4.55,Furthest
5181,February,2021,King,WA,Passenger,28230,8448,36678,1364916,1401594,2.62,Washington
5182,February,2021,Wilson,TX,Passenger,0,1,1,5,6,16.67,Mid-Distance
5183,February,2021,Montgomery,MD,Passenger,1,0,1,228,229,0.44,Furthest
5184,February,2021,Chesapeake,VA,Passenger,0,3,3,399,402,0.75,Furthest
5185,February,2021,Lewis,WA,Passenger,127,132,259,58860,59119,0.44,Washington
5186,February,2021,Grant,WA,Truck,0,0,0,27662,27662,0.0,Washington
5187,February,2021,Ferry,WA,Passenger,10,3,13,4332,4345,0.3,Washington
5188,February,2022,Suffolk,MA,Passenger,0,2,2,23,25,8.0,Furthest
5189,February,2022,Pacific,WA,Passenger,58,65,123,16024,16147,0.76,Washington
5190,February,2022,Sevier,AR,Passenger,0,1,1,0,1,100.0,Mid-Distance
5191,February,2022,Whatcom,WA,Passenger,1690,685,2375,149351,151726,1.57,Washington
5192,February,2022,Jefferson,NY,Passenger,0,1,1,201,202,0.5,Furthest
5193,February,2022,Lane,OR,Passenger,0,1,1,103,104,0.96,Nearest
5194,February,2022,El Paso,TX,Passenger,2,0,2,342,344,0.58,Mid-Distance
5195,February,2022,St. Mary's,MD,Passenger,1,0,1,199,200,0.5,Furthest
5196,February,2022,Clark,NV,Passenger,4,2,6,541,547,1.1,Nearest
5197,February,2022,Clallam,WA,Passenger,393,243,636,50137,50773,1.25,Washington
5198,February,2022,Mason,WA,Truck,0,0,0,21184,21184,0.0,Washington
5199,February,2022,Cook,IL,Passenger,2,0,2,192,194,1.03,Mid-Distance
5200,February,2022,Travis,TX,Passenger,1,0,1,118,119,0.84,Mid-Distance
5201,February,2022,Stevens,WA,Truck,0,0,0,18976,18976,0.0,Washington
5202,February,2022,Kings,CA,Passenger,2,1,3,311,314,0.96,Nearest
5203,February,2022,Multnomah,OR,Passenger,1,4,5,576,581,0.86,Nearest
5204,February,2022,Loudoun,VA,Passenger,1,0,1,65,66,1.52,Furthest
5205,February,2022,San Joaquin,CA,Passenger,1,1,2,89,91,2.2,Nearest
5206,February,2022,Williams,ND,Passenger,0,1,1,7,8,12.5,Mid-Distance
5207,February,2022,Nueces,TX,Passenger,1,1,2,59,61,3.28,Mid-Distance
5208,February,2022,San Juan,WA,Truck,1,0,1,6017,6018,0.02,Washington
5209,February,2022,Moore,NC,Passenger,0,1,1,121,122,0.82,Furthest
5210,February,2022,Arlington,VA,Passenger,1,0,1,128,129,0.78,Furthest
5211,February,2022,Howard,IN,Passenger,0,1,1,6,7,14.29,Furthest
5212,February,2022,Coryell,TX,Passenger,1,0,1,102,103,0.97,Mid-Distance
5213,February,2022,Benton,WA,Passenger,664,451,1115,135846,136961,0.81,Washington
5214,February,2022,Spartanburg,SC,Passenger,0,1,1,44,45,2.22,Furthest
5215,February,2022,Essex,NJ,Passenger,2,0,2,10,12,16.67,Furthest
5216,February,2022,Montgomery,MD,Passenger,3,2,5,193,198,2.53,Furthest
5217,February,2022,Charleston,SC,Passenger,2,1,3,69,72,4.17,Furthest
5218,February,2022,Boulder,CO,Passenger,1,0,1,35,36,2.78,Mid-Distance
5219,February,2022,Skagit,WA,Passenger,716,316,1032,90675,91707,1.13,Washington
5220,February,2022,New Haven,CT,Passenger,0,2,2,29,31,6.45,Furthest
5221,February,2022,Thurston,WA,Passenger,1970,990,2960,196039,198999,1.49,Washington
5222,February,2022,Contra Costa,CA,Passenger,1,4,5,259,264,1.89,Nearest
5223,February,2022,El Paso,CO,Passenger,3,1,4,628,632,0.63,Mid-Distance
5224,February,2022,Monterey,CA,Passenger,0,1,1,130,131,0.76,Nearest
5225,February,2022,Erie,NY,Passenger,1,0,1,29,30,3.33,Furthest
5226,February,2022,Santa Clara,CA,Passenger,8,1,9,227,236,3.81,Nearest
5227,February,2022,Ulster,NY,Passenger,1,0,1,9,10,10.0,Furthest
5228,February,2022,Calvert,MD,Passenger,0,2,2,79,81,2.47,Furthest
5229,February,2022,Grays Harbor,WA,Truck,0,0,0,21340,21340,0.0,Washington
5230,February,2022,Leavenworth,KS,Passenger,0,1,1,102,103,0.97,Mid-Distance
5231,February,2022,Harnett,NC,Passenger,1,0,1,142,143,0.7,Furthest
5232,February,2022,Fort Bend,TX,Passenger,1,0,1,32,33,3.03,Mid-Distance
5234,February,2022,Lincoln,OR,Passenger,0,1,1,30,31,3.23,Nearest
5235,February,2022,Ray,MO,Passenger,0,1,1,1,2,50.0,Furthest
5236,February,2022,Douglas,CO,Passenger,0,1,1,76,77,1.3,Mid-Distance
5237,February,2022,Spokane,WA,Passenger,1392,784,2176,326237,328413,0.66,Washington
5238,February,2022,Los Angeles,CA,Passenger,10,7,17,809,826,2.06,Nearest
5239,February,2022,Wood,OH,Passenger,0,1,1,4,5,20.0,Furthest
5240,February,2022,Clark,WA,Passenger,3627,1600,5227,319148,324375,1.61,Washington
5241,February,2022,Garfield,WA,Passenger,0,3,3,1353,1356,0.22,Washington
5242,February,2022,Washington,MD,Passenger,2,0,2,14,16,12.5,Furthest
5243,February,2022,Lincoln,WA,Truck,0,0,0,4845,4845,0.0,Washington
5244,February,2022,Kitsap,WA,Passenger,2230,982,3212,179653,182865,1.76,Washington
5245,February,2022,Platte,MO,Passenger,1,0,1,17,18,5.56,Furthest
5246,February,2022,Benton,WA,Truck,0,0,0,43644,43644,0.0,Washington
5247,February,2022,Clallam,WA,Truck,1,0,1,22104,22105,0.0,Washington
5248,February,2022,DeKalb,GA,Passenger,1,0,1,51,52,1.92,Furthest
5249,February,2022,Miami-Dade,FL,Passenger,1,0,1,87,88,1.14,Furthest
5250,February,2022,Lewis,WA,Truck,0,0,0,26607,26607,0.0,Washington
5251,February,2022,Kauai,HI,Passenger,1,0,1,18,19,5.26,Nearest
5252,February,2022,Geary,KS,Passenger,1,0,1,89,90,1.11,Mid-Distance
5253,February,2022,Suffolk,VA,Passenger,1,0,1,121,122,0.82,Furthest
5254,February,2022,Camden,NJ,Passenger,0,1,1,13,14,7.14,Furthest
5255,February,2022,San Diego,CA,Passenger,14,8,22,2347,2369,0.93,Nearest
5256,February,2022,Nassau,NY,Passenger,2,0,2,24,26,7.69,Furthest
5257,February,2022,San Francisco,CA,Passenger,0,1,1,76,77,1.3,Nearest
5258,February,2022,Greene,MO,Passenger,0,1,1,24,25,4.0,Furthest
5259,February,2022,Columbia,WA,Passenger,6,1,7,2457,2464,0.28,Washington
5260,February,2022,San Juan,WA,Passenger,485,152,637,14178,14815,4.3,Washington
5261,February,2022,Kittitas,WA,Truck,0,0,0,14753,14753,0.0,Washington
5262,February,2022,Onslow,NC,Passenger,0,1,1,165,166,0.6,Furthest
5263,February,2022,Richmond,GA,Passenger,0,1,1,69,70,1.43,Furthest
5264,February,2022,Owyhee,ID,Passenger,1,0,1,2,3,33.33,Nearest
5265,February,2022,Jefferson,WA,Truck,0,0,0,9576,9576,0.0,Washington
5266,February,2022,St. Louis,MO,Passenger,1,0,1,71,72,1.39,Furthest
5267,February,2022,Pierce,WA,Passenger,4484,2176,6660,552620,559280,1.19,Washington
5268,February,2022,Adams,WA,Passenger,17,14,31,13020,13051,0.24,Washington
5269,February,2022,Danville,VA,Passenger,1,0,1,0,1,100.0,Furthest
5270,February,2022,Sarasota,FL,Passenger,2,0,2,27,29,6.9,Furthest
5271,February,2022,Wahkiakum,WA,Truck,0,0,0,1815,1815,0.0,Washington
5272,February,2022,Asotin,WA,Truck,0,0,0,6741,6741,0.0,Washington
5273,February,2022,Rockdale,GA,Passenger,1,0,1,7,8,12.5,Furthest
5274,February,2022,Garfield,WA,Truck,0,0,0,998,998,0.0,Washington
5275,February,2022,Escambia,FL,Passenger,0,1,1,136,137,0.73,Furthest
5276,February,2022,Allen,IN,Passenger,1,0,1,14,15,6.67,Furthest
5277,February,2022,Klickitat,WA,Truck,0,0,0,8332,8332,0.0,Washington
5278,February,2022,Prince George's,MD,Passenger,2,1,3,134,137,2.19,Furthest
5279,February,2022,Penobscot,ME,Passenger,0,1,1,6,7,14.29,Furthest
5280,February,2022,Pend Oreille,WA,Truck,0,0,0,5718,5718,0.0,Washington
5281,February,2022,Lake,FL,Passenger,1,0,1,22,23,4.35,Furthest
5282,February,2022,Kern,CA,Passenger,0,1,1,196,197,0.51,Nearest
5283,February,2022,New London,CT,Passenger,1,4,5,206,211,2.37,Furthest
5284,February,2022,Honolulu,HI,Passenger,4,4,8,338,346,2.31,Nearest
5285,February,2022,Island,WA,Passenger,745,351,1096,62408,63504,1.73,Washington
5286,February,2022,Flathead,MT,Passenger,1,0,1,37,38,2.63,Nearest
5287,February,2022,Ventura,CA,Passenger,2,1,3,235,238,1.26,Nearest
5288,February,2022,Thurston,WA,Truck,3,0,3,55853,55856,0.01,Washington
5289,February,2022,Grant,WA,Truck,0,0,0,28009,28009,0.0,Washington
5290,February,2022,Elmore,ID,Passenger,1,0,1,15,16,6.25,Nearest
5291,February,2022,Larimer,CO,Passenger,1,0,1,49,50,2.0,Mid-Distance
5292,February,2022,Powhatan,VA,Passenger,1,0,1,1,2,50.0,Furthest
5293,February,2022,Rock Island,IL,Passenger,0,1,1,16,17,5.88,Mid-Distance
5294,February,2022,Clackamas,OR,Passenger,2,0,2,157,159,1.26,Nearest
5295,February,2022,Chesapeake,VA,Passenger,2,3,5,356,361,1.39,Furthest
5296,February,2022,Chelan,WA,Truck,0,0,0,23075,23075,0.0,Washington
5297,February,2022,Pima,AZ,Passenger,1,1,2,241,243,0.82,Nearest
5298,February,2022,Oldham,KY,Passenger,0,1,1,4,5,20.0,Furthest
5299,February,2022,Snohomish,WA,Truck,3,0,3,125152,125155,0.0,Washington
5300,February,2022,Juneau,AK,Passenger,0,1,1,28,29,3.45,Nearest
5301,February,2022,Orange,FL,Passenger,1,0,1,95,96,1.04,Furthest
5302,February,2022,Yellowstone,MT,Passenger,0,1,1,28,29,3.45,Nearest
5303,February,2022,Wilson,NC,Passenger,1,0,1,0,1,100.0,Furthest
5304,February,2022,Broward,FL,Passenger,2,0,2,86,88,2.27,Furthest
5305,February,2022,Howard,MD,Passenger,0,1,1,56,57,1.75,Furthest
5306,February,2022,Williamson,TX,Passenger,1,2,3,87,90,3.33,Mid-Distance
5307,February,2022,Placer,CA,Passenger,2,0,2,70,72,2.78,Nearest
5308,February,2022,Hennepin,MN,Passenger,3,0,3,62,65,4.62,Mid-Distance
5309,February,2022,Fairfax,VA,Passenger,3,3,6,629,635,0.94,Furthest
5310,February,2022,Klamath,OR,Passenger,1,0,1,27,28,3.57,Nearest
5311,February,2022,Yakima,WA,Passenger,301,178,479,168019,168498,0.28,Washington
5312,February,2022,St. Tammany,LA,Passenger,1,0,1,37,38,2.63,Mid-Distance
5313,February,2022,Grant,WA,Passenger,142,99,241,66798,67039,0.36,Washington
5314,February,2022,Pennington,SD,Passenger,2,0,2,29,31,6.45,Mid-Distance
5315,February,2022,Anne Arundel,MD,Passenger,4,3,7,357,364,1.92,Furthest
5316,February,2022,Boone,MO,Passenger,0,1,1,9,10,10.0,Furthest
5317,February,2022,Walla Walla,WA,Truck,0,0,0,14072,14072,0.0,Washington
5318,February,2022,New York,NY,Passenger,1,0,1,34,35,2.86,Furthest
5319,February,2022,Middlesex,MA,Passenger,0,1,1,81,82,1.22,Furthest
5320,February,2022,Salt Lake,UT,Passenger,1,1,2,146,148,1.35,Nearest
5321,February,2022,San Bernardino,CA,Passenger,1,1,2,344,346,0.58,Nearest
5322,February,2022,Richmond,NY,Passenger,1,0,1,6,7,14.29,Furthest
5323,February,2022,Kittitas,WA,Passenger,218,72,290,29778,30068,0.96,Washington
5324,February,2022,Tarrant,TX,Passenger,1,0,1,125,126,0.79,Mid-Distance
5325,February,2022,Albemarle,VA,Passenger,1,0,1,18,19,5.26,Furthest
5326,February,2022,Anchorage,AK,Passenger,1,0,1,121,122,0.82,Nearest
5327,February,2022,Douglas,NE,Passenger,1,2,3,46,49,6.12,Mid-Distance
5328,February,2022,Sumter,SC,Passenger,0,1,1,33,34,2.94,Furthest
5329,February,2022,Philadelphia,PA,Passenger,1,0,1,35,36,2.78,Furthest
5330,February,2022,Lee,FL,Passenger,1,0,1,28,29,3.45,Furthest
5331,February,2022,Champaign,IL,Passenger,1,0,1,11,12,8.33,Mid-Distance
5332,February,2022,Dorchester,SC,Passenger,1,0,1,62,63,1.59,Furthest
5333,February,2022,Hidalgo,TX,Passenger,0,1,1,52,53,1.89,Mid-Distance
5334,February,2022,Burlington,NJ,Passenger,0,1,1,115,116,0.86,Furthest
5335,February,2022,Rockingham,NH,Passenger,1,0,1,17,18,5.56,Furthest
5336,February,2022,Maricopa,AZ,Passenger,7,2,9,985,994,0.91,Nearest
5337,February,2022,Pierce,WA,Truck,2,0,2,144061,144063,0.0,Washington
5338,February,2022,Prince William,VA,Passenger,1,1,2,200,202,0.99,Furthest
5339,February,2022,Okanogan,WA,Passenger,74,47,121,26474,26595,0.45,Washington
5340,February,2022,Queens,NY,Passenger,1,0,1,46,47,2.13,Furthest
5341,February,2022,Vigo,IN,Passenger,1,0,1,5,6,16.67,Furthest
5342,February,2022,Franklin,WA,Truck,0,0,0,20925,20925,0.0,Washington
5343,February,2022,Jefferson,WA,Passenger,394,202,596,24685,25281,2.36,Washington
5344,February,2022,Ferry,WA,Passenger,15,3,18,4443,4461,0.4,Washington
5345,February,2022,Whitman,WA,Truck,0,0,0,8578,8578,0.0,Washington
5346,February,2022,Whitman,WA,Passenger,70,56,126,22020,22146,0.57,Washington
5347,February,2022,Hamilton,OH,Passenger,1,0,1,30,31,3.23,Furthest
5348,February,2022,Manassas,VA,Passenger,0,1,1,7,8,12.5,Furthest
5349,February,2022,Randolph,NC,Passenger,1,0,1,5,6,16.67,Furthest
5350,February,2022,Denton,TX,Passenger,1,0,1,70,71,1.41,Mid-Distance
5351,February,2022,Hudson,NJ,Passenger,2,0,2,35,37,5.41,Furthest
5352,February,2022,Sedgwick,KS,Passenger,1,1,2,82,84,2.38,Mid-Distance
5353,February,2022,Kings,NY,Passenger,1,0,1,66,67,1.49,Furthest
5354,February,2022,Galveston,TX,Passenger,0,1,1,20,21,4.76,Mid-Distance
5355,February,2022,Stevens,WA,Passenger,58,47,105,30105,30210,0.35,Washington
5356,February,2022,Frederick,MD,Passenger,1,1,2,67,69,2.9,Furthest
5357,February,2022,Skagit,WA,Truck,1,0,1,32638,32639,0.0,Washington
5358,February,2022,Saratoga,NY,Passenger,1,0,1,39,40,2.5,Furthest
5359,February,2022,Pinellas,FL,Passenger,0,1,1,81,82,1.22,Furthest
5360,February,2022,Island,WA,Truck,1,0,1,21490,21491,0.0,Washington
5361,February,2022,Stafford,VA,Passenger,2,1,3,91,94,3.19,Furthest
5362,February,2022,San Luis Obispo,CA,Passenger,1,0,1,55,56,1.79,Nearest
5363,February,2022,Skamania,WA,Truck,0,0,0,4001,4001,0.0,Washington
5364,February,2022,Kitsap,WA,Truck,0,0,0,54096,54096,0.0,Washington
5365,February,2022,Rogers,OK,Passenger,1,0,1,2,3,33.33,Mid-Distance
5366,February,2022,Montgomery,TX,Passenger,1,0,1,31,32,3.12,Mid-Distance
5367,February,2022,Lincoln,WA,Passenger,7,17,24,7685,7709,0.31,Washington
5368,February,2022,Pacific,WA,Truck,0,0,0,8006,8006,0.0,Washington
5369,February,2022,Walla Walla,WA,Passenger,152,91,243,36233,36476,0.67,Washington
5370,February,2022,Whatcom,WA,Truck,4,0,4,43608,43612,0.01,Washington
5371,February,2022,Bexar,TX,Passenger,3,4,7,470,477,1.47,Mid-Distance
5372,February,2022,Cape May,NJ,Passenger,0,1,1,8,9,11.11,Furthest
5373,February,2022,Gwinnett,GA,Passenger,1,0,1,56,57,1.75,Furthest
5374,February,2022,Santa Cruz,CA,Passenger,1,0,1,24,25,4.0,Nearest
5375,February,2022,Goochland,VA,Passenger,3,2,5,166,171,2.92,Furthest
5376,February,2022,Portsmouth,VA,Passenger,0,1,1,75,76,1.32,Furthest
5377,February,2022,Yamhill,OR,Passenger,1,0,1,31,32,3.12,Nearest
5378,February,2022,Wahkiakum,WA,Passenger,17,11,28,3096,3124,0.9,Washington
5379,February,2022,Bell,TX,Passenger,1,0,1,330,331,0.3,Mid-Distance
5380,February,2022,Houston,GA,Passenger,1,0,1,39,40,2.5,Furthest
5381,February,2022,Wilson,TX,Passenger,0,1,1,2,3,33.33,Mid-Distance
5382,February,2022,Asotin,WA,Passenger,22,18,40,12641,12681,0.32,Washington
5383,February,2022,Carroll,NH,Passenger,0,1,1,5,6,16.67,Furthest
5384,February,2022,Richland,SC,Passenger,0,1,1,126,127,0.79,Furthest
5385,February,2022,Lake,IL,Passenger,3,0,3,146,149,2.01,Mid-Distance
5386,February,2022,Douglas,WA,Truck,0,0,0,12686,12686,0.0,Washington
5387,February,2022,Carroll,MD,Passenger,0,1,1,15,16,6.25,Furthest
5388,February,2022,Okaloosa,FL,Passenger,0,1,1,103,104,0.96,Furthest
5389,February,2022,San Mateo,CA,Passenger,2,0,2,76,78,2.56,Nearest
5390,February,2022,Harris,TX,Passenger,1,0,1,154,155,0.65,Mid-Distance
5391,February,2022,DuPage,IL,Passenger,1,0,1,48,49,2.04,Mid-Distance
5392,February,2022,Plaquemines,LA,Passenger,0,1,1,17,18,5.56,Mid-Distance
5393,February,2022,Norfolk,VA,Passenger,3,3,6,299,305,1.97,Furthest
5394,February,2022,King,WA,Passenger,37216,10526,47742,1354857,1402599,3.4,Washington
5395,February,2022,Charles,MD,Passenger,0,1,1,61,62,1.61,Furthest
5396,February,2022,Adams,WA,Truck,0,0,0,5459,5459,0.0,Washington
5397,February,2022,Alameda,CA,Passenger,4,0,4,202,206,1.94,Nearest
5398,February,2022,Sonoma,CA,Passenger,0,1,1,74,75,1.33,Nearest
5399,February,2022,Baltimore,MD,Passenger,1,0,1,76,77,1.3,Furthest
5400,February,2022,Cowlitz,WA,Passenger,280,168,448,71262,71710,0.62,Washington
5401,February,2022,Wichita,TX,Passenger,1,0,1,41,42,2.38,Mid-Distance
5402,February,2022,Louisa,VA,Passenger,0,1,1,1,2,50.0,Furthest
5403,February,2022,Snohomish,WA,Passenger,7454,2311,9765,535946,545711,1.79,Washington
5404,February,2022,Las Animas,CO,Passenger,1,0,1,1,2,50.0,Mid-Distance
5405,February,2022,Okanogan,WA,Truck,0,0,0,16714,16714,0.0,Washington
5406,February,2022,St. Clair,IL,Passenger,2,0,2,121,123,1.63,Mid-Distance
5407,February,2022,Harrison,MS,Passenger,2,0,2,45,47,4.26,Mid-Distance
5408,February,2022,Bartow,GA,Passenger,0,1,1,3,4,25.0,Furthest
5409,February,2022,Chelan,WA,Passenger,429,121,550,54566,55116,1.0,Washington
5410,February,2022,Lewis,WA,Passenger,221,166,387,59453,59840,0.65,Washington
5411,February,2022,Allegheny,PA,Passenger,1,1,2,53,55,3.64,Furthest
5412,February,2022,Hamilton,IN,Passenger,2,0,2,21,23,8.7,Furthest
5413,February,2022,Solano,CA,Passenger,1,0,1,169,170,0.59,Nearest
5414,February,2022,Shelby,OH,Passenger,0,1,1,2,3,33.33,Furthest
5415,February,2022,Hillsborough,FL,Passenger,0,1,1,129,130,0.77,Furthest
5416,February,2022,Collin,TX,Passenger,2,0,2,97,99,2.02,Mid-Distance
5417,February,2022,Alexandria,VA,Passenger,3,0,3,110,113,2.65,Furthest
5418,February,2022,Spokane,WA,Truck,0,0,0,102602,102602,0.0,Washington
5419,February,2022,Sarpy,NE,Passenger,1,0,1,55,56,1.79,Mid-Distance
5420,February,2022,Yakima,WA,Truck,0,0,0,61654,61654,0.0,Washington
5421,February,2022,Montgomery,PA,Passenger,2,0,2,22,24,8.33,Furthest
5422,February,2022,Cowlitz,WA,Truck,0,1,1,28908,28909,0.0,Washington
5423,February,2022,Riverside,CA,Passenger,5,1,6,476,482,1.24,Nearest
5424,February,2022,Duval,FL,Passenger,0,2,2,296,298,0.67,Furthest
5425,February,2022,Orange,CA,Passenger,4,2,6,369,375,1.6,Nearest
5426,February,2022,Carson City,NV,Passenger,1,0,1,7,8,12.5,Nearest
5427,February,2022,Clark,WA,Truck,2,0,2,83758,83760,0.0,Washington
5428,February,2022,King,WA,Truck,22,1,23,182492,182515,0.01,Washington
5429,February,2022,Sacramento,CA,Passenger,2,0,2,202,204,0.98,Nearest
5430,February,2022,Skamania,WA,Passenger,59,45,104,8311,8415,1.24,Washington
5431,February,2022,Klickitat,WA,Passenger,92,53,145,15306,15451,0.94,Washington
5432,February,2022,Pend Oreille,WA,Passenger,17,9,26,9075,9101,0.29,Washington
5433,February,2022,Fairbanks North Star,AK,Passenger,0,1,1,76,77,1.3,Nearest
5434,February,2022,Wake,NC,Passenger,1,0,1,101,102,0.98,Furthest
5435,February,2022,Marin,CA,Passenger,0,1,1,30,31,3.23,Nearest
5436,February,2022,Cumberland,NC,Passenger,1,2,3,377,380,0.79,Furthest
5437,February,2022,Mason,WA,Passenger,280,166,446,47722,48168,0.93,Washington
5438,February,2022,Virginia Beach,VA,Passenger,2,0,2,551,553,0.36,Furthest
5439,February,2022,Hawaii,HI,Passenger,1,0,1,37,38,2.63,Nearest
5440,February,2022,Grays Harbor,WA,Passenger,202,157,359,49318,49677,0.72,Washington
5441,February,2022,Ferry,WA,Truck,0,0,0,3567,3567,0.0,Washington
5442,February,2022,Columbia,WA,Truck,0,0,0,1571,1571,0.0,Washington
5443,February,2022,Fresno,CA,Passenger,1,0,1,152,153,0.65,Nearest
5444,February,2022,RÃ­o Grande,PR,Passenger,1,0,1,0,1,100.0,Mid-Distance
5445,February,2022,Dallas,TX,Passenger,1,0,1,125,126,0.79,Mid-Distance
5446,February,2022,Douglas,WA,Passenger,122,55,177,28558,28735,0.62,Washington
5447,February,2022,District of Columbia,DC,Passenger,5,0,5,184,189,2.65,Furthest
5448,February,2022,Franklin,WA,Passenger,175,102,277,62074,62351,0.44,Washington
5449,February,2023,Santa Clara,CA,Passenger,8,2,10,163,173,5.78,Nearest
5450,February,2023,Nassau,NY,Passenger,1,0,1,21,22,4.55,Furthest
5451,February,2023,Santa Cruz,CA,Passenger,1,0,1,12,13,7.69,Nearest
5452,February,2023,Monterey,CA,Passenger,1,1,2,113,115,1.74,Nearest
5453,February,2023,Solano,CA,Passenger,4,0,4,135,139,2.88,Nearest
5454,February,2023,Vernon,LA,Passenger,1,0,1,71,72,1.39,Mid-Distance
5455,February,2023,Skagit,WA,Passenger,987,377,1364,89175,90539,1.51,Washington
5456,February,2023,Platte,MO,Passenger,1,0,1,17,18,5.56,Furthest
5457,February,2023,Leavenworth,KS,Passenger,0,1,1,90,91,1.1,Mid-Distance
5458,February,2023,Cowlitz,WA,Passenger,424,193,617,70210,70827,0.87,Washington
5459,February,2023,Benton,WA,Truck,15,0,15,43323,43338,0.03,Washington
5460,February,2023,Rockingham,NH,Passenger,1,0,1,10,11,9.09,Furthest
5461,February,2023,Emmet,MI,Passenger,0,1,1,0,1,100.0,Furthest
5462,February,2023,Gwinnett,GA,Passenger,1,0,1,42,43,2.33,Furthest
5463,February,2023,El Paso,CO,Passenger,3,1,4,497,501,0.8,Mid-Distance
5464,February,2023,Ferry,WA,Truck,0,0,0,3565,3565,0.0,Washington
5465,February,2023,Galveston,TX,Passenger,0,1,1,17,18,5.56,Mid-Distance
5466,February,2023,Salt Lake,UT,Passenger,0,1,1,97,98,1.02,Nearest
5467,February,2023,Lewis,WA,Truck,4,0,4,26200,26204,0.02,Washington
5468,February,2023,Pulaski,AR,Passenger,3,0,3,22,25,12.0,Mid-Distance
5469,February,2023,Collin,TX,Passenger,2,0,2,44,46,4.35,Mid-Distance
5470,February,2023,Clark,WA,Passenger,5174,2109,7283,313862,321145,2.27,Washington
5471,February,2023,Lee,AL,Passenger,1,0,1,11,12,8.33,Furthest
5472,February,2023,Whitman,WA,Truck,4,0,4,8658,8662,0.05,Washington
5473,February,2023,Cook,IL,Passenger,2,0,2,148,150,1.33,Mid-Distance
5474,February,2023,New Haven,CT,Passenger,0,2,2,22,24,8.33,Furthest
5475,February,2023,Honolulu,HI,Passenger,2,3,5,266,271,1.85,Nearest
5476,February,2023,Hamilton,OH,Truck,1,0,1,2,3,33.33,Furthest
5477,February,2023,Columbia,WA,Truck,0,0,0,1574,1574,0.0,Washington
5478,February,2023,Klickitat,WA,Truck,4,0,4,8261,8265,0.05,Washington
5479,February,2023,El Paso,TX,Passenger,2,0,2,273,275,0.73,Mid-Distance
5480,February,2023,Spokane,WA,Passenger,2041,983,3024,323909,326933,0.92,Washington
5481,February,2023,Larimer,CO,Passenger,1,0,1,37,38,2.63,Mid-Distance
5482,February,2023,Clallam,WA,Passenger,504,272,776,49281,50057,1.55,Washington
5483,February,2023,Portsmouth,VA,Passenger,0,1,1,62,63,1.59,Furthest
5484,February,2023,San Juan,WA,Passenger,580,172,752,13878,14630,5.14,Washington
5485,February,2023,Douglas,CO,Passenger,0,1,1,55,56,1.79,Mid-Distance
5486,February,2023,Travis,TX,Passenger,1,0,1,77,78,1.28,Mid-Distance
5487,February,2023,Island,WA,Truck,20,0,20,21105,21125,0.09,Washington
5488,February,2023,Yakima,WA,Passenger,445,240,685,166120,166805,0.41,Washington
5489,February,2023,Kitsap,WA,Passenger,2890,1171,4061,176810,180871,2.25,Washington
5490,February,2023,Geary,KS,Passenger,1,0,1,71,72,1.39,Mid-Distance
5491,February,2023,Hennepin,MN,Passenger,1,0,1,31,32,3.12,Mid-Distance
5492,February,2023,Rock Island,IL,Passenger,0,1,1,14,15,6.67,Mid-Distance
5493,February,2023,Hillsborough,FL,Passenger,0,1,1,103,104,0.96,Furthest
5494,February,2023,Onslow,NC,Passenger,0,1,1,140,141,0.71,Furthest
5495,February,2023,Sarpy,NE,Passenger,1,0,1,45,46,2.17,Mid-Distance
5496,February,2023,Hoke,NC,Passenger,1,0,1,58,59,1.69,Furthest
5497,February,2023,Snohomish,WA,Truck,122,0,122,122092,122214,0.1,Washington
5498,February,2023,Stevens,WA,Truck,2,0,2,18777,18779,0.01,Washington
5499,February,2023,Marin,CA,Passenger,0,1,1,27,28,3.57,Nearest
5500,February,2023,Adams,WA,Passenger,21,11,32,13008,13040,0.25,Washington
5501,February,2023,Garfield,WA,Truck,0,0,0,979,979,0.0,Washington
5502,February,2023,Virginia Beach,VA,Passenger,2,0,2,438,440,0.45,Furthest
5503,February,2023,Whitman,WA,Passenger,124,71,195,22018,22213,0.88,Washington
5504,February,2023,Ray,MO,Passenger,0,1,1,0,1,100.0,Furthest
5505,February,2023,Kootenai,ID,Truck,1,0,1,26,27,3.7,Nearest
5506,February,2023,DeKalb,GA,Passenger,1,0,1,39,40,2.5,Furthest
5507,February,2023,San Juan,WA,Truck,10,0,10,5886,5896,0.17,Washington
5508,February,2023,Louisa,VA,Passenger,0,1,1,1,2,50.0,Furthest
5509,February,2023,Wahkiakum,WA,Truck,1,0,1,1793,1794,0.06,Washington
5510,February,2023,Sumter,SC,Passenger,0,1,1,32,33,3.03,Furthest
5511,February,2023,Douglas,WA,Truck,6,0,6,12882,12888,0.05,Washington
5512,February,2023,Lincoln,WA,Truck,0,0,0,4846,4846,0.0,Washington
5513,February,2023,Douglas,NE,Passenger,2,1,3,27,30,10.0,Mid-Distance
5514,February,2023,Broward,FL,Passenger,1,0,1,58,59,1.69,Furthest
5515,February,2023,Arapahoe,CO,Passenger,1,1,2,64,66,3.03,Mid-Distance
5516,February,2023,Klickitat,WA,Passenger,127,57,184,15144,15328,1.2,Washington
5517,February,2023,Kent,DE,Passenger,1,0,1,48,49,2.04,Furthest
5518,February,2023,Nueces,TX,Passenger,0,1,1,50,51,1.96,Mid-Distance
5519,February,2023,Walla Walla,WA,Passenger,206,108,314,35642,35956,0.87,Washington
5520,February,2023,Arlington,VA,Passenger,1,0,1,103,104,0.96,Furthest
5521,February,2023,Madison,IL,Passenger,1,0,1,15,16,6.25,Mid-Distance
5522,February,2023,Alameda,CA,Passenger,3,0,3,152,155,1.94,Nearest
5523,February,2023,Okaloosa,FL,Passenger,0,1,1,89,90,1.11,Furthest
5524,February,2023,Lake,IL,Passenger,1,0,1,114,115,0.87,Mid-Distance
5525,February,2023,Chelan,WA,Truck,19,0,19,23120,23139,0.08,Washington
5526,February,2023,Newport News,VA,Passenger,1,0,1,93,94,1.06,Furthest
5527,February,2023,Clark,NV,Passenger,4,2,6,398,404,1.49,Nearest
5528,February,2023,Kittitas,WA,Truck,6,0,6,14560,14566,0.04,Washington
5529,February,2023,Fairfax,VA,Passenger,5,3,8,546,554,1.44,Furthest
5530,February,2023,Grays Harbor,WA,Truck,2,0,2,21049,21051,0.01,Washington
5531,February,2023,Montgomery,MD,Passenger,3,3,6,173,179,3.35,Furthest
5532,February,2023,Skamania,WA,Passenger,93,53,146,8095,8241,1.77,Washington
5533,February,2023,Island,WA,Passenger,977,411,1388,61460,62848,2.21,Washington
5534,February,2023,San Diego,CA,Passenger,17,9,26,1971,1997,1.3,Nearest
5535,February,2023,Randolph,NC,Passenger,1,0,1,4,5,20.0,Furthest
5536,February,2023,Dallas,TX,Passenger,1,0,1,75,76,1.32,Mid-Distance
5537,February,2023,Sonoma,CA,Passenger,1,1,2,58,60,3.33,Nearest
5538,February,2023,Lewis,WA,Passenger,292,186,478,59690,60168,0.79,Washington
5539,February,2023,District of Columbia,DC,Passenger,4,0,4,150,154,2.6,Furthest
5540,February,2023,Carroll,MD,Passenger,0,1,1,17,18,5.56,Furthest
5541,February,2023,Stafford,VA,Passenger,3,1,4,77,81,4.94,Furthest
5542,February,2023,Frederick,MD,Passenger,1,0,1,54,55,1.82,Furthest
5543,February,2023,Hawaii,HI,Passenger,1,0,1,24,25,4.0,Nearest
5544,February,2023,Allegheny,PA,Passenger,1,0,1,46,47,2.13,Furthest
5545,February,2023,Yavapai,AZ,Passenger,1,0,1,22,23,4.35,Nearest
5546,February,2023,Pierce,WA,Passenger,6593,2579,9172,535692,544864,1.68,Washington
5547,February,2023,King,WA,Truck,495,2,497,177291,177788,0.28,Washington
5548,February,2023,Whatcom,WA,Truck,44,0,44,42882,42926,0.1,Washington
5549,February,2023,Sheridan,WY,Passenger,1,0,1,5,6,16.67,Nearest
5550,February,2023,Danville,VA,Passenger,1,0,1,0,1,100.0,Furthest
5551,February,2023,Spokane,WA,Truck,26,0,26,101868,101894,0.03,Washington
5552,February,2023,Ferry,WA,Passenger,21,4,25,4341,4366,0.57,Washington
5553,February,2023,Los Angeles,CA,Passenger,4,5,9,618,627,1.44,Nearest
5554,February,2023,Yellowstone,MT,Passenger,0,1,1,15,16,6.25,Nearest
5555,February,2023,Suffolk,VA,Passenger,1,0,1,110,111,0.9,Furthest
5556,February,2023,Oldham,KY,Passenger,0,1,1,4,5,20.0,Furthest
5557,February,2023,Calvert,MD,Passenger,0,2,2,75,77,2.6,Furthest
5558,February,2023,Washington,MD,Passenger,2,0,2,14,16,12.5,Furthest
5559,February,2023,Coryell,TX,Passenger,1,0,1,78,79,1.27,Mid-Distance
5560,February,2023,Grays Harbor,WA,Passenger,272,171,443,48597,49040,0.9,Washington
5561,February,2023,Hudson,NJ,Passenger,1,0,1,24,25,4.0,Furthest
5562,February,2023,Elmore,ID,Passenger,1,0,1,10,11,9.09,Nearest
5563,February,2023,Douglas,WA,Passenger,180,59,239,28618,28857,0.83,Washington
5564,February,2023,San Joaquin,CA,Passenger,1,0,1,73,74,1.35,Nearest
5565,February,2023,Thurston,WA,Truck,49,0,49,54485,54534,0.09,Washington
5566,February,2023,Skagit,WA,Truck,13,0,13,32041,32054,0.04,Washington
5567,February,2023,Rockdale,GA,Passenger,1,0,1,5,6,16.67,Furthest
5568,February,2023,Jefferson,NY,Passenger,1,1,2,178,180,1.11,Furthest
5569,February,2023,Santa Barbara,CA,Passenger,1,0,1,63,64,1.56,Nearest
5570,February,2023,Asotin,WA,Passenger,30,20,50,12475,12525,0.4,Washington
5571,February,2023,Essex,NJ,Passenger,2,0,2,6,8,25.0,Furthest
5572,February,2023,Charles,MD,Passenger,1,1,2,49,51,3.92,Furthest
5573,February,2023,Placer,CA,Passenger,1,0,1,53,54,1.85,Nearest
5574,February,2023,Norfolk,VA,Passenger,3,3,6,263,269,2.23,Furthest
5575,February,2023,Lane,OR,Passenger,0,1,1,70,71,1.41,Nearest
5576,February,2023,King,WA,Passenger,50928,12806,63734,1330234,1393968,4.57,Washington
5577,February,2023,St. Louis,MO,Passenger,1,0,1,50,51,1.96,Furthest
5578,February,2023,Lincoln,OR,Passenger,0,1,1,13,14,7.14,Nearest
5579,February,2023,Orange,CA,Passenger,7,2,9,286,295,3.05,Nearest
5580,February,2023,Miami-Dade,FL,Passenger,1,0,1,60,61,1.64,Furthest
5581,February,2023,Okanogan,WA,Truck,2,0,2,16449,16451,0.01,Washington
5582,February,2023,Adams,CO,Passenger,1,0,1,30,31,3.23,Mid-Distance
5583,February,2023,Champaign,IL,Passenger,1,0,1,8,9,11.11,Mid-Distance
5584,February,2023,Loudoun,VA,Passenger,3,0,3,57,60,5.0,Furthest
5585,February,2023,Harris,TX,Passenger,1,0,1,116,117,0.85,Mid-Distance
5586,February,2023,Montgomery,AL,Passenger,0,1,1,29,30,3.33,Furthest
5587,February,2023,Jefferson,WA,Truck,9,0,9,9332,9341,0.1,Washington
5588,February,2023,Sedgwick,KS,Passenger,1,1,2,61,63,3.17,Mid-Distance
5589,February,2023,Middlesex,MA,Passenger,2,1,3,59,62,4.84,Furthest
5590,February,2023,Montgomery,PA,Passenger,1,0,1,16,17,5.88,Furthest
5591,February,2023,Alexandria,VA,Passenger,3,1,4,89,93,4.3,Furthest
5592,February,2023,Jackson,OK,Passenger,0,1,1,31,32,3.12,Mid-Distance
5593,February,2023,St. Mary's,MD,Passenger,1,0,1,167,168,0.6,Furthest
5594,February,2023,Ventura,CA,Passenger,2,1,3,200,203,1.48,Nearest
5595,February,2023,Jefferson,WA,Passenger,508,242,750,24237,24987,3.0,Washington
5596,February,2023,Moore,NC,Passenger,0,1,1,101,102,0.98,Furthest
5597,February,2023,Allen,IN,Passenger,1,0,1,11,12,8.33,Furthest
5598,February,2023,Pend Oreille,WA,Truck,0,0,0,5573,5573,0.0,Washington
5599,February,2023,Walla Walla,WA,Truck,3,0,3,13814,13817,0.02,Washington
5600,February,2023,Harrison,MS,Passenger,1,0,1,31,32,3.12,Mid-Distance
5601,February,2023,Mason,WA,Truck,9,0,9,20863,20872,0.04,Washington
5602,February,2023,Sarasota,FL,Passenger,1,0,1,16,17,5.88,Furthest
5603,February,2023,Clallam,WA,Truck,12,0,12,21812,21824,0.05,Washington
5604,February,2023,Benton,WA,Passenger,989,517,1506,135708,137214,1.1,Washington
5605,February,2023,Lake,FL,Passenger,1,0,1,14,15,6.67,Furthest
5606,February,2023,Cape May,NJ,Passenger,0,1,1,7,8,12.5,Furthest
5607,February,2023,Grant,WA,Truck,7,0,7,28056,28063,0.02,Washington
5608,February,2023,Lincoln,WA,Passenger,16,17,33,7744,7777,0.42,Washington
5609,February,2023,Bartow,GA,Passenger,0,1,1,3,4,25.0,Furthest
5610,February,2023,Cumberland,NC,Passenger,1,2,3,302,305,0.98,Furthest
5611,February,2023,Bell,TX,Passenger,1,0,1,259,260,0.38,Mid-Distance
5612,February,2023,Burlington,NJ,Passenger,0,2,2,92,94,2.13,Furthest
5613,February,2023,Riverside,CA,Passenger,7,0,7,380,387,1.81,Nearest
5614,February,2023,Snohomish,WA,Passenger,10921,2841,13762,529463,543225,2.53,Washington
5615,February,2023,Stevens,WA,Passenger,99,58,157,29968,30125,0.52,Washington
5617,February,2023,Dorchester,SC,Passenger,1,0,1,41,42,2.38,Furthest
5618,February,2023,Berkeley,SC,Passenger,0,1,1,104,105,0.95,Furthest
5619,February,2023,Hidalgo,TX,Passenger,0,1,1,46,47,2.13,Mid-Distance
5620,February,2023,Clark,WA,Truck,70,0,70,81540,81610,0.09,Washington
5621,February,2023,Chelan,WA,Passenger,566,151,717,54278,54995,1.3,Washington
5622,February,2023,Bexar,TX,Passenger,4,3,7,356,363,1.93,Mid-Distance
5623,February,2023,Pacific,WA,Passenger,71,82,153,15680,15833,0.97,Washington
5624,February,2023,New London,CT,Passenger,2,4,6,174,180,3.33,Furthest
5625,February,2023,Fairfax,VA,Truck,1,0,1,94,95,1.05,Furthest
5626,February,2023,Fairbanks North Star,AK,Passenger,0,1,1,56,57,1.75,Nearest
5627,February,2023,Wilson,TX,Passenger,0,1,1,2,3,33.33,Mid-Distance
5628,February,2023,Howard,MD,Passenger,0,1,1,43,44,2.27,Furthest
5629,February,2023,Adams,WA,Truck,2,0,2,5362,5364,0.04,Washington
5630,February,2023,Multnomah,OR,Passenger,0,2,2,423,425,0.47,Nearest
5631,February,2023,Richmond,NY,Passenger,1,0,1,6,7,14.29,Furthest
5632,February,2023,Goochland,VA,Passenger,0,1,1,53,54,1.85,Furthest
5633,February,2023,Wahkiakum,WA,Passenger,26,15,41,3046,3087,1.33,Washington
5634,February,2023,Hamilton,OH,Passenger,1,0,1,24,25,4.0,Furthest
5635,February,2023,Charleston,SC,Passenger,2,2,4,54,58,6.9,Furthest
5636,February,2023,Yakima,WA,Truck,9,0,9,61121,61130,0.01,Washington
5637,February,2023,Kitsap,WA,Truck,49,0,49,52804,52853,0.09,Washington
5638,February,2023,Okanogan,WA,Passenger,107,56,163,26100,26263,0.62,Washington
5639,February,2023,Garfield,WA,Passenger,1,3,4,1315,1319,0.3,Washington
5640,February,2023,Camden,NJ,Passenger,0,1,1,12,13,7.69,Furthest
5641,February,2023,Houston,GA,Passenger,1,0,1,24,25,4.0,Furthest
5642,February,2023,Harnett,NC,Passenger,2,0,2,124,126,1.59,Furthest
5643,February,2023,Chesapeake,VA,Passenger,2,3,5,282,287,1.74,Furthest
5644,February,2023,Wichita,TX,Passenger,2,0,2,34,36,5.56,Mid-Distance
5645,February,2023,Richmond,GA,Passenger,0,1,1,56,57,1.75,Furthest
5646,February,2023,Ulster,NY,Passenger,1,0,1,4,5,20.0,Furthest
5647,February,2023,Kings,CA,Passenger,2,1,3,273,276,1.09,Nearest
5648,February,2023,Thurston,WA,Passenger,2773,1153,3926,191440,195366,2.01,Washington
5649,February,2023,St. Clair,IL,Passenger,2,0,2,106,108,1.85,Mid-Distance
5650,February,2023,Denton,TX,Passenger,1,0,1,46,47,2.13,Mid-Distance
5651,February,2023,Columbia,WA,Passenger,8,1,9,2424,2433,0.37,Washington
5652,February,2023,Franklin,WA,Passenger,275,128,403,61808,62211,0.65,Washington
5653,February,2023,Kern,CA,Passenger,1,1,2,182,184,1.09,Nearest
5654,February,2023,Franklin,WA,Truck,4,0,4,20960,20964,0.02,Washington
5655,February,2023,Lee,FL,Passenger,1,0,1,24,25,4.0,Furthest
5656,February,2023,Pierce,WA,Truck,111,0,111,138554,138665,0.08,Washington
5657,February,2023,St. Tammany,LA,Passenger,1,0,1,30,31,3.23,Mid-Distance
5658,February,2023,Pacific,WA,Truck,2,0,2,7825,7827,0.03,Washington
5659,February,2023,Prince George's,MD,Passenger,3,1,4,113,117,3.42,Furthest
5660,February,2023,Saratoga,NY,Passenger,1,1,2,32,34,5.88,Furthest
5661,February,2023,Asotin,WA,Truck,0,0,0,6661,6661,0.0,Washington
5662,February,2023,Williamson,TX,Passenger,0,2,2,57,59,3.39,Mid-Distance
5663,February,2023,Maricopa,AZ,Passenger,7,3,10,643,653,1.53,Nearest
5664,February,2023,Cowlitz,WA,Truck,7,0,7,28319,28326,0.02,Washington
5665,February,2023,Sacramento,CA,Passenger,4,0,4,152,156,2.56,Nearest
5666,February,2023,Duval,FL,Passenger,1,0,1,232,233,0.43,Furthest
5667,February,2023,Anne Arundel,MD,Passenger,4,4,8,297,305,2.62,Furthest
5668,February,2023,Contra Costa,CA,Passenger,0,3,3,199,202,1.49,Nearest
5669,February,2023,Grant,WA,Passenger,241,114,355,66906,67261,0.53,Washington
5670,February,2023,Boulder,CO,Passenger,1,0,1,26,27,3.7,Mid-Distance
5671,February,2023,Beaufort,SC,Passenger,1,0,1,19,20,5.0,Furthest
5672,February,2023,Mason,WA,Passenger,394,199,593,46628,47221,1.26,Washington
5673,February,2023,Whatcom,WA,Passenger,2212,826,3038,148577,151615,2.0,Washington
5674,February,2023,Kauai,HI,Passenger,1,1,2,13,15,13.33,Nearest
5675,February,2023,Pend Oreille,WA,Passenger,26,13,39,8936,8975,0.43,Washington
5676,February,2023,Napa,CA,Passenger,0,1,1,9,10,10.0,Nearest
5677,February,2023,Polk,OR,Passenger,0,1,1,17,18,5.56,Nearest
5678,February,2023,Kittitas,WA,Passenger,322,92,414,29510,29924,1.38,Washington
5679,February,2023,Skamania,WA,Truck,1,0,1,3860,3861,0.03,Washington
5680,February,2023,San Bernardino,CA,Passenger,2,1,3,272,275,1.09,Nearest
5681,February,2023,Plaquemines,LA,Passenger,1,1,2,16,18,11.11,Mid-Distance
5682,February,2023,Cumberland,PA,Passenger,1,0,1,32,33,3.03,Furthest
5683,February,2023,Escambia,FL,Passenger,0,1,1,110,111,0.9,Furthest
5684,February,2023,Las Animas,CO,Passenger,1,0,1,0,1,100.0,Mid-Distance
5685,February,2020,Spartanburg,SC,Passenger,0,1,1,45,46,2.17,Furthest
5686,February,2020,Camden,NJ,Passenger,0,2,2,21,23,8.7,Furthest
5687,February,2020,Randolph,NC,Passenger,1,0,1,7,8,12.5,Furthest
5688,February,2020,Santa Cruz,CA,Passenger,1,0,1,36,37,2.7,Nearest
5689,February,2020,Williams,ND,Passenger,0,1,1,13,14,7.14,Mid-Distance
5690,February,2020,Jones,GA,Passenger,1,0,1,1,2,50.0,Furthest
5691,February,2020,Prince George's,MD,Passenger,1,1,2,171,173,1.16,Furthest
5692,February,2020,San Diego,CA,Passenger,11,5,16,2780,2796,0.57,Nearest
5693,February,2020,Osceola,FL,Passenger,1,0,1,41,42,2.38,Furthest
5694,February,2020,Jefferson,CO,Passenger,0,1,1,60,61,1.64,Mid-Distance
5695,February,2020,Alexandria,VA,Passenger,1,0,1,144,145,0.69,Furthest
5696,February,2020,Manassas,VA,Passenger,0,1,1,6,7,14.29,Furthest
5697,February,2020,Goochland,VA,Passenger,2,1,3,261,264,1.14,Furthest
5698,February,2020,Broward,FL,Passenger,2,1,3,119,122,2.46,Furthest
5699,February,2020,Fulton,GA,Passenger,1,2,3,104,107,2.8,Furthest
5700,February,2020,Dakota,MN,Passenger,0,1,1,32,33,3.03,Mid-Distance
5701,February,2020,San Joaquin,CA,Passenger,1,0,1,135,136,0.74,Nearest
5702,February,2020,Saginaw,MI,Passenger,1,0,1,11,12,8.33,Furthest
5703,February,2020,Bucks,PA,Passenger,1,0,1,19,20,5.0,Furthest
5704,February,2020,Franklin,WA,Truck,0,0,0,19897,19897,0.0,Washington
5705,February,2020,Skamania,WA,Truck,0,0,0,4102,4102,0.0,Washington
5706,February,2020,Garfield,WA,Passenger,0,1,1,1349,1350,0.07,Washington
5707,February,2020,RÃ­o Grande,PR,Passenger,1,0,1,1,2,50.0,Mid-Distance
5708,February,2020,Queens,NY,Passenger,1,0,1,53,54,1.85,Furthest
5709,February,2020,Lake,IL,Passenger,1,0,1,164,165,0.61,Mid-Distance
5710,February,2020,Portsmouth,VA,Passenger,0,1,1,78,79,1.27,Furthest
5711,February,2020,Jefferson,WA,Passenger,230,139,369,25171,25540,1.44,Washington
5712,February,2020,Whitman,WA,Truck,0,0,0,8555,8555,0.0,Washington
5713,February,2020,Denver,CO,Passenger,1,0,1,126,127,0.79,Mid-Distance
5714,February,2020,Skagit,WA,Truck,1,0,1,32559,32560,0.0,Washington
5715,February,2020,Riverside,CA,Passenger,3,1,4,643,647,0.62,Nearest
5716,February,2020,Okanogan,WA,Passenger,34,31,65,26121,26186,0.25,Washington
5717,February,2020,Okanogan,WA,Truck,0,0,0,16498,16498,0.0,Washington
5718,February,2020,Charles,MD,Passenger,0,1,1,76,77,1.3,Furthest
5719,February,2020,Honolulu,HI,Passenger,4,2,6,467,473,1.27,Nearest
5720,February,2020,El Paso,TX,Passenger,3,0,3,443,446,0.67,Mid-Distance
5721,February,2020,Lee,FL,Passenger,1,0,1,52,53,1.89,Furthest
5722,February,2020,Pierce,WA,Passenger,2253,1684,3937,551186,555123,0.71,Washington
5723,February,2020,Harrison,MS,Passenger,1,0,1,60,61,1.64,Mid-Distance
5724,February,2020,Fort Bend,TX,Passenger,1,0,1,48,49,2.04,Mid-Distance
5725,February,2020,Vigo,IN,Passenger,1,0,1,5,6,16.67,Furthest
5726,February,2020,San Mateo,CA,Passenger,0,1,1,116,117,0.85,Nearest
5727,February,2020,DeKalb,GA,Passenger,1,0,1,83,84,1.19,Furthest
5728,February,2020,Sedgwick,KS,Passenger,1,1,2,95,97,2.06,Mid-Distance
5729,February,2020,Guadalupe,TX,Passenger,1,0,1,66,67,1.49,Mid-Distance
5730,February,2020,Hennepin,MN,Passenger,3,1,4,98,102,3.92,Mid-Distance
5731,February,2020,Orange,CA,Passenger,7,2,9,502,511,1.76,Nearest
5732,February,2020,District of Columbia,DC,Passenger,1,1,2,205,207,0.97,Furthest
5733,February,2020,Clark,WA,Passenger,1970,1058,3028,320541,323569,0.94,Washington
5734,February,2020,Douglas,NE,Passenger,0,1,1,57,58,1.72,Mid-Distance
5735,February,2020,Fairfax,VA,Passenger,4,3,7,752,759,0.92,Furthest
5736,February,2020,Fresno,CA,Passenger,1,0,1,188,189,0.53,Nearest
5737,February,2020,Albemarle,VA,Passenger,1,0,1,25,26,3.85,Furthest
5738,February,2020,Tarrant,TX,Passenger,2,0,2,186,188,1.06,Mid-Distance
5739,February,2020,Cowlitz,WA,Passenger,128,111,239,73460,73699,0.32,Washington
5740,February,2020,Juneau,AK,Passenger,0,2,2,32,34,5.88,Nearest
5741,February,2020,Pinal,AZ,Passenger,1,0,1,192,193,0.52,Nearest
5742,February,2020,Asotin,WA,Truck,0,0,0,6695,6695,0.0,Washington
5743,February,2020,Owyhee,ID,Passenger,1,0,1,3,4,25.0,Nearest
5744,February,2020,Denton,TX,Passenger,1,0,1,89,90,1.11,Mid-Distance
5745,February,2020,Klamath,OR,Passenger,1,0,1,37,38,2.63,Nearest
5746,February,2020,Lincoln,WA,Passenger,1,12,13,7781,7794,0.17,Washington
5747,February,2020,Grays Harbor,WA,Truck,0,0,0,20809,20809,0.0,Washington
5748,February,2020,Mason,WA,Passenger,150,135,285,47595,47880,0.6,Washington
5749,February,2020,Polk,FL,Passenger,1,0,1,67,68,1.47,Furthest
5750,February,2020,Allegheny,PA,Passenger,1,0,1,73,74,1.35,Furthest
5751,February,2020,Clay,FL,Passenger,0,1,1,85,86,1.16,Furthest
5752,February,2020,Cumberland,NC,Passenger,0,2,2,478,480,0.42,Furthest
5753,February,2020,Placer,CA,Passenger,2,0,2,93,95,2.11,Nearest
5754,February,2020,Washtenaw,MI,Passenger,1,0,1,40,41,2.44,Furthest
5755,February,2020,Garfield,WA,Truck,0,0,0,965,965,0.0,Washington
5756,February,2020,Williamson,TX,Passenger,0,2,2,142,144,1.39,Mid-Distance
5757,February,2020,Contra Costa,CA,Passenger,3,2,5,331,336,1.49,Nearest
5758,February,2020,Spokane,WA,Passenger,696,469,1165,317560,318725,0.37,Washington
5759,February,2020,Greene,MO,Passenger,0,1,1,30,31,3.23,Furthest
5760,February,2020,Sacramento,CA,Passenger,1,0,1,278,279,0.36,Nearest
5761,February,2020,Stafford,VA,Passenger,1,1,2,91,93,2.15,Furthest
5762,February,2020,Klickitat,WA,Truck,0,0,0,8301,8301,0.0,Washington
5763,February,2020,Lewis,WA,Passenger,108,105,213,59582,59795,0.36,Washington
5764,February,2020,Washington,OR,Passenger,1,0,1,459,460,0.22,Nearest
5765,February,2020,Boulder,CO,Passenger,0,1,1,48,49,2.04,Mid-Distance
5766,February,2020,Kitsap,WA,Truck,1,0,1,54392,54393,0.0,Washington
5767,February,2020,Arapahoe,CO,Passenger,1,0,1,141,142,0.7,Mid-Distance
5768,February,2020,Clark,WA,Truck,0,0,0,81980,81980,0.0,Washington
5769,February,2020,Ventura,CA,Passenger,0,3,3,294,297,1.01,Nearest
5770,February,2020,Moore,NC,Passenger,0,1,1,164,165,0.61,Furthest
5771,February,2020,Boone,MO,Passenger,0,1,1,11,12,8.33,Furthest
5772,February,2020,Grant,WA,Truck,0,0,0,27065,27065,0.0,Washington
5773,February,2020,Cowlitz,WA,Truck,0,0,0,28994,28994,0.0,Washington
5774,February,2020,Skagit,WA,Passenger,379,215,594,92466,93060,0.64,Washington
5775,February,2020,Oklahoma,OK,Passenger,0,1,1,128,129,0.78,Mid-Distance
5776,February,2020,Shasta,CA,Passenger,1,0,1,36,37,2.7,Nearest
5777,February,2020,DuPage,IL,Passenger,3,0,3,62,65,4.62,Mid-Distance
5778,February,2020,Pend Oreille,WA,Passenger,8,7,15,9454,9469,0.16,Washington
5779,February,2020,Maui,HI,Passenger,1,0,1,36,37,2.7,Nearest
5780,February,2020,Cape May,NJ,Passenger,0,1,1,13,14,7.14,Furthest
5781,February,2020,Hudson,NJ,Passenger,1,0,1,39,40,2.5,Furthest
5782,February,2020,Douglas,WA,Passenger,69,40,109,28271,28380,0.38,Washington
5783,February,2020,Grant,WA,Passenger,58,70,128,65569,65697,0.19,Washington
5784,February,2020,Brevard,FL,Passenger,0,1,1,88,89,1.12,Furthest
5785,February,2020,Maricopa,AZ,Passenger,8,6,14,1474,1488,0.94,Nearest
5786,February,2020,Kern,CA,Passenger,0,1,1,223,224,0.45,Nearest
5787,February,2020,Spokane,WA,Truck,1,0,1,97160,97161,0.0,Washington
5788,February,2020,Wahkiakum,WA,Truck,0,0,0,1762,1762,0.0,Washington
5789,February,2020,Montgomery,TX,Passenger,1,0,1,52,53,1.89,Mid-Distance
5790,February,2020,Tuolumne,CA,Passenger,0,1,1,10,11,9.09,Nearest
5791,February,2020,Travis,TX,Passenger,2,1,3,187,190,1.58,Mid-Distance
5792,February,2020,Grays Harbor,WA,Passenger,109,108,217,48374,48591,0.45,Washington
5793,February,2020,Ada,ID,Passenger,0,1,1,287,288,0.35,Nearest
5794,February,2020,Yakima,WA,Passenger,122,116,238,165956,166194,0.14,Washington
5795,February,2020,Lewis,WA,Truck,0,0,0,26101,26101,0.0,Washington
5796,February,2020,Pierce,WA,Truck,0,0,0,141517,141517,0.0,Washington
5797,February,2020,Clark,NV,Passenger,3,2,5,685,690,0.72,Nearest
5798,February,2020,Rockingham,NH,Passenger,1,0,1,28,29,3.45,Furthest
5799,February,2020,Suffolk,VA,Passenger,1,0,1,124,125,0.8,Furthest
5800,February,2020,Ferry,WA,Truck,0,0,0,3582,3582,0.0,Washington
5801,February,2020,Duval,FL,Passenger,1,2,3,365,368,0.82,Furthest
5802,February,2020,Richland,SC,Passenger,0,1,1,159,160,0.62,Furthest
5803,February,2020,Walla Walla,WA,Truck,0,0,0,13701,13701,0.0,Washington
5804,February,2020,Washoe,NV,Passenger,1,0,1,109,110,0.91,Nearest
5805,February,2020,Anne Arundel,MD,Passenger,1,2,3,424,427,0.7,Furthest
5806,February,2020,Cascade,MT,Passenger,0,1,1,55,56,1.79,Nearest
5807,February,2020,San Juan,WA,Passenger,279,82,361,14330,14691,2.46,Washington
5808,February,2020,St. Mary's,MD,Passenger,1,0,1,216,217,0.46,Furthest
5809,February,2020,Harris,TX,Passenger,1,0,1,237,238,0.42,Mid-Distance
5810,February,2020,Clallam,WA,Truck,1,0,1,21839,21840,0.0,Washington
5811,February,2020,Klickitat,WA,Passenger,49,41,90,15686,15776,0.57,Washington
5812,February,2020,King,WA,Truck,6,1,7,182612,182619,0.0,Washington
5813,February,2020,Fairbanks North Star,AK,Passenger,0,1,1,99,100,1.0,Nearest
5814,February,2020,Lake,FL,Passenger,1,0,1,21,22,4.55,Furthest
5815,February,2020,King,WA,Passenger,23446,7675,31121,1400298,1431419,2.17,Washington
5816,February,2020,Ulster,NY,Passenger,1,0,1,8,9,11.11,Furthest
5817,February,2020,Nassau,NY,Passenger,4,0,4,38,42,9.52,Furthest
5818,February,2020,Houston,GA,Passenger,1,0,1,58,59,1.69,Furthest
5819,February,2020,Pacific,WA,Passenger,30,32,62,16071,16133,0.38,Washington
5820,February,2020,Ramsey,MN,Passenger,1,0,1,40,41,2.44,Mid-Distance
5821,February,2020,Stevens,WA,Truck,0,0,0,18756,18756,0.0,Washington
5822,February,2020,Island,WA,Passenger,401,263,664,63475,64139,1.04,Washington
5823,February,2020,Arlington,VA,Passenger,0,2,2,154,156,1.28,Furthest
5824,February,2020,Mason,WA,Truck,0,0,0,20602,20602,0.0,Washington
5825,February,2020,Carson City,NV,Passenger,1,0,1,10,11,9.09,Nearest
5826,February,2020,Lincoln,WA,Truck,0,0,0,4658,4658,0.0,Washington
5827,February,2020,Whatcom,WA,Truck,3,0,3,43146,43149,0.01,Washington
5828,February,2020,Tulsa,OK,Passenger,1,1,2,48,50,4.0,Mid-Distance
5829,February,2020,Oldham,KY,Passenger,0,1,1,4,5,20.0,Furthest
5830,February,2020,Solano,CA,Passenger,1,0,1,211,212,0.47,Nearest
5831,February,2020,Adams,WA,Truck,0,0,0,5221,5221,0.0,Washington
5832,February,2020,New London,CT,Passenger,0,2,2,250,252,0.79,Furthest
5833,February,2020,Flathead,MT,Passenger,1,0,1,63,64,1.56,Nearest
5834,February,2020,Thurston,WA,Truck,0,0,0,55720,55720,0.0,Washington
5835,February,2020,Kittitas,WA,Passenger,94,49,143,30014,30157,0.47,Washington
5836,February,2020,St. Clair,IL,Passenger,1,0,1,141,142,0.7,Mid-Distance
5837,February,2020,Clackamas,OR,Passenger,2,1,3,214,217,1.38,Nearest
5838,February,2020,Wahkiakum,WA,Passenger,5,5,10,3017,3027,0.33,Washington
5839,February,2020,Pend Oreille,WA,Truck,0,0,0,5763,5763,0.0,Washington
5840,February,2020,Collin,TX,Passenger,1,1,2,129,131,1.53,Mid-Distance
5841,February,2020,Ferry,WA,Passenger,5,2,7,4373,4380,0.16,Washington
5842,February,2020,Powhatan,VA,Passenger,1,0,1,0,1,100.0,Furthest
5843,February,2020,Howard,MD,Passenger,0,1,1,71,72,1.39,Furthest
5844,February,2020,Yakima,WA,Truck,0,0,0,59625,59625,0.0,Washington
5845,February,2020,Alameda,CA,Passenger,3,1,4,282,286,1.4,Nearest
5846,February,2020,Putnam,TN,Passenger,0,1,1,3,4,25.0,Furthest
5847,February,2020,Shelby,OH,Passenger,0,1,1,1,2,50.0,Furthest
5848,February,2020,Palm Beach,FL,Passenger,0,1,1,84,85,1.18,Furthest
5849,February,2020,Bexar,TX,Passenger,2,5,7,635,642,1.09,Mid-Distance
5850,February,2020,San Juan,WA,Truck,0,0,0,5925,5925,0.0,Washington
5851,February,2020,Whitman,WA,Passenger,42,48,90,22621,22711,0.4,Washington
5852,February,2020,Columbia,WA,Passenger,3,3,6,2433,2439,0.25,Washington
5853,February,2020,Virginia Beach,VA,Passenger,1,0,1,690,691,0.14,Furthest
5854,February,2020,Adams,WA,Passenger,7,7,14,12913,12927,0.11,Washington
5855,February,2020,Island,WA,Truck,1,0,1,21333,21334,0.0,Washington
5856,February,2020,Benton,WA,Passenger,338,320,658,135315,135973,0.48,Washington
5857,February,2020,Kent,MI,Passenger,0,1,1,23,24,4.17,Furthest
5858,February,2020,Penobscot,ME,Passenger,0,1,1,15,16,6.25,Furthest
5859,February,2020,Stevens,WA,Passenger,33,33,66,31445,31511,0.21,Washington
5860,February,2020,Nueces,TX,Passenger,1,0,1,83,84,1.19,Mid-Distance
5861,February,2020,Douglas,WA,Truck,0,0,0,12320,12320,0.0,Washington
5862,February,2020,Charleston,SC,Passenger,1,0,1,106,107,0.93,Furthest
5863,February,2020,Pima,AZ,Passenger,3,1,4,364,368,1.09,Nearest
5864,February,2020,DeKalb,IN,Passenger,1,0,1,1,2,50.0,Furthest
5865,February,2020,Columbia,WA,Truck,0,0,0,1535,1535,0.0,Washington
5866,February,2020,Thurston,WA,Passenger,1109,725,1834,198984,200818,0.91,Washington
5867,February,2020,Snohomish,WA,Truck,0,0,0,123728,123728,0.0,Washington
5868,February,2020,Middlesex,MA,Passenger,1,1,2,101,103,1.94,Furthest
5869,February,2020,Suffolk,MA,Passenger,0,1,1,38,39,2.56,Furthest
5870,February,2020,Chelan,WA,Truck,0,0,0,22573,22573,0.0,Washington
5871,February,2020,Shelby,TN,Passenger,0,1,1,93,94,1.06,Furthest
5872,February,2020,Benton,WA,Truck,0,0,0,42572,42572,0.0,Washington
5873,February,2020,Valencia,NM,Passenger,1,0,1,5,6,16.67,Mid-Distance
5874,February,2020,Deschutes,OR,Passenger,3,0,3,140,143,2.1,Nearest
5875,February,2020,Dallas,TX,Passenger,1,0,1,201,202,0.5,Mid-Distance
5876,February,2020,New Haven,CT,Passenger,0,2,2,43,45,4.44,Furthest
5877,February,2020,Cochise,AZ,Passenger,0,1,1,102,103,0.97,Nearest
5878,February,2020,Santa Clara,CA,Passenger,7,2,9,334,343,2.62,Nearest
5879,February,2020,Richmond,GA,Passenger,0,1,1,89,90,1.11,Furthest
5880,February,2020,Montgomery,OH,Passenger,0,1,1,48,49,2.04,Furthest
5881,February,2020,Harnett,NC,Passenger,1,1,2,207,209,0.96,Furthest
5882,February,2020,Walla Walla,WA,Passenger,68,62,130,36314,36444,0.36,Washington
5883,February,2020,Jefferson,NY,Passenger,0,1,1,218,219,0.46,Furthest
5884,February,2020,Los Angeles,CA,Passenger,8,11,19,1039,1058,1.8,Nearest
5885,February,2020,Norfolk,VA,Passenger,2,2,4,352,356,1.12,Furthest
5886,February,2020,El Paso,CO,Passenger,2,0,2,734,736,0.27,Mid-Distance
5887,February,2020,Larimer,CO,Passenger,1,0,1,54,55,1.82,Mid-Distance
5888,February,2020,Pacific,WA,Truck,0,0,0,7745,7745,0.0,Washington
5889,February,2020,Chesapeake,VA,Passenger,0,2,2,432,434,0.46,Furthest
5890,February,2020,Twin Falls,ID,Passenger,0,1,1,29,30,3.33,Nearest
5891,February,2020,Wayne,MI,Passenger,0,1,1,58,59,1.69,Furthest
5892,February,2020,Whatcom,WA,Passenger,1042,486,1528,151612,153140,1.0,Washington
5893,February,2020,Kitsap,WA,Passenger,1273,661,1934,182316,184250,1.05,Washington
5894,February,2020,Sumter,FL,Passenger,0,1,1,9,10,10.0,Furthest
5895,February,2020,Monroe,IL,Passenger,1,0,1,4,5,20.0,Mid-Distance
5896,February,2020,Franklin,WA,Passenger,58,76,134,61129,61263,0.22,Washington
5897,February,2020,Rogers,OK,Passenger,1,0,1,5,6,16.67,Mid-Distance
5898,February,2020,Multnomah,OR,Passenger,4,7,11,733,744,1.48,Nearest
5899,February,2020,Frederick,MD,Passenger,1,1,2,81,83,2.41,Furthest
5900,February,2020,Loudoun,VA,Passenger,1,0,1,90,91,1.1,Furthest
5901,February,2020,Wilson,TX,Passenger,0,1,1,7,8,12.5,Mid-Distance
5902,February,2020,Asotin,WA,Passenger,16,11,27,12671,12698,0.21,Washington
5903,February,2020,Montgomery,AL,Passenger,0,1,1,39,40,2.5,Furthest
5904,February,2020,San Francisco,CA,Passenger,2,1,3,100,103,2.91,Nearest
5905,February,2020,Sarasota,FL,Passenger,2,0,2,27,29,6.9,Furthest
5906,February,2020,Kootenai,ID,Passenger,1,1,2,229,231,0.87,Nearest
5907,February,2020,Prince William,VA,Passenger,2,3,5,232,237,2.11,Furthest
5908,February,2020,Chelan,WA,Passenger,216,78,294,54606,54900,0.54,Washington
5909,February,2020,Snohomish,WA,Passenger,4302,1729,6031,538151,544182,1.11,Washington
5910,February,2020,Jefferson,WA,Truck,0,0,0,9642,9642,0.0,Washington
5911,February,2020,Calvert,MD,Passenger,0,2,2,90,92,2.17,Furthest
5912,February,2020,Santa Rosa,FL,Passenger,1,0,1,85,86,1.16,Furthest
5913,February,2020,Clallam,WA,Passenger,206,163,369,50804,51173,0.72,Washington
5914,February,2020,Pinellas,FL,Passenger,1,1,2,110,112,1.79,Furthest
5916,February,2020,Hawaii,HI,Passenger,1,0,1,61,62,1.61,Nearest
5917,February,2020,Kittitas,WA,Truck,0,0,0,14649,14649,0.0,Washington
5918,February,2020,Carroll,NH,Passenger,0,1,1,4,5,20.0,Furthest
5919,February,2020,Montgomery,PA,Passenger,2,0,2,35,37,5.41,Furthest
5920,February,2020,Skamania,WA,Passenger,28,19,47,8773,8820,0.53,Washington
5921,January,2017,Collier,FL,Passenger,0,1,1,22,23,4.35,Furthest
5922,January,2017,Portsmouth,VA,Passenger,0,1,1,65,66,1.52,Furthest
5923,January,2017,Monroe,NY,Passenger,1,0,1,30,31,3.23,Furthest
5924,January,2017,Garfield,WA,Truck,0,0,0,941,941,0.0,Washington
5925,January,2017,Lane,OR,Passenger,0,1,1,291,292,0.34,Nearest
5926,January,2017,Sumter,FL,Passenger,0,1,1,10,11,9.09,Furthest
5927,January,2017,Skagit,WA,Truck,1,0,1,31404,31405,0.0,Washington
5928,January,2017,Anne Arundel,MD,Passenger,0,1,1,515,516,0.19,Furthest
5929,January,2017,Dane,WI,Passenger,1,0,1,192,193,0.52,Mid-Distance
5930,January,2017,Saratoga,NY,Passenger,1,1,2,79,81,2.47,Furthest
5931,January,2017,Adams,WA,Passenger,1,1,2,12175,12177,0.02,Washington
5932,January,2017,Skamania,WA,Truck,0,0,0,3908,3908,0.0,Washington
5933,January,2017,Kitsap,WA,Passenger,556,262,818,172401,173219,0.47,Washington
5934,January,2017,Los Angeles,CA,Passenger,3,1,4,1470,1474,0.27,Nearest
5935,January,2017,Guilford,NC,Passenger,1,0,1,34,35,2.86,Furthest
5936,January,2017,Cape May,NJ,Passenger,0,1,1,19,20,5.0,Furthest
5937,January,2017,Thurston,WA,Truck,0,0,0,53340,53340,0.0,Washington
5938,January,2017,Yakima,WA,Passenger,36,49,85,159930,160015,0.05,Washington
5939,January,2017,Pend Oreille,WA,Truck,0,0,0,5595,5595,0.0,Washington
5940,January,2017,Brown,WI,Passenger,1,0,1,46,47,2.13,Mid-Distance
5941,January,2017,Kitsap,WA,Truck,1,0,1,52380,52381,0.0,Washington
5942,January,2017,Cowlitz,WA,Passenger,51,44,95,69109,69204,0.14,Washington
5943,January,2017,Grant,WA,Truck,0,0,0,25039,25039,0.0,Washington
5944,January,2017,Utah,UT,Passenger,0,1,1,195,196,0.51,Nearest
5945,January,2017,Whitman,WA,Passenger,8,19,27,21936,21963,0.12,Washington
5946,January,2017,Santa Clara,CA,Passenger,5,3,8,460,468,1.71,Nearest
5947,January,2017,Douglas,WA,Truck,0,0,0,11426,11426,0.0,Washington
5948,January,2017,Monterey,CA,Passenger,0,1,1,232,233,0.43,Nearest
5949,January,2017,Durham,NC,Passenger,0,1,1,38,39,2.56,Furthest
5950,January,2017,Columbia,WA,Passenger,0,1,1,2331,2332,0.04,Washington
5951,January,2017,DeKalb,GA,Passenger,1,0,1,91,92,1.09,Furthest
5952,January,2017,Carroll,NH,Passenger,0,1,1,0,1,100.0,Furthest
5953,January,2017,Yakima,WA,Truck,0,0,0,57337,57337,0.0,Washington
5954,January,2017,Stevens,WA,Truck,0,0,0,18341,18341,0.0,Washington
5955,January,2017,Clark,WA,Truck,0,0,0,77522,77522,0.0,Washington
5956,January,2017,El Paso,CO,Passenger,1,1,2,884,886,0.23,Mid-Distance
5957,January,2017,Clark,WA,Passenger,673,426,1099,297819,298918,0.37,Washington
5958,January,2017,Wayne,MI,Passenger,0,2,2,77,79,2.53,Furthest
5959,January,2017,Maricopa,AZ,Passenger,3,0,3,1977,1980,0.15,Nearest
5960,January,2017,Chelan,WA,Passenger,54,28,82,51898,51980,0.16,Washington
5961,January,2017,Pend Oreille,WA,Passenger,1,4,5,9345,9350,0.05,Washington
5962,January,2017,Hardin,KY,Passenger,0,1,1,127,128,0.78,Furthest
5963,January,2017,Loudoun,VA,Passenger,0,1,1,86,87,1.15,Furthest
5964,January,2017,Lincoln,WA,Truck,0,0,0,4462,4462,0.0,Washington
5965,January,2017,Skamania,WA,Passenger,7,7,14,8549,8563,0.16,Washington
5966,January,2017,Mason,WA,Passenger,48,60,108,42807,42915,0.25,Washington
5967,January,2017,Lincoln,WA,Passenger,2,4,6,7543,7549,0.08,Washington
5968,January,2017,Clallam,WA,Truck,0,0,0,21044,21044,0.0,Washington
5969,January,2017,Bexar,TX,Passenger,3,3,6,1255,1261,0.48,Mid-Distance
5970,January,2017,Ferry,WA,Passenger,2,1,3,4386,4389,0.07,Washington
5971,January,2017,Clackamas,OR,Passenger,1,2,3,426,429,0.7,Nearest
5972,January,2017,Alameda,CA,Passenger,6,1,7,399,406,1.72,Nearest
5973,January,2017,Cowlitz,WA,Truck,0,0,0,27949,27949,0.0,Washington
5974,January,2017,Deschutes,OR,Passenger,1,1,2,238,240,0.83,Nearest
5975,January,2017,Hamilton,IN,Passenger,1,0,1,73,74,1.35,Furthest
5976,January,2017,Franklin,MA,Passenger,0,1,1,5,6,16.67,Furthest
5977,January,2017,Walla Walla,WA,Passenger,16,21,37,34864,34901,0.11,Washington
5978,January,2017,Benton,WA,Passenger,129,129,258,127860,128118,0.2,Washington
5979,January,2017,Lewis,NY,Passenger,0,1,1,10,11,9.09,Furthest
5980,January,2017,Lewis,WA,Truck,0,0,0,24791,24791,0.0,Washington
5981,January,2017,Klickitat,WA,Truck,0,0,0,7945,7945,0.0,Washington
5982,January,2017,Fairfax,VA,Passenger,2,2,4,885,889,0.45,Furthest
5983,January,2017,Clark,NV,Passenger,1,4,5,930,935,0.53,Nearest
5984,January,2017,Cascade,MT,Passenger,0,1,1,62,63,1.59,Nearest
5985,January,2017,Asotin,WA,Passenger,4,3,7,12319,12326,0.06,Washington
5986,January,2017,Gwinnett,GA,Passenger,0,1,1,94,95,1.05,Furthest
5987,January,2017,New London,CT,Passenger,2,1,3,271,274,1.09,Furthest
5988,January,2017,Douglas,WA,Passenger,29,19,48,26580,26628,0.18,Washington
5989,January,2017,Orleans,LA,Passenger,0,1,1,52,53,1.89,Mid-Distance
5990,January,2017,Middlesex,MA,Passenger,1,0,1,161,162,0.62,Furthest
5991,January,2017,Shoshone,ID,Passenger,0,1,1,99,100,1.0,Nearest
5992,January,2017,Polk,FL,Passenger,1,0,1,64,65,1.54,Furthest
5993,January,2017,Morris,NJ,Passenger,1,0,1,23,24,4.17,Furthest
5994,January,2017,Santa Fe,NM,Passenger,0,1,1,44,45,2.22,Mid-Distance
5995,January,2017,DeKalb,IN,Passenger,1,0,1,1,2,50.0,Furthest
5996,January,2017,Juneau,AK,Passenger,0,1,1,58,59,1.69,Nearest
5997,January,2017,Pierce,WA,Passenger,822,751,1573,528314,529887,0.3,Washington
5998,January,2017,Okanogan,WA,Passenger,3,15,18,25814,25832,0.07,Washington
5999,January,2017,Arlington,VA,Passenger,1,1,2,176,178,1.12,Furthest
6000,January,2017,Thurston,WA,Passenger,336,299,635,184964,185599,0.34,Washington
6001,January,2017,Montgomery,MD,Passenger,1,0,1,312,313,0.32,Furthest
6002,January,2017,Hamilton,TN,Passenger,1,0,1,28,29,3.45,Furthest
6003,January,2017,Manassas,VA,Passenger,0,1,1,8,9,11.11,Furthest
6004,January,2017,King,WA,Truck,8,1,9,191085,191094,0.0,Washington
6005,January,2017,Spokane,WA,Truck,1,0,1,90429,90430,0.0,Washington
6006,January,2017,Douglas,OR,Passenger,0,1,1,90,91,1.1,Nearest
6007,January,2017,Walla Walla,WA,Truck,0,0,0,13168,13168,0.0,Washington
6008,January,2017,Lee,AL,Passenger,1,0,1,36,37,2.7,Furthest
6009,January,2017,Jefferson,WA,Truck,0,0,0,9469,9469,0.0,Washington
6010,January,2017,Pacific,WA,Passenger,5,6,11,15034,15045,0.07,Washington
6011,January,2017,New Haven,CT,Passenger,0,1,1,66,67,1.49,Furthest
6012,January,2017,Jackson,MO,Passenger,1,0,1,75,76,1.32,Furthest
6013,January,2017,Cobb,GA,Passenger,0,1,1,82,83,1.2,Furthest
6014,January,2017,Allegheny,PA,Passenger,1,0,1,94,95,1.05,Furthest
6015,January,2017,Jefferson,NY,Passenger,1,1,2,250,252,0.79,Furthest
6016,January,2017,San Mateo,CA,Passenger,0,1,1,177,178,0.56,Nearest
6017,January,2017,Franklin,WA,Passenger,27,42,69,55402,55471,0.12,Washington
6018,January,2017,Adams,WA,Truck,0,0,0,5077,5077,0.0,Washington
6019,January,2017,Spokane,WA,Passenger,221,196,417,296020,296437,0.14,Washington
6020,January,2017,Grant,WA,Passenger,16,21,37,60386,60423,0.06,Washington
6021,January,2017,Marion,FL,Passenger,1,0,1,26,27,3.7,Furthest
6022,January,2017,Okaloosa,FL,Passenger,1,0,1,189,190,0.53,Furthest
6023,January,2017,Snohomish,WA,Truck,1,0,1,122825,122826,0.0,Washington
6024,January,2017,Stevens,WA,Passenger,6,21,27,31528,31555,0.09,Washington
6025,January,2017,Multnomah,OR,Passenger,0,3,3,1282,1285,0.23,Nearest
6026,January,2017,Skagit,WA,Passenger,106,81,187,87447,87634,0.21,Washington
6027,January,2017,Ferry,WA,Truck,0,0,0,3581,3581,0.0,Washington
6028,January,2017,Orange,CA,Passenger,2,1,3,704,707,0.42,Nearest
6029,January,2017,Salt Lake,UT,Passenger,0,1,1,358,359,0.28,Nearest
6030,January,2017,San Juan,WA,Truck,0,0,0,5594,5594,0.0,Washington
6031,January,2017,Shelby,TN,Passenger,0,1,1,113,114,0.88,Furthest
6032,January,2017,Travis,TX,Passenger,0,1,1,213,214,0.47,Mid-Distance
6033,January,2017,Norfolk,MA,Passenger,1,0,1,39,40,2.5,Furthest
6034,January,2017,Kittitas,WA,Passenger,15,16,31,27158,27189,0.11,Washington
6035,January,2017,Orange,FL,Passenger,0,1,1,159,160,0.62,Furthest
6036,January,2017,Pinal,AZ,Passenger,2,0,2,281,283,0.71,Nearest
6037,January,2017,Asotin,WA,Truck,0,0,0,6487,6487,0.0,Washington
6038,January,2017,Northampton,PA,Passenger,2,0,2,259,261,0.77,Furthest
6039,January,2017,Essex,NJ,Passenger,1,0,1,16,17,5.88,Furthest
6040,January,2017,Pacific,WA,Truck,0,0,0,7509,7509,0.0,Washington
6041,January,2017,Honolulu,HI,Passenger,4,2,6,663,669,0.9,Nearest
6042,January,2017,Hidalgo,TX,Passenger,0,1,1,98,99,1.01,Mid-Distance
6043,January,2017,St. Lucie,FL,Passenger,1,0,1,32,33,3.03,Furthest
6044,January,2017,Prince George's,MD,Passenger,0,1,1,189,190,0.53,Furthest
6045,January,2017,Richmond,GA,Passenger,0,1,1,103,104,0.96,Furthest
6046,January,2017,Prince William,VA,Passenger,0,3,3,281,284,1.06,Furthest
6047,January,2017,San Diego,CA,Passenger,4,2,6,2895,2901,0.21,Nearest
6048,January,2017,Santa Barbara,CA,Passenger,0,1,1,133,134,0.75,Nearest
6049,January,2017,Norfolk,VA,Passenger,1,1,2,305,307,0.65,Furthest
6050,January,2017,Latah,ID,Passenger,0,1,1,142,143,0.7,Nearest
6051,January,2017,Pierce,WA,Truck,0,0,0,138768,138768,0.0,Washington
6052,January,2017,Oklahoma,OK,Passenger,0,1,1,211,212,0.47,Mid-Distance
6053,January,2017,Muscogee,GA,Passenger,0,1,1,265,266,0.38,Furthest
6054,January,2017,Klickitat,WA,Passenger,20,22,42,14793,14835,0.28,Washington
6055,January,2017,Hood River,OR,Passenger,1,0,1,43,44,2.27,Nearest
6056,January,2017,King,WA,Passenger,8804,3621,12425,1387384,1399809,0.89,Washington
6057,January,2017,Clallam,WA,Passenger,73,64,137,48005,48142,0.28,Washington
6058,January,2017,Grays Harbor,WA,Passenger,27,24,51,44315,44366,0.11,Washington
6059,January,2017,Harnett,NC,Passenger,1,0,1,269,270,0.37,Furthest
6060,January,2017,Columbia,WA,Truck,0,0,0,1543,1543,0.0,Washington
6061,January,2017,Dale,AL,Passenger,0,1,1,67,68,1.47,Furthest
6062,January,2017,El Paso,TX,Passenger,0,1,1,593,594,0.17,Mid-Distance
6063,January,2017,Cumberland,NC,Passenger,1,0,1,636,637,0.16,Furthest
6064,January,2017,Yavapai,AZ,Passenger,1,0,1,85,86,1.16,Nearest
6065,January,2017,Whitman,WA,Truck,0,0,0,8403,8403,0.0,Washington
6066,January,2017,Manatee,FL,Passenger,1,0,1,59,60,1.67,Furthest
6067,January,2017,Island,WA,Truck,1,0,1,20520,20521,0.0,Washington
6068,January,2017,Lake,IL,Passenger,1,0,1,187,188,0.53,Mid-Distance
6069,January,2017,Whatcom,WA,Passenger,383,141,524,141886,142410,0.37,Washington
6070,January,2017,Hawaii,HI,Passenger,1,0,1,90,91,1.1,Nearest
6071,January,2017,Whatcom,WA,Truck,2,0,2,41337,41339,0.0,Washington
6072,January,2017,Island,WA,Passenger,103,119,222,59416,59638,0.37,Washington
6073,January,2017,Maui,HI,Passenger,1,0,1,82,83,1.2,Nearest
6074,January,2017,Mason,WA,Truck,0,0,0,19187,19187,0.0,Washington
6075,January,2017,Charles,MD,Passenger,0,1,1,89,90,1.11,Furthest
6076,January,2017,Kittitas,WA,Truck,0,0,0,13412,13412,0.0,Washington
6077,January,2017,Madison,ID,Passenger,1,0,1,48,49,2.04,Nearest
6078,January,2017,Dallas,TX,Passenger,1,0,1,230,231,0.43,Mid-Distance
6079,January,2017,Garfield,WA,Passenger,0,0,0,1285,1285,0.0,Washington
6080,January,2017,Chelan,WA,Truck,0,0,0,21262,21262,0.0,Washington
6081,January,2017,District of Columbia,DC,Passenger,0,3,3,238,241,1.24,Furthest
6082,January,2017,Benton,WA,Truck,0,0,0,39813,39813,0.0,Washington
6083,January,2017,Bergen,NJ,Passenger,0,2,2,33,35,5.71,Furthest
6084,January,2017,Marion,OR,Passenger,1,0,1,238,239,0.42,Nearest
6086,January,2017,Duval,FL,Passenger,1,1,2,379,381,0.52,Furthest
6087,January,2017,Lewis,WA,Passenger,43,30,73,54960,55033,0.13,Washington
6088,January,2017,Nantucket,MA,Passenger,1,0,1,3,4,25.0,Furthest
6089,January,2017,Union,OH,Passenger,1,0,1,4,5,20.0,Furthest
6090,January,2017,Okanogan,WA,Truck,0,0,0,16374,16374,0.0,Washington
6091,January,2017,Riverside,CA,Passenger,1,1,2,888,890,0.22,Nearest
6092,January,2017,Tulare,CA,Passenger,1,0,1,203,204,0.49,Nearest
6093,January,2017,Moore,NC,Passenger,0,1,1,210,211,0.47,Furthest
6094,January,2017,Pima,AZ,Passenger,0,2,2,468,470,0.43,Nearest
6095,January,2017,Montgomery,TN,Passenger,1,0,1,307,308,0.32,Furthest
6096,January,2017,Contra Costa,CA,Passenger,1,0,1,683,684,0.15,Nearest
6097,January,2017,Canyon,ID,Passenger,0,1,1,118,119,0.84,Nearest
6098,January,2017,Jefferson,WA,Passenger,87,53,140,23606,23746,0.59,Washington
6099,January,2017,Howard,MD,Passenger,0,2,2,90,92,2.17,Furthest
6100,January,2017,Grays Harbor,WA,Truck,0,0,0,19862,19862,0.0,Washington
6101,January,2017,Virginia Beach,VA,Passenger,2,1,3,658,661,0.45,Furthest
6102,January,2017,Ventura,CA,Passenger,0,2,2,392,394,0.51,Nearest
6103,January,2017,St. Mary's,MD,Passenger,0,1,1,205,206,0.49,Furthest
6104,January,2017,Fulton,GA,Passenger,1,2,3,136,139,2.16,Furthest
6105,January,2017,San Juan,WA,Passenger,84,31,115,13348,13463,0.85,Washington
6106,January,2017,Franklin,WA,Truck,0,0,0,17912,17912,0.0,Washington
6107,January,2017,Marin,CA,Passenger,1,0,1,57,58,1.72,Nearest
6108,January,2017,Wahkiakum,WA,Passenger,0,1,1,2861,2862,0.03,Washington
6109,January,2017,Snohomish,WA,Passenger,1549,803,2352,514965,517317,0.45,Washington
6110,January,2017,Wahkiakum,WA,Truck,0,0,0,1624,1624,0.0,Washington
6111,January,2017,Volusia,FL,Passenger,0,1,1,49,50,2.0,Furthest
6112,January,2017,Tarrant,TX,Passenger,0,2,2,333,335,0.6,Mid-Distance
6113,January,2017,Dakota,MN,Passenger,0,1,1,46,47,2.13,Mid-Distance
6114,January,2018,Polk,FL,Passenger,1,0,1,62,63,1.59,Furthest
6115,January,2018,Garfield,WA,Truck,0,0,0,945,945,0.0,Washington
6116,January,2018,Walla Walla,WA,Truck,0,0,0,13323,13323,0.0,Washington
6117,January,2018,Klickitat,WA,Truck,0,0,0,8000,8000,0.0,Washington
6118,January,2018,Palm Beach,FL,Passenger,0,1,1,87,88,1.14,Furthest
6119,January,2018,Canyon,ID,Passenger,0,1,1,95,96,1.04,Nearest
6120,January,2018,Fairfax,VA,Passenger,2,2,4,821,825,0.48,Furthest
6121,January,2018,Hardin,KY,Passenger,0,1,1,118,119,0.84,Furthest
6122,January,2018,Multnomah,OR,Passenger,3,4,7,845,852,0.82,Nearest
6123,January,2018,Spokane,WA,Passenger,300,255,555,300795,301350,0.18,Washington
6124,January,2018,Clark,WA,Truck,0,0,0,78578,78578,0.0,Washington
6125,January,2018,Cowlitz,WA,Passenger,54,69,123,70972,71095,0.17,Washington
6126,January,2018,Franklin,WA,Passenger,31,51,82,57013,57095,0.14,Washington
6127,January,2018,Benton,WA,Passenger,175,179,354,130623,130977,0.27,Washington
6128,January,2018,Pinal,AZ,Passenger,2,0,2,210,212,0.94,Nearest
6129,January,2018,Jefferson,NY,Passenger,1,0,1,228,229,0.44,Furthest
6130,January,2018,Skamania,WA,Passenger,11,8,19,8608,8627,0.22,Washington
6131,January,2018,Okaloosa,FL,Passenger,1,0,1,179,180,0.56,Furthest
6132,January,2018,Franklin,MA,Passenger,0,1,1,3,4,25.0,Furthest
6133,January,2018,District of Columbia,DC,Passenger,0,3,3,198,201,1.49,Furthest
6134,January,2018,King,WA,Passenger,11619,4878,16497,1370831,1387328,1.19,Washington
6135,January,2018,El Paso,CO,Passenger,2,0,2,762,764,0.26,Mid-Distance
6136,January,2018,Grant,WA,Truck,0,0,0,25641,25641,0.0,Washington
6137,January,2018,Pend Oreille,WA,Passenger,4,4,8,9441,9449,0.08,Washington
6138,January,2018,Mason,WA,Truck,0,0,0,19646,19646,0.0,Washington
6139,January,2018,Tuolumne,CA,Passenger,0,1,1,14,15,6.67,Nearest
6140,January,2018,Shelby,TN,Passenger,0,1,1,104,105,0.95,Furthest
6141,January,2018,Garfield,WA,Passenger,1,0,1,1329,1330,0.08,Washington
6142,January,2018,Snohomish,WA,Passenger,2073,1094,3167,518066,521233,0.61,Washington
6143,January,2018,Kittitas,WA,Passenger,36,27,63,28637,28700,0.22,Washington
6144,January,2018,Clark,NV,Passenger,1,2,3,746,749,0.4,Nearest
6145,January,2018,Carroll,NH,Passenger,0,1,1,1,2,50.0,Furthest
6146,January,2018,Pierce,WA,Passenger,1095,996,2091,527421,529512,0.39,Washington
6147,January,2018,Lewis,WA,Passenger,52,43,95,56805,56900,0.17,Washington
6148,January,2018,Volusia,FL,Passenger,0,1,1,34,35,2.86,Furthest
6149,January,2018,Santa Rosa,FL,Passenger,1,0,1,102,103,0.97,Furthest
6150,January,2018,Essex,NJ,Passenger,1,0,1,10,11,9.09,Furthest
6151,January,2018,Richmond,GA,Passenger,0,1,1,93,94,1.06,Furthest
6152,January,2018,Sumter,FL,Passenger,0,1,1,10,11,9.09,Furthest
6153,January,2018,Santa Fe,NM,Passenger,0,1,1,44,45,2.22,Mid-Distance
6154,January,2018,Manassas,VA,Passenger,0,1,1,9,10,10.0,Furthest
6155,January,2018,Orleans,LA,Passenger,0,1,1,46,47,2.13,Mid-Distance
6156,January,2018,Travis,TX,Passenger,0,1,1,185,186,0.54,Mid-Distance
6157,January,2018,Cook,IL,Passenger,1,0,1,284,285,0.35,Mid-Distance
6158,January,2018,Kitsap,WA,Truck,1,0,1,52751,52752,0.0,Washington
6159,January,2018,Morris,NJ,Passenger,1,0,1,20,21,4.76,Furthest
6161,January,2018,Spokane,WA,Truck,1,0,1,91739,91740,0.0,Washington
6162,January,2018,Pacific,WA,Passenger,15,13,28,15453,15481,0.18,Washington
6163,January,2018,Twin Falls,ID,Passenger,0,1,1,23,24,4.17,Nearest
6164,January,2018,Norfolk,VA,Passenger,1,1,2,316,318,0.63,Furthest
6165,January,2018,Whatcom,WA,Truck,1,0,1,42070,42071,0.0,Washington
6166,January,2018,Bexar,TX,Passenger,1,2,3,813,816,0.37,Mid-Distance
6167,January,2018,Lumpkin,GA,Passenger,1,0,1,7,8,12.5,Furthest
6168,January,2018,Wahkiakum,WA,Passenger,0,2,2,2844,2846,0.07,Washington
6169,January,2018,Dale,AL,Passenger,0,1,1,66,67,1.49,Furthest
6170,January,2018,Chelan,WA,Truck,0,0,0,21676,21676,0.0,Washington
6171,January,2018,Prince George's,MD,Passenger,0,1,1,179,180,0.56,Furthest
6172,January,2018,Jefferson,WA,Passenger,124,80,204,24352,24556,0.83,Washington
6173,January,2018,Monterey,CA,Passenger,0,2,2,195,197,1.02,Nearest
6174,January,2018,Anne Arundel,MD,Passenger,0,1,1,471,472,0.21,Furthest
6175,January,2018,Honolulu,HI,Passenger,2,2,4,555,559,0.72,Nearest
6176,January,2018,Benton,WA,Truck,0,0,0,40708,40708,0.0,Washington
6177,January,2018,St. Clair,IL,Passenger,0,1,1,159,160,0.62,Mid-Distance
6178,January,2018,Skamania,WA,Truck,0,0,0,3900,3900,0.0,Washington
6179,January,2018,Queens,NY,Passenger,1,0,1,62,63,1.59,Furthest
6180,January,2018,Portsmouth,VA,Passenger,0,1,1,71,72,1.39,Furthest
6181,January,2018,Pima,AZ,Passenger,1,1,2,412,414,0.48,Nearest
6182,January,2018,Klickitat,WA,Passenger,23,26,49,14933,14982,0.33,Washington
6183,January,2018,Norfolk,MA,Passenger,1,0,1,36,37,2.7,Furthest
6184,January,2018,Asotin,WA,Passenger,8,5,13,12548,12561,0.1,Washington
6185,January,2018,Lane,OR,Passenger,0,1,1,201,202,0.5,Nearest
6186,January,2018,Nantucket,MA,Passenger,1,0,1,3,4,25.0,Furthest
6187,January,2018,Jefferson,WA,Truck,0,0,0,9485,9485,0.0,Washington
6188,January,2018,Missoula,MT,Passenger,1,0,1,68,69,1.45,Nearest
6189,January,2018,Allegheny,PA,Passenger,1,0,1,83,84,1.19,Furthest
6190,January,2018,Lincoln,WA,Truck,0,0,0,4504,4504,0.0,Washington
6191,January,2018,Stevens,WA,Truck,0,0,0,18391,18391,0.0,Washington
6192,January,2018,Stevens,WA,Passenger,10,22,32,31598,31630,0.1,Washington
6193,January,2018,Northampton,PA,Passenger,0,1,1,65,66,1.52,Furthest
6194,January,2018,Frederick,MD,Passenger,0,1,1,90,91,1.1,Furthest
6195,January,2018,Gwinnett,GA,Passenger,0,1,1,81,82,1.22,Furthest
6196,January,2018,Arlington,VA,Passenger,1,2,3,172,175,1.71,Furthest
6197,January,2018,Okanogan,WA,Passenger,7,19,26,25706,25732,0.1,Washington
6198,January,2018,Marin,CA,Passenger,1,0,1,56,57,1.75,Nearest
6199,January,2018,Asotin,WA,Truck,0,0,0,6559,6559,0.0,Washington
6200,January,2018,Maricopa,AZ,Passenger,2,0,2,1621,1623,0.12,Nearest
6201,January,2018,Franklin,OH,Passenger,0,1,1,110,111,0.9,Furthest
6202,January,2018,Sangamon,IL,Passenger,1,0,1,11,12,8.33,Mid-Distance
6203,January,2018,Santa Clara,CA,Passenger,7,1,8,389,397,2.02,Nearest
6204,January,2018,Thurston,WA,Passenger,487,407,894,190668,191562,0.47,Washington
6205,January,2018,Albemarle,VA,Passenger,0,1,1,30,31,3.23,Furthest
6206,January,2018,Sedgwick,KS,Passenger,0,1,1,106,107,0.93,Mid-Distance
6207,January,2018,Adams,WA,Truck,0,0,0,5148,5148,0.0,Washington
6208,January,2018,Montgomery,TX,Passenger,1,0,1,61,62,1.61,Mid-Distance
6209,January,2018,Manatee,FL,Passenger,1,0,1,39,40,2.5,Furthest
6210,January,2018,Riverside,CA,Passenger,1,2,3,731,734,0.41,Nearest
6211,January,2018,Okanogan,WA,Truck,0,0,0,16333,16333,0.0,Washington
6212,January,2018,Wahkiakum,WA,Truck,0,0,0,1681,1681,0.0,Washington
6213,January,2018,Ferry,WA,Truck,0,0,0,3544,3544,0.0,Washington
6214,January,2018,Skagit,WA,Truck,1,0,1,31840,31841,0.0,Washington
6215,January,2018,Thurston,WA,Truck,0,0,0,53893,53893,0.0,Washington
6216,January,2018,Grays Harbor,WA,Truck,0,0,0,20089,20089,0.0,Washington
6217,January,2018,Richland,SC,Passenger,0,1,1,173,174,0.57,Furthest
6218,January,2018,Alameda,CA,Passenger,0,1,1,358,359,0.28,Nearest
6219,January,2018,New London,CT,Passenger,1,1,2,251,253,0.79,Furthest
6220,January,2018,Kittitas,WA,Truck,0,0,0,13876,13876,0.0,Washington
6221,January,2018,Lewis,WA,Truck,0,0,0,25325,25325,0.0,Washington
6222,January,2018,Ferry,WA,Passenger,1,3,4,4408,4412,0.09,Washington
6223,January,2018,Howard,MD,Passenger,0,2,2,87,89,2.25,Furthest
6224,January,2018,Duval,FL,Passenger,1,2,3,367,370,0.81,Furthest
6225,January,2018,Hamilton,IN,Passenger,1,0,1,53,54,1.85,Furthest
6226,January,2018,Moore,NC,Passenger,0,1,1,199,200,0.5,Furthest
6227,January,2018,Sacramento,CA,Passenger,1,0,1,303,304,0.33,Nearest
6228,January,2018,King,WA,Truck,8,1,9,184806,184815,0.0,Washington
6229,January,2018,San Diego,CA,Passenger,6,1,7,2567,2574,0.27,Nearest
6230,January,2018,Brevard,FL,Passenger,0,1,1,102,103,0.97,Furthest
6231,January,2018,Clark,WA,Passenger,873,599,1472,305301,306773,0.48,Washington
6232,January,2018,Contra Costa,CA,Passenger,0,1,1,469,470,0.21,Nearest
6233,January,2018,Hawaii,HI,Passenger,1,0,1,79,80,1.25,Nearest
6234,January,2018,Adams,WA,Passenger,4,4,8,12443,12451,0.06,Washington
6235,January,2018,New Haven,CT,Passenger,0,1,1,53,54,1.85,Furthest
6236,January,2018,Pend Oreille,WA,Truck,0,0,0,5618,5618,0.0,Washington
6237,January,2018,DeKalb,GA,Passenger,1,0,1,84,85,1.18,Furthest
6238,January,2018,Dakota,MN,Passenger,0,2,2,38,40,5.0,Mid-Distance
6239,January,2018,Grant,WA,Passenger,29,37,66,62283,62349,0.11,Washington
6240,January,2018,Fulton,GA,Passenger,1,0,1,106,107,0.93,Furthest
6241,January,2018,Skagit,WA,Passenger,170,140,310,89781,90091,0.34,Washington
6242,January,2018,Cowlitz,WA,Truck,0,0,0,28201,28201,0.0,Washington
6243,January,2018,Whitman,WA,Passenger,18,20,38,22475,22513,0.17,Washington
6244,January,2018,Walla Walla,WA,Passenger,30,33,63,35373,35436,0.18,Washington
6245,January,2018,Dallas,TX,Passenger,0,1,1,186,187,0.53,Mid-Distance
6246,January,2018,Latah,ID,Passenger,0,1,1,76,77,1.3,Nearest
6247,January,2018,Utah,UT,Passenger,0,1,1,135,136,0.74,Nearest
6248,January,2018,El Paso,TX,Passenger,1,0,1,520,521,0.19,Mid-Distance
6249,January,2018,Flathead,MT,Passenger,1,0,1,52,53,1.89,Nearest
6250,January,2018,Island,WA,Truck,0,0,0,20786,20786,0.0,Washington
6251,January,2018,San Mateo,CA,Passenger,0,1,1,142,143,0.7,Nearest
6252,January,2018,Yakima,WA,Passenger,60,76,136,162512,162648,0.08,Washington
6253,January,2018,Cape May,NJ,Passenger,0,1,1,22,23,4.35,Furthest
6254,January,2018,Mason,WA,Passenger,65,77,142,44977,45119,0.31,Washington
6255,January,2018,Hamilton,TN,Passenger,1,0,1,21,22,4.55,Furthest
6256,January,2018,Douglas,WA,Truck,0,0,0,11790,11790,0.0,Washington
6257,January,2018,Charles,MD,Passenger,0,1,1,82,83,1.2,Furthest
6258,January,2018,Nueces,TX,Passenger,1,1,2,95,97,2.06,Mid-Distance
6259,January,2018,Los Angeles,CA,Passenger,5,3,8,1195,1203,0.67,Nearest
6260,January,2018,Yakima,WA,Truck,0,0,0,58106,58106,0.0,Washington
6261,January,2018,Ventura,CA,Passenger,0,1,1,327,328,0.3,Nearest
6262,January,2018,Montgomery,TN,Passenger,1,0,1,270,271,0.37,Furthest
6263,January,2018,Saratoga,NY,Passenger,1,1,2,68,70,2.86,Furthest
6264,January,2018,Pierce,WA,Truck,0,0,0,137147,137147,0.0,Washington
6265,January,2018,Lincoln,WA,Passenger,2,5,7,7587,7594,0.09,Washington
6266,January,2018,Kitsap,WA,Passenger,706,402,1108,176404,177512,0.62,Washington
6267,January,2018,Snohomish,WA,Truck,1,0,1,121550,121551,0.0,Washington
6268,January,2018,Columbia,WA,Truck,0,0,0,1545,1545,0.0,Washington
6269,January,2018,Grays Harbor,WA,Passenger,42,42,84,45972,46056,0.18,Washington
6270,January,2018,San Juan,WA,Passenger,137,46,183,13927,14110,1.3,Washington
6271,January,2018,DuPage,IL,Passenger,1,0,1,64,65,1.54,Mid-Distance
6272,January,2018,Maui,HI,Passenger,1,0,1,66,67,1.49,Nearest
6273,January,2018,Clay,FL,Passenger,0,1,1,106,107,0.93,Furthest
6274,January,2018,Kent,MI,Passenger,0,1,1,35,36,2.78,Furthest
6275,January,2018,Tarrant,TX,Passenger,1,0,1,224,225,0.44,Mid-Distance
6276,January,2018,Ada,ID,Passenger,0,1,1,348,349,0.29,Nearest
6277,January,2018,Whitman,WA,Truck,0,0,0,8472,8472,0.0,Washington
6278,January,2018,Clallam,WA,Passenger,106,95,201,49281,49482,0.41,Washington
6279,January,2018,Lee,AL,Passenger,1,0,1,35,36,2.78,Furthest
6280,January,2018,Whatcom,WA,Passenger,548,238,786,145510,146296,0.54,Washington
6281,January,2018,Virginia Beach,VA,Passenger,2,1,3,673,676,0.44,Furthest
6282,January,2018,Chelan,WA,Passenger,94,38,132,53236,53368,0.25,Washington
6283,January,2018,Douglas,WA,Passenger,43,33,76,27223,27299,0.28,Washington
6284,January,2018,Orange,CA,Passenger,3,1,4,565,569,0.7,Nearest
6285,January,2018,St. Lucie,FL,Passenger,1,0,1,27,28,3.57,Furthest
6286,January,2018,Prince William,VA,Passenger,0,4,4,268,272,1.47,Furthest
6287,January,2018,Ramsey,MN,Passenger,1,0,1,39,40,2.5,Mid-Distance
6288,January,2018,Clallam,WA,Truck,0,0,0,21280,21280,0.0,Washington
6289,January,2018,Juneau,AK,Passenger,0,1,1,44,45,2.22,Nearest
6290,January,2018,Orange,FL,Passenger,2,1,3,166,169,1.78,Furthest
6291,January,2018,Pacific,WA,Truck,0,0,0,7534,7534,0.0,Washington
6292,January,2018,Nassau,NY,Passenger,1,0,1,37,38,2.63,Furthest
6293,January,2018,Montgomery,MD,Passenger,1,0,1,298,299,0.33,Furthest
6294,January,2018,Island,WA,Passenger,159,167,326,61838,62164,0.52,Washington
6295,January,2018,Prince George,VA,Passenger,0,1,1,74,75,1.33,Furthest
6296,January,2018,Columbia,WA,Passenger,2,1,3,2401,2404,0.12,Washington
6297,January,2018,San Juan,WA,Truck,0,0,0,5644,5644,0.0,Washington
6298,January,2018,Deschutes,OR,Passenger,1,0,1,178,179,0.56,Nearest
6299,January,2018,Montgomery,PA,Passenger,1,0,1,34,35,2.86,Furthest
6300,January,2018,Madison,ID,Passenger,1,0,1,39,40,2.5,Nearest
6301,January,2018,Franklin,WA,Truck,0,0,0,18563,18563,0.0,Washington
6302,January,2018,DeKalb,IN,Passenger,1,0,1,1,2,50.0,Furthest
6303,January,2019,Portsmouth,VA,Passenger,0,1,1,80,81,1.23,Furthest
6304,January,2019,San Juan,WA,Truck,0,0,0,5802,5802,0.0,Washington
6305,January,2019,Ferry,WA,Passenger,3,2,5,4388,4393,0.11,Washington
6306,January,2019,Okanogan,WA,Truck,0,0,0,16477,16477,0.0,Washington
6307,January,2019,Ventura,CA,Passenger,0,2,2,314,316,0.63,Nearest
6308,January,2019,Stevens,WA,Truck,0,0,0,18768,18768,0.0,Washington
6309,January,2019,Island,WA,Truck,0,0,0,21211,21211,0.0,Washington
6310,January,2019,Jefferson,CO,Passenger,0,2,2,61,63,3.17,Mid-Distance
6311,January,2019,Charles,MD,Passenger,0,1,1,75,76,1.32,Furthest
6312,January,2019,Montgomery,AL,Passenger,0,1,1,45,46,2.17,Furthest
6313,January,2019,Marion,IN,Passenger,1,0,1,117,118,0.85,Furthest
6314,January,2019,San Juan,PR,Passenger,0,1,1,5,6,16.67,Mid-Distance
6315,January,2019,Adams,WA,Truck,0,0,0,5142,5142,0.0,Washington
6316,January,2019,King,WA,Truck,6,1,7,182396,182403,0.0,Washington
6317,January,2019,Cowlitz,WA,Truck,0,0,0,28728,28728,0.0,Washington
6318,January,2019,Honolulu,HI,Passenger,1,3,4,517,521,0.77,Nearest
6319,January,2019,Harnett,NC,Passenger,1,0,1,221,222,0.45,Furthest
6320,January,2019,Lee,FL,Passenger,1,0,1,52,53,1.89,Furthest
6321,January,2019,Pacific,WA,Truck,0,0,0,7615,7615,0.0,Washington
6322,January,2019,Albemarle,VA,Passenger,1,0,1,24,25,4.0,Furthest
6323,January,2019,Duval,FL,Passenger,1,2,3,382,385,0.78,Furthest
6324,January,2019,Asotin,WA,Truck,0,0,0,6645,6645,0.0,Washington
6325,January,2019,Hawaii,HI,Passenger,1,0,1,60,61,1.64,Nearest
6326,January,2019,DeKalb,IN,Passenger,1,0,1,1,2,50.0,Furthest
6327,January,2019,Klamath,OR,Passenger,1,0,1,37,38,2.63,Nearest
6328,January,2019,Grant,WA,Passenger,33,53,86,64365,64451,0.13,Washington
6329,January,2019,Cowlitz,WA,Passenger,79,96,175,72557,72732,0.24,Washington
6330,January,2019,Adams,WA,Passenger,5,6,11,12742,12753,0.09,Washington
6331,January,2019,Clark,WA,Passenger,1313,868,2181,312092,314273,0.69,Washington
6332,January,2019,Carson City,NV,Passenger,1,0,1,14,15,6.67,Nearest
6333,January,2019,Franklin,WA,Passenger,49,68,117,59324,59441,0.2,Washington
6334,January,2019,Hennepin,MN,Passenger,2,0,2,106,108,1.85,Mid-Distance
6335,January,2019,Wahkiakum,WA,Passenger,1,1,2,3006,3008,0.07,Washington
6336,January,2019,Guadalupe,TX,Passenger,1,0,1,78,79,1.27,Mid-Distance
6337,January,2019,Franklin,WA,Truck,0,0,0,19128,19128,0.0,Washington
6338,January,2019,DuPage,IL,Passenger,1,0,1,60,61,1.64,Mid-Distance
6339,January,2019,Lumpkin,GA,Passenger,1,0,1,6,7,14.29,Furthest
6340,January,2019,Bergen,NJ,Passenger,1,0,1,27,28,3.57,Furthest
6341,January,2019,Benton,WA,Passenger,232,243,475,133224,133699,0.36,Washington
6342,January,2019,Nassau,NY,Passenger,3,0,3,36,39,7.69,Furthest
6343,January,2019,Pend Oreille,WA,Passenger,5,5,10,9538,9548,0.1,Washington
6344,January,2019,Columbia,WA,Passenger,2,2,4,2423,2427,0.16,Washington
6345,January,2019,Asotin,WA,Passenger,12,9,21,12729,12750,0.16,Washington
6346,January,2019,Kootenai,ID,Passenger,1,1,2,214,216,0.93,Nearest
6347,January,2019,El Paso,TX,Passenger,2,0,2,501,503,0.4,Mid-Distance
6348,January,2019,Walla Walla,WA,Passenger,42,54,96,36138,36234,0.26,Washington
6349,January,2019,Calvert,MD,Passenger,0,1,1,88,89,1.12,Furthest
6350,January,2019,Kent,MI,Passenger,0,1,1,23,24,4.17,Furthest
6351,January,2019,Oldham,KY,Passenger,0,1,1,5,6,16.67,Furthest
6352,January,2019,Middlesex,MA,Passenger,1,1,2,121,123,1.63,Furthest
6353,January,2019,Snohomish,WA,Passenger,3075,1488,4563,528288,532851,0.86,Washington
6354,January,2019,Clallam,WA,Truck,0,0,0,21632,21632,0.0,Washington
6355,January,2019,Travis,TX,Passenger,2,1,3,200,203,1.48,Mid-Distance
6356,January,2019,Allegheny,PA,Passenger,1,0,1,85,86,1.16,Furthest
6357,January,2019,Kittitas,WA,Passenger,69,36,105,29465,29570,0.36,Washington
6358,January,2019,Pima,AZ,Passenger,1,1,2,403,405,0.49,Nearest
6359,January,2019,Alameda,CA,Passenger,0,2,2,316,318,0.63,Nearest
6360,January,2019,Clark,WA,Truck,0,0,0,79967,79967,0.0,Washington
6361,January,2019,Whitman,WA,Passenger,24,40,64,22845,22909,0.28,Washington
6362,January,2019,Pend Oreille,WA,Truck,0,0,0,5743,5743,0.0,Washington
6363,January,2019,Frederick,MD,Passenger,0,1,1,80,81,1.23,Furthest
6364,January,2019,Manatee,FL,Passenger,1,0,1,36,37,2.7,Furthest
6365,January,2019,Collin,TX,Passenger,1,1,2,143,145,1.38,Mid-Distance
6366,January,2019,Clallam,WA,Passenger,152,128,280,50402,50682,0.55,Washington
6367,January,2019,Klickitat,WA,Truck,0,0,0,8228,8228,0.0,Washington
6368,January,2019,Monroe,IL,Passenger,1,0,1,4,5,20.0,Mid-Distance
6369,January,2019,Nueces,TX,Passenger,1,1,2,90,92,2.17,Mid-Distance
6370,January,2019,Palm Beach,FL,Passenger,0,1,1,91,92,1.09,Furthest
6371,January,2019,Maricopa,AZ,Passenger,5,2,7,1551,1558,0.45,Nearest
6372,January,2019,Grays Harbor,WA,Truck,0,0,0,20319,20319,0.0,Washington
6373,January,2019,Caddo,LA,Passenger,0,1,1,21,22,4.55,Mid-Distance
6374,January,2019,Grant,WA,Truck,0,0,0,26324,26324,0.0,Washington
6375,January,2019,Pinal,AZ,Passenger,2,0,2,203,205,0.98,Nearest
6376,January,2019,Benton,WA,Truck,0,0,0,41617,41617,0.0,Washington
6377,January,2019,Yakima,WA,Passenger,84,100,184,164930,165114,0.11,Washington
6378,January,2019,Klickitat,WA,Passenger,29,32,61,15485,15546,0.39,Washington
6379,January,2019,Cook,IL,Passenger,1,0,1,245,246,0.41,Mid-Distance
6380,January,2019,Chelan,WA,Truck,0,0,0,22107,22107,0.0,Washington
6381,January,2019,Fulton,GA,Passenger,1,2,3,107,110,2.73,Furthest
6382,January,2019,Mason,WA,Truck,0,0,0,20224,20224,0.0,Washington
6383,January,2019,Snohomish,WA,Truck,1,0,1,122005,122006,0.0,Washington
6384,January,2019,Montgomery,PA,Passenger,2,0,2,35,37,5.41,Furthest
6385,January,2019,Sangamon,IL,Passenger,1,0,1,8,9,11.11,Mid-Distance
6386,January,2019,Carroll,NH,Passenger,0,1,1,1,2,50.0,Furthest
6387,January,2019,Kern,CA,Passenger,0,1,1,232,233,0.43,Nearest
6388,January,2019,Penobscot,ME,Passenger,0,1,1,12,13,7.69,Furthest
6389,January,2019,San Diego,CA,Passenger,9,2,11,2582,2593,0.42,Nearest
6390,January,2019,Dale,AL,Passenger,0,1,1,56,57,1.75,Furthest
6391,January,2019,Island,WA,Passenger,288,229,517,63253,63770,0.81,Washington
6392,January,2019,Lewis,WA,Truck,0,0,0,25661,25661,0.0,Washington
6393,January,2019,Bexar,TX,Passenger,3,4,7,706,713,0.98,Mid-Distance
6394,January,2019,Norfolk,MA,Passenger,1,0,1,36,37,2.7,Furthest
6395,January,2019,Santa Rosa,FL,Passenger,1,0,1,89,90,1.11,Furthest
6396,January,2019,Houston,GA,Passenger,1,0,1,51,52,1.92,Furthest
6397,January,2019,El Paso,CO,Passenger,3,1,4,761,765,0.52,Mid-Distance
6398,January,2019,Clackamas,OR,Passenger,1,1,2,212,214,0.93,Nearest
6399,January,2019,Walla Walla,WA,Truck,0,0,0,13535,13535,0.0,Washington
6400,January,2019,Jefferson,WA,Truck,0,0,0,9619,9619,0.0,Washington
6401,January,2019,Saratoga,NY,Passenger,1,0,1,61,62,1.61,Furthest
6402,January,2019,Lee,AL,Passenger,1,0,1,35,36,2.78,Furthest
6403,January,2019,Multnomah,OR,Passenger,3,5,8,768,776,1.03,Nearest
6404,January,2019,Kittitas,WA,Truck,0,0,0,14237,14237,0.0,Washington
6405,January,2019,Skagit,WA,Truck,1,0,1,32319,32320,0.0,Washington
6406,January,2019,Richland,SC,Passenger,0,1,1,163,164,0.61,Furthest
6407,January,2019,Okanogan,WA,Passenger,18,21,39,26053,26092,0.15,Washington
6408,January,2019,Clark,NV,Passenger,2,2,4,719,723,0.55,Nearest
6409,January,2019,Santa Fe,NM,Passenger,0,1,1,41,42,2.38,Mid-Distance
6410,January,2019,Madison,ID,Passenger,1,0,1,36,37,2.7,Nearest
6411,January,2019,Goochland,VA,Passenger,0,1,1,245,246,0.41,Furthest
6412,January,2019,Sumter,FL,Passenger,0,1,1,10,11,9.09,Furthest
6413,January,2019,Santa Clara,CA,Passenger,8,1,9,370,379,2.37,Nearest
6414,January,2019,Flathead,MT,Passenger,1,0,1,59,60,1.67,Nearest
6415,January,2019,Denver,CO,Passenger,1,0,1,130,131,0.76,Mid-Distance
6416,January,2019,Moore,NC,Passenger,0,1,1,187,188,0.53,Furthest
6417,January,2019,Santa Cruz,CA,Passenger,1,0,1,42,43,2.33,Nearest
6418,January,2019,Camden,NJ,Passenger,0,1,1,27,28,3.57,Furthest
6419,January,2019,Gwinnett,GA,Passenger,0,1,1,75,76,1.32,Furthest
6420,January,2019,DeKalb,GA,Passenger,1,0,1,77,78,1.28,Furthest
6421,January,2019,Juneau,AK,Passenger,0,1,1,39,40,2.5,Nearest
6422,January,2019,Whatcom,WA,Truck,2,0,2,42739,42741,0.0,Washington
6423,January,2019,Ramsey,MN,Passenger,1,0,1,38,39,2.56,Mid-Distance
6424,January,2019,Alexandria,VA,Passenger,1,0,1,163,164,0.61,Furthest
6425,January,2019,Norfolk,VA,Passenger,2,2,4,340,344,1.16,Furthest
6426,January,2019,Skamania,WA,Passenger,18,15,33,8741,8774,0.38,Washington
6427,January,2019,Larimer,CO,Passenger,1,0,1,58,59,1.69,Mid-Distance
6428,January,2019,District of Columbia,DC,Passenger,1,3,4,203,207,1.93,Furthest
6429,January,2019,Jefferson,WA,Passenger,175,112,287,24852,25139,1.14,Washington
6430,January,2019,Kitsap,WA,Passenger,981,556,1537,179937,181474,0.85,Washington
6432,January,2019,Twin Falls,ID,Passenger,0,1,1,20,21,4.76,Nearest
6433,January,2019,Deschutes,OR,Passenger,2,0,2,164,166,1.2,Nearest
6434,January,2019,St. Mary's,MD,Passenger,1,0,1,211,212,0.47,Furthest
6435,January,2019,Thurston,WA,Passenger,771,590,1361,196046,197407,0.69,Washington
6436,January,2019,Shasta,CA,Passenger,1,0,1,43,44,2.27,Nearest
6437,January,2019,New Haven,CT,Passenger,0,1,1,49,50,2.0,Furthest
6438,January,2019,Whatcom,WA,Passenger,778,375,1153,149711,150864,0.76,Washington
6439,January,2019,Garfield,WA,Passenger,1,1,2,1332,1334,0.15,Washington
6440,January,2019,Columbia,WA,Truck,0,0,0,1529,1529,0.0,Washington
6441,January,2019,Valencia,NM,Passenger,1,0,1,9,10,10.0,Mid-Distance
6442,January,2019,Richmond,GA,Passenger,0,1,1,90,91,1.1,Furthest
6443,January,2019,Pierce,WA,Truck,0,0,0,139124,139124,0.0,Washington
6444,January,2019,Howard,MD,Passenger,0,1,1,82,83,1.2,Furthest
6445,January,2019,Los Angeles,CA,Passenger,7,5,12,1096,1108,1.08,Nearest
6446,January,2019,Douglas,NE,Passenger,0,1,1,67,68,1.47,Mid-Distance
6447,January,2019,Montgomery,MD,Passenger,1,0,1,276,277,0.36,Furthest
6448,January,2019,Garfield,OK,Passenger,1,0,1,13,14,7.14,Mid-Distance
6449,January,2019,Maui,HI,Passenger,1,0,1,50,51,1.96,Nearest
6450,January,2019,Charleston,SC,Passenger,1,0,1,122,123,0.81,Furthest
6451,January,2019,Broward,FL,Passenger,2,1,3,128,131,2.29,Furthest
6452,January,2019,Douglas,WA,Passenger,51,35,86,28011,28097,0.31,Washington
6453,January,2019,Skamania,WA,Truck,0,0,0,4008,4008,0.0,Washington
6454,January,2019,Thurston,WA,Truck,0,0,0,54922,54922,0.0,Washington
6455,January,2019,San Francisco,CA,Passenger,2,1,3,114,117,2.56,Nearest
6456,January,2019,Mecklenburg,NC,Passenger,1,0,1,80,81,1.23,Furthest
6457,January,2019,Fresno,CA,Passenger,1,0,1,187,188,0.53,Nearest
6458,January,2019,Tuolumne,CA,Passenger,0,1,1,12,13,7.69,Nearest
6459,January,2019,Washoe,NV,Passenger,2,0,2,107,109,1.83,Nearest
6460,January,2019,Volusia,FL,Passenger,0,1,1,37,38,2.63,Furthest
6461,January,2019,Beaufort,SC,Passenger,1,0,1,36,37,2.7,Furthest
6462,January,2019,Cape May,NJ,Passenger,0,1,1,20,21,4.76,Furthest
6463,January,2019,Williamson,TX,Passenger,0,1,1,149,150,0.67,Mid-Distance
6464,January,2019,Mason,WA,Passenger,108,115,223,46659,46882,0.48,Washington
6465,January,2019,Montgomery,TX,Passenger,2,0,2,60,62,3.23,Mid-Distance
6466,January,2019,Rogers,OK,Passenger,1,0,1,5,6,16.67,Mid-Distance
6467,January,2019,Chelan,WA,Passenger,140,64,204,54205,54409,0.37,Washington
6468,January,2019,Washington,OR,Passenger,0,1,1,471,472,0.21,Nearest
6469,January,2019,Pierce,WA,Passenger,1581,1423,3004,539770,542774,0.55,Washington
6470,January,2019,Jefferson,NY,Passenger,0,1,1,229,230,0.43,Furthest
6471,January,2019,Douglas,WA,Truck,0,0,0,12172,12172,0.0,Washington
6472,January,2019,Anne Arundel,MD,Passenger,0,2,2,450,452,0.44,Furthest
6473,January,2019,Contra Costa,CA,Passenger,1,2,3,405,408,0.74,Nearest
6474,January,2019,Sedgwick,KS,Passenger,0,1,1,99,100,1.0,Mid-Distance
6475,January,2019,Washtenaw,MI,Passenger,1,0,1,39,40,2.5,Furthest
6476,January,2019,Dakota,MN,Passenger,0,2,2,33,35,5.71,Mid-Distance
6477,January,2019,Wahkiakum,WA,Truck,0,0,0,1711,1711,0.0,Washington
6478,January,2019,Tulsa,OK,Passenger,1,1,2,48,50,4.0,Mid-Distance
6479,January,2019,Stevens,WA,Passenger,18,28,46,31816,31862,0.14,Washington
6480,January,2019,Skagit,WA,Passenger,270,186,456,91360,91816,0.5,Washington
6481,January,2019,Ada,ID,Passenger,0,2,2,310,312,0.64,Nearest
6482,January,2019,Lincoln,WA,Passenger,2,5,7,7755,7762,0.09,Washington
6483,January,2019,Prince George's,MD,Passenger,1,1,2,183,185,1.08,Furthest
6484,January,2019,Spokane,WA,Passenger,471,380,851,307611,308462,0.28,Washington
6485,January,2019,Whitman,WA,Truck,0,0,0,8512,8512,0.0,Washington
6486,January,2019,Garfield,WA,Truck,0,0,0,962,962,0.0,Washington
6487,January,2019,Spartanburg,SC,Passenger,0,1,1,33,34,2.94,Furthest
6488,January,2019,Ferry,WA,Truck,0,0,0,3590,3590,0.0,Washington
6489,January,2019,San Mateo,CA,Passenger,2,1,3,126,129,2.33,Nearest
6490,January,2019,Spokane,WA,Truck,1,0,1,93943,93944,0.0,Washington
6491,January,2019,Orange,CA,Passenger,5,2,7,538,545,1.28,Nearest
6492,January,2019,Kitsap,WA,Truck,1,0,1,53730,53731,0.0,Washington
6493,January,2019,Harris,TX,Passenger,0,1,1,254,255,0.39,Mid-Distance
6494,January,2019,Prince William,VA,Passenger,0,4,4,256,260,1.54,Furthest
6495,January,2019,Virginia Beach,VA,Passenger,2,1,3,698,701,0.43,Furthest
6496,January,2019,Tarrant,TX,Passenger,1,0,1,203,204,0.49,Mid-Distance
6497,January,2019,Marion,OR,Passenger,1,0,1,117,118,0.85,Nearest
6498,January,2019,Polk,FL,Passenger,1,0,1,66,67,1.49,Furthest
6499,January,2019,New London,CT,Passenger,0,2,2,248,250,0.8,Furthest
6500,January,2019,Lincoln,WA,Truck,0,0,0,4666,4666,0.0,Washington
6501,January,2019,Pacific,WA,Passenger,22,26,48,15882,15930,0.3,Washington
6502,January,2019,San Juan,WA,Passenger,190,68,258,14255,14513,1.78,Washington
6503,January,2019,Lewis,WA,Passenger,95,82,177,58367,58544,0.3,Washington
6504,January,2019,King,WA,Passenger,17167,6678,23845,1381057,1404902,1.7,Washington
6505,January,2019,Fairfax,VA,Passenger,3,2,5,801,806,0.62,Furthest
6506,January,2019,Yakima,WA,Truck,0,0,0,58929,58929,0.0,Washington
6507,January,2019,Franklin,MA,Passenger,0,1,1,1,2,50.0,Furthest
6508,January,2019,Nantucket,MA,Passenger,1,0,1,4,5,20.0,Furthest
6509,January,2019,Clay,FL,Passenger,0,1,1,86,87,1.15,Furthest
6510,January,2019,Arlington,VA,Passenger,1,2,3,162,165,1.82,Furthest
6511,January,2019,Grays Harbor,WA,Passenger,67,76,143,47449,47592,0.3,Washington
6512,January,2019,Manassas,VA,Passenger,0,1,1,9,10,10.0,Furthest
6513,January,2019,Cumberland,NC,Passenger,0,2,2,522,524,0.38,Furthest
6514,January,2019,Brevard,FL,Passenger,0,1,1,90,91,1.1,Furthest
6515,January,2019,Cochise,AZ,Passenger,0,1,1,118,119,0.84,Nearest
6516,January,2019,Suffolk,MA,Passenger,0,1,1,40,41,2.44,Furthest
6517,January,2019,Riverside,CA,Passenger,2,2,4,669,673,0.59,Nearest
6518,January,2019,Bucks,PA,Passenger,1,0,1,16,17,5.88,Furthest
6519,January,2019,Shelby,TN,Passenger,0,1,1,96,97,1.03,Furthest
6520,January,2019,Hardin,KY,Passenger,0,1,1,104,105,0.95,Furthest
6521,January,2019,Randolph,NC,Passenger,1,0,1,6,7,14.29,Furthest
6522,January,2019,St. Lucie,FL,Passenger,1,0,1,30,31,3.23,Furthest
6523,January,2019,St. Clair,IL,Passenger,0,1,1,167,168,0.6,Mid-Distance
6524,January,2020,Los Angeles,CA,Passenger,8,11,19,1058,1077,1.76,Nearest
6525,January,2020,Charles,MD,Passenger,0,1,1,80,81,1.23,Furthest
6526,January,2020,Washington,OR,Passenger,1,0,1,457,458,0.22,Nearest
6527,January,2020,Carroll,NH,Passenger,0,1,1,4,5,20.0,Furthest
6528,January,2020,Rogers,OK,Passenger,1,0,1,5,6,16.67,Mid-Distance
6529,January,2020,Riverside,CA,Passenger,4,1,5,641,646,0.77,Nearest
6530,January,2020,Prince George's,MD,Passenger,1,1,2,172,174,1.15,Furthest
6531,January,2020,Bexar,TX,Passenger,2,5,7,639,646,1.08,Mid-Distance
6532,January,2020,San Diego,CA,Passenger,10,5,15,2781,2796,0.54,Nearest
6533,January,2020,Snohomish,WA,Truck,0,0,0,123641,123641,0.0,Washington
6534,January,2020,Douglas,NE,Passenger,0,1,1,56,57,1.75,Mid-Distance
6535,January,2020,Whitman,WA,Passenger,42,48,90,22664,22754,0.4,Washington
6536,January,2020,Okanogan,WA,Passenger,32,30,62,26220,26282,0.24,Washington
6537,January,2020,Frederick,MD,Passenger,1,1,2,81,83,2.41,Furthest
6538,January,2020,Fort Bend,TX,Passenger,1,0,1,49,50,2.0,Mid-Distance
6539,January,2020,Lake,FL,Passenger,1,0,1,21,22,4.55,Furthest
6540,January,2020,Sedgwick,KS,Passenger,1,1,2,95,97,2.06,Mid-Distance
6541,January,2020,Maricopa,AZ,Passenger,7,6,13,1484,1497,0.87,Nearest
6542,January,2020,Santa Cruz,CA,Passenger,1,0,1,34,35,2.86,Nearest
6543,January,2020,Grays Harbor,WA,Passenger,105,105,210,48505,48715,0.43,Washington
6544,January,2020,Oldham,KY,Passenger,0,1,1,4,5,20.0,Furthest
6545,January,2020,Greene,MO,Passenger,0,1,1,30,31,3.23,Furthest
6546,January,2020,Calvert,MD,Passenger,0,2,2,91,93,2.15,Furthest
6547,January,2020,Whatcom,WA,Passenger,1032,486,1518,151794,153312,0.99,Washington
6548,January,2020,Walla Walla,WA,Truck,0,0,0,13710,13710,0.0,Washington
6549,January,2020,Rockingham,NH,Passenger,1,0,1,28,29,3.45,Furthest
6550,January,2020,Ada,ID,Passenger,0,1,1,288,289,0.35,Nearest
6551,January,2020,Alameda,CA,Passenger,4,1,5,285,290,1.72,Nearest
6552,January,2020,Montgomery,OH,Passenger,0,1,1,50,51,1.96,Furthest
6553,January,2020,Chelan,WA,Truck,0,0,0,22573,22573,0.0,Washington
6554,January,2020,Clackamas,OR,Passenger,2,1,3,210,213,1.41,Nearest
6555,January,2020,Williamson,TX,Passenger,0,2,2,146,148,1.35,Mid-Distance
6556,January,2020,Portsmouth,VA,Passenger,0,1,1,80,81,1.23,Furthest
6557,January,2020,Monroe,IL,Passenger,1,0,1,4,5,20.0,Mid-Distance
6558,January,2020,Lee,FL,Passenger,1,0,1,52,53,1.89,Furthest
6559,January,2020,Stevens,WA,Truck,0,0,0,18790,18790,0.0,Washington
6560,January,2020,Larimer,CO,Passenger,1,0,1,56,57,1.75,Mid-Distance
6561,January,2020,Garfield,WA,Passenger,0,1,1,1321,1322,0.08,Washington
6562,January,2020,Stafford,VA,Passenger,1,1,2,93,95,2.11,Furthest
6563,January,2020,Brevard,FL,Passenger,0,1,1,87,88,1.14,Furthest
6564,January,2020,Chelan,WA,Passenger,213,77,290,54617,54907,0.53,Washington
6565,January,2020,Wahkiakum,WA,Passenger,4,5,9,3034,3043,0.3,Washington
6566,January,2020,Benton,WA,Passenger,337,315,652,135323,135975,0.48,Washington
6567,January,2020,DeKalb,IN,Passenger,1,0,1,1,2,50.0,Furthest
6568,January,2020,Pend Oreille,WA,Passenger,8,7,15,9470,9485,0.16,Washington
6569,January,2020,King,WA,Passenger,23196,7620,30816,1399178,1429994,2.15,Washington
6570,January,2020,Owyhee,ID,Passenger,1,0,1,3,4,25.0,Nearest
6571,January,2020,Hennepin,MN,Passenger,3,1,4,101,105,3.81,Mid-Distance
6572,January,2020,Tarrant,TX,Passenger,2,0,2,187,189,1.06,Mid-Distance
6573,January,2020,Travis,TX,Passenger,2,1,3,191,194,1.55,Mid-Distance
6574,January,2020,Cascade,MT,Passenger,0,1,1,56,57,1.75,Nearest
6575,January,2020,Island,WA,Truck,1,0,1,21354,21355,0.0,Washington
6576,January,2020,Montgomery,AL,Passenger,0,1,1,39,40,2.5,Furthest
6577,January,2020,Nueces,TX,Passenger,1,0,1,84,85,1.18,Mid-Distance
6578,January,2020,Mason,WA,Passenger,150,135,285,47624,47909,0.59,Washington
6579,January,2020,Douglas,WA,Passenger,69,39,108,28367,28475,0.38,Washington
6580,January,2020,Manassas,VA,Passenger,0,1,1,6,7,14.29,Furthest
6581,January,2020,Suffolk,MA,Passenger,0,1,1,36,37,2.7,Furthest
6582,January,2020,Maui,HI,Passenger,1,0,1,38,39,2.56,Nearest
6583,January,2020,Juneau,AK,Passenger,0,2,2,30,32,6.25,Nearest
6584,January,2020,Clay,FL,Passenger,0,1,1,87,88,1.14,Furthest
6585,January,2020,Harrison,MS,Passenger,1,0,1,59,60,1.67,Mid-Distance
6586,January,2020,Harnett,NC,Passenger,1,1,2,205,207,0.97,Furthest
6587,January,2020,Placer,CA,Passenger,1,0,1,93,94,1.06,Nearest
6588,January,2020,Klickitat,WA,Passenger,48,39,87,15683,15770,0.55,Washington
6589,January,2020,Pacific,WA,Truck,0,0,0,7748,7748,0.0,Washington
6590,January,2020,Hawaii,HI,Passenger,1,0,1,61,62,1.61,Nearest
6591,January,2020,Skagit,WA,Passenger,378,215,593,92622,93215,0.64,Washington
6592,January,2020,Washtenaw,MI,Passenger,1,0,1,41,42,2.38,Furthest
6593,January,2020,Pinellas,FL,Passenger,1,1,2,110,112,1.79,Furthest
6594,January,2020,Charleston,SC,Passenger,1,0,1,110,111,0.9,Furthest
6595,January,2020,Fairbanks North Star,AK,Passenger,0,1,1,101,102,0.98,Nearest
6596,January,2020,Columbia,WA,Truck,0,0,0,1534,1534,0.0,Washington
6597,January,2020,DuPage,IL,Passenger,3,0,3,63,66,4.55,Mid-Distance
6598,January,2020,Skagit,WA,Truck,1,0,1,32593,32594,0.0,Washington
6599,January,2020,Spokane,WA,Truck,1,0,1,96899,96900,0.0,Washington
6600,January,2020,Clark,NV,Passenger,3,2,5,688,693,0.72,Nearest
6601,January,2020,Washoe,NV,Passenger,1,0,1,107,108,0.93,Nearest
6602,January,2020,Klamath,OR,Passenger,1,0,1,36,37,2.7,Nearest
6603,January,2020,Queens,NY,Passenger,1,0,1,52,53,1.89,Furthest
6604,January,2020,Loudoun,VA,Passenger,1,0,1,91,92,1.09,Furthest
6605,January,2020,Bucks,PA,Passenger,1,0,1,19,20,5.0,Furthest
6606,January,2020,Thurston,WA,Truck,0,0,0,55762,55762,0.0,Washington
6607,January,2020,Clark,WA,Passenger,1940,1054,2994,319981,322975,0.93,Washington
6608,January,2020,Fulton,GA,Passenger,1,2,3,105,108,2.78,Furthest
6609,January,2020,Sacramento,CA,Passenger,1,0,1,284,285,0.35,Nearest
6610,January,2020,Tulsa,OK,Passenger,1,1,2,48,50,4.0,Mid-Distance
6611,January,2020,Solano,CA,Passenger,1,0,1,208,209,0.48,Nearest
6612,January,2020,Hudson,NJ,Passenger,1,0,1,39,40,2.5,Furthest
6613,January,2020,Osceola,FL,Passenger,1,0,1,41,42,2.38,Furthest
6614,January,2020,Clallam,WA,Truck,1,0,1,21855,21856,0.0,Washington
6615,January,2020,Grant,WA,Passenger,58,71,129,65624,65753,0.2,Washington
6616,January,2020,Denton,TX,Passenger,1,0,1,87,88,1.14,Mid-Distance
6617,January,2020,Lincoln,WA,Passenger,1,11,12,7787,7799,0.15,Washington
6618,January,2020,Pima,AZ,Passenger,3,1,4,367,371,1.08,Nearest
6619,January,2020,King,WA,Truck,6,1,7,182654,182661,0.0,Washington
6620,January,2020,Yakima,WA,Passenger,120,115,235,166247,166482,0.14,Washington
6621,January,2020,Fairfax,VA,Passenger,4,2,6,755,761,0.79,Furthest
6622,January,2020,Whatcom,WA,Truck,3,0,3,43229,43232,0.01,Washington
6623,January,2020,Pend Oreille,WA,Truck,0,0,0,5778,5778,0.0,Washington
6624,January,2020,Kittitas,WA,Passenger,93,47,140,30081,30221,0.46,Washington
6625,January,2020,Grays Harbor,WA,Truck,0,0,0,20827,20827,0.0,Washington
6626,January,2020,Palm Beach,FL,Passenger,0,1,1,85,86,1.16,Furthest
6627,January,2020,Norfolk,VA,Passenger,2,2,4,353,357,1.12,Furthest
6628,January,2020,Berkshire,MA,Passenger,0,1,1,5,6,16.67,Furthest
6629,January,2020,Dakota,MN,Passenger,0,1,1,33,34,2.94,Mid-Distance
6630,January,2020,Jefferson,CO,Passenger,0,2,2,58,60,3.33,Mid-Distance
6631,January,2020,Virginia Beach,VA,Passenger,1,0,1,696,697,0.14,Furthest
6632,January,2020,Moore,NC,Passenger,0,1,1,164,165,0.61,Furthest
6633,January,2020,Ramsey,MN,Passenger,1,0,1,39,40,2.5,Mid-Distance
6634,January,2020,Anne Arundel,MD,Passenger,1,2,3,432,435,0.69,Furthest
6636,January,2020,Prince William,VA,Passenger,2,3,5,233,238,2.1,Furthest
6637,January,2020,Kootenai,ID,Passenger,1,1,2,232,234,0.85,Nearest
6638,January,2020,Cochise,AZ,Passenger,0,1,1,103,104,0.96,Nearest
6639,January,2020,Pierce,WA,Passenger,2229,1679,3908,550655,554563,0.7,Washington
6640,January,2020,Twin Falls,ID,Passenger,0,1,1,28,29,3.45,Nearest
6641,January,2020,Kitsap,WA,Passenger,1258,656,1914,182446,184360,1.04,Washington
6642,January,2020,Arlington,VA,Passenger,0,2,2,152,154,1.3,Furthest
6643,January,2020,Thurston,WA,Passenger,1093,719,1812,199295,201107,0.9,Washington
6644,January,2020,Columbia,WA,Passenger,3,3,6,2447,2453,0.24,Washington
6645,January,2020,Albemarle,VA,Passenger,1,0,1,25,26,3.85,Furthest
6646,January,2020,Tuolumne,CA,Passenger,0,1,1,11,12,8.33,Nearest
6647,January,2020,Guadalupe,TX,Passenger,1,0,1,67,68,1.47,Mid-Distance
6648,January,2020,Asotin,WA,Passenger,17,11,28,12723,12751,0.22,Washington
6649,January,2020,Garfield,WA,Truck,0,0,0,969,969,0.0,Washington
6650,January,2020,Arapahoe,CO,Passenger,1,0,1,142,143,0.7,Mid-Distance
6651,January,2020,Island,WA,Passenger,392,257,649,63598,64247,1.01,Washington
6652,January,2020,Pacific,WA,Passenger,30,31,61,16096,16157,0.38,Washington
6653,January,2020,San Mateo,CA,Passenger,1,1,2,116,118,1.69,Nearest
6654,January,2020,Houston,GA,Passenger,1,0,1,60,61,1.64,Furthest
6655,January,2020,Polk,FL,Passenger,1,0,1,65,66,1.52,Furthest
6656,January,2020,Randolph,NC,Passenger,1,0,1,7,8,12.5,Furthest
6657,January,2020,Franklin,WA,Passenger,57,76,133,61093,61226,0.22,Washington
6658,January,2020,Honolulu,HI,Passenger,4,2,6,476,482,1.24,Nearest
6659,January,2020,Yakima,WA,Truck,0,0,0,59638,59638,0.0,Washington
6660,January,2020,Ferry,WA,Passenger,5,2,7,4381,4388,0.16,Washington
6661,January,2020,Clallam,WA,Passenger,203,163,366,50913,51279,0.71,Washington
6662,January,2020,DeKalb,GA,Passenger,1,0,1,83,84,1.19,Furthest
6663,January,2020,San Juan,WA,Truck,0,0,0,5928,5928,0.0,Washington
6664,January,2020,Wilson,TX,Passenger,0,1,1,7,8,12.5,Mid-Distance
6665,January,2020,Penobscot,ME,Passenger,0,1,1,14,15,6.67,Furthest
6666,January,2020,Alexandria,VA,Passenger,1,0,1,147,148,0.68,Furthest
6667,January,2020,Skamania,WA,Truck,0,0,0,4106,4106,0.0,Washington
6668,January,2020,Shasta,CA,Passenger,1,0,1,35,36,2.78,Nearest
6669,January,2020,Sarasota,FL,Passenger,2,0,2,26,28,7.14,Furthest
6670,January,2020,Wayne,MI,Passenger,0,1,1,58,59,1.69,Furthest
6671,January,2020,Pierce,WA,Truck,0,0,0,141347,141347,0.0,Washington
6672,January,2020,Broward,FL,Passenger,2,1,3,122,125,2.4,Furthest
6673,January,2020,Benton,WA,Truck,0,0,0,42555,42555,0.0,Washington
6674,January,2020,Jones,GA,Passenger,1,0,1,1,2,50.0,Furthest
6675,January,2020,Lewis,WA,Passenger,109,104,213,59601,59814,0.36,Washington
6676,January,2020,El Paso,TX,Passenger,3,0,3,451,454,0.66,Mid-Distance
6677,January,2020,Shelby,OH,Passenger,0,1,1,1,2,50.0,Furthest
6678,January,2020,Chesapeake,VA,Passenger,0,2,2,431,433,0.46,Furthest
6679,January,2020,New London,CT,Passenger,0,2,2,250,252,0.79,Furthest
6680,January,2020,Orange,CA,Passenger,7,2,9,506,515,1.75,Nearest
6681,January,2020,New Haven,CT,Passenger,0,2,2,45,47,4.26,Furthest
6682,January,2020,Klickitat,WA,Truck,0,0,0,8299,8299,0.0,Washington
6683,January,2020,Kittitas,WA,Truck,0,0,0,14666,14666,0.0,Washington
6684,January,2020,Powhatan,VA,Passenger,1,0,1,0,1,100.0,Furthest
6685,January,2020,Spokane,WA,Passenger,684,467,1151,316758,317909,0.36,Washington
6686,January,2020,Franklin,WA,Truck,0,0,0,19851,19851,0.0,Washington
6687,January,2020,Stevens,WA,Passenger,33,32,65,31499,31564,0.21,Washington
6688,January,2020,Lewis,WA,Truck,0,0,0,26097,26097,0.0,Washington
6689,January,2020,Boulder,CO,Passenger,0,1,1,51,52,1.92,Mid-Distance
6690,January,2020,Jefferson,WA,Truck,0,0,0,9661,9661,0.0,Washington
6691,January,2020,Shelby,TN,Passenger,0,1,1,96,97,1.03,Furthest
6692,January,2020,Adams,WA,Passenger,7,7,14,12913,12927,0.11,Washington
6693,January,2020,Adams,WA,Truck,0,0,0,5211,5211,0.0,Washington
6694,January,2020,Ventura,CA,Passenger,0,3,3,299,302,0.99,Nearest
6695,January,2020,Richland,SC,Passenger,0,1,1,157,158,0.63,Furthest
6696,January,2020,Carson City,NV,Passenger,1,0,1,9,10,10.0,Nearest
6697,January,2020,Duval,FL,Passenger,1,2,3,370,373,0.8,Furthest
6698,January,2020,Skamania,WA,Passenger,29,19,48,8769,8817,0.54,Washington
6699,January,2020,Collin,TX,Passenger,1,1,2,128,130,1.54,Mid-Distance
6700,January,2020,Pinal,AZ,Passenger,1,0,1,190,191,0.52,Nearest
6701,January,2020,Valencia,NM,Passenger,1,0,1,5,6,16.67,Mid-Distance
6702,January,2020,Wahkiakum,WA,Truck,0,0,0,1759,1759,0.0,Washington
6703,January,2020,Lincoln,WA,Truck,0,0,0,4671,4671,0.0,Washington
6704,January,2020,Putnam,TN,Passenger,0,1,1,3,4,25.0,Furthest
6705,January,2020,Jefferson,WA,Passenger,224,139,363,25209,25572,1.42,Washington
6706,January,2020,Middlesex,MA,Passenger,1,1,2,104,106,1.89,Furthest
6707,January,2020,Whitman,WA,Truck,0,0,0,8567,8567,0.0,Washington
6708,January,2020,St. Clair,IL,Passenger,1,0,1,143,144,0.69,Mid-Distance
6709,January,2020,Santa Clara,CA,Passenger,7,2,9,343,352,2.56,Nearest
6710,January,2020,Walla Walla,WA,Passenger,65,61,126,36352,36478,0.35,Washington
6711,January,2020,Lake,IL,Passenger,1,0,1,161,162,0.62,Mid-Distance
6712,January,2020,San Joaquin,CA,Passenger,1,0,1,136,137,0.73,Nearest
6713,January,2020,Contra Costa,CA,Passenger,3,2,5,336,341,1.47,Nearest
6714,January,2020,Flathead,MT,Passenger,1,0,1,61,62,1.61,Nearest
6715,January,2020,Saginaw,MI,Passenger,1,0,1,11,12,8.33,Furthest
6716,January,2020,Ferry,WA,Truck,0,0,0,3586,3586,0.0,Washington
6717,January,2020,El Paso,CO,Passenger,2,1,3,735,738,0.41,Mid-Distance
6718,January,2020,Nassau,NY,Passenger,4,0,4,39,43,9.3,Furthest
6719,January,2020,Jefferson,NY,Passenger,0,1,1,219,220,0.45,Furthest
6720,January,2020,District of Columbia,DC,Passenger,1,1,2,209,211,0.95,Furthest
6721,January,2020,Cape May,NJ,Passenger,0,1,1,13,14,7.14,Furthest
6722,January,2020,Goochland,VA,Passenger,2,1,3,263,266,1.13,Furthest
6723,January,2020,Fresno,CA,Passenger,1,0,1,190,191,0.52,Nearest
6724,January,2020,Cowlitz,WA,Passenger,127,111,238,73602,73840,0.32,Washington
6725,January,2020,Santa Rosa,FL,Passenger,1,0,1,86,87,1.15,Furthest
6726,January,2020,Clark,WA,Truck,0,0,0,81767,81767,0.0,Washington
6727,January,2020,Vigo,IN,Passenger,1,0,1,6,7,14.29,Furthest
6728,January,2020,Montgomery,TX,Passenger,1,0,1,56,57,1.75,Mid-Distance
6729,January,2020,Multnomah,OR,Passenger,4,7,11,730,741,1.48,Nearest
6730,January,2020,Spartanburg,SC,Passenger,0,1,1,43,44,2.27,Furthest
6731,January,2020,Howard,MD,Passenger,0,1,1,74,75,1.33,Furthest
6732,January,2020,Cowlitz,WA,Truck,0,0,0,29028,29028,0.0,Washington
6733,January,2020,Sumter,FL,Passenger,0,1,1,9,10,10.0,Furthest
6734,January,2020,Richmond,GA,Passenger,0,1,1,90,91,1.1,Furthest
6735,January,2020,Mason,WA,Truck,0,0,0,20563,20563,0.0,Washington
6736,January,2020,Grant,WA,Truck,0,0,0,27036,27036,0.0,Washington
6737,January,2020,RÃ­o Grande,PR,Passenger,1,0,1,1,2,50.0,Mid-Distance
6738,January,2020,Kitsap,WA,Truck,1,0,1,54484,54485,0.0,Washington
6739,January,2020,Montgomery,PA,Passenger,2,0,2,34,36,5.56,Furthest
6740,January,2020,Denver,CO,Passenger,1,0,1,124,125,0.8,Mid-Distance
6741,January,2020,Douglas,WA,Truck,0,0,0,12312,12312,0.0,Washington
6742,January,2020,Kern,CA,Passenger,0,1,1,225,226,0.44,Nearest
6743,January,2020,Dallas,TX,Passenger,1,0,1,208,209,0.48,Mid-Distance
6744,January,2020,Suffolk,VA,Passenger,1,0,1,124,125,0.8,Furthest
6745,January,2020,Snohomish,WA,Passenger,4244,1718,5962,537912,543874,1.1,Washington
6746,January,2020,Oklahoma,OK,Passenger,0,1,1,127,128,0.78,Mid-Distance
6747,January,2020,Cumberland,NC,Passenger,0,2,2,488,490,0.41,Furthest
6748,January,2020,Harris,TX,Passenger,1,0,1,240,241,0.41,Mid-Distance
6749,January,2020,Okanogan,WA,Truck,0,0,0,16557,16557,0.0,Washington
6750,January,2020,Allegheny,PA,Passenger,1,0,1,74,75,1.33,Furthest
6751,January,2020,San Juan,WA,Passenger,265,83,348,14402,14750,2.36,Washington
6752,January,2020,Kent,MI,Passenger,0,1,1,24,25,4.0,Furthest
6753,January,2020,Asotin,WA,Truck,0,0,0,6720,6720,0.0,Washington
6754,January,2020,Boone,MO,Passenger,0,1,1,11,12,8.33,Furthest
6755,January,2020,San Francisco,CA,Passenger,2,1,3,101,104,2.88,Nearest
6756,January,2020,Deschutes,OR,Passenger,3,0,3,145,148,2.03,Nearest
6757,January,2020,St. Mary's,MD,Passenger,1,0,1,214,215,0.47,Furthest
6758,January,2020,Camden,NJ,Passenger,0,2,2,21,23,8.7,Furthest
6759,January,2021,Asotin,WA,Truck,0,0,0,6690,6690,0.0,Washington
6760,January,2021,Mason,WA,Passenger,179,137,316,47690,48006,0.66,Washington
6761,January,2021,Whitman,WA,Truck,0,0,0,8512,8512,0.0,Washington
6762,January,2021,Adams,WA,Truck,0,0,0,5347,5347,0.0,Washington
6763,January,2021,Fairbanks North Star,AK,Passenger,0,1,1,87,88,1.14,Nearest
6764,January,2021,Virginia Beach,VA,Passenger,3,0,3,628,631,0.48,Furthest
6765,January,2021,Allegheny,PA,Passenger,1,1,2,65,67,2.99,Furthest
6766,January,2021,San Juan,WA,Passenger,377,113,490,14023,14513,3.38,Washington
6767,January,2021,El Paso,TX,Passenger,3,0,3,388,391,0.77,Mid-Distance
6768,January,2021,Norfolk,VA,Passenger,2,3,5,335,340,1.47,Furthest
6769,January,2021,Missoula,MT,Passenger,1,0,1,64,65,1.54,Nearest
6770,January,2021,Lee,FL,Passenger,1,0,1,42,43,2.33,Furthest
6771,January,2021,Skamania,WA,Passenger,34,23,57,8339,8396,0.68,Washington
6772,January,2021,Los Angeles,CA,Passenger,10,11,21,927,948,2.22,Nearest
6773,January,2021,Grays Harbor,WA,Passenger,133,126,259,48779,49038,0.53,Washington
6774,January,2021,Albemarle,VA,Passenger,1,0,1,21,22,4.55,Furthest
6775,January,2021,Harrison,MS,Passenger,2,0,2,52,54,3.7,Mid-Distance
6776,January,2021,Pierce,WA,Passenger,2963,1790,4753,555715,560468,0.85,Washington
6777,January,2021,St. Clair,IL,Passenger,1,0,1,135,136,0.74,Mid-Distance
6778,January,2021,Wilson,TX,Passenger,0,1,1,5,6,16.67,Mid-Distance
6779,January,2021,Yakima,WA,Passenger,178,129,307,167569,167876,0.18,Washington
6780,January,2021,Anchorage,AK,Passenger,1,0,1,143,144,0.69,Nearest
6781,January,2021,Bexar,TX,Passenger,3,5,8,562,570,1.4,Mid-Distance
6782,January,2021,Sedgwick,KS,Passenger,1,1,2,89,91,2.2,Mid-Distance
6783,January,2021,Jefferson,NY,Passenger,0,1,1,211,212,0.47,Furthest
6784,January,2021,Contra Costa,CA,Passenger,3,3,6,278,284,2.11,Nearest
6785,January,2021,Moore,NC,Passenger,0,1,1,141,142,0.7,Furthest
6786,January,2021,Wahkiakum,WA,Truck,0,0,0,1769,1769,0.0,Washington
6787,January,2021,Grant,WA,Truck,0,0,0,27594,27594,0.0,Washington
6788,January,2021,Deschutes,OR,Passenger,1,0,1,119,120,0.83,Nearest
6789,January,2021,Hamilton,IN,Passenger,2,0,2,34,36,5.56,Furthest
6790,January,2021,Randolph,NC,Passenger,1,0,1,6,7,14.29,Furthest
6791,January,2021,Snohomish,WA,Passenger,5177,1876,7053,538376,545429,1.29,Washington
6792,January,2021,Santa Clara,CA,Passenger,7,2,9,263,272,3.31,Nearest
6793,January,2021,Adams,WA,Passenger,10,6,16,12971,12987,0.12,Washington
6794,January,2021,Harris,TX,Passenger,1,1,2,209,211,0.95,Mid-Distance
6795,January,2021,Orange,FL,Passenger,1,0,1,112,113,0.88,Furthest
6796,January,2021,Nassau,NY,Passenger,4,0,4,27,31,12.9,Furthest
6797,January,2021,Boulder,CO,Passenger,0,1,1,43,44,2.27,Mid-Distance
6798,January,2021,Grays Harbor,WA,Truck,0,0,0,21244,21244,0.0,Washington
6799,January,2021,DeKalb,GA,Passenger,1,0,1,64,65,1.54,Furthest
6800,January,2021,Cowlitz,WA,Truck,0,0,0,28973,28973,0.0,Washington
6801,January,2021,Montgomery,OH,Passenger,0,1,1,53,54,1.85,Furthest
6802,January,2021,Pinellas,FL,Passenger,1,1,2,96,98,2.04,Furthest
6803,January,2021,Riverside,CA,Passenger,4,1,5,582,587,0.85,Nearest
6804,January,2021,Wichita,TX,Passenger,1,0,1,42,43,2.33,Mid-Distance
6805,January,2021,Frederick,MD,Passenger,1,1,2,69,71,2.82,Furthest
6806,January,2021,Charles,MD,Passenger,1,1,2,72,74,2.7,Furthest
6807,January,2021,Loudoun,VA,Passenger,1,0,1,73,74,1.35,Furthest
6808,January,2021,Cowlitz,WA,Passenger,188,129,317,72162,72479,0.44,Washington
6809,January,2021,Anne Arundel,MD,Passenger,3,1,4,400,404,0.99,Furthest
6810,January,2021,Garfield,WA,Truck,0,0,0,1003,1003,0.0,Washington
6811,January,2021,Manassas,VA,Passenger,0,1,1,5,6,16.67,Furthest
6812,January,2021,Hennepin,MN,Passenger,2,0,2,79,81,2.47,Mid-Distance
6813,January,2021,Montgomery,MD,Passenger,1,0,1,226,227,0.44,Furthest
6814,January,2021,Okanogan,WA,Truck,0,0,0,16594,16594,0.0,Washington
6815,January,2021,Jefferson,WA,Truck,0,0,0,9597,9597,0.0,Washington
6816,January,2021,Williams,ND,Passenger,0,1,1,10,11,9.09,Mid-Distance
6817,January,2021,Placer,CA,Passenger,2,0,2,81,83,2.41,Nearest
6818,January,2021,El Paso,CO,Passenger,2,0,2,689,691,0.29,Mid-Distance
6819,January,2021,Dallas,TX,Passenger,1,0,1,166,167,0.6,Mid-Distance
6820,January,2021,Oldham,KY,Passenger,0,1,1,4,5,20.0,Furthest
6821,January,2021,Houston,GA,Passenger,1,0,1,52,53,1.89,Furthest
6822,January,2021,Klamath,OR,Passenger,1,0,1,30,31,3.23,Nearest
6823,January,2021,Juneau,AK,Passenger,0,1,1,25,26,3.85,Nearest
6824,January,2021,Flathead,MT,Passenger,1,0,1,48,49,2.04,Nearest
6825,January,2021,Stevens,WA,Truck,0,0,0,18751,18751,0.0,Washington
6826,January,2021,Sevier,AR,Passenger,0,1,1,0,1,100.0,Mid-Distance
6827,January,2021,King,WA,Truck,6,1,7,184346,184353,0.0,Washington
6828,January,2021,Lewis,WA,Truck,0,0,0,26714,26714,0.0,Washington
6829,January,2021,Suffolk,MA,Passenger,0,2,2,30,32,6.25,Furthest
6830,January,2021,Palm Beach,FL,Passenger,0,1,1,72,73,1.37,Furthest
6832,January,2021,Klickitat,WA,Passenger,63,43,106,14989,15095,0.7,Washington
6833,January,2021,Nueces,TX,Passenger,1,0,1,81,82,1.22,Mid-Distance
6834,January,2021,Greene,MO,Passenger,0,1,1,32,33,3.03,Furthest
6835,January,2021,Washoe,NV,Passenger,1,0,1,99,100,1.0,Nearest
6836,January,2021,Travis,TX,Passenger,2,3,5,162,167,2.99,Mid-Distance
6837,January,2021,Clallam,WA,Passenger,281,190,471,49972,50443,0.93,Washington
6838,January,2021,Thurston,WA,Truck,0,0,0,56449,56449,0.0,Washington
6839,January,2021,St. Mary's,MD,Passenger,1,0,1,213,214,0.47,Furthest
6840,January,2021,Shelby,OH,Passenger,0,1,1,1,2,50.0,Furthest
6841,January,2021,Alexandria,VA,Passenger,2,0,2,133,135,1.48,Furthest
6842,January,2021,Bradley,TN,Passenger,1,0,1,0,1,100.0,Furthest
6843,January,2021,Pima,AZ,Passenger,2,1,3,309,312,0.96,Nearest
6844,January,2021,Walla Walla,WA,Truck,0,0,0,13897,13897,0.0,Washington
6845,January,2021,Arapahoe,CO,Passenger,1,0,1,120,121,0.83,Mid-Distance
6846,January,2021,Miami-Dade,FL,Passenger,1,0,1,97,98,1.02,Furthest
6847,January,2021,Clallam,WA,Truck,1,0,1,21869,21870,0.0,Washington
6848,January,2021,Pacific,WA,Truck,0,0,0,7802,7802,0.0,Washington
6849,January,2021,Carroll,MD,Passenger,0,1,1,20,21,4.76,Furthest
6850,January,2021,Morris,NJ,Passenger,1,0,1,16,17,5.88,Furthest
6851,January,2021,Mason,WA,Truck,0,0,0,21024,21024,0.0,Washington
6852,January,2021,Camden,NJ,Passenger,0,1,1,18,19,5.26,Furthest
6853,January,2021,Lewis,WA,Passenger,126,131,257,58904,59161,0.43,Washington
6854,January,2021,Hampshire,MA,Passenger,1,0,1,6,7,14.29,Furthest
6855,January,2021,Prince William,VA,Passenger,1,1,2,216,218,0.92,Furthest
6856,January,2021,Whatcom,WA,Truck,3,0,3,43603,43606,0.01,Washington
6857,January,2021,Whitman,WA,Passenger,51,46,97,21847,21944,0.44,Washington
6858,January,2021,Stafford,VA,Passenger,2,1,3,94,97,3.09,Furthest
6859,January,2021,Ferry,WA,Truck,0,0,0,3606,3606,0.0,Washington
6860,January,2021,Ventura,CA,Passenger,1,1,2,268,270,0.74,Nearest
6861,January,2021,Island,WA,Passenger,527,294,821,62983,63804,1.29,Washington
6862,January,2021,Platte,MO,Passenger,1,0,1,18,19,5.26,Furthest
6863,January,2021,Pend Oreille,WA,Passenger,12,3,15,9181,9196,0.16,Washington
6864,January,2021,Powhatan,VA,Passenger,1,0,1,1,2,50.0,Furthest
6865,January,2021,Asotin,WA,Passenger,16,13,29,12441,12470,0.23,Washington
6866,January,2021,Collin,TX,Passenger,1,1,2,115,117,1.71,Mid-Distance
6867,January,2021,Okanogan,WA,Passenger,56,36,92,26138,26230,0.35,Washington
6868,January,2021,Salt Lake,UT,Passenger,0,1,1,172,173,0.58,Nearest
6869,January,2021,Okaloosa,FL,Passenger,0,1,1,133,134,0.75,Furthest
6870,January,2021,Larimer,CO,Passenger,1,0,1,52,53,1.89,Mid-Distance
6871,January,2021,Washtenaw,MI,Passenger,1,0,1,31,32,3.12,Furthest
6872,January,2021,Leavenworth,KS,Passenger,0,1,1,121,122,0.82,Mid-Distance
6873,January,2021,Richmond,GA,Passenger,0,1,1,77,78,1.28,Furthest
6874,January,2021,Columbia,WA,Passenger,5,3,8,2452,2460,0.33,Washington
6875,January,2021,Vigo,IN,Passenger,1,0,1,6,7,14.29,Furthest
6876,January,2021,San Francisco,CA,Passenger,1,1,2,89,91,2.2,Nearest
6877,January,2021,Spokane,WA,Passenger,910,551,1461,320997,322458,0.45,Washington
6878,January,2021,Philadelphia,PA,Passenger,1,0,1,58,59,1.69,Furthest
6879,January,2021,Lincoln,WA,Truck,0,0,0,4693,4693,0.0,Washington
6880,January,2021,Clark,NV,Passenger,4,2,6,644,650,0.92,Nearest
6881,January,2021,Rogers,OK,Passenger,1,0,1,4,5,20.0,Mid-Distance
6882,January,2021,Monterey,CA,Passenger,0,1,1,150,151,0.66,Nearest
6883,January,2021,DuPage,IL,Passenger,2,0,2,54,56,3.57,Mid-Distance
6884,January,2021,Jones,GA,Passenger,1,0,1,1,2,50.0,Furthest
6885,January,2021,Garfield,WA,Passenger,0,2,2,1362,1364,0.15,Washington
6886,January,2021,Douglas,WA,Truck,0,0,0,12505,12505,0.0,Washington
6887,January,2021,Alameda,CA,Passenger,3,0,3,259,262,1.15,Nearest
6888,January,2021,Fort Bend,TX,Passenger,1,0,1,42,43,2.33,Mid-Distance
6889,January,2021,Stevens,WA,Passenger,37,40,77,30273,30350,0.25,Washington
6890,January,2021,Lake,IL,Passenger,2,0,2,158,160,1.25,Mid-Distance
6891,January,2021,Grant,WA,Passenger,87,84,171,66105,66276,0.26,Washington
6892,January,2021,San Juan,WA,Truck,0,0,0,5867,5867,0.0,Washington
6893,January,2021,Skagit,WA,Passenger,517,243,760,91439,92199,0.82,Washington
6894,January,2021,Dakota,MN,Passenger,0,1,1,26,27,3.7,Mid-Distance
6895,January,2021,Utah,UT,Passenger,0,1,1,124,125,0.8,Nearest
6896,January,2021,Polk,FL,Passenger,1,0,1,55,56,1.79,Furthest
6897,January,2021,Clark,WA,Passenger,2459,1211,3670,319410,323080,1.14,Washington
6898,January,2021,Tulsa,OK,Passenger,1,1,2,39,41,4.88,Mid-Distance
6899,January,2021,Pend Oreille,WA,Truck,0,0,0,5717,5717,0.0,Washington
6900,January,2021,Benton,WA,Passenger,453,358,811,135157,135968,0.6,Washington
6901,January,2021,Kittitas,WA,Truck,0,0,0,14675,14675,0.0,Washington
6902,January,2021,Charleston,SC,Passenger,2,0,2,85,87,2.3,Furthest
6903,January,2021,Saginaw,MI,Passenger,2,0,2,9,11,18.18,Furthest
6904,January,2021,Thurston,WA,Passenger,1350,796,2146,197459,199605,1.08,Washington
6905,January,2021,New York,NY,Passenger,1,0,1,52,53,1.89,Furthest
6906,January,2021,San Mateo,CA,Passenger,1,1,2,106,108,1.85,Nearest
6907,January,2021,Yakima,WA,Truck,0,0,0,61081,61081,0.0,Washington
6908,January,2021,Pierce,WA,Truck,0,0,0,144891,144891,0.0,Washington
6909,January,2021,Hudson,NJ,Passenger,1,0,1,40,41,2.44,Furthest
6910,January,2021,Kings,NY,Passenger,1,0,1,62,63,1.59,Furthest
6911,January,2021,Howard,MD,Passenger,0,1,1,63,64,1.56,Furthest
6912,January,2021,Fulton,GA,Passenger,0,2,2,86,88,2.27,Furthest
6913,January,2021,Kent,MI,Passenger,0,1,1,23,24,4.17,Furthest
6914,January,2021,Suffolk,VA,Passenger,1,0,1,124,125,0.8,Furthest
6915,January,2021,St. Louis,MO,Passenger,1,0,1,95,96,1.04,Furthest
6916,January,2021,Benton,WA,Truck,0,0,0,43331,43331,0.0,Washington
6917,January,2021,Middlesex,MA,Passenger,1,1,2,91,93,2.15,Furthest
6918,January,2021,Richland,SC,Passenger,0,1,1,140,141,0.71,Furthest
6919,January,2021,Franklin,WA,Truck,0,0,0,20491,20491,0.0,Washington
6920,January,2021,Fairfax,VA,Passenger,4,3,7,696,703,1.0,Furthest
6921,January,2021,Twin Falls,ID,Passenger,0,1,1,25,26,3.85,Nearest
6922,January,2021,Owyhee,ID,Passenger,1,0,1,3,4,25.0,Nearest
6923,January,2021,Goochland,VA,Passenger,4,3,7,240,247,2.83,Furthest
6924,January,2021,Milwaukee,WI,Passenger,1,0,1,39,40,2.5,Mid-Distance
6925,January,2021,Kitsap,WA,Passenger,1607,765,2372,179318,181690,1.31,Washington
6926,January,2021,Lincoln,WA,Passenger,6,12,18,7632,7650,0.24,Washington
6927,January,2021,Denver,CO,Passenger,1,0,1,116,117,0.85,Mid-Distance
6928,January,2021,Whatcom,WA,Passenger,1253,564,1817,150089,151906,1.2,Washington
6929,January,2021,Klickitat,WA,Truck,0,0,0,8117,8117,0.0,Washington
6930,January,2021,Kern,CA,Passenger,0,1,1,214,215,0.47,Nearest
6931,January,2021,Lake,FL,Passenger,1,0,1,21,22,4.55,Furthest
6932,January,2021,Boone,MO,Passenger,0,1,1,10,11,9.09,Furthest
6933,January,2021,Chelan,WA,Truck,0,0,0,22844,22844,0.0,Washington
6934,January,2021,Sacramento,CA,Passenger,2,0,2,232,234,0.85,Nearest
6935,January,2021,Sarasota,FL,Passenger,2,0,2,25,27,7.41,Furthest
6936,January,2021,Orange,CA,Passenger,4,3,7,440,447,1.57,Nearest
6937,January,2021,Hawaii,HI,Passenger,1,0,1,51,52,1.92,Nearest
6938,January,2021,Putnam,TN,Passenger,0,1,1,2,3,33.33,Furthest
6939,January,2021,Cascade,MT,Passenger,0,1,1,54,55,1.82,Nearest
6940,January,2021,Skamania,WA,Truck,0,0,0,4017,4017,0.0,Washington
6941,January,2021,Fresno,CA,Passenger,1,0,1,170,171,0.58,Nearest
6942,January,2021,Franklin,WA,Passenger,89,85,174,61500,61674,0.28,Washington
6943,January,2021,Walla Walla,WA,Passenger,103,68,171,36164,36335,0.47,Washington
6944,January,2021,New Haven,CT,Passenger,0,2,2,35,37,5.41,Furthest
6945,January,2021,Calvert,MD,Passenger,0,2,2,85,87,2.3,Furthest
6946,January,2021,Clark,WA,Truck,0,0,0,83564,83564,0.0,Washington
6947,January,2021,Douglas,NE,Passenger,1,1,2,51,53,3.77,Mid-Distance
6948,January,2021,Bucks,PA,Passenger,1,0,1,18,19,5.26,Furthest
6949,January,2021,Skagit,WA,Truck,1,0,1,32861,32862,0.0,Washington
6950,January,2021,Gwinnett,GA,Passenger,1,0,1,66,67,1.49,Furthest
6951,January,2021,Plaquemines,LA,Passenger,0,1,1,14,15,6.67,Mid-Distance
6952,January,2021,Snohomish,WA,Truck,1,0,1,125692,125693,0.0,Washington
6953,January,2021,Montgomery,TX,Passenger,1,0,1,46,47,2.13,Mid-Distance
6954,January,2021,Rockingham,NH,Passenger,1,0,1,22,23,4.35,Furthest
6955,January,2021,Maricopa,AZ,Passenger,5,5,10,1286,1296,0.77,Nearest
6956,January,2021,Ray,MO,Passenger,0,1,1,1,2,50.0,Furthest
6957,January,2021,Honolulu,HI,Passenger,5,2,7,416,423,1.65,Nearest
6958,January,2021,San Diego,CA,Passenger,13,5,18,2686,2704,0.67,Nearest
6959,January,2021,Chelan,WA,Passenger,294,87,381,54481,54862,0.69,Washington
6960,January,2021,Jefferson,WA,Passenger,290,166,456,24802,25258,1.81,Washington
6961,January,2021,Howard,IN,Passenger,0,1,1,3,4,25.0,Furthest
6962,January,2021,New London,CT,Passenger,1,2,3,229,232,1.29,Furthest
6963,January,2021,El Dorado,CA,Passenger,1,0,1,32,33,3.03,Nearest
6964,January,2021,Duval,FL,Passenger,0,2,2,352,354,0.56,Furthest
6965,January,2021,Clackamas,OR,Passenger,3,0,3,177,180,1.67,Nearest
6966,January,2021,DeKalb,IN,Passenger,1,0,1,0,1,100.0,Furthest
6967,January,2021,Pacific,WA,Passenger,35,37,72,15798,15870,0.45,Washington
6968,January,2021,Montgomery,PA,Passenger,1,0,1,26,27,3.7,Furthest
6969,January,2021,Douglas,WA,Passenger,84,46,130,28199,28329,0.46,Washington
6970,January,2021,Arlington,VA,Passenger,0,1,1,137,138,0.72,Furthest
6971,January,2021,District of Columbia,DC,Passenger,3,1,4,201,205,1.95,Furthest
6972,January,2021,Spartanburg,SC,Passenger,0,1,1,50,51,1.96,Furthest
6973,January,2021,RÃ­o Grande,PR,Passenger,1,0,1,1,2,50.0,Mid-Distance
6974,January,2021,Kitsap,WA,Truck,0,0,0,54300,54300,0.0,Washington
6975,January,2021,Kittitas,WA,Passenger,134,52,186,29834,30020,0.62,Washington
6976,January,2021,Monroe,IL,Passenger,1,0,1,3,4,25.0,Mid-Distance
6977,January,2021,Harnett,NC,Passenger,1,0,1,182,183,0.55,Furthest
6978,January,2021,Carroll,NH,Passenger,0,1,1,5,6,16.67,Furthest
6979,January,2021,Portsmouth,VA,Passenger,0,1,1,76,77,1.3,Furthest
6980,January,2021,Penobscot,ME,Passenger,0,1,1,9,10,10.0,Furthest
6981,January,2021,Cape May,NJ,Passenger,0,1,1,9,10,10.0,Furthest
6982,January,2021,Williamson,TX,Passenger,0,2,2,120,122,1.64,Mid-Distance
6983,January,2021,Erie,NY,Passenger,1,0,1,43,44,2.27,Furthest
6984,January,2021,Sumter,FL,Passenger,0,1,1,10,11,9.09,Furthest
6985,January,2021,Multnomah,OR,Passenger,3,5,8,671,679,1.18,Nearest
6986,January,2021,Queens,NY,Passenger,1,0,1,50,51,1.96,Furthest
6987,January,2021,Ferry,WA,Passenger,9,3,12,4341,4353,0.28,Washington
6988,January,2021,Wahkiakum,WA,Passenger,7,6,13,3040,3053,0.43,Washington
6989,January,2021,Pennington,SD,Passenger,1,0,1,34,35,2.86,Mid-Distance
6990,January,2021,Prince George's,MD,Passenger,2,1,3,144,147,2.04,Furthest
6991,January,2021,Broward,FL,Passenger,2,1,3,106,109,2.75,Furthest
6992,January,2021,San Joaquin,CA,Passenger,1,0,1,107,108,0.93,Nearest
6993,January,2021,Maui,HI,Passenger,1,0,1,26,27,3.7,Nearest
6994,January,2021,Nassau,FL,Passenger,1,0,1,34,35,2.86,Furthest
6995,January,2021,Washington,OR,Passenger,1,0,1,401,402,0.25,Nearest
6996,January,2021,Ramsey,MN,Passenger,1,0,1,34,35,2.86,Mid-Distance
6997,January,2021,Santa Cruz,CA,Passenger,1,0,1,27,28,3.57,Nearest
6998,January,2021,Solano,CA,Passenger,1,0,1,198,199,0.5,Nearest
6999,January,2021,Island,WA,Truck,0,0,0,21409,21409,0.0,Washington
7000,January,2021,Carson City,NV,Passenger,1,0,1,12,13,7.69,Nearest
7001,January,2021,Columbia,WA,Truck,0,0,0,1547,1547,0.0,Washington
7002,January,2021,Spokane,WA,Truck,0,0,0,100880,100880,0.0,Washington
7003,January,2021,Ulster,NY,Passenger,1,0,1,7,8,12.5,Furthest
7004,January,2021,Chesapeake,VA,Passenger,0,3,3,401,404,0.74,Furthest
7005,January,2021,Kauai,HI,Passenger,1,0,1,14,15,6.67,Nearest
7006,January,2021,Douglas,CO,Passenger,0,1,1,78,79,1.27,Mid-Distance
7007,January,2021,Cumberland,NC,Passenger,0,2,2,440,442,0.45,Furthest
7008,January,2021,King,WA,Passenger,27793,8324,36117,1367229,1403346,2.57,Washington
7009,January,2021,Bartow,GA,Passenger,0,1,1,4,5,20.0,Furthest
7010,January,2022,Hillsborough,FL,Passenger,0,1,1,132,133,0.75,Furthest
7011,January,2022,Ray,MO,Passenger,0,1,1,1,2,50.0,Furthest
7012,January,2022,Douglas,WA,Passenger,118,56,174,28586,28760,0.61,Washington
7013,January,2022,Rogers,OK,Passenger,1,0,1,2,3,33.33,Mid-Distance
7014,January,2022,New London,CT,Passenger,1,4,5,211,216,2.31,Furthest
7015,January,2022,Howard,MD,Passenger,0,1,1,55,56,1.79,Furthest
7016,January,2022,Duval,FL,Passenger,0,2,2,301,303,0.66,Furthest
7017,January,2022,Montgomery,TX,Passenger,1,1,2,31,33,6.06,Mid-Distance
7018,January,2022,Whatcom,WA,Truck,3,0,3,43614,43617,0.01,Washington
7019,January,2022,Asotin,WA,Truck,0,0,0,6736,6736,0.0,Washington
7020,January,2022,Orange,FL,Passenger,1,0,1,99,100,1.0,Furthest
7021,January,2022,Onslow,NC,Passenger,0,1,1,167,168,0.6,Furthest
7022,January,2022,Garfield,WA,Truck,0,0,0,995,995,0.0,Washington
7023,January,2022,Williams,ND,Passenger,0,1,1,8,9,11.11,Mid-Distance
7024,January,2022,San Joaquin,CA,Passenger,1,1,2,90,92,2.17,Nearest
7025,January,2022,Flathead,MT,Passenger,1,0,1,37,38,2.63,Nearest
7026,January,2022,Whatcom,WA,Passenger,1665,673,2338,149528,151866,1.54,Washington
7027,January,2022,King,WA,Passenger,36353,10406,46759,1356535,1403294,3.33,Washington
7028,January,2022,Walla Walla,WA,Passenger,146,89,235,36290,36525,0.64,Washington
7029,January,2022,Stevens,WA,Passenger,58,47,105,30190,30295,0.35,Washington
7030,January,2022,Clark,WA,Passenger,3541,1572,5113,319486,324599,1.58,Washington
7031,January,2022,Monterey,CA,Passenger,0,1,1,134,135,0.74,Nearest
7032,January,2022,Anchorage,AK,Passenger,1,0,1,122,123,0.81,Nearest
7033,January,2022,Owyhee,ID,Passenger,1,0,1,2,3,33.33,Nearest
7034,January,2022,San Juan,WA,Passenger,482,151,633,14173,14806,4.28,Washington
7035,January,2022,Frederick,MD,Passenger,1,1,2,68,70,2.86,Furthest
7036,January,2022,King,WA,Truck,14,1,15,182672,182687,0.01,Washington
7037,January,2022,Anne Arundel,MD,Passenger,4,3,7,353,360,1.94,Furthest
7038,January,2022,El Paso,CO,Passenger,3,0,3,641,644,0.47,Mid-Distance
7039,January,2022,Chelan,WA,Truck,0,0,0,23062,23062,0.0,Washington
7040,January,2022,Carroll,MD,Passenger,0,1,1,15,16,6.25,Furthest
7041,January,2022,Cowlitz,WA,Truck,0,1,1,28923,28924,0.0,Washington
7042,January,2022,Cape May,NJ,Passenger,0,1,1,8,9,11.11,Furthest
7043,January,2022,Snohomish,WA,Truck,3,0,3,125304,125307,0.0,Washington
7044,January,2022,Louisa,VA,Passenger,0,1,1,1,2,50.0,Furthest
7045,January,2022,Lewis,WA,Passenger,213,165,378,59516,59894,0.63,Washington
7046,January,2022,District of Columbia,DC,Passenger,5,0,5,185,190,2.63,Furthest
7047,January,2022,Sonoma,CA,Passenger,0,1,1,75,76,1.32,Nearest
7048,January,2022,Gwinnett,GA,Passenger,1,0,1,56,57,1.75,Furthest
7049,January,2022,Richmond,GA,Passenger,0,1,1,70,71,1.41,Furthest
7050,January,2022,Okanogan,WA,Passenger,70,47,117,26533,26650,0.44,Washington
7051,January,2022,New Haven,CT,Passenger,0,2,2,30,32,6.25,Furthest
7052,January,2022,Bartow,GA,Passenger,0,1,1,3,4,25.0,Furthest
7053,January,2022,Salt Lake,UT,Passenger,1,1,2,149,151,1.32,Nearest
7054,January,2022,Spokane,WA,Truck,0,0,0,102647,102647,0.0,Washington
7055,January,2022,Goochland,VA,Passenger,3,2,5,172,177,2.82,Furthest
7056,January,2022,Pennington,SD,Passenger,2,0,2,29,31,6.45,Mid-Distance
7057,January,2022,Kings,NY,Passenger,1,0,1,66,67,1.49,Furthest
7058,January,2022,Bexar,TX,Passenger,3,4,7,474,481,1.46,Mid-Distance
7059,January,2022,Yakima,WA,Passenger,294,177,471,168293,168764,0.28,Washington
7060,January,2022,Clackamas,OR,Passenger,2,0,2,157,159,1.26,Nearest
7061,January,2022,Hidalgo,TX,Passenger,0,1,1,53,54,1.85,Mid-Distance
7062,January,2022,Las Animas,CO,Passenger,1,0,1,1,2,50.0,Mid-Distance
7063,January,2022,Carroll,NH,Passenger,0,1,1,5,6,16.67,Furthest
7064,January,2022,Elmore,ID,Passenger,1,0,1,15,16,6.25,Nearest
7065,January,2022,Skamania,WA,Passenger,60,43,103,8316,8419,1.22,Washington
7066,January,2022,St. Tammany,LA,Passenger,1,0,1,38,39,2.56,Mid-Distance
7067,January,2022,Charles,MD,Passenger,1,1,2,64,66,3.03,Furthest
7068,January,2022,Jefferson,WA,Passenger,385,197,582,24693,25275,2.3,Washington
7069,January,2022,Walla Walla,WA,Truck,0,0,0,14104,14104,0.0,Washington
7070,January,2022,Arlington,VA,Passenger,1,0,1,130,131,0.76,Furthest
7071,January,2022,Richland,SC,Passenger,0,1,1,126,127,0.79,Furthest
7072,January,2022,Orange,CA,Passenger,5,2,7,379,386,1.81,Nearest
7073,January,2022,Sedgwick,KS,Passenger,1,1,2,82,84,2.38,Mid-Distance
7074,January,2022,San Francisco,CA,Passenger,0,1,1,77,78,1.28,Nearest
7075,January,2022,Burlington,NJ,Passenger,0,1,1,116,117,0.85,Furthest
7076,January,2022,Island,WA,Passenger,734,344,1078,62598,63676,1.69,Washington
7077,January,2022,Kitsap,WA,Truck,0,0,0,54155,54155,0.0,Washington
7078,January,2022,Randolph,NC,Passenger,1,0,1,5,6,16.67,Furthest
7079,January,2022,Benton,WA,Passenger,654,453,1107,135958,137065,0.81,Washington
7080,January,2022,Thurston,WA,Truck,3,0,3,55934,55937,0.01,Washington
7081,January,2022,Harnett,NC,Passenger,1,1,2,143,145,1.38,Furthest
7082,January,2022,Calvert,MD,Passenger,0,2,2,79,81,2.47,Furthest
7083,January,2022,Miami-Dade,FL,Passenger,1,0,1,88,89,1.12,Furthest
7084,January,2022,RÃ­o Grande,PR,Passenger,1,0,1,0,1,100.0,Mid-Distance
7085,January,2022,Norfolk,VA,Passenger,3,3,6,301,307,1.95,Furthest
7086,January,2022,Boulder,CO,Passenger,1,1,2,36,38,5.26,Mid-Distance
7087,January,2022,El Paso,TX,Passenger,2,0,2,344,346,0.58,Mid-Distance
7088,January,2022,Mason,WA,Truck,0,0,0,21187,21187,0.0,Washington
7089,January,2022,Larimer,CO,Passenger,1,0,1,49,50,2.0,Mid-Distance
7090,January,2022,Nueces,TX,Passenger,1,1,2,61,63,3.17,Mid-Distance
7091,January,2022,Dallas,TX,Passenger,1,0,1,129,130,0.77,Mid-Distance
7092,January,2022,Solano,CA,Passenger,1,0,1,172,173,0.58,Nearest
7093,January,2022,Alameda,CA,Passenger,4,0,4,204,208,1.92,Nearest
7094,January,2022,Kitsap,WA,Passenger,2191,970,3161,179910,183071,1.73,Washington
7095,January,2022,St. Clair,IL,Passenger,2,0,2,119,121,1.65,Mid-Distance
7096,January,2022,Santa Clara,CA,Passenger,8,1,9,228,237,3.8,Nearest
7097,January,2022,Benton,WA,Truck,0,0,0,43600,43600,0.0,Washington
7098,January,2022,Pierce,WA,Passenger,4367,2153,6520,554116,560636,1.16,Washington
7099,January,2022,Portsmouth,VA,Passenger,0,1,1,76,77,1.3,Furthest
7100,January,2022,Pierce,WA,Truck,0,0,0,144454,144454,0.0,Washington
7101,January,2022,Hamilton,OH,Passenger,1,0,1,30,31,3.23,Furthest
7102,January,2022,Cumberland,NC,Passenger,1,2,3,385,388,0.77,Furthest
7103,January,2022,Plaquemines,LA,Passenger,0,1,1,17,18,5.56,Mid-Distance
7104,January,2022,Washington,MD,Passenger,2,0,2,14,16,12.5,Furthest
7105,January,2022,Suffolk,VA,Passenger,1,0,1,120,121,0.83,Furthest
7106,January,2022,Howard,IN,Passenger,0,1,1,6,7,14.29,Furthest
7107,January,2022,Harrison,MS,Passenger,2,0,2,43,45,4.44,Mid-Distance
7108,January,2022,Kittitas,WA,Truck,0,0,0,14768,14768,0.0,Washington
7109,January,2022,Wake,NC,Passenger,1,0,1,103,104,0.96,Furthest
7110,January,2022,Virginia Beach,VA,Passenger,2,0,2,556,558,0.36,Furthest
7111,January,2022,Williamson,TX,Passenger,1,2,3,88,91,3.3,Mid-Distance
7112,January,2022,Pacific,WA,Passenger,55,63,118,16055,16173,0.73,Washington
7114,January,2022,Moore,NC,Passenger,0,1,1,122,123,0.81,Furthest
7115,January,2022,Grant,WA,Truck,0,0,0,27996,27996,0.0,Washington
7116,January,2022,Shelby,OH,Passenger,0,1,1,2,3,33.33,Furthest
7117,January,2022,Clallam,WA,Passenger,391,241,632,50236,50868,1.24,Washington
7118,January,2022,Klamath,OR,Passenger,1,0,1,28,29,3.45,Nearest
7119,January,2022,Broward,FL,Passenger,2,0,2,91,93,2.15,Furthest
7120,January,2022,Prince William,VA,Passenger,1,1,2,200,202,0.99,Furthest
7121,January,2022,Penobscot,ME,Passenger,0,1,1,7,8,12.5,Furthest
7122,January,2022,Wilson,NC,Passenger,1,0,1,0,1,100.0,Furthest
7123,January,2022,Garfield,WA,Passenger,0,3,3,1356,1359,0.22,Washington
7124,January,2022,Placer,CA,Passenger,2,0,2,71,73,2.74,Nearest
7125,January,2022,San Mateo,CA,Passenger,2,0,2,77,79,2.53,Nearest
7126,January,2022,Philadelphia,PA,Passenger,1,0,1,35,36,2.78,Furthest
7127,January,2022,Franklin,WA,Truck,0,0,0,20891,20891,0.0,Washington
7128,January,2022,Ferry,WA,Passenger,14,3,17,4436,4453,0.38,Washington
7129,January,2022,Carson City,NV,Passenger,1,0,1,8,9,11.11,Nearest
7130,January,2022,San Juan,WA,Truck,1,0,1,6022,6023,0.02,Washington
7131,January,2022,Montgomery,PA,Passenger,2,0,2,22,24,8.33,Furthest
7132,January,2022,Chelan,WA,Passenger,421,117,538,54587,55125,0.98,Washington
7133,January,2022,Thurston,WA,Passenger,1920,973,2893,196481,199374,1.45,Washington
7134,January,2022,Clark,NV,Passenger,4,2,6,551,557,1.08,Nearest
7135,January,2022,Klickitat,WA,Passenger,90,54,144,15313,15457,0.93,Washington
7136,January,2022,Kittitas,WA,Passenger,216,71,287,29812,30099,0.95,Washington
7137,January,2022,Clark,WA,Truck,2,0,2,83892,83894,0.0,Washington
7138,January,2022,Baltimore,MD,Passenger,1,0,1,79,80,1.25,Furthest
7139,January,2022,Grays Harbor,WA,Passenger,197,158,355,49346,49701,0.71,Washington
7140,January,2022,Sarpy,NE,Passenger,1,0,1,57,58,1.72,Mid-Distance
7141,January,2022,Allen,IN,Passenger,1,0,1,14,15,6.67,Furthest
7142,January,2022,Adams,WA,Truck,0,0,0,5434,5434,0.0,Washington
7143,January,2022,Essex,NJ,Passenger,2,0,2,10,12,16.67,Furthest
7144,January,2022,Wood,OH,Passenger,0,1,1,4,5,20.0,Furthest
7145,January,2022,Queens,NY,Passenger,1,0,1,49,50,2.0,Furthest
7146,January,2022,Montgomery,MD,Passenger,3,2,5,195,200,2.5,Furthest
7147,January,2022,Yakima,WA,Truck,0,0,0,61615,61615,0.0,Washington
7148,January,2022,Pinellas,FL,Passenger,0,1,1,84,85,1.18,Furthest
7149,January,2022,Skagit,WA,Passenger,701,307,1008,90876,91884,1.1,Washington
7150,January,2022,Clallam,WA,Truck,1,0,1,22143,22144,0.0,Washington
7151,January,2022,DuPage,IL,Passenger,1,0,1,49,50,2.0,Mid-Distance
7152,January,2022,Marin,CA,Passenger,0,1,1,31,32,3.12,Nearest
7153,January,2022,Lake,FL,Passenger,1,0,1,22,23,4.35,Furthest
7154,January,2022,Honolulu,HI,Passenger,4,4,8,341,349,2.29,Nearest
7155,January,2022,Yamhill,OR,Passenger,1,0,1,30,31,3.23,Nearest
7156,January,2022,Juneau,AK,Passenger,0,1,1,28,29,3.45,Nearest
7157,January,2022,Travis,TX,Passenger,1,0,1,123,124,0.81,Mid-Distance
7158,January,2022,Fort Bend,TX,Passenger,1,0,1,31,32,3.12,Mid-Distance
7159,January,2022,Lee,FL,Passenger,1,0,1,28,29,3.45,Furthest
7160,January,2022,Sumter,SC,Passenger,0,1,1,34,35,2.86,Furthest
7161,January,2022,Hawaii,HI,Passenger,1,0,1,37,38,2.63,Nearest
7162,January,2022,Hudson,NJ,Passenger,2,0,2,36,38,5.26,Furthest
7163,January,2022,Champaign,IL,Passenger,1,0,1,10,11,9.09,Mid-Distance
7164,January,2022,Lewis,WA,Truck,0,0,0,26654,26654,0.0,Washington
7165,January,2022,Maricopa,AZ,Passenger,7,2,9,1014,1023,0.88,Nearest
7166,January,2022,Nassau,NY,Passenger,2,0,2,25,27,7.41,Furthest
7167,January,2022,Okaloosa,FL,Passenger,0,1,1,105,106,0.94,Furthest
7168,January,2022,Adams,WA,Passenger,17,14,31,13041,13072,0.24,Washington
7169,January,2022,Oldham,KY,Passenger,0,1,1,4,5,20.0,Furthest
7170,January,2022,Wichita,TX,Passenger,1,0,1,41,42,2.38,Mid-Distance
7171,January,2022,Albemarle,VA,Passenger,1,0,1,18,19,5.26,Furthest
7172,January,2022,Los Angeles,CA,Passenger,10,7,17,817,834,2.04,Nearest
7173,January,2022,Jefferson,WA,Truck,0,0,0,9571,9571,0.0,Washington
7174,January,2022,Rockingham,NH,Passenger,1,0,1,17,18,5.56,Furthest
7175,January,2022,Pend Oreille,WA,Passenger,17,9,26,9118,9144,0.28,Washington
7176,January,2022,Richmond,NY,Passenger,1,0,1,6,7,14.29,Furthest
7177,January,2022,Middlesex,MA,Passenger,0,1,1,83,84,1.19,Furthest
7178,January,2022,Cook,IL,Passenger,2,0,2,191,193,1.04,Mid-Distance
7179,January,2022,Leavenworth,KS,Passenger,0,1,1,105,106,0.94,Mid-Distance
7180,January,2022,Cowlitz,WA,Passenger,273,164,437,71316,71753,0.61,Washington
7181,January,2022,San Diego,CA,Passenger,15,8,23,2380,2403,0.96,Nearest
7182,January,2022,Franklin,WA,Passenger,169,101,270,62152,62422,0.43,Washington
7183,January,2022,Stafford,VA,Passenger,2,1,3,90,93,3.23,Furthest
7184,January,2022,Columbia,WA,Truck,0,0,0,1557,1557,0.0,Washington
7185,January,2022,San Bernardino,CA,Passenger,1,1,2,349,351,0.57,Nearest
7186,January,2022,Fairfax,VA,Passenger,3,3,6,637,643,0.93,Furthest
7187,January,2022,Jefferson,NY,Passenger,0,1,1,201,202,0.5,Furthest
7188,January,2022,Stevens,WA,Truck,0,0,0,18938,18938,0.0,Washington
7189,January,2022,Fresno,CA,Passenger,1,0,1,154,155,0.65,Nearest
7190,January,2022,Lincoln,WA,Truck,0,0,0,4835,4835,0.0,Washington
7191,January,2022,Sacramento,CA,Passenger,2,0,2,204,206,0.97,Nearest
7192,January,2022,Escambia,FL,Passenger,0,1,1,136,137,0.73,Furthest
7193,January,2022,Denton,TX,Passenger,1,0,1,70,71,1.41,Mid-Distance
7194,January,2022,Wahkiakum,WA,Truck,0,0,0,1816,1816,0.0,Washington
7195,January,2022,Yellowstone,MT,Passenger,0,1,1,32,33,3.03,Nearest
7196,January,2022,Riverside,CA,Passenger,5,1,6,490,496,1.21,Nearest
7197,January,2022,Okanogan,WA,Truck,0,0,0,16692,16692,0.0,Washington
7198,January,2022,Island,WA,Truck,1,0,1,21481,21482,0.0,Washington
7199,January,2022,Vigo,IN,Passenger,1,0,1,5,6,16.67,Furthest
7200,January,2022,Charleston,SC,Passenger,2,1,3,70,73,4.11,Furthest
7201,January,2022,Pend Oreille,WA,Truck,0,0,0,5731,5731,0.0,Washington
7202,January,2022,Loudoun,VA,Passenger,1,0,1,66,67,1.49,Furthest
7203,January,2022,Columbia,WA,Passenger,6,2,8,2452,2460,0.33,Washington
7204,January,2022,Houston,GA,Passenger,1,0,1,40,41,2.44,Furthest
7205,January,2022,Snohomish,WA,Passenger,7221,2278,9499,536658,546157,1.74,Washington
7206,January,2022,Ferry,WA,Truck,0,0,0,3582,3582,0.0,Washington
7207,January,2022,Spokane,WA,Passenger,1350,766,2116,326674,328790,0.64,Washington
7208,January,2022,Alexandria,VA,Passenger,2,0,2,111,113,1.77,Furthest
7209,January,2022,Douglas,NE,Passenger,1,2,3,46,49,6.12,Mid-Distance
7210,January,2022,Manassas,VA,Passenger,0,1,1,7,8,12.5,Furthest
7211,January,2022,Tarrant,TX,Passenger,1,0,1,126,127,0.79,Mid-Distance
7212,January,2022,Skagit,WA,Truck,1,0,1,32658,32659,0.0,Washington
7213,January,2022,Danville,VA,Passenger,1,0,1,0,1,100.0,Furthest
7214,January,2022,Kern,CA,Passenger,0,1,1,195,196,0.51,Nearest
7215,January,2022,Douglas,CO,Passenger,0,1,1,75,76,1.32,Mid-Distance
7216,January,2022,Suffolk,MA,Passenger,0,2,2,24,26,7.69,Furthest
7217,January,2022,Harris,TX,Passenger,1,0,1,159,160,0.62,Mid-Distance
7218,January,2022,Galveston,TX,Passenger,0,1,1,20,21,4.76,Mid-Distance
7219,January,2022,New York,NY,Passenger,1,0,1,36,37,2.7,Furthest
7220,January,2022,Whitman,WA,Truck,0,0,0,8565,8565,0.0,Washington
7221,January,2022,San Luis Obispo,CA,Passenger,1,0,1,55,56,1.79,Nearest
7222,January,2022,Wahkiakum,WA,Passenger,17,11,28,3075,3103,0.9,Washington
7223,January,2022,Rockdale,GA,Passenger,1,0,1,7,8,12.5,Furthest
7224,January,2022,Dorchester,SC,Passenger,1,0,1,63,64,1.56,Furthest
7225,January,2022,Powhatan,VA,Passenger,1,0,1,1,2,50.0,Furthest
7226,January,2022,Fairbanks North Star,AK,Passenger,0,1,1,76,77,1.3,Nearest
7227,January,2022,Lincoln,OR,Passenger,0,1,1,32,33,3.03,Nearest
7228,January,2022,Grays Harbor,WA,Truck,0,0,0,21347,21347,0.0,Washington
7229,January,2022,Boone,MO,Passenger,0,1,1,9,10,10.0,Furthest
7230,January,2022,Lincoln,WA,Passenger,6,17,23,7738,7761,0.3,Washington
7231,January,2022,Ventura,CA,Passenger,2,1,3,237,240,1.25,Nearest
7232,January,2022,Saratoga,NY,Passenger,1,0,1,39,40,2.5,Furthest
7233,January,2022,Coryell,TX,Passenger,1,0,1,103,104,0.96,Mid-Distance
7234,January,2022,Asotin,WA,Passenger,23,17,40,12668,12708,0.31,Washington
7235,January,2022,Hennepin,MN,Passenger,3,0,3,62,65,4.62,Mid-Distance
7236,January,2022,Contra Costa,CA,Passenger,1,4,5,255,260,1.92,Nearest
7237,January,2022,Santa Cruz,CA,Passenger,1,0,1,23,24,4.17,Nearest
7238,January,2022,Allegheny,PA,Passenger,1,1,2,55,57,3.51,Furthest
7239,January,2022,Erie,NY,Passenger,1,0,1,30,31,3.23,Furthest
7240,January,2022,Camden,NJ,Passenger,0,1,1,13,14,7.14,Furthest
7241,January,2022,Douglas,WA,Truck,0,0,0,12682,12682,0.0,Washington
7242,January,2022,Geary,KS,Passenger,1,0,1,91,92,1.09,Mid-Distance
7243,January,2022,Collin,TX,Passenger,1,0,1,100,101,0.99,Mid-Distance
7244,January,2022,Chesapeake,VA,Passenger,2,3,5,366,371,1.35,Furthest
7245,January,2022,Grant,WA,Passenger,140,100,240,66811,67051,0.36,Washington
7246,January,2022,Pima,AZ,Passenger,1,1,2,246,248,0.81,Nearest
7247,January,2022,Ulster,NY,Passenger,1,0,1,9,10,10.0,Furthest
7248,January,2022,Kauai,HI,Passenger,1,0,1,17,18,5.56,Nearest
7249,January,2022,Platte,MO,Passenger,1,0,1,17,18,5.56,Furthest
7250,January,2022,Mason,WA,Passenger,272,161,433,47766,48199,0.9,Washington
7251,January,2022,Multnomah,OR,Passenger,1,4,5,587,592,0.84,Nearest
7252,January,2022,DeKalb,GA,Passenger,1,0,1,54,55,1.82,Furthest
7253,January,2022,St. Louis,MO,Passenger,1,0,1,72,73,1.37,Furthest
7254,January,2022,Pacific,WA,Truck,0,0,0,8024,8024,0.0,Washington
7255,January,2022,Spartanburg,SC,Passenger,0,1,1,47,48,2.08,Furthest
7256,January,2022,Kings,CA,Passenger,2,1,3,317,320,0.94,Nearest
7257,January,2022,Lake,IL,Passenger,3,0,3,149,152,1.97,Mid-Distance
7258,January,2022,Prince George's,MD,Passenger,2,1,3,138,141,2.13,Furthest
7259,January,2022,Sevier,AR,Passenger,0,1,1,0,1,100.0,Mid-Distance
7260,January,2022,Skamania,WA,Truck,0,0,0,3990,3990,0.0,Washington
7261,January,2022,Wilson,TX,Passenger,0,1,1,2,3,33.33,Mid-Distance
7262,January,2022,Bell,TX,Passenger,1,0,1,337,338,0.3,Mid-Distance
7263,January,2022,St. Mary's,MD,Passenger,1,0,1,200,201,0.5,Furthest
7264,January,2022,Whitman,WA,Passenger,69,58,127,21971,22098,0.57,Washington
7265,January,2022,Hamilton,IN,Passenger,2,0,2,21,23,8.7,Furthest
7266,January,2022,Greene,MO,Passenger,0,1,1,24,25,4.0,Furthest
7267,January,2022,Klickitat,WA,Truck,0,0,0,8335,8335,0.0,Washington
7268,January,2022,Lane,OR,Passenger,0,1,1,104,105,0.95,Nearest
7269,January,2022,Sarasota,FL,Passenger,2,0,2,28,30,6.67,Furthest
7270,January,2023,St. Mary's,MD,Passenger,1,0,1,169,170,0.59,Furthest
7271,January,2023,Chelan,WA,Truck,15,0,15,23105,23120,0.06,Washington
7272,January,2023,Hawaii,HI,Passenger,1,0,1,25,26,3.85,Nearest
7273,January,2023,Randolph,NC,Passenger,1,0,1,4,5,20.0,Furthest
7274,January,2023,Sarasota,FL,Passenger,1,0,1,16,17,5.88,Furthest
7275,January,2023,San Joaquin,CA,Passenger,1,0,1,74,75,1.33,Nearest
7276,January,2023,Clark,WA,Passenger,5070,2078,7148,314583,321731,2.22,Washington
7277,January,2023,Island,WA,Passenger,955,401,1356,61553,62909,2.16,Washington
7278,January,2023,Harnett,NC,Passenger,2,0,2,129,131,1.53,Furthest
7279,January,2023,Douglas,NE,Passenger,2,1,3,28,31,9.68,Mid-Distance
7280,January,2023,Hamilton,OH,Passenger,1,0,1,25,26,3.85,Furthest
7281,January,2023,Rock Island,IL,Passenger,0,1,1,14,15,6.67,Mid-Distance
7282,January,2023,Williamson,TX,Passenger,0,2,2,58,60,3.33,Mid-Distance
7283,January,2023,Allegheny,PA,Passenger,1,0,1,48,49,2.04,Furthest
7284,January,2023,Santa Clara,CA,Passenger,9,2,11,167,178,6.18,Nearest
7285,January,2023,Berkeley,SC,Passenger,0,1,1,108,109,0.92,Furthest
7286,January,2023,Kent,DE,Passenger,1,0,1,48,49,2.04,Furthest
7287,January,2023,Richmond,GA,Passenger,0,1,1,58,59,1.69,Furthest
7288,January,2023,Rockdale,GA,Passenger,1,0,1,6,7,14.29,Furthest
7289,January,2023,Prince George's,MD,Passenger,3,1,4,110,114,3.51,Furthest
7290,January,2023,Yellowstone,MT,Passenger,0,1,1,16,17,5.88,Nearest
7291,January,2023,San Juan,WA,Truck,9,0,9,5904,5913,0.15,Washington
7292,January,2023,Skamania,WA,Passenger,93,53,146,8110,8256,1.77,Washington
7293,January,2023,Whatcom,WA,Truck,37,0,37,42986,43023,0.09,Washington
7294,January,2023,Danville,VA,Passenger,1,0,1,0,1,100.0,Furthest
7295,January,2023,Harris,TX,Passenger,1,0,1,118,119,0.84,Mid-Distance
7296,January,2023,Whitman,WA,Passenger,120,70,190,22014,22204,0.86,Washington
7297,January,2023,Montgomery,PA,Passenger,1,0,1,17,18,5.56,Furthest
7298,January,2023,Harrison,MS,Passenger,1,0,1,32,33,3.03,Mid-Distance
7299,January,2023,Okaloosa,FL,Passenger,0,1,1,89,90,1.11,Furthest
7300,January,2023,St. Louis,MO,Passenger,1,0,1,51,52,1.92,Furthest
7301,January,2023,Galveston,TX,Passenger,0,1,1,16,17,5.88,Mid-Distance
7302,January,2023,Bexar,TX,Passenger,4,3,7,365,372,1.88,Mid-Distance
7303,January,2023,Grays Harbor,WA,Passenger,260,164,424,48595,49019,0.86,Washington
7304,January,2023,Cowlitz,WA,Truck,7,0,7,28344,28351,0.02,Washington
7305,January,2023,Arlington,VA,Passenger,1,0,1,104,105,0.95,Furthest
7306,January,2023,Miami-Dade,FL,Passenger,1,0,1,61,62,1.61,Furthest
7307,January,2023,Wahkiakum,WA,Truck,1,0,1,1794,1795,0.06,Washington
7308,January,2023,Ulster,NY,Passenger,1,0,1,4,5,20.0,Furthest
7309,January,2023,Gwinnett,GA,Passenger,1,0,1,43,44,2.27,Furthest
7310,January,2023,Chesapeake,VA,Passenger,2,3,5,286,291,1.72,Furthest
7311,January,2023,King,WA,Truck,461,2,463,177951,178414,0.26,Washington
7312,January,2023,Honolulu,HI,Passenger,3,3,6,272,278,2.16,Nearest
7313,January,2023,Elmore,ID,Passenger,1,0,1,11,12,8.33,Nearest
7314,January,2023,Stevens,WA,Passenger,96,57,153,29986,30139,0.51,Washington
7315,January,2023,Frederick,MD,Passenger,1,0,1,55,56,1.79,Furthest
7316,January,2023,Lewis,WA,Passenger,281,185,466,59747,60213,0.77,Washington
7317,January,2023,Broward,FL,Passenger,1,0,1,60,61,1.64,Furthest
7318,January,2023,St. Clair,IL,Passenger,2,0,2,107,109,1.83,Mid-Distance
7319,January,2023,Asotin,WA,Passenger,30,20,50,12490,12540,0.4,Washington
7320,January,2023,Douglas,WA,Passenger,172,58,230,28592,28822,0.8,Washington
7321,January,2023,St. Tammany,LA,Passenger,1,0,1,29,30,3.33,Mid-Distance
7322,January,2023,Kittitas,WA,Truck,5,0,5,14551,14556,0.03,Washington
7323,January,2023,Camden,NJ,Passenger,0,1,1,12,13,7.69,Furthest
7324,January,2023,Plaquemines,LA,Passenger,1,1,2,16,18,11.11,Mid-Distance
7325,January,2023,Alexandria,VA,Passenger,3,1,4,91,95,4.21,Furthest
7326,January,2023,Contra Costa,CA,Passenger,0,3,3,203,206,1.46,Nearest
7327,January,2023,Collin,TX,Passenger,2,0,2,46,48,4.17,Mid-Distance
7328,January,2023,Jefferson,WA,Truck,6,0,6,9368,9374,0.06,Washington
7329,January,2023,Riverside,CA,Passenger,7,0,7,384,391,1.79,Nearest
7330,January,2023,Sedgwick,KS,Passenger,1,1,2,62,64,3.12,Mid-Distance
7331,January,2023,Virginia Beach,VA,Passenger,2,0,2,448,450,0.44,Furthest
7332,January,2023,Bartow,GA,Passenger,0,1,1,3,4,25.0,Furthest
7333,January,2023,Thurston,WA,Truck,42,0,42,54598,54640,0.08,Washington
7334,January,2023,Louisa,VA,Passenger,0,1,1,1,2,50.0,Furthest
7335,January,2023,Fairbanks North Star,AK,Passenger,0,1,1,57,58,1.72,Nearest
7336,January,2023,Adams,WA,Passenger,22,11,33,13010,13043,0.25,Washington
7337,January,2023,Los Angeles,CA,Passenger,4,5,9,635,644,1.4,Nearest
7338,January,2023,Skagit,WA,Passenger,958,364,1322,89336,90658,1.46,Washington
7339,January,2023,Platte,MO,Passenger,1,0,1,18,19,5.26,Furthest
7340,January,2023,Adams,CO,Passenger,1,0,1,32,33,3.03,Mid-Distance
7341,January,2023,Grant,WA,Truck,5,0,5,28035,28040,0.02,Washington
7342,January,2023,Richmond,NY,Passenger,1,0,1,6,7,14.29,Furthest
7343,January,2023,Saratoga,NY,Passenger,1,1,2,34,36,5.56,Furthest
7344,January,2023,Ferry,WA,Truck,0,0,0,3552,3552,0.0,Washington
7345,January,2023,Larimer,CO,Passenger,1,0,1,39,40,2.5,Mid-Distance
7346,January,2023,Nassau,NY,Passenger,1,0,1,21,22,4.55,Furthest
7347,January,2023,Lee,FL,Passenger,1,0,1,24,25,4.0,Furthest
7348,January,2023,Santa Barbara,CA,Passenger,1,0,1,65,66,1.52,Nearest
7349,January,2023,Chelan,WA,Passenger,556,147,703,54338,55041,1.28,Washington
7350,January,2023,Douglas,WA,Truck,5,0,5,12874,12879,0.04,Washington
7351,January,2023,Klickitat,WA,Truck,4,0,4,8231,8235,0.05,Washington
7352,January,2023,Marin,CA,Passenger,0,1,1,29,30,3.33,Nearest
7353,January,2023,Hoke,NC,Passenger,1,0,1,58,59,1.69,Furthest
7354,January,2023,Island,WA,Truck,20,0,20,21176,21196,0.09,Washington
7355,January,2023,Clark,WA,Truck,62,0,62,81807,81869,0.08,Washington
7356,January,2023,San Bernardino,CA,Passenger,2,1,3,276,279,1.08,Nearest
7357,January,2023,Essex,NJ,Passenger,2,0,2,7,9,22.22,Furthest
7358,January,2023,Ray,MO,Passenger,0,1,1,0,1,100.0,Furthest
7359,January,2023,Boulder,CO,Passenger,1,0,1,27,28,3.57,Mid-Distance
7360,January,2023,Geary,KS,Passenger,1,0,1,73,74,1.35,Mid-Distance
7361,January,2023,Pacific,WA,Passenger,72,81,153,15730,15883,0.96,Washington
7362,January,2023,Walla Walla,WA,Passenger,203,107,310,35733,36043,0.86,Washington
7363,January,2023,Bell,TX,Passenger,1,0,1,263,264,0.38,Mid-Distance
7364,January,2023,Lake,IL,Passenger,1,0,1,115,116,0.86,Mid-Distance
7365,January,2023,Norfolk,VA,Passenger,3,3,6,265,271,2.21,Furthest
7366,January,2023,District of Columbia,DC,Passenger,4,0,4,152,156,2.56,Furthest
7367,January,2023,Las Animas,CO,Passenger,1,0,1,0,1,100.0,Mid-Distance
7368,January,2023,DeKalb,GA,Passenger,1,0,1,39,40,2.5,Furthest
7369,January,2023,Clark,NV,Passenger,4,2,6,405,411,1.46,Nearest
7370,January,2023,Salt Lake,UT,Passenger,0,1,1,100,101,0.99,Nearest
7371,January,2023,Oldham,KY,Passenger,0,1,1,4,5,20.0,Furthest
7372,January,2023,Kitsap,WA,Passenger,2835,1163,3998,177157,181155,2.21,Washington
7373,January,2023,Montgomery,MD,Passenger,3,3,6,172,178,3.37,Furthest
7374,January,2023,Hillsborough,FL,Passenger,0,1,1,103,104,0.96,Furthest
7375,January,2023,Yakima,WA,Passenger,435,228,663,166438,167101,0.4,Washington
7376,January,2023,Lake,FL,Passenger,1,0,1,15,16,6.25,Furthest
7377,January,2023,Cumberland,NC,Passenger,1,2,3,306,309,0.97,Furthest
7378,January,2023,Garfield,WA,Passenger,1,3,4,1319,1323,0.3,Washington
7379,January,2023,Coryell,TX,Passenger,1,0,1,79,80,1.25,Mid-Distance
7380,January,2023,Yavapai,AZ,Passenger,1,0,1,22,23,4.35,Nearest
7381,January,2023,Snohomish,WA,Truck,113,0,113,122400,122513,0.09,Washington
7382,January,2023,Wichita,TX,Passenger,2,0,2,34,36,5.56,Mid-Distance
7383,January,2023,Burlington,NJ,Passenger,0,2,2,93,95,2.11,Furthest
7384,January,2023,Leavenworth,KS,Passenger,0,1,1,92,93,1.08,Mid-Distance
7385,January,2023,Kauai,HI,Passenger,1,1,2,13,15,13.33,Nearest
7386,January,2023,Houston,GA,Passenger,1,0,1,24,25,4.0,Furthest
7387,January,2023,Lincoln,WA,Truck,0,0,0,4853,4853,0.0,Washington
7388,January,2023,Santa Cruz,CA,Passenger,1,0,1,13,14,7.14,Nearest
7389,January,2023,Lee,AL,Passenger,1,0,1,11,12,8.33,Furthest
7390,January,2023,Sumter,SC,Passenger,0,1,1,31,32,3.12,Furthest
7391,January,2023,Thurston,WA,Passenger,2703,1144,3847,191970,195817,1.96,Washington
7392,January,2023,Fairfax,VA,Passenger,5,3,8,559,567,1.41,Furthest
7393,January,2023,Howard,MD,Passenger,0,1,1,43,44,2.27,Furthest
7394,January,2023,Denton,TX,Passenger,1,0,1,45,46,2.17,Mid-Distance
7395,January,2023,Kittitas,WA,Passenger,312,94,406,29546,29952,1.36,Washington
7396,January,2023,Jefferson,NY,Passenger,1,1,2,183,185,1.08,Furthest
7397,January,2023,Lane,OR,Passenger,0,1,1,74,75,1.33,Nearest
7398,January,2023,Jackson,OK,Passenger,0,1,1,32,33,3.03,Mid-Distance
7399,January,2023,Dorchester,SC,Passenger,1,0,1,42,43,2.33,Furthest
7400,January,2023,San Diego,CA,Passenger,17,9,26,1998,2024,1.28,Nearest
7401,January,2023,Suffolk,VA,Passenger,1,0,1,113,114,0.88,Furthest
7402,January,2023,Beaufort,SC,Passenger,1,0,1,19,20,5.0,Furthest
7403,January,2023,New London,CT,Passenger,2,4,6,179,185,3.24,Furthest
7404,January,2023,Whitman,WA,Truck,3,0,3,8648,8651,0.03,Washington
7406,January,2023,Okanogan,WA,Passenger,105,53,158,26127,26285,0.6,Washington
7407,January,2023,Douglas,CO,Passenger,0,1,1,55,56,1.79,Mid-Distance
7408,January,2023,Okanogan,WA,Truck,2,0,2,16435,16437,0.01,Washington
7409,January,2023,Grays Harbor,WA,Truck,2,0,2,21070,21072,0.01,Washington
7410,January,2023,Cape May,NJ,Passenger,0,1,1,7,8,12.5,Furthest
7411,January,2023,Snohomish,WA,Passenger,10586,2793,13379,530262,543641,2.46,Washington
7412,January,2023,Charles,MD,Passenger,1,1,2,47,49,4.08,Furthest
7413,January,2023,Lincoln,OR,Passenger,0,1,1,13,14,7.14,Nearest
7414,January,2023,Mason,WA,Passenger,380,192,572,46777,47349,1.21,Washington
7415,January,2023,Garfield,WA,Truck,0,0,0,976,976,0.0,Washington
7416,January,2023,Rockingham,NH,Passenger,1,0,1,10,11,9.09,Furthest
7417,January,2023,Clallam,WA,Truck,9,0,9,21848,21857,0.04,Washington
7418,January,2023,Franklin,WA,Passenger,262,124,386,61842,62228,0.62,Washington
7419,January,2023,Carroll,MD,Passenger,0,1,1,17,18,5.56,Furthest
7420,January,2023,Spokane,WA,Truck,22,0,22,101916,101938,0.02,Washington
7421,January,2023,Stafford,VA,Passenger,3,1,4,78,82,4.88,Furthest
7422,January,2023,Cowlitz,WA,Passenger,417,193,610,70247,70857,0.86,Washington
7423,January,2023,Wilson,TX,Passenger,0,1,1,2,3,33.33,Mid-Distance
7424,January,2023,Grant,WA,Passenger,230,113,343,66923,67266,0.51,Washington
7425,January,2023,Washington,MD,Passenger,2,0,2,14,16,12.5,Furthest
7426,January,2023,Hamilton,OH,Truck,1,0,1,2,3,33.33,Furthest
7427,January,2023,Moore,NC,Passenger,0,1,1,102,103,0.97,Furthest
7428,January,2023,Fairfax,VA,Truck,1,0,1,96,97,1.03,Furthest
7429,January,2023,Sacramento,CA,Passenger,4,0,4,159,163,2.45,Nearest
7430,January,2023,Goochland,VA,Passenger,0,1,1,57,58,1.72,Furthest
7431,January,2023,Columbia,WA,Truck,0,0,0,1579,1579,0.0,Washington
7432,January,2023,Portsmouth,VA,Passenger,0,1,1,63,64,1.56,Furthest
7433,January,2023,Maricopa,AZ,Passenger,7,3,10,669,679,1.47,Nearest
7434,January,2023,Polk,OR,Passenger,0,1,1,17,18,5.56,Nearest
7435,January,2023,Newport News,VA,Passenger,1,0,1,94,95,1.05,Furthest
7436,January,2023,King,WA,Passenger,49761,12517,62278,1334257,1396535,4.46,Washington
7437,January,2023,Placer,CA,Passenger,2,0,2,53,55,3.64,Nearest
7438,January,2023,Mason,WA,Truck,8,0,8,20880,20888,0.04,Washington
7439,January,2023,Kootenai,ID,Truck,1,0,1,28,29,3.45,Nearest
7440,January,2023,Ventura,CA,Passenger,2,1,3,201,204,1.47,Nearest
7441,January,2023,Hidalgo,TX,Passenger,0,1,1,47,48,2.08,Mid-Distance
7442,January,2023,Pulaski,AR,Passenger,3,0,3,23,26,11.54,Mid-Distance
7443,January,2023,Clallam,WA,Passenger,499,267,766,49348,50114,1.53,Washington
7444,January,2023,Hennepin,MN,Passenger,1,0,1,35,36,2.78,Mid-Distance
7445,January,2023,Allen,IN,Passenger,1,0,1,11,12,8.33,Furthest
7446,January,2023,El Paso,TX,Passenger,2,0,2,276,278,0.72,Mid-Distance
7447,January,2023,Kitsap,WA,Truck,41,0,41,52943,52984,0.08,Washington
7448,January,2023,Pend Oreille,WA,Truck,0,0,0,5572,5572,0.0,Washington
7449,January,2023,Lincoln,WA,Passenger,14,19,33,7764,7797,0.42,Washington
7450,January,2023,Skagit,WA,Truck,11,0,11,32085,32096,0.03,Washington
7451,January,2023,Anne Arundel,MD,Passenger,4,4,8,298,306,2.61,Furthest
7452,January,2023,Monterey,CA,Passenger,1,1,2,113,115,1.74,Nearest
7453,January,2023,Nueces,TX,Passenger,0,1,1,50,51,1.96,Mid-Distance
7454,January,2023,Emmet,MI,Passenger,0,1,1,0,1,100.0,Furthest
7455,January,2023,Spokane,WA,Passenger,1998,953,2951,324493,327444,0.9,Washington
7456,January,2023,Arapahoe,CO,Passenger,0,1,1,65,66,1.52,Mid-Distance
7457,January,2023,Pierce,WA,Passenger,6394,2548,8942,537638,546580,1.64,Washington
7458,January,2023,Calvert,MD,Passenger,0,2,2,77,79,2.53,Furthest
7459,January,2023,Napa,CA,Passenger,0,1,1,9,10,10.0,Nearest
7460,January,2023,Vernon,LA,Passenger,1,0,1,71,72,1.39,Mid-Distance
7461,January,2023,Asotin,WA,Truck,0,0,0,6681,6681,0.0,Washington
7462,January,2023,Klickitat,WA,Passenger,127,53,180,15178,15358,1.17,Washington
7463,January,2023,Loudoun,VA,Passenger,3,1,4,58,62,6.45,Furthest
7464,January,2023,Middlesex,MA,Passenger,2,1,3,60,63,4.76,Furthest
7465,January,2023,Adams,WA,Truck,1,0,1,5377,5378,0.02,Washington
7466,January,2023,Yakima,WA,Truck,8,0,8,61183,61191,0.01,Washington
7467,January,2023,Duval,FL,Passenger,1,0,1,236,237,0.42,Furthest
7468,January,2023,Kings,CA,Passenger,2,1,3,273,276,1.09,Nearest
7469,January,2023,Franklin,WA,Truck,4,0,4,20981,20985,0.02,Washington
7470,January,2023,Escambia,FL,Passenger,0,1,1,109,110,0.91,Furthest
7471,January,2023,San Juan,WA,Passenger,572,173,745,13878,14623,5.09,Washington
7472,January,2023,Columbia,WA,Passenger,8,1,9,2438,2447,0.37,Washington
7473,January,2023,Alameda,CA,Passenger,3,0,3,154,157,1.91,Nearest
7474,January,2023,Montgomery,AL,Passenger,0,1,1,29,30,3.33,Furthest
7475,January,2023,Onslow,NC,Passenger,0,1,1,141,142,0.7,Furthest
7476,January,2023,Hudson,NJ,Passenger,1,0,1,27,28,3.57,Furthest
7477,January,2023,Ferry,WA,Passenger,24,4,28,4346,4374,0.64,Washington
7478,January,2023,Lewis,WA,Truck,2,0,2,26285,26287,0.01,Washington
7479,January,2023,Charleston,SC,Passenger,2,2,4,54,58,6.9,Furthest
7480,January,2023,Pacific,WA,Truck,2,0,2,7831,7833,0.03,Washington
7481,January,2023,Pend Oreille,WA,Passenger,23,14,37,8954,8991,0.41,Washington
7482,January,2023,Sarpy,NE,Passenger,1,0,1,46,47,2.13,Mid-Distance
7483,January,2023,Stevens,WA,Truck,2,0,2,18772,18774,0.01,Washington
7484,January,2023,Solano,CA,Passenger,4,0,4,140,144,2.78,Nearest
7485,January,2023,El Paso,CO,Passenger,3,1,4,511,515,0.78,Mid-Distance
7486,January,2023,Cook,IL,Passenger,2,0,2,152,154,1.3,Mid-Distance
7487,January,2023,Whatcom,WA,Passenger,2153,822,2975,148714,151689,1.96,Washington
7488,January,2023,Dallas,TX,Passenger,1,0,1,79,80,1.25,Mid-Distance
7489,January,2023,Walla Walla,WA,Truck,3,0,3,13863,13866,0.02,Washington
7490,January,2023,Sheridan,WY,Passenger,1,0,1,5,6,16.67,Nearest
7491,January,2023,Cumberland,PA,Passenger,1,0,1,32,33,3.03,Furthest
7492,January,2023,Bryan,GA,Passenger,0,1,1,37,38,2.63,Furthest
7493,January,2023,Orange,CA,Passenger,7,2,9,289,298,3.02,Nearest
7494,January,2023,Benton,WA,Passenger,961,512,1473,135906,137379,1.07,Washington
7495,January,2023,Pierce,WA,Truck,97,0,97,139157,139254,0.07,Washington
7496,January,2023,Madison,IL,Passenger,1,0,1,15,16,6.25,Mid-Distance
7497,January,2023,Kern,CA,Passenger,1,1,2,186,188,1.06,Nearest
7498,January,2023,Champaign,IL,Passenger,1,0,1,7,8,12.5,Mid-Distance
7499,January,2023,New Haven,CT,Passenger,0,2,2,22,24,8.33,Furthest
7500,January,2023,Jefferson,WA,Passenger,495,236,731,24276,25007,2.92,Washington
7501,January,2023,Travis,TX,Passenger,1,0,1,77,78,1.28,Mid-Distance
7502,January,2023,Wahkiakum,WA,Passenger,25,15,40,3050,3090,1.29,Washington
7503,January,2023,Skamania,WA,Truck,1,0,1,3877,3878,0.03,Washington
7504,January,2023,Multnomah,OR,Passenger,0,2,2,432,434,0.46,Nearest
7505,January,2023,Sonoma,CA,Passenger,1,1,2,60,62,3.23,Nearest
7506,January,2023,Benton,WA,Truck,13,0,13,43322,43335,0.03,Washington
7507,July,2017,Pierce,WA,Passenger,986,856,1842,524592,526434,0.35,Washington
7508,July,2017,Jefferson,NY,Passenger,1,1,2,249,251,0.8,Furthest
7509,July,2017,Allegheny,PA,Passenger,1,0,1,90,91,1.1,Furthest
7510,July,2017,Clark,NV,Passenger,1,2,3,813,816,0.37,Nearest
7511,July,2017,Volusia,FL,Passenger,0,1,1,45,46,2.17,Furthest
7512,July,2017,Franklin,MA,Passenger,0,1,1,4,5,20.0,Furthest
7513,July,2017,New Haven,CT,Passenger,0,1,1,57,58,1.72,Furthest
7514,July,2017,Gwinnett,GA,Passenger,0,1,1,82,83,1.2,Furthest
7515,July,2017,Walla Walla,WA,Truck,0,0,0,13177,13177,0.0,Washington
7516,July,2017,Sedgwick,KS,Passenger,0,1,1,109,110,0.91,Mid-Distance
7517,July,2017,Dane,WI,Passenger,1,0,1,86,87,1.15,Mid-Distance
7518,July,2017,Franklin,WA,Passenger,26,47,73,55735,55808,0.13,Washington
7519,July,2017,Clark,WA,Truck,0,0,0,77737,77737,0.0,Washington
7520,July,2017,Latah,ID,Passenger,0,1,1,97,98,1.02,Nearest
7521,July,2017,Ferry,WA,Truck,0,0,0,3526,3526,0.0,Washington
7522,July,2017,Hardin,KY,Passenger,0,1,1,121,122,0.82,Furthest
7523,July,2017,Clallam,WA,Truck,0,0,0,21043,21043,0.0,Washington
7524,July,2017,Pinal,AZ,Passenger,2,0,2,235,237,0.84,Nearest
7525,July,2017,Nassau,NY,Passenger,1,1,2,39,41,4.88,Furthest
7526,July,2017,Garfield,WA,Passenger,0,0,0,1296,1296,0.0,Washington
7527,July,2017,Yakima,WA,Truck,0,0,0,57469,57469,0.0,Washington
7528,July,2017,Island,WA,Truck,0,0,0,20500,20500,0.0,Washington
7529,July,2017,Anne Arundel,MD,Passenger,0,1,1,501,502,0.2,Furthest
7530,July,2017,Kittitas,WA,Truck,0,0,0,13581,13581,0.0,Washington
7531,July,2017,Canyon,ID,Passenger,0,1,1,97,98,1.02,Nearest
7532,July,2017,King,WA,Passenger,10255,4174,14429,1373311,1387740,1.04,Washington
7533,July,2017,Nueces,TX,Passenger,0,1,1,96,97,1.03,Mid-Distance
7534,July,2017,Kitsap,WA,Passenger,622,324,946,173384,174330,0.54,Washington
7535,July,2017,Morris,NJ,Passenger,1,0,1,25,26,3.85,Furthest
7536,July,2017,Whitman,WA,Passenger,12,19,31,22108,22139,0.14,Washington
7537,July,2017,Flathead,MT,Passenger,1,0,1,60,61,1.64,Nearest
7538,July,2017,Fairfax,VA,Passenger,2,2,4,848,852,0.47,Furthest
7539,July,2017,Alameda,CA,Passenger,1,1,2,358,360,0.56,Nearest
7540,July,2017,Mason,WA,Truck,0,0,0,19261,19261,0.0,Washington
7541,July,2017,Juneau,AK,Passenger,0,1,1,45,46,2.17,Nearest
7542,July,2017,Wayne,MI,Passenger,0,1,1,69,70,1.43,Furthest
7543,July,2017,Pend Oreille,WA,Truck,0,0,0,5582,5582,0.0,Washington
7544,July,2017,Tulare,CA,Passenger,1,0,1,195,196,0.51,Nearest
7545,July,2017,Grant,WA,Passenger,19,30,49,61004,61053,0.08,Washington
7546,July,2017,Marion,OR,Passenger,1,0,1,162,163,0.61,Nearest
7547,July,2017,St. Lucie,FL,Passenger,1,0,1,32,33,3.03,Furthest
7548,July,2017,Jefferson,WA,Truck,0,0,0,9414,9414,0.0,Washington
7549,July,2017,Douglas,WA,Passenger,35,26,61,26756,26817,0.23,Washington
7550,July,2017,Orleans,LA,Passenger,0,1,1,47,48,2.08,Mid-Distance
7551,July,2017,Albemarle,VA,Passenger,0,1,1,32,33,3.03,Furthest
7552,July,2017,Dallas,TX,Passenger,0,1,1,180,181,0.55,Mid-Distance
7553,July,2017,Grays Harbor,WA,Truck,0,0,0,19894,19894,0.0,Washington
7554,July,2017,Asotin,WA,Passenger,8,4,12,12439,12451,0.1,Washington
7555,July,2017,Shelby,TN,Passenger,0,1,1,109,110,0.91,Furthest
7556,July,2017,Garfield,WA,Truck,0,0,0,926,926,0.0,Washington
7557,July,2017,San Diego,CA,Passenger,6,1,7,2699,2706,0.26,Nearest
7558,July,2017,Lincoln,WA,Truck,0,0,0,4445,4445,0.0,Washington
7559,July,2017,Clark,WA,Passenger,795,517,1312,299957,301269,0.44,Washington
7560,July,2017,Montgomery,MD,Passenger,1,0,1,306,307,0.33,Furthest
7561,July,2017,Multnomah,OR,Passenger,1,3,4,953,957,0.42,Nearest
7562,July,2017,San Juan,WA,Truck,0,0,0,5547,5547,0.0,Washington
7563,July,2017,Lewis,WA,Truck,0,0,0,24914,24914,0.0,Washington
7564,July,2017,Hamilton,TN,Passenger,1,0,1,18,19,5.26,Furthest
7565,July,2017,Skagit,WA,Passenger,141,104,245,88182,88427,0.28,Washington
7566,July,2017,Palm Beach,FL,Passenger,0,1,1,96,97,1.03,Furthest
7567,July,2017,Hawaii,HI,Passenger,1,0,1,80,81,1.23,Nearest
7568,July,2017,Skamania,WA,Passenger,9,7,16,8552,8568,0.19,Washington
7569,July,2017,Tuolumne,CA,Passenger,0,1,1,14,15,6.67,Nearest
7570,July,2017,Essex,NJ,Passenger,1,0,1,14,15,6.67,Furthest
7571,July,2017,Bergen,NJ,Passenger,0,2,2,30,32,6.25,Furthest
7572,July,2017,Richmond,GA,Passenger,0,1,1,88,89,1.12,Furthest
7573,July,2017,Deschutes,OR,Passenger,1,0,1,195,196,0.51,Nearest
7574,July,2017,Thurston,WA,Passenger,418,350,768,187062,187830,0.41,Washington
7575,July,2017,Kittitas,WA,Passenger,24,19,43,27678,27721,0.16,Washington
7576,July,2017,Snohomish,WA,Passenger,1818,920,2738,513286,516024,0.53,Washington
7577,July,2017,Lincoln,WA,Passenger,2,5,7,7519,7526,0.09,Washington
7578,July,2017,Prince George's,MD,Passenger,0,1,1,187,188,0.53,Furthest
7579,July,2017,Pierce,WA,Truck,0,0,0,137369,137369,0.0,Washington
7580,July,2017,Clallam,WA,Passenger,93,77,170,48417,48587,0.35,Washington
7581,July,2017,Jackson,MO,Passenger,1,0,1,57,58,1.72,Furthest
7582,July,2017,Kent,MI,Passenger,0,1,1,37,38,2.63,Furthest
7583,July,2017,San Mateo,CA,Passenger,0,1,1,151,152,0.66,Nearest
7584,July,2017,Madison,ID,Passenger,1,0,1,39,40,2.5,Nearest
7585,July,2017,Manassas,VA,Passenger,0,1,1,9,10,10.0,Furthest
7586,July,2017,DeKalb,IN,Passenger,1,0,1,1,2,50.0,Furthest
7587,July,2017,Okaloosa,FL,Passenger,1,0,1,183,184,0.54,Furthest
7588,July,2017,Chelan,WA,Passenger,68,35,103,52135,52238,0.2,Washington
7589,July,2017,District of Columbia,DC,Passenger,0,3,3,211,214,1.4,Furthest
7590,July,2017,Virginia Beach,VA,Passenger,2,1,3,653,656,0.46,Furthest
7591,July,2017,Franklin,WA,Truck,0,0,0,18175,18175,0.0,Washington
7592,July,2017,Cowlitz,WA,Truck,0,0,0,27954,27954,0.0,Washington
7593,July,2017,Missoula,MT,Passenger,1,0,1,72,73,1.37,Nearest
7594,July,2017,Santa Clara,CA,Passenger,5,2,7,399,406,1.72,Nearest
7595,July,2017,Hamilton,IN,Passenger,1,0,1,58,59,1.69,Furthest
7596,July,2017,Stevens,WA,Truck,0,0,0,18211,18211,0.0,Washington
7597,July,2017,Polk,FL,Passenger,1,0,1,63,64,1.56,Furthest
7598,July,2017,Chelan,WA,Truck,0,0,0,21329,21329,0.0,Washington
7599,July,2017,Dale,AL,Passenger,0,1,1,64,65,1.54,Furthest
7600,July,2017,Pacific,WA,Passenger,10,9,19,15197,15216,0.12,Washington
7601,July,2017,Montgomery,PA,Passenger,1,0,1,39,40,2.5,Furthest
7602,July,2017,Carroll,NH,Passenger,0,1,1,1,2,50.0,Furthest
7604,July,2017,Fulton,GA,Passenger,1,0,1,113,114,0.88,Furthest
7605,July,2017,Monterey,CA,Passenger,0,2,2,199,201,1.0,Nearest
7606,July,2017,Grant,WA,Truck,0,0,0,25271,25271,0.0,Washington
7607,July,2017,Honolulu,HI,Passenger,3,2,5,570,575,0.87,Nearest
7608,July,2017,Charles,MD,Passenger,0,1,1,86,87,1.15,Furthest
7609,July,2017,Skagit,WA,Truck,1,0,1,31485,31486,0.0,Washington
7610,July,2017,Okanogan,WA,Passenger,4,18,22,25634,25656,0.09,Washington
7611,July,2017,Cobb,GA,Passenger,0,1,1,77,78,1.28,Furthest
7612,July,2017,Jefferson,WA,Passenger,107,61,168,23895,24063,0.7,Washington
7613,July,2017,Franklin,OH,Passenger,0,1,1,119,120,0.83,Furthest
7614,July,2017,Columbia,WA,Truck,0,0,0,1533,1533,0.0,Washington
7615,July,2017,Utah,UT,Passenger,0,1,1,153,154,0.65,Nearest
7616,July,2017,Wahkiakum,WA,Passenger,0,2,2,2836,2838,0.07,Washington
7617,July,2017,Benton,WA,Passenger,155,148,303,128671,128974,0.23,Washington
7618,July,2017,Orange,FL,Passenger,1,1,2,131,133,1.5,Furthest
7619,July,2017,Spokane,WA,Truck,1,0,1,90744,90745,0.0,Washington
7620,July,2017,El Paso,CO,Passenger,2,0,2,789,791,0.25,Mid-Distance
7621,July,2017,Prince William,VA,Passenger,0,3,3,271,274,1.09,Furthest
7622,July,2017,Frederick,MD,Passenger,0,1,1,82,83,1.2,Furthest
7623,July,2017,Moore,NC,Passenger,0,1,1,199,200,0.5,Furthest
7624,July,2017,Dakota,MN,Passenger,0,1,1,36,37,2.7,Mid-Distance
7625,July,2017,Pima,AZ,Passenger,1,2,3,425,428,0.7,Nearest
7626,July,2017,Wahkiakum,WA,Truck,0,0,0,1659,1659,0.0,Washington
7627,July,2017,Santa Fe,NM,Passenger,0,1,1,43,44,2.27,Mid-Distance
7628,July,2017,Duval,FL,Passenger,1,1,2,378,380,0.53,Furthest
7629,July,2017,New London,CT,Passenger,1,1,2,253,255,0.78,Furthest
7630,July,2017,Okanogan,WA,Truck,0,0,0,16226,16226,0.0,Washington
7631,July,2017,Island,WA,Passenger,121,141,262,60273,60535,0.43,Washington
7632,July,2017,Yakima,WA,Passenger,49,62,111,159655,159766,0.07,Washington
7633,July,2017,Sangamon,IL,Passenger,1,0,1,11,12,8.33,Mid-Distance
7634,July,2017,Grays Harbor,WA,Passenger,36,35,71,44850,44921,0.16,Washington
7635,July,2017,Kitsap,WA,Truck,1,0,1,52511,52512,0.0,Washington
7636,July,2017,Columbia,WA,Passenger,1,1,2,2350,2352,0.09,Washington
7637,July,2017,Stevens,WA,Passenger,8,23,31,31395,31426,0.1,Washington
7638,July,2017,Klickitat,WA,Truck,0,0,0,7953,7953,0.0,Washington
7639,July,2017,Asotin,WA,Truck,0,0,0,6532,6532,0.0,Washington
7640,July,2017,DeKalb,GA,Passenger,1,0,1,84,85,1.18,Furthest
7641,July,2017,Sumter,FL,Passenger,0,1,1,10,11,9.09,Furthest
7642,July,2017,Walla Walla,WA,Passenger,27,26,53,34886,34939,0.15,Washington
7643,July,2017,Adams,WA,Truck,0,0,0,5123,5123,0.0,Washington
7644,July,2017,Pacific,WA,Truck,0,0,0,7495,7495,0.0,Washington
7645,July,2017,Pend Oreille,WA,Passenger,3,4,7,9321,9328,0.08,Washington
7646,July,2017,Spokane,WA,Passenger,262,213,475,296652,297127,0.16,Washington
7647,July,2017,Whatcom,WA,Truck,2,0,2,41660,41662,0.0,Washington
7648,July,2017,Travis,TX,Passenger,0,1,1,190,191,0.52,Mid-Distance
7649,July,2017,Maui,HI,Passenger,1,0,1,68,69,1.45,Nearest
7650,July,2017,Benton,WA,Truck,0,0,0,40129,40129,0.0,Washington
7651,July,2017,Los Angeles,CA,Passenger,3,1,4,1271,1275,0.31,Nearest
7652,July,2017,Norfolk,MA,Passenger,1,0,1,37,38,2.63,Furthest
7653,July,2017,Cape May,NJ,Passenger,0,1,1,19,20,5.0,Furthest
7654,July,2017,Arlington,VA,Passenger,1,1,2,167,169,1.18,Furthest
7655,July,2017,Lumpkin,GA,Passenger,1,0,1,9,10,10.0,Furthest
7656,July,2017,Portsmouth,VA,Passenger,0,1,1,66,67,1.49,Furthest
7657,July,2017,San Juan,WA,Passenger,112,39,151,13563,13714,1.1,Washington
7658,July,2017,Ferry,WA,Passenger,1,1,2,4400,4402,0.05,Washington
7659,July,2017,Lee,AL,Passenger,1,0,1,36,37,2.7,Furthest
7660,July,2017,Ramsey,MN,Passenger,1,0,1,40,41,2.44,Mid-Distance
7661,July,2017,Manatee,FL,Passenger,1,0,1,42,43,2.33,Furthest
7662,July,2017,Snohomish,WA,Truck,1,0,1,121771,121772,0.0,Washington
7663,July,2017,Klickitat,WA,Passenger,22,24,46,14803,14849,0.31,Washington
7664,July,2017,Adams,WA,Passenger,3,3,6,12184,12190,0.05,Washington
7665,July,2017,Thurston,WA,Truck,0,0,0,53297,53297,0.0,Washington
7666,July,2017,Lane,OR,Passenger,0,1,1,228,229,0.44,Nearest
7667,July,2017,Douglas,WA,Truck,0,0,0,11515,11515,0.0,Washington
7668,July,2017,Howard,MD,Passenger,0,2,2,92,94,2.13,Furthest
7669,July,2017,Montgomery,TN,Passenger,1,0,1,280,281,0.36,Furthest
7670,July,2017,Riverside,CA,Passenger,1,1,2,787,789,0.25,Nearest
7671,July,2017,Skamania,WA,Truck,0,0,0,3873,3873,0.0,Washington
7672,July,2017,Mason,WA,Passenger,57,71,128,43631,43759,0.29,Washington
7673,July,2017,Maricopa,AZ,Passenger,2,0,2,1705,1707,0.12,Nearest
7674,July,2017,Whitman,WA,Truck,0,0,0,8425,8425,0.0,Washington
7675,July,2017,Lewis,WA,Passenger,52,36,88,55557,55645,0.16,Washington
7676,July,2017,Bexar,TX,Passenger,1,1,2,888,890,0.22,Mid-Distance
7677,July,2017,Whatcom,WA,Passenger,474,179,653,143186,143839,0.45,Washington
7678,July,2017,Orange,CA,Passenger,3,1,4,627,631,0.63,Nearest
7679,July,2017,King,WA,Truck,8,1,9,187250,187259,0.0,Washington
7680,July,2017,Norfolk,VA,Passenger,1,1,2,312,314,0.64,Furthest
7681,July,2017,Saratoga,NY,Passenger,1,1,2,74,76,2.63,Furthest
7682,July,2017,Tarrant,TX,Passenger,1,0,1,242,243,0.41,Mid-Distance
7683,July,2017,Nantucket,MA,Passenger,1,0,1,3,4,25.0,Furthest
7684,July,2017,Santa Rosa,FL,Passenger,1,0,1,112,113,0.88,Furthest
7685,July,2017,Cowlitz,WA,Passenger,52,61,113,69775,69888,0.16,Washington
7686,July,2017,Marin,CA,Passenger,1,0,1,58,59,1.69,Nearest
7687,July,2017,Twin Falls,ID,Passenger,0,1,1,23,24,4.17,Nearest
7688,July,2018,Whatcom,WA,Truck,2,0,2,42313,42315,0.0,Washington
7689,July,2018,Nantucket,MA,Passenger,1,0,1,4,5,20.0,Furthest
7690,July,2018,Whatcom,WA,Passenger,637,318,955,147985,148940,0.64,Washington
7691,July,2018,Skagit,WA,Truck,1,0,1,32118,32119,0.0,Washington
7692,July,2018,Grays Harbor,WA,Truck,0,0,0,20227,20227,0.0,Washington
7693,July,2018,Washington,OR,Passenger,0,1,1,479,480,0.21,Nearest
7694,July,2018,Pacific,WA,Truck,0,0,0,7611,7611,0.0,Washington
7695,July,2018,Charles,MD,Passenger,0,1,1,82,83,1.2,Furthest
7696,July,2018,Okanogan,WA,Truck,0,0,0,16423,16423,0.0,Washington
7697,July,2018,Stevens,WA,Passenger,11,25,36,31650,31686,0.11,Washington
7698,July,2018,Jefferson,CO,Passenger,0,1,1,65,66,1.52,Mid-Distance
7699,July,2018,Lane,OR,Passenger,0,1,1,184,185,0.54,Nearest
7700,July,2018,Hawaii,HI,Passenger,1,0,1,73,74,1.35,Nearest
7701,July,2018,Clay,FL,Passenger,0,1,1,92,93,1.08,Furthest
7702,July,2018,Lewis,WA,Truck,0,0,0,25583,25583,0.0,Washington
7703,July,2018,Franklin,MA,Passenger,0,1,1,1,2,50.0,Furthest
7704,July,2018,Multnomah,OR,Passenger,3,4,7,791,798,0.88,Nearest
7705,July,2018,DeKalb,GA,Passenger,1,0,1,79,80,1.25,Furthest
7706,July,2018,Carson City,NV,Passenger,1,0,1,14,15,6.67,Nearest
7707,July,2018,Clackamas,OR,Passenger,0,1,1,216,217,0.46,Nearest
7708,July,2018,Island,WA,Truck,0,0,0,20994,20994,0.0,Washington
7709,July,2018,Cowlitz,WA,Truck,0,0,0,28560,28560,0.0,Washington
7710,July,2018,Los Angeles,CA,Passenger,7,4,11,1140,1151,0.96,Nearest
7711,July,2018,Benton,WA,Passenger,193,197,390,131733,132123,0.3,Washington
7712,July,2018,Anne Arundel,MD,Passenger,0,1,1,450,451,0.22,Furthest
7713,July,2018,Spokane,WA,Truck,1,0,1,92869,92870,0.0,Washington
7714,July,2018,Pima,AZ,Passenger,1,1,2,410,412,0.49,Nearest
7715,July,2018,Garfield,WA,Passenger,1,1,2,1320,1322,0.15,Washington
7716,July,2018,Manassas,VA,Passenger,0,1,1,9,10,10.0,Furthest
7717,July,2018,Richland,SC,Passenger,0,1,1,169,170,0.59,Furthest
7718,July,2018,Lewis,WA,Passenger,83,59,142,57814,57956,0.25,Washington
7719,July,2018,Manatee,FL,Passenger,1,0,1,37,38,2.63,Furthest
7720,July,2018,Morris,NJ,Passenger,1,0,1,16,17,5.88,Furthest
7721,July,2018,Grant,WA,Truck,0,0,0,25943,25943,0.0,Washington
7722,July,2018,Virginia Beach,VA,Passenger,2,1,3,692,695,0.43,Furthest
7723,July,2018,Cowlitz,WA,Passenger,57,77,134,71871,72005,0.19,Washington
7724,July,2018,Grant,WA,Passenger,33,47,80,63265,63345,0.13,Washington
7725,July,2018,Columbia,WA,Truck,0,0,0,1530,1530,0.0,Washington
7726,July,2018,Tarrant,TX,Passenger,1,0,1,218,219,0.46,Mid-Distance
7727,July,2018,Allegheny,PA,Passenger,1,0,1,77,78,1.28,Furthest
7728,July,2018,San Mateo,CA,Passenger,1,1,2,130,132,1.52,Nearest
7729,July,2018,Ada,ID,Passenger,0,2,2,319,321,0.62,Nearest
7730,July,2018,Pierce,WA,Truck,0,0,0,138077,138077,0.0,Washington
7731,July,2018,Queens,NY,Passenger,1,0,1,61,62,1.61,Furthest
7732,July,2018,Wahkiakum,WA,Truck,0,0,0,1681,1681,0.0,Washington
7733,July,2018,Richmond,GA,Passenger,0,1,1,92,93,1.08,Furthest
7734,July,2018,Cochise,AZ,Passenger,0,1,1,119,120,0.83,Nearest
7735,July,2018,Klickitat,WA,Truck,0,0,0,8126,8126,0.0,Washington
7736,July,2018,Jefferson,WA,Passenger,147,99,246,24581,24827,0.99,Washington
7737,July,2018,Grays Harbor,WA,Passenger,54,62,116,46760,46876,0.25,Washington
7738,July,2018,Yakima,WA,Passenger,65,93,158,163968,164126,0.1,Washington
7739,July,2018,Skamania,WA,Truck,0,0,0,3960,3960,0.0,Washington
7740,July,2018,Arlington,VA,Passenger,1,2,3,175,178,1.69,Furthest
7741,July,2018,Clark,WA,Passenger,1042,744,1786,308652,310438,0.58,Washington
7742,July,2018,Shelby,TN,Passenger,0,1,1,102,103,0.97,Furthest
7743,July,2018,Ramsey,MN,Passenger,1,0,1,40,41,2.44,Mid-Distance
7744,July,2018,Lincoln,WA,Passenger,3,6,9,7748,7757,0.12,Washington
7745,July,2018,Hennepin,MN,Passenger,1,0,1,108,109,0.92,Mid-Distance
7746,July,2018,Brevard,FL,Passenger,0,1,1,91,92,1.09,Furthest
7747,July,2018,Sangamon,IL,Passenger,1,0,1,11,12,8.33,Mid-Distance
7748,July,2018,Washtenaw,MI,Passenger,1,0,1,38,39,2.56,Furthest
7749,July,2018,Jefferson,NY,Passenger,0,1,1,226,227,0.44,Furthest
7750,July,2018,San Juan,PR,Passenger,0,1,1,4,5,20.0,Mid-Distance
7751,July,2018,Frederick,MD,Passenger,0,1,1,86,87,1.15,Furthest
7752,July,2018,Nueces,TX,Passenger,1,1,2,89,91,2.2,Mid-Distance
7753,July,2018,Carroll,NH,Passenger,0,1,1,1,2,50.0,Furthest
7754,July,2018,Tuolumne,CA,Passenger,0,1,1,11,12,8.33,Nearest
7755,July,2018,King,WA,Passenger,13479,5802,19281,1372470,1391751,1.39,Washington
7756,July,2018,Montgomery,PA,Passenger,2,0,2,34,36,5.56,Furthest
7757,July,2018,Adams,WA,Passenger,5,5,10,12641,12651,0.08,Washington
7758,July,2018,Honolulu,HI,Passenger,1,2,3,525,528,0.57,Nearest
7759,July,2018,Pinal,AZ,Passenger,2,0,2,204,206,0.97,Nearest
7760,July,2018,Thurston,WA,Truck,0,0,0,54414,54414,0.0,Washington
7761,July,2018,Jefferson,WA,Truck,0,0,0,9588,9588,0.0,Washington
7762,July,2018,Moore,NC,Passenger,0,1,1,197,198,0.51,Furthest
7763,July,2018,Lee,AL,Passenger,1,0,1,37,38,2.63,Furthest
7764,July,2018,Franklin,WA,Passenger,38,66,104,58177,58281,0.18,Washington
7765,July,2018,Beaufort,SC,Passenger,1,0,1,37,38,2.63,Furthest
7766,July,2018,Whitman,WA,Truck,0,0,0,8496,8496,0.0,Washington
7767,July,2018,Montgomery,TX,Passenger,1,0,1,62,63,1.59,Mid-Distance
7768,July,2018,Twin Falls,ID,Passenger,0,1,1,23,24,4.17,Nearest
7769,July,2018,Island,WA,Passenger,206,194,400,62580,62980,0.64,Washington
7770,July,2018,Ferry,WA,Truck,0,0,0,3535,3535,0.0,Washington
7771,July,2018,New London,CT,Passenger,0,1,1,250,251,0.4,Furthest
7772,July,2018,Kootenai,ID,Passenger,0,1,1,220,221,0.45,Nearest
7773,July,2018,Orleans,LA,Passenger,0,1,1,47,48,2.08,Mid-Distance
7774,July,2018,Charleston,SC,Passenger,1,0,1,128,129,0.78,Furthest
7775,July,2018,Gwinnett,GA,Passenger,0,1,1,82,83,1.2,Furthest
7776,July,2018,Volusia,FL,Passenger,0,1,1,32,33,3.03,Furthest
7777,July,2018,Monroe,IL,Passenger,1,0,1,5,6,16.67,Mid-Distance
7778,July,2018,District of Columbia,DC,Passenger,0,3,3,192,195,1.54,Furthest
7779,July,2018,Madison,ID,Passenger,1,0,1,40,41,2.44,Nearest
7780,July,2018,Collin,TX,Passenger,1,0,1,155,156,0.64,Mid-Distance
7781,July,2018,Franklin,WA,Truck,0,0,0,18741,18741,0.0,Washington
7782,July,2018,Lumpkin,GA,Passenger,1,0,1,7,8,12.5,Furthest
7783,July,2018,Fulton,GA,Passenger,1,2,3,106,109,2.75,Furthest
7784,July,2018,Chelan,WA,Truck,0,0,0,21950,21950,0.0,Washington
7785,July,2018,Skagit,WA,Passenger,215,171,386,90712,91098,0.42,Washington
7786,July,2018,Riverside,CA,Passenger,2,2,4,693,697,0.57,Nearest
7787,July,2018,Thurston,WA,Passenger,577,497,1074,193753,194827,0.55,Washington
7788,July,2018,San Juan,WA,Passenger,149,62,211,14115,14326,1.47,Washington
7789,July,2018,Sedgwick,KS,Passenger,0,1,1,99,100,1.0,Mid-Distance
7790,July,2018,Douglas,WA,Passenger,43,32,75,27719,27794,0.27,Washington
7791,July,2018,San Diego,CA,Passenger,7,1,8,2569,2577,0.31,Nearest
7792,July,2018,Montgomery,MD,Passenger,1,0,1,285,286,0.35,Furthest
7793,July,2018,Alameda,CA,Passenger,0,1,1,343,344,0.29,Nearest
7794,July,2018,Caddo,LA,Passenger,0,1,1,22,23,4.35,Mid-Distance
7795,July,2018,Skamania,WA,Passenger,13,9,22,8635,8657,0.25,Washington
7796,July,2018,Palm Beach,FL,Passenger,0,1,1,85,86,1.16,Furthest
7797,July,2018,Pend Oreille,WA,Passenger,5,5,10,9578,9588,0.1,Washington
7798,July,2018,Santa Clara,CA,Passenger,7,0,7,372,379,1.85,Nearest
7799,July,2018,Washoe,NV,Passenger,1,0,1,119,120,0.83,Nearest
7800,July,2018,Mason,WA,Truck,0,0,0,20051,20051,0.0,Washington
7801,July,2018,DuPage,IL,Passenger,1,0,1,61,62,1.61,Mid-Distance
7802,July,2018,Mason,WA,Passenger,87,93,180,45864,46044,0.39,Washington
7803,July,2018,Essex,NJ,Passenger,1,0,1,11,12,8.33,Furthest
7804,July,2018,Cook,IL,Passenger,1,0,1,257,258,0.39,Mid-Distance
7805,July,2018,Santa Fe,NM,Passenger,0,1,1,44,45,2.22,Mid-Distance
7806,July,2018,St. Lucie,FL,Passenger,1,0,1,29,30,3.33,Furthest
7807,July,2018,Ventura,CA,Passenger,0,2,2,312,314,0.64,Nearest
7809,July,2018,Stevens,WA,Truck,0,0,0,18650,18650,0.0,Washington
7810,July,2018,Hamilton,IN,Passenger,1,0,1,46,47,2.13,Furthest
7811,July,2018,Klickitat,WA,Passenger,24,31,55,15220,15275,0.36,Washington
7812,July,2018,Howard,MD,Passenger,0,1,1,87,88,1.14,Furthest
7813,July,2018,San Juan,WA,Truck,0,0,0,5730,5730,0.0,Washington
7814,July,2018,Kitsap,WA,Truck,1,0,1,53372,53373,0.0,Washington
7815,July,2018,Marion,IN,Passenger,1,0,1,118,119,0.84,Furthest
7816,July,2018,Pierce,WA,Passenger,1262,1194,2456,533502,535958,0.46,Washington
7817,July,2018,Lincoln,WA,Truck,0,0,0,4557,4557,0.0,Washington
7818,July,2018,Snohomish,WA,Passenger,2404,1295,3699,522666,526365,0.7,Washington
7819,July,2018,Saratoga,NY,Passenger,1,1,2,63,65,3.08,Furthest
7820,July,2018,Asotin,WA,Passenger,11,8,19,12637,12656,0.15,Washington
7821,July,2018,Deschutes,OR,Passenger,1,0,1,165,166,0.6,Nearest
7822,July,2018,Kitsap,WA,Passenger,809,473,1282,178849,180131,0.71,Washington
7823,July,2018,King,WA,Truck,7,1,8,182983,182991,0.0,Washington
7824,July,2018,Bexar,TX,Passenger,2,4,6,741,747,0.8,Mid-Distance
7825,July,2018,Asotin,WA,Truck,0,0,0,6628,6628,0.0,Washington
7826,July,2018,San Francisco,CA,Passenger,1,1,2,124,126,1.59,Nearest
7827,July,2018,Pend Oreille,WA,Truck,0,0,0,5699,5699,0.0,Washington
7828,July,2018,Pacific,WA,Passenger,19,21,40,15621,15661,0.26,Washington
7829,July,2018,Polk,FL,Passenger,1,0,1,65,66,1.52,Furthest
7830,July,2018,Walla Walla,WA,Passenger,34,44,78,35739,35817,0.22,Washington
7831,July,2018,Benton,WA,Truck,0,0,0,41093,41093,0.0,Washington
7832,July,2018,Santa Rosa,FL,Passenger,1,0,1,94,95,1.05,Furthest
7833,July,2018,Monterey,CA,Passenger,0,1,1,184,185,0.54,Nearest
7834,July,2018,Contra Costa,CA,Passenger,0,1,1,449,450,0.22,Nearest
7835,July,2018,Garfield,OK,Passenger,1,0,1,16,17,5.88,Mid-Distance
7836,July,2018,Nassau,NY,Passenger,2,0,2,37,39,5.13,Furthest
7837,July,2018,DeKalb,IN,Passenger,1,0,1,1,2,50.0,Furthest
7838,July,2018,Snohomish,WA,Truck,1,0,1,121679,121680,0.0,Washington
7839,July,2018,Hardin,KY,Passenger,0,1,1,120,121,0.83,Furthest
7840,July,2018,Walla Walla,WA,Truck,0,0,0,13467,13467,0.0,Washington
7841,July,2018,Cape May,NJ,Passenger,0,1,1,21,22,4.55,Furthest
7842,July,2018,Marin,CA,Passenger,1,0,1,55,56,1.79,Nearest
7843,July,2018,Orange,CA,Passenger,4,1,5,553,558,0.9,Nearest
7844,July,2018,Prince William,VA,Passenger,0,4,4,264,268,1.49,Furthest
7845,July,2018,Wahkiakum,WA,Passenger,1,1,2,2938,2940,0.07,Washington
7846,July,2018,Norfolk,MA,Passenger,1,0,1,38,39,2.56,Furthest
7847,July,2018,Clallam,WA,Truck,0,0,0,21477,21477,0.0,Washington
7848,July,2018,El Paso,CO,Passenger,2,1,3,755,758,0.4,Mid-Distance
7849,July,2018,Broward,FL,Passenger,1,1,2,131,133,1.5,Furthest
7850,July,2018,Chelan,WA,Passenger,112,52,164,53574,53738,0.31,Washington
7851,July,2018,Maui,HI,Passenger,1,0,1,55,56,1.79,Nearest
7852,July,2018,Lee,FL,Passenger,1,0,1,57,58,1.72,Furthest
7853,July,2018,Juneau,AK,Passenger,0,1,1,48,49,2.04,Nearest
7854,July,2018,St. Clair,IL,Passenger,0,1,1,152,153,0.65,Mid-Distance
7855,July,2018,Sumter,FL,Passenger,0,1,1,10,11,9.09,Furthest
7856,July,2018,Spokane,WA,Passenger,347,320,667,304017,304684,0.22,Washington
7857,July,2018,Columbia,WA,Passenger,2,2,4,2419,2423,0.17,Washington
7858,July,2018,Clark,WA,Truck,0,0,0,79240,79240,0.0,Washington
7859,July,2018,Portsmouth,VA,Passenger,0,1,1,72,73,1.37,Furthest
7860,July,2018,Maricopa,AZ,Passenger,2,1,3,1570,1573,0.19,Nearest
7861,July,2018,New Haven,CT,Passenger,0,1,1,48,49,2.04,Furthest
7862,July,2018,Prince George,VA,Passenger,0,1,1,76,77,1.3,Furthest
7863,July,2018,Douglas,NE,Passenger,0,1,1,71,72,1.39,Mid-Distance
7864,July,2018,Orange,FL,Passenger,2,1,3,172,175,1.71,Furthest
7865,July,2018,Prince George's,MD,Passenger,1,1,2,185,187,1.07,Furthest
7866,July,2018,Flathead,MT,Passenger,1,0,1,49,50,2.0,Nearest
7867,July,2018,Williamson,TX,Passenger,0,1,1,161,162,0.62,Mid-Distance
7868,July,2018,Duval,FL,Passenger,1,2,3,383,386,0.78,Furthest
7869,July,2018,Norfolk,VA,Passenger,2,2,4,328,332,1.2,Furthest
7870,July,2018,Kent,MI,Passenger,0,1,1,28,29,3.45,Furthest
7871,July,2018,Camden,NJ,Passenger,0,1,1,32,33,3.03,Furthest
7872,July,2018,Fairfax,VA,Passenger,2,2,4,832,836,0.48,Furthest
7873,July,2018,St. Mary's,MD,Passenger,1,0,1,217,218,0.46,Furthest
7874,July,2018,El Paso,TX,Passenger,1,0,1,509,510,0.2,Mid-Distance
7875,July,2018,Garfield,WA,Truck,0,0,0,956,956,0.0,Washington
7876,July,2018,Tulsa,OK,Passenger,1,1,2,47,49,4.08,Mid-Distance
7877,July,2018,Travis,TX,Passenger,0,1,1,191,192,0.52,Mid-Distance
7878,July,2018,Yakima,WA,Truck,0,0,0,58542,58542,0.0,Washington
7879,July,2018,Utah,UT,Passenger,0,1,1,133,134,0.75,Nearest
7880,July,2018,Ferry,WA,Passenger,3,3,6,4424,4430,0.14,Washington
7881,July,2018,Clallam,WA,Passenger,127,111,238,49977,50215,0.47,Washington
7882,July,2018,Kittitas,WA,Truck,0,0,0,14053,14053,0.0,Washington
7883,July,2018,Dale,AL,Passenger,0,1,1,59,60,1.67,Furthest
7884,July,2018,Adams,WA,Truck,0,0,0,5161,5161,0.0,Washington
7885,July,2018,Kittitas,WA,Passenger,48,32,80,28990,29070,0.28,Washington
7886,July,2018,Dakota,MN,Passenger,0,2,2,35,37,5.41,Mid-Distance
7887,July,2018,Douglas,WA,Truck,0,0,0,11970,11970,0.0,Washington
7888,July,2018,Clark,NV,Passenger,1,2,3,739,742,0.4,Nearest
7889,July,2018,Latah,ID,Passenger,0,1,1,72,73,1.37,Nearest
7890,July,2018,Okanogan,WA,Passenger,9,20,29,26029,26058,0.11,Washington
7891,July,2018,Whitman,WA,Passenger,19,28,47,22658,22705,0.21,Washington
7892,July,2018,Klamath,OR,Passenger,1,0,1,35,36,2.78,Nearest
7893,July,2018,Dallas,TX,Passenger,0,1,1,193,194,0.52,Mid-Distance
7894,July,2019,Juneau,AK,Passenger,0,2,2,31,33,6.06,Nearest
7895,July,2019,Lake,IL,Passenger,1,0,1,166,167,0.6,Mid-Distance
7896,July,2019,Riverside,CA,Passenger,3,2,5,653,658,0.76,Nearest
7897,July,2019,Whatcom,WA,Truck,2,0,2,42929,42931,0.0,Washington
7898,July,2019,San Diego,CA,Passenger,10,3,13,2733,2746,0.47,Nearest
7899,July,2019,Pend Oreille,WA,Truck,0,0,0,5730,5730,0.0,Washington
7900,July,2019,DuPage,IL,Passenger,3,0,3,57,60,5.0,Mid-Distance
7901,July,2019,Fresno,CA,Passenger,1,0,1,193,194,0.52,Nearest
7902,July,2019,Albemarle,VA,Passenger,1,0,1,22,23,4.35,Furthest
7903,July,2019,Montgomery,MD,Passenger,1,0,1,279,280,0.36,Furthest
7904,July,2019,Walla Walla,WA,Passenger,52,61,113,36208,36321,0.31,Washington
7905,July,2019,Wayne,MI,Passenger,0,1,1,66,67,1.49,Furthest
7906,July,2019,Nassau,NY,Passenger,4,0,4,38,42,9.52,Furthest
7907,July,2019,Owyhee,ID,Passenger,1,0,1,5,6,16.67,Nearest
7908,July,2019,Montgomery,PA,Passenger,2,0,2,37,39,5.13,Furthest
7909,July,2019,Walla Walla,WA,Truck,0,0,0,13617,13617,0.0,Washington
7910,July,2019,Moore,NC,Passenger,0,1,1,183,184,0.54,Furthest
7911,July,2019,Norfolk,MA,Passenger,1,0,1,38,39,2.56,Furthest
7912,July,2019,Columbia,WA,Passenger,2,2,4,2454,2458,0.16,Washington
7913,July,2019,Charleston,SC,Passenger,1,0,1,114,115,0.87,Furthest
7914,July,2019,Jefferson,NY,Passenger,0,2,2,214,216,0.93,Furthest
7915,July,2019,Ada,ID,Passenger,0,2,2,306,308,0.65,Nearest
7916,July,2019,Prince George's,MD,Passenger,1,1,2,177,179,1.12,Furthest
7917,July,2019,DeKalb,IN,Passenger,1,0,1,1,2,50.0,Furthest
7918,July,2019,Maui,HI,Passenger,1,0,1,45,46,2.17,Nearest
7919,July,2019,Kittitas,WA,Passenger,79,41,120,29679,29799,0.4,Washington
7920,July,2019,Monroe,IL,Passenger,1,0,1,5,6,16.67,Mid-Distance
7921,July,2019,Denver,CO,Passenger,1,0,1,128,129,0.78,Mid-Distance
7922,July,2019,Thurston,WA,Truck,0,0,0,55259,55259,0.0,Washington
7923,July,2019,Manassas,VA,Passenger,0,1,1,9,10,10.0,Furthest
7924,July,2019,Pinal,AZ,Passenger,2,0,2,191,193,1.04,Nearest
7925,July,2019,Saratoga,NY,Passenger,1,0,1,54,55,1.82,Furthest
7926,July,2019,Douglas,NE,Passenger,0,1,1,61,62,1.61,Mid-Distance
7927,July,2019,Columbia,WA,Truck,0,0,0,1529,1529,0.0,Washington
7928,July,2019,Garfield,WA,Passenger,1,1,2,1298,1300,0.15,Washington
7929,July,2019,Norfolk,VA,Passenger,2,2,4,351,355,1.13,Furthest
7930,July,2019,Yakima,WA,Passenger,109,107,216,165397,165613,0.13,Washington
7931,July,2019,San Juan,WA,Passenger,220,72,292,14446,14738,1.98,Washington
7932,July,2019,Lewis,WA,Truck,0,0,0,25966,25966,0.0,Washington
7933,July,2019,Alexandria,VA,Passenger,1,0,1,147,148,0.68,Furthest
7934,July,2019,Hawaii,HI,Passenger,1,0,1,59,60,1.67,Nearest
7935,July,2019,Fairbanks North Star,AK,Passenger,0,1,1,98,99,1.01,Nearest
7936,July,2019,El Paso,TX,Passenger,3,0,3,484,487,0.62,Mid-Distance
7937,July,2019,Skamania,WA,Passenger,25,18,43,8739,8782,0.49,Washington
7938,July,2019,Shelby,OH,Passenger,0,1,1,1,2,50.0,Furthest
7939,July,2019,Pierce,WA,Truck,0,0,0,140021,140021,0.0,Washington
7940,July,2019,Cowlitz,WA,Passenger,106,107,213,73140,73353,0.29,Washington
7941,July,2019,Thurston,WA,Passenger,905,652,1557,198166,199723,0.78,Washington
7942,July,2019,Harnett,NC,Passenger,1,1,2,212,214,0.93,Furthest
7943,July,2019,San Mateo,CA,Passenger,2,1,3,117,120,2.5,Nearest
7944,July,2019,Richland,SC,Passenger,0,1,1,161,162,0.62,Furthest
7945,July,2019,Skagit,WA,Truck,1,0,1,32524,32525,0.0,Washington
7946,July,2019,Los Angeles,CA,Passenger,8,5,13,1110,1123,1.16,Nearest
7947,July,2019,Charles,MD,Passenger,0,1,1,88,89,1.12,Furthest
7948,July,2019,Montgomery,AL,Passenger,0,1,1,43,44,2.27,Furthest
7949,July,2019,Middlesex,MA,Passenger,1,1,2,114,116,1.72,Furthest
7950,July,2019,Jefferson,CO,Passenger,0,2,2,57,59,3.39,Mid-Distance
7951,July,2019,Carson City,NV,Passenger,1,0,1,11,12,8.33,Nearest
7952,July,2019,Clark,WA,Passenger,1588,944,2532,314921,317453,0.8,Washington
7953,July,2019,Lincoln,WA,Truck,0,0,0,4684,4684,0.0,Washington
7954,July,2019,New London,CT,Passenger,0,2,2,242,244,0.82,Furthest
7955,July,2019,Cowlitz,WA,Truck,0,0,0,28867,28867,0.0,Washington
7956,July,2019,Clay,FL,Passenger,0,1,1,87,88,1.14,Furthest
7957,July,2019,Oklahoma,OK,Passenger,0,1,1,125,126,0.79,Mid-Distance
7958,July,2019,Skagit,WA,Passenger,307,210,517,92211,92728,0.56,Washington
7959,July,2019,Deschutes,OR,Passenger,2,0,2,155,157,1.27,Nearest
7960,July,2019,Houston,GA,Passenger,1,0,1,54,55,1.82,Furthest
7961,July,2019,Shasta,CA,Passenger,1,0,1,40,41,2.44,Nearest
7962,July,2019,Loudoun,VA,Passenger,1,0,1,96,97,1.03,Furthest
7963,July,2019,Clackamas,OR,Passenger,1,1,2,213,215,0.93,Nearest
7964,July,2019,Placer,CA,Passenger,1,0,1,99,100,1.0,Nearest
7965,July,2019,Clark,WA,Truck,0,0,0,80613,80613,0.0,Washington
7967,July,2019,El Paso,CO,Passenger,2,1,3,737,740,0.41,Mid-Distance
7968,July,2019,Fairfax,VA,Passenger,3,2,5,781,786,0.64,Furthest
7969,July,2019,Klickitat,WA,Truck,0,0,0,8255,8255,0.0,Washington
7970,July,2019,King,WA,Truck,5,1,6,182265,182271,0.0,Washington
7971,July,2019,Asotin,WA,Truck,0,0,0,6660,6660,0.0,Washington
7972,July,2019,New Haven,CT,Passenger,0,2,2,47,49,4.08,Furthest
7973,July,2019,Benton,WA,Passenger,270,289,559,134166,134725,0.41,Washington
7974,July,2019,Ramsey,MN,Passenger,1,0,1,39,40,2.5,Mid-Distance
7975,July,2019,Kent,MI,Passenger,0,1,1,21,22,4.55,Furthest
7976,July,2019,Valencia,NM,Passenger,1,0,1,6,7,14.29,Mid-Distance
7977,July,2019,Flathead,MT,Passenger,1,0,1,62,63,1.59,Nearest
7978,July,2019,Wilson,TX,Passenger,0,1,1,6,7,14.29,Mid-Distance
7979,July,2019,Jefferson,WA,Truck,0,0,0,9683,9683,0.0,Washington
7980,July,2019,Twin Falls,ID,Passenger,0,1,1,24,25,4.0,Nearest
7981,July,2019,Santa Fe,NM,Passenger,0,1,1,39,40,2.5,Mid-Distance
7982,July,2019,Bexar,TX,Passenger,2,5,7,658,665,1.05,Mid-Distance
7983,July,2019,Putnam,TN,Passenger,0,1,1,3,4,25.0,Furthest
7984,July,2019,Skamania,WA,Truck,0,0,0,4063,4063,0.0,Washington
7985,July,2019,Mason,WA,Passenger,127,126,253,47316,47569,0.53,Washington
7986,July,2019,Dallas,TX,Passenger,1,0,1,203,204,0.49,Mid-Distance
7987,July,2019,Marion,OR,Passenger,1,0,1,117,118,0.85,Nearest
7988,July,2019,Osceola,FL,Passenger,1,0,1,41,42,2.38,Furthest
7989,July,2019,Solano,CA,Passenger,1,0,1,215,216,0.46,Nearest
7990,July,2019,Randolph,NC,Passenger,1,0,1,6,7,14.29,Furthest
7991,July,2019,St. Clair,IL,Passenger,0,1,1,158,159,0.63,Mid-Distance
7992,July,2019,Clallam,WA,Truck,1,0,1,21812,21813,0.0,Washington
7993,July,2019,Jefferson,WA,Passenger,202,118,320,25065,25385,1.26,Washington
7994,July,2019,Bergen,NJ,Passenger,1,0,1,26,27,3.7,Furthest
7995,July,2019,Dale,AL,Passenger,0,1,1,59,60,1.67,Furthest
7996,July,2019,Ferry,WA,Truck,0,0,0,3580,3580,0.0,Washington
7997,July,2019,Nantucket,MA,Passenger,1,0,1,2,3,33.33,Furthest
7998,July,2019,Powhatan,VA,Passenger,1,0,1,0,1,100.0,Furthest
7999,July,2019,Maricopa,AZ,Passenger,7,4,11,1530,1541,0.71,Nearest
8000,July,2019,Sedgwick,KS,Passenger,1,1,2,99,101,1.98,Mid-Distance
8001,July,2019,Clark,NV,Passenger,4,2,6,690,696,0.86,Nearest
8002,July,2019,Pima,AZ,Passenger,0,1,1,392,393,0.25,Nearest
8003,July,2019,Sumter,FL,Passenger,0,1,1,10,11,9.09,Furthest
8004,July,2019,Washtenaw,MI,Passenger,1,0,1,41,42,2.38,Furthest
8005,July,2019,Snohomish,WA,Truck,0,0,0,122619,122619,0.0,Washington
8006,July,2019,Brevard,FL,Passenger,0,1,1,83,84,1.19,Furthest
8007,July,2019,Palm Beach,FL,Passenger,0,1,1,85,86,1.16,Furthest
8008,July,2019,Spartanburg,SC,Passenger,0,1,1,37,38,2.63,Furthest
8009,July,2019,Asotin,WA,Passenger,12,8,20,12658,12678,0.16,Washington
8010,July,2019,Calvert,MD,Passenger,0,2,2,89,91,2.2,Furthest
8011,July,2019,Suffolk,MA,Passenger,0,1,1,37,38,2.63,Furthest
8012,July,2019,Harris,TX,Passenger,1,1,2,249,251,0.8,Mid-Distance
8013,July,2019,Benton,WA,Truck,0,0,0,42072,42072,0.0,Washington
8014,July,2019,DeKalb,GA,Passenger,1,0,1,77,78,1.28,Furthest
8015,July,2019,Bucks,PA,Passenger,1,0,1,21,22,4.55,Furthest
8016,July,2019,Mecklenburg,NC,Passenger,1,0,1,88,89,1.12,Furthest
8017,July,2019,Dakota,MN,Passenger,0,1,1,37,38,2.63,Mid-Distance
8018,July,2019,RÃ­o Grande,PR,Passenger,1,0,1,1,2,50.0,Mid-Distance
8019,July,2019,Sarasota,FL,Passenger,1,0,1,24,25,4.0,Furthest
8020,July,2019,Chelan,WA,Truck,0,0,0,22349,22349,0.0,Washington
8021,July,2019,Alameda,CA,Passenger,4,2,6,303,309,1.94,Nearest
8022,July,2019,Cumberland,NC,Passenger,0,2,2,498,500,0.4,Furthest
8023,July,2019,Frederick,MD,Passenger,1,1,2,81,83,2.41,Furthest
8024,July,2019,Boone,MO,Passenger,0,1,1,10,11,9.09,Furthest
8025,July,2019,Snohomish,WA,Passenger,3556,1617,5173,532742,537915,0.96,Washington
8026,July,2019,Island,WA,Truck,0,0,0,21312,21312,0.0,Washington
8027,July,2019,Franklin,WA,Passenger,53,71,124,60145,60269,0.21,Washington
8028,July,2019,Tarrant,TX,Passenger,2,0,2,201,203,0.99,Mid-Distance
8029,July,2019,Tulsa,OK,Passenger,1,1,2,45,47,4.26,Mid-Distance
8030,July,2019,Duval,FL,Passenger,1,2,3,372,375,0.8,Furthest
8031,July,2019,Santa Rosa,FL,Passenger,1,0,1,90,91,1.1,Furthest
8032,July,2019,Allegheny,PA,Passenger,1,0,1,78,79,1.27,Furthest
8033,July,2019,Kitsap,WA,Truck,1,0,1,54128,54129,0.0,Washington
8034,July,2019,Lewis,WA,Passenger,100,96,196,59368,59564,0.33,Washington
8035,July,2019,Harrison,MS,Passenger,1,0,1,62,63,1.59,Mid-Distance
8036,July,2019,Penobscot,ME,Passenger,0,1,1,13,14,7.14,Furthest
8037,July,2019,Saginaw,MI,Passenger,1,0,1,11,12,8.33,Furthest
8038,July,2019,Grant,WA,Truck,0,0,0,26703,26703,0.0,Washington
8039,July,2019,Franklin,WA,Truck,0,0,0,19368,19368,0.0,Washington
8040,July,2019,Lake,FL,Passenger,1,0,1,19,20,5.0,Furthest
8041,July,2019,Portsmouth,VA,Passenger,0,1,1,78,79,1.27,Furthest
8042,July,2019,Nueces,TX,Passenger,1,1,2,93,95,2.11,Mid-Distance
8043,July,2019,Adams,WA,Passenger,5,6,11,12835,12846,0.09,Washington
8044,July,2019,Cochise,AZ,Passenger,0,1,1,111,112,0.89,Nearest
8045,July,2019,Cook,IL,Passenger,1,0,1,240,241,0.41,Mid-Distance
8046,July,2019,Spokane,WA,Passenger,557,435,992,312718,313710,0.32,Washington
8047,July,2019,Wahkiakum,WA,Passenger,2,2,4,3007,3011,0.13,Washington
8048,July,2019,Broward,FL,Passenger,2,1,3,126,129,2.33,Furthest
8049,July,2019,Yakima,WA,Truck,0,0,0,59260,59260,0.0,Washington
8050,July,2019,Manatee,FL,Passenger,1,0,1,31,32,3.12,Furthest
8051,July,2019,Contra Costa,CA,Passenger,2,2,4,377,381,1.05,Nearest
8052,July,2019,Grant,WA,Passenger,43,61,104,65017,65121,0.16,Washington
8053,July,2019,Klickitat,WA,Passenger,35,33,68,15579,15647,0.43,Washington
8054,July,2019,Carroll,NH,Passenger,0,1,1,3,4,25.0,Furthest
8055,July,2019,San Juan,WA,Truck,0,0,0,5890,5890,0.0,Washington
8056,July,2019,Arlington,VA,Passenger,0,2,2,157,159,1.26,Furthest
8057,July,2019,Stevens,WA,Passenger,19,30,49,31721,31770,0.15,Washington
8058,July,2019,Goochland,VA,Passenger,1,1,2,259,261,0.77,Furthest
8059,July,2019,Pend Oreille,WA,Passenger,4,6,10,9537,9547,0.1,Washington
8060,July,2019,Guadalupe,TX,Passenger,1,0,1,73,74,1.35,Mid-Distance
8061,July,2019,Larimer,CO,Passenger,1,0,1,57,58,1.72,Mid-Distance
8062,July,2019,Orange,CA,Passenger,6,1,7,521,528,1.33,Nearest
8063,July,2019,District of Columbia,DC,Passenger,1,1,2,211,213,0.94,Furthest
8064,July,2019,Cascade,MT,Passenger,0,1,1,61,62,1.61,Nearest
8065,July,2019,Adams,WA,Truck,0,0,0,5132,5132,0.0,Washington
8066,July,2019,St. Mary's,MD,Passenger,1,0,1,217,218,0.46,Furthest
8067,July,2019,Kern,CA,Passenger,0,1,1,218,219,0.46,Nearest
8068,July,2019,Montgomery,TX,Passenger,1,0,1,59,60,1.67,Mid-Distance
8069,July,2019,Shelby,TN,Passenger,0,1,1,90,91,1.1,Furthest
8070,July,2019,Grays Harbor,WA,Truck,0,0,0,20535,20535,0.0,Washington
8071,July,2019,Vigo,IN,Passenger,1,0,1,6,7,14.29,Furthest
8072,July,2019,Santa Cruz,CA,Passenger,1,0,1,39,40,2.5,Nearest
8073,July,2019,Spokane,WA,Truck,1,0,1,95241,95242,0.0,Washington
8074,July,2019,Kootenai,ID,Passenger,1,1,2,221,223,0.9,Nearest
8075,July,2019,Grays Harbor,WA,Passenger,82,85,167,47997,48164,0.35,Washington
8076,July,2019,Ferry,WA,Passenger,5,2,7,4399,4406,0.16,Washington
8077,July,2019,Collin,TX,Passenger,1,1,2,134,136,1.47,Mid-Distance
8078,July,2019,Travis,TX,Passenger,2,1,3,199,202,1.49,Mid-Distance
8079,July,2019,Kittitas,WA,Truck,0,0,0,14488,14488,0.0,Washington
8080,July,2019,Rogers,OK,Passenger,1,0,1,5,6,16.67,Mid-Distance
8081,July,2019,Wahkiakum,WA,Truck,0,0,0,1761,1761,0.0,Washington
8082,July,2019,Washoe,NV,Passenger,2,0,2,111,113,1.77,Nearest
8083,July,2019,Prince William,VA,Passenger,1,3,4,248,252,1.59,Furthest
8084,July,2019,Howard,MD,Passenger,0,1,1,74,75,1.33,Furthest
8085,July,2019,Polk,FL,Passenger,1,0,1,66,67,1.49,Furthest
8086,July,2019,Mason,WA,Truck,0,0,0,20412,20412,0.0,Washington
8087,July,2019,San Francisco,CA,Passenger,2,1,3,105,108,2.78,Nearest
8088,July,2019,Lee,FL,Passenger,1,0,1,51,52,1.92,Furthest
8089,July,2019,Okanogan,WA,Truck,0,0,0,16490,16490,0.0,Washington
8090,July,2019,Oldham,KY,Passenger,0,1,1,5,6,16.67,Furthest
8091,July,2019,Island,WA,Passenger,328,243,571,63488,64059,0.89,Washington
8092,July,2019,Stevens,WA,Truck,0,0,0,18704,18704,0.0,Washington
8093,July,2019,Pacific,WA,Passenger,24,30,54,16029,16083,0.34,Washington
8094,July,2019,Virginia Beach,VA,Passenger,1,0,1,709,710,0.14,Furthest
8095,July,2019,Garfield,WA,Truck,0,0,0,961,961,0.0,Washington
8096,July,2019,Lincoln,WA,Passenger,2,10,12,7793,7805,0.15,Washington
8097,July,2019,Camden,NJ,Passenger,0,1,1,25,26,3.85,Furthest
8098,July,2019,Okanogan,WA,Passenger,23,26,49,26123,26172,0.19,Washington
8099,July,2019,Franklin,MA,Passenger,0,1,1,1,2,50.0,Furthest
8100,July,2019,Williamson,TX,Passenger,0,2,2,144,146,1.37,Mid-Distance
8101,July,2019,Pierce,WA,Passenger,1877,1570,3447,544359,547806,0.63,Washington
8102,July,2019,Clallam,WA,Passenger,177,144,321,50640,50961,0.63,Washington
8103,July,2019,Pinellas,FL,Passenger,1,0,1,113,114,0.88,Furthest
8104,July,2019,Fulton,GA,Passenger,0,2,2,102,104,1.92,Furthest
8105,July,2019,Ventura,CA,Passenger,0,2,2,311,313,0.64,Nearest
8106,July,2019,Richmond,GA,Passenger,0,1,1,91,92,1.09,Furthest
8107,July,2019,Volusia,FL,Passenger,0,1,1,38,39,2.56,Furthest
8108,July,2019,Hennepin,MN,Passenger,2,1,3,104,107,2.8,Mid-Distance
8109,July,2019,Douglas,WA,Passenger,60,37,97,28078,28175,0.34,Washington
8110,July,2019,Douglas,WA,Truck,0,0,0,12221,12221,0.0,Washington
8111,July,2019,Sangamon,IL,Passenger,1,0,1,6,7,14.29,Mid-Distance
8112,July,2019,Anne Arundel,MD,Passenger,1,2,3,440,443,0.68,Furthest
8113,July,2019,Cape May,NJ,Passenger,0,1,1,15,16,6.25,Furthest
8114,July,2019,Multnomah,OR,Passenger,5,6,11,742,753,1.46,Nearest
8115,July,2019,Berkshire,MA,Passenger,0,1,1,4,5,20.0,Furthest
8116,July,2019,Whitman,WA,Truck,0,0,0,8629,8629,0.0,Washington
8117,July,2019,Caddo,LA,Passenger,0,1,1,21,22,4.55,Mid-Distance
8118,July,2019,Whatcom,WA,Passenger,883,436,1319,151115,152434,0.87,Washington
8119,July,2019,Kitsap,WA,Passenger,1093,625,1718,181246,182964,0.94,Washington
8120,July,2019,King,WA,Passenger,19627,7112,26739,1391293,1418032,1.89,Washington
8121,July,2019,Pacific,WA,Truck,0,0,0,7669,7669,0.0,Washington
8122,July,2019,Chelan,WA,Passenger,161,68,229,54431,54660,0.42,Washington
8123,July,2019,San Joaquin,CA,Passenger,1,0,1,128,129,0.78,Nearest
8124,July,2019,Tuolumne,CA,Passenger,0,1,1,12,13,7.69,Nearest
8125,July,2019,Klamath,OR,Passenger,1,0,1,38,39,2.56,Nearest
8126,July,2019,Santa Clara,CA,Passenger,4,2,6,365,371,1.62,Nearest
8127,July,2019,Whitman,WA,Passenger,33,45,78,22702,22780,0.34,Washington
8128,July,2019,Honolulu,HI,Passenger,3,3,6,492,498,1.2,Nearest
8129,July,2020,Snohomish,WA,Passenger,4583,1775,6358,535609,541967,1.17,Washington
8130,July,2020,Pacific,WA,Passenger,33,33,66,15766,15832,0.42,Washington
8131,July,2020,Richmond,GA,Passenger,0,1,1,82,83,1.2,Furthest
8132,July,2020,Monterey,CA,Passenger,0,1,1,162,163,0.61,Nearest
8133,July,2020,Skamania,WA,Truck,0,0,0,4032,4032,0.0,Washington
8134,July,2020,Fairbanks North Star,AK,Passenger,0,1,1,95,96,1.04,Nearest
8135,July,2020,Frederick,MD,Passenger,1,1,2,75,77,2.6,Furthest
8136,July,2020,Whitman,WA,Passenger,45,49,94,22124,22218,0.42,Washington
8137,July,2020,San Diego,CA,Passenger,14,5,19,2756,2775,0.68,Nearest
8138,July,2020,Hamilton,IN,Passenger,1,0,1,40,41,2.44,Furthest
8139,July,2020,Sacramento,CA,Passenger,1,0,1,262,263,0.38,Nearest
8140,July,2020,Snohomish,WA,Truck,0,0,0,124342,124342,0.0,Washington
8141,July,2020,Pierce,WA,Passenger,2467,1697,4164,551463,555627,0.75,Washington
8142,July,2020,Whitman,WA,Truck,0,0,0,8507,8507,0.0,Washington
8143,July,2020,Harnett,NC,Passenger,1,0,1,196,197,0.51,Furthest
8144,July,2020,Rockingham,NH,Passenger,1,0,1,21,22,4.55,Furthest
8145,July,2020,King,WA,Truck,7,1,8,182955,182963,0.0,Washington
8146,July,2020,Harris,TX,Passenger,1,0,1,221,222,0.45,Mid-Distance
8147,July,2020,Fresno,CA,Passenger,1,0,1,175,176,0.57,Nearest
8148,July,2020,Klickitat,WA,Truck,0,0,0,8117,8117,0.0,Washington
8149,July,2020,Middlesex,MA,Passenger,1,1,2,92,94,2.13,Furthest
8150,July,2020,Ramsey,MN,Passenger,1,0,1,38,39,2.56,Mid-Distance
8151,July,2020,Nassau,NY,Passenger,4,0,4,29,33,12.12,Furthest
8152,July,2020,Twin Falls,ID,Passenger,0,1,1,22,23,4.35,Nearest
8153,July,2020,Hudson,NJ,Passenger,1,0,1,37,38,2.63,Furthest
8154,July,2020,Montgomery,TX,Passenger,1,0,1,50,51,1.96,Mid-Distance
8155,July,2020,Goochland,VA,Passenger,3,1,4,255,259,1.54,Furthest
8156,July,2020,Prince William,VA,Passenger,2,3,5,222,227,2.2,Furthest
8157,July,2020,Cascade,MT,Passenger,0,1,1,53,54,1.85,Nearest
8158,July,2020,Fort Bend,TX,Passenger,1,0,1,45,46,2.17,Mid-Distance
8159,July,2020,Chesapeake,VA,Passenger,0,2,2,414,416,0.48,Furthest
8160,July,2020,Howard,MD,Passenger,0,1,1,69,70,1.43,Furthest
8161,July,2020,Skagit,WA,Passenger,423,223,646,91309,91955,0.7,Washington
8162,July,2020,Cowlitz,WA,Truck,0,0,0,28879,28879,0.0,Washington
8163,July,2020,Pacific,WA,Truck,0,0,0,7714,7714,0.0,Washington
8164,July,2020,Putnam,TN,Passenger,0,1,1,3,4,25.0,Furthest
8165,July,2020,Chelan,WA,Truck,0,0,0,22628,22628,0.0,Washington
8166,July,2020,Cumberland,NC,Passenger,0,3,3,461,464,0.65,Furthest
8167,July,2020,Walla Walla,WA,Passenger,77,65,142,35905,36047,0.39,Washington
8168,July,2020,Thurston,WA,Truck,0,0,0,55895,55895,0.0,Washington
8169,July,2020,New London,CT,Passenger,1,2,3,240,243,1.23,Furthest
8170,July,2020,Mason,WA,Truck,0,0,0,20714,20714,0.0,Washington
8171,July,2020,Pinellas,FL,Passenger,1,1,2,108,110,1.82,Furthest
8172,July,2020,Williamson,TX,Passenger,0,2,2,135,137,1.46,Mid-Distance
8173,July,2020,El Paso,CO,Passenger,2,0,2,716,718,0.28,Mid-Distance
8174,July,2020,Lincoln,WA,Truck,0,0,0,4661,4661,0.0,Washington
8175,July,2020,Anne Arundel,MD,Passenger,0,1,1,412,413,0.24,Furthest
8176,July,2020,Washtenaw,MI,Passenger,1,0,1,36,37,2.7,Furthest
8177,July,2020,Williams,ND,Passenger,0,1,1,11,12,8.33,Mid-Distance
8178,July,2020,Tulsa,OK,Passenger,1,1,2,42,44,4.55,Mid-Distance
8179,July,2020,Kootenai,ID,Passenger,1,0,1,217,218,0.46,Nearest
8180,July,2020,El Paso,TX,Passenger,3,0,3,417,420,0.71,Mid-Distance
8181,July,2020,Nassau,FL,Passenger,1,0,1,35,36,2.78,Furthest
8182,July,2020,DeKalb,IN,Passenger,1,0,1,1,2,50.0,Furthest
8183,July,2020,Ulster,NY,Passenger,1,0,1,7,8,12.5,Furthest
8184,July,2020,Grays Harbor,WA,Passenger,109,112,221,48286,48507,0.46,Washington
8185,July,2020,Guadalupe,TX,Passenger,1,0,1,60,61,1.64,Mid-Distance
8186,July,2020,Kings,NY,Passenger,1,0,1,66,67,1.49,Furthest
8187,July,2020,Fairfax,VA,Passenger,4,3,7,734,741,0.94,Furthest
8188,July,2020,Larimer,CO,Passenger,1,0,1,51,52,1.92,Mid-Distance
8189,July,2020,RÃ­o Grande,PR,Passenger,1,0,1,1,2,50.0,Mid-Distance
8190,July,2020,Okanogan,WA,Truck,0,0,0,16492,16492,0.0,Washington
8191,July,2020,Orange,CA,Passenger,7,2,9,482,491,1.83,Nearest
8192,July,2020,Alameda,CA,Passenger,2,0,2,264,266,0.75,Nearest
8193,July,2020,Franklin,WA,Passenger,65,79,144,60778,60922,0.24,Washington
8194,July,2020,Lewis,WA,Passenger,107,115,222,58138,58360,0.38,Washington
8195,July,2020,Wahkiakum,WA,Truck,0,0,0,1742,1742,0.0,Washington
8196,July,2020,Island,WA,Passenger,430,272,702,62871,63573,1.1,Washington
8197,July,2020,Denton,TX,Passenger,1,0,1,88,89,1.12,Mid-Distance
8198,July,2020,Jefferson,CO,Passenger,0,1,1,57,58,1.72,Mid-Distance
8199,July,2020,Lewis,WA,Truck,0,0,0,26284,26284,0.0,Washington
8200,July,2020,Saginaw,MI,Passenger,1,0,1,10,11,9.09,Furthest
8201,July,2020,Douglas,WA,Truck,0,0,0,12352,12352,0.0,Washington
8202,July,2020,Queens,NY,Passenger,1,0,1,50,51,1.96,Furthest
8203,July,2020,Cape May,NJ,Passenger,0,1,1,13,14,7.14,Furthest
8204,July,2020,Virginia Beach,VA,Passenger,1,0,1,665,666,0.15,Furthest
8205,July,2020,Washington,OR,Passenger,1,0,1,432,433,0.23,Nearest
8206,July,2020,Clallam,WA,Passenger,237,169,406,50056,50462,0.8,Washington
8207,July,2020,Allegheny,PA,Passenger,1,0,1,72,73,1.37,Furthest
8208,July,2020,Stafford,VA,Passenger,1,1,2,91,93,2.15,Furthest
8209,July,2020,District of Columbia,DC,Passenger,2,1,3,203,206,1.46,Furthest
8210,July,2020,Pinal,AZ,Passenger,1,0,1,176,177,0.56,Nearest
8211,July,2020,Ferry,WA,Passenger,7,3,10,4330,4340,0.23,Washington
8212,July,2020,Pierce,WA,Truck,0,0,0,142931,142931,0.0,Washington
8213,July,2020,Columbia,WA,Truck,0,0,0,1541,1541,0.0,Washington
8214,July,2020,Lake,FL,Passenger,1,0,1,22,23,4.35,Furthest
8215,July,2020,Boone,MO,Passenger,0,1,1,10,11,9.09,Furthest
8216,July,2020,Salt Lake,UT,Passenger,0,1,1,182,183,0.55,Nearest
8217,July,2020,St. Mary's,MD,Passenger,1,0,1,218,219,0.46,Furthest
8218,July,2020,Whatcom,WA,Passenger,1091,499,1590,149332,150922,1.05,Washington
8219,July,2020,Nueces,TX,Passenger,1,0,1,83,84,1.19,Mid-Distance
8220,July,2020,Skagit,WA,Truck,1,0,1,32590,32591,0.0,Washington
8221,July,2020,Penobscot,ME,Passenger,0,1,1,14,15,6.67,Furthest
8222,July,2020,Manassas,VA,Passenger,0,1,1,5,6,16.67,Furthest
8223,July,2020,Jefferson,WA,Passenger,249,142,391,24737,25128,1.56,Washington
8224,July,2020,Asotin,WA,Truck,0,0,0,6653,6653,0.0,Washington
8225,July,2020,Clark,WA,Truck,0,0,0,82429,82429,0.0,Washington
8226,July,2020,Montgomery,AL,Passenger,0,1,1,40,41,2.44,Furthest
8227,July,2020,DeKalb,GA,Passenger,1,0,1,76,77,1.3,Furthest
8228,July,2020,Powhatan,VA,Passenger,1,0,1,0,1,100.0,Furthest
8229,July,2020,Collin,TX,Passenger,1,1,2,119,121,1.65,Mid-Distance
8230,July,2020,Grays Harbor,WA,Truck,0,0,0,20981,20981,0.0,Washington
8231,July,2020,Grant,WA,Truck,0,0,0,27176,27176,0.0,Washington
8232,July,2020,Stevens,WA,Passenger,37,35,72,30627,30699,0.23,Washington
8233,July,2020,Travis,TX,Passenger,2,1,3,170,173,1.73,Mid-Distance
8234,July,2020,Maui,HI,Passenger,1,0,1,32,33,3.03,Nearest
8235,July,2020,Broward,FL,Passenger,2,1,3,107,110,2.73,Furthest
8236,July,2020,Bradley,TN,Passenger,1,0,1,3,4,25.0,Furthest
8237,July,2020,Kent,MI,Passenger,0,1,1,23,24,4.17,Furthest
8238,July,2020,Asotin,WA,Passenger,16,12,28,12378,12406,0.23,Washington
8239,July,2020,Santa Clara,CA,Passenger,8,2,10,284,294,3.4,Nearest
8240,July,2020,Moore,NC,Passenger,0,2,2,156,158,1.27,Furthest
8241,July,2020,San Francisco,CA,Passenger,2,1,3,91,94,3.19,Nearest
8242,July,2020,Pend Oreille,WA,Passenger,7,5,12,9246,9258,0.13,Washington
8243,July,2020,Kittitas,WA,Truck,0,0,0,14564,14564,0.0,Washington
8244,July,2020,Wilson,TX,Passenger,0,1,1,5,6,16.67,Mid-Distance
8245,July,2020,Garfield,WA,Truck,0,0,0,988,988,0.0,Washington
8246,July,2020,Cowlitz,WA,Passenger,146,117,263,72232,72495,0.36,Washington
8247,July,2020,Harrison,MS,Passenger,1,0,1,51,52,1.92,Mid-Distance
8248,July,2020,Charles,MD,Passenger,1,1,2,74,76,2.63,Furthest
8249,July,2020,Loudoun,VA,Passenger,1,0,1,83,84,1.19,Furthest
8250,July,2020,Jefferson,WA,Truck,0,0,0,9542,9542,0.0,Washington
8251,July,2020,Charleston,SC,Passenger,2,0,2,98,100,2.0,Furthest
8252,July,2020,King,WA,Passenger,24904,7756,32660,1371156,1403816,2.33,Washington
8253,July,2020,San Juan,WA,Truck,0,0,0,5844,5844,0.0,Washington
8254,July,2020,Bartow,GA,Passenger,0,1,1,4,5,20.0,Furthest
8255,July,2020,Clark,NV,Passenger,2,2,4,671,675,0.59,Nearest
8256,July,2020,Shasta,CA,Passenger,1,0,1,38,39,2.56,Nearest
8257,July,2020,Sarasota,FL,Passenger,2,0,2,24,26,7.69,Furthest
8258,July,2020,Kitsap,WA,Truck,0,0,0,54144,54144,0.0,Washington
8259,July,2020,Clark,WA,Passenger,2097,1066,3163,317956,321119,0.98,Washington
8260,July,2020,Riverside,CA,Passenger,3,1,4,610,614,0.65,Nearest
8261,July,2020,Maricopa,AZ,Passenger,5,6,11,1401,1412,0.78,Nearest
8262,July,2020,St. Louis,MO,Passenger,1,0,1,97,98,1.02,Furthest
8263,July,2020,Santa Cruz,CA,Passenger,1,0,1,31,32,3.12,Nearest
8264,July,2020,Spokane,WA,Passenger,753,491,1244,316437,317681,0.39,Washington
8265,July,2020,Palm Beach,FL,Passenger,0,1,1,80,81,1.23,Furthest
8266,July,2020,Utah,UT,Passenger,0,1,1,131,132,0.76,Nearest
8267,July,2020,Skamania,WA,Passenger,31,20,51,8428,8479,0.6,Washington
8268,July,2020,Ventura,CA,Passenger,1,2,3,278,281,1.07,Nearest
8269,July,2020,Rogers,OK,Passenger,1,0,1,4,5,20.0,Mid-Distance
8270,July,2020,Island,WA,Truck,1,0,1,21235,21236,0.0,Washington
8271,July,2020,Franklin,WA,Truck,0,0,0,20096,20096,0.0,Washington
8272,July,2020,Arapahoe,CO,Passenger,1,0,1,128,129,0.78,Mid-Distance
8273,July,2020,Boulder,CO,Passenger,0,1,1,44,45,2.22,Mid-Distance
8274,July,2020,Deschutes,OR,Passenger,2,0,2,130,132,1.52,Nearest
8275,July,2020,Dallas,TX,Passenger,1,0,1,188,189,0.53,Mid-Distance
8276,July,2020,Carroll,NH,Passenger,0,1,1,4,5,20.0,Furthest
8277,July,2020,Calvert,MD,Passenger,0,2,2,89,91,2.2,Furthest
8278,July,2020,San Mateo,CA,Passenger,0,1,1,108,109,0.92,Nearest
8279,July,2020,Fulton,GA,Passenger,1,2,3,101,104,2.88,Furthest
8280,July,2020,Stevens,WA,Truck,0,0,0,18672,18672,0.0,Washington
8281,July,2020,San Joaquin,CA,Passenger,1,0,1,125,126,0.79,Nearest
8283,July,2020,Sedgwick,KS,Passenger,1,1,2,96,98,2.04,Mid-Distance
8284,July,2020,Shelby,OH,Passenger,0,1,1,1,2,50.0,Furthest
8285,July,2020,Garfield,WA,Passenger,0,1,1,1350,1351,0.07,Washington
8286,July,2020,Okanogan,WA,Passenger,37,34,71,25923,25994,0.27,Washington
8287,July,2020,Carson City,NV,Passenger,1,0,1,10,11,9.09,Nearest
8288,July,2020,Morris,NJ,Passenger,1,0,1,17,18,5.56,Furthest
8289,July,2020,Hawaii,HI,Passenger,1,0,1,55,56,1.79,Nearest
8290,July,2020,Honolulu,HI,Passenger,4,2,6,440,446,1.35,Nearest
8291,July,2020,Walla Walla,WA,Truck,0,0,0,13755,13755,0.0,Washington
8292,July,2020,Kittitas,WA,Passenger,104,47,151,29761,29912,0.5,Washington
8293,July,2020,Suffolk,MA,Passenger,0,2,2,36,38,5.26,Furthest
8294,July,2020,Yakima,WA,Passenger,139,119,258,165771,166029,0.16,Washington
8295,July,2020,Douglas,NE,Passenger,0,1,1,50,51,1.96,Mid-Distance
8296,July,2020,Whatcom,WA,Truck,3,0,3,43156,43159,0.01,Washington
8297,July,2020,Yakima,WA,Truck,0,0,0,60200,60200,0.0,Washington
8298,July,2020,DuPage,IL,Passenger,3,0,3,58,61,4.92,Mid-Distance
8299,July,2020,Dakota,MN,Passenger,0,1,1,33,34,2.94,Mid-Distance
8300,July,2020,Benton,WA,Truck,0,0,0,42882,42882,0.0,Washington
8301,July,2020,Los Angeles,CA,Passenger,7,11,18,981,999,1.8,Nearest
8302,July,2020,Mason,WA,Passenger,160,134,294,47372,47666,0.62,Washington
8303,July,2020,Jefferson,NY,Passenger,0,1,1,210,211,0.47,Furthest
8304,July,2020,Chelan,WA,Passenger,240,82,322,54232,54554,0.59,Washington
8305,July,2020,Houston,GA,Passenger,1,0,1,55,56,1.79,Furthest
8306,July,2020,Albemarle,VA,Passenger,1,0,1,20,21,4.76,Furthest
8307,July,2020,Flathead,MT,Passenger,1,0,1,55,56,1.79,Nearest
8308,July,2020,Clay,FL,Passenger,0,1,1,82,83,1.2,Furthest
8309,July,2020,Oldham,KY,Passenger,0,1,1,4,5,20.0,Furthest
8310,July,2020,Placer,CA,Passenger,2,0,2,85,87,2.3,Nearest
8311,July,2020,Camden,NJ,Passenger,0,1,1,22,23,4.35,Furthest
8312,July,2020,Lee,FL,Passenger,1,0,1,50,51,1.96,Furthest
8313,July,2020,San Juan,WA,Passenger,311,94,405,13959,14364,2.82,Washington
8314,July,2020,Clallam,WA,Truck,1,0,1,21697,21698,0.0,Washington
8315,July,2020,Kitsap,WA,Passenger,1377,696,2073,179884,181957,1.14,Washington
8316,July,2020,Adams,WA,Passenger,9,7,16,12866,12882,0.12,Washington
8317,July,2020,Lake,IL,Passenger,1,0,1,163,164,0.61,Mid-Distance
8318,July,2020,Juneau,AK,Passenger,0,1,1,29,30,3.33,Nearest
8319,July,2020,Klamath,OR,Passenger,1,0,1,33,34,2.94,Nearest
8320,July,2020,Duval,FL,Passenger,0,2,2,361,363,0.55,Furthest
8321,July,2020,Spartanburg,SC,Passenger,0,1,1,47,48,2.08,Furthest
8322,July,2020,Monroe,IL,Passenger,1,0,1,4,5,20.0,Mid-Distance
8323,July,2020,Norfolk,VA,Passenger,2,2,4,346,350,1.14,Furthest
8324,July,2020,Montgomery,OH,Passenger,0,1,1,48,49,2.04,Furthest
8325,July,2020,Contra Costa,CA,Passenger,4,3,7,305,312,2.24,Nearest
8326,July,2020,Prince George's,MD,Passenger,1,1,2,156,158,1.27,Furthest
8327,July,2020,Greene,MO,Passenger,0,1,1,33,34,2.94,Furthest
8328,July,2020,Okaloosa,FL,Passenger,0,1,1,138,139,0.72,Furthest
8329,July,2020,Bexar,TX,Passenger,4,5,9,597,606,1.49,Mid-Distance
8330,July,2020,Erie,NY,Passenger,1,0,1,45,46,2.17,Furthest
8331,July,2020,Pend Oreille,WA,Truck,0,0,0,5762,5762,0.0,Washington
8332,July,2020,Polk,FL,Passenger,1,0,1,64,65,1.54,Furthest
8333,July,2020,Jones,GA,Passenger,1,0,1,1,2,50.0,Furthest
8334,July,2020,Columbia,WA,Passenger,4,3,7,2418,2425,0.29,Washington
8335,July,2020,Vigo,IN,Passenger,1,0,1,5,6,16.67,Furthest
8336,July,2020,Owyhee,ID,Passenger,1,0,1,3,4,25.0,Nearest
8337,July,2020,Wahkiakum,WA,Passenger,6,6,12,3001,3013,0.4,Washington
8338,July,2020,St. Clair,IL,Passenger,1,0,1,136,137,0.73,Mid-Distance
8339,July,2020,Ada,ID,Passenger,0,1,1,261,262,0.38,Nearest
8340,July,2020,Benton,WA,Passenger,373,321,694,134304,134998,0.51,Washington
8341,July,2020,Gwinnett,GA,Passenger,1,0,1,70,71,1.41,Furthest
8342,July,2020,Arlington,VA,Passenger,0,2,2,148,150,1.33,Furthest
8343,July,2020,Ferry,WA,Truck,0,0,0,3568,3568,0.0,Washington
8344,July,2020,New Haven,CT,Passenger,0,2,2,36,38,5.26,Furthest
8345,July,2020,Brevard,FL,Passenger,0,1,1,84,85,1.18,Furthest
8346,July,2020,Sumter,FL,Passenger,0,1,1,9,10,10.0,Furthest
8347,July,2020,Solano,CA,Passenger,1,0,1,207,208,0.48,Nearest
8348,July,2020,Klickitat,WA,Passenger,56,43,99,15115,15214,0.65,Washington
8349,July,2020,Portsmouth,VA,Passenger,0,1,1,75,76,1.32,Furthest
8350,July,2020,Washoe,NV,Passenger,1,0,1,100,101,0.99,Nearest
8351,July,2020,Richland,SC,Passenger,0,1,1,149,150,0.67,Furthest
8352,July,2020,Hennepin,MN,Passenger,3,0,3,89,92,3.26,Mid-Distance
8353,July,2020,Suffolk,VA,Passenger,1,0,1,127,128,0.78,Furthest
8354,July,2020,Adams,WA,Truck,0,0,0,5283,5283,0.0,Washington
8355,July,2020,Kern,CA,Passenger,0,1,1,223,224,0.45,Nearest
8356,July,2020,Montgomery,PA,Passenger,1,0,1,29,30,3.33,Furthest
8357,July,2020,Randolph,NC,Passenger,1,0,1,7,8,12.5,Furthest
8358,July,2020,Valencia,NM,Passenger,1,0,1,6,7,14.29,Mid-Distance
8359,July,2020,Bucks,PA,Passenger,1,0,1,20,21,4.76,Furthest
8360,July,2020,Multnomah,OR,Passenger,4,7,11,707,718,1.53,Nearest
8361,July,2020,Pima,AZ,Passenger,3,1,4,334,338,1.18,Nearest
8362,July,2020,Alexandria,VA,Passenger,2,0,2,138,140,1.43,Furthest
8363,July,2020,Lincoln,WA,Passenger,5,11,16,7648,7664,0.21,Washington
8364,July,2020,Clackamas,OR,Passenger,2,0,2,190,192,1.04,Nearest
8365,July,2020,Douglas,WA,Passenger,75,41,116,28050,28166,0.41,Washington
8366,July,2020,Spokane,WA,Truck,1,0,1,98982,98983,0.0,Washington
8367,July,2020,Grant,WA,Passenger,61,75,136,65284,65420,0.21,Washington
8368,July,2020,Denver,CO,Passenger,1,0,1,116,117,0.85,Mid-Distance
8369,July,2020,Thurston,WA,Passenger,1175,744,1919,197158,199077,0.96,Washington
8370,July,2020,Shelby,TN,Passenger,0,1,1,85,86,1.16,Furthest
8371,July,2020,New York,NY,Passenger,1,0,1,57,58,1.72,Furthest
8372,July,2021,Howard,IN,Passenger,0,1,1,5,6,16.67,Furthest
8373,July,2021,Honolulu,HI,Passenger,5,2,7,382,389,1.8,Nearest
8374,July,2021,San Juan,WA,Passenger,443,139,582,14241,14823,3.93,Washington
8375,July,2021,Louisa,VA,Passenger,0,1,1,1,2,50.0,Furthest
8376,July,2021,Okanogan,WA,Truck,0,0,0,16751,16751,0.0,Washington
8377,July,2021,Montgomery,TX,Passenger,1,1,2,38,40,5.0,Mid-Distance
8378,July,2021,Benton,WA,Truck,0,0,0,43648,43648,0.0,Washington
8379,July,2021,San Diego,CA,Passenger,17,7,24,2530,2554,0.94,Nearest
8380,July,2021,Larimer,CO,Passenger,1,0,1,50,51,1.96,Mid-Distance
8381,July,2021,Jefferson,WA,Truck,0,0,0,9618,9618,0.0,Washington
8382,July,2021,Snohomish,WA,Passenger,6126,2100,8226,539757,547983,1.5,Washington
8383,July,2021,Mason,WA,Passenger,216,139,355,48095,48450,0.73,Washington
8384,July,2021,Hampshire,MA,Passenger,1,0,1,6,7,14.29,Furthest
8385,July,2021,Queens,NY,Passenger,2,0,2,47,49,4.08,Furthest
8386,July,2021,Charles,MD,Passenger,1,1,2,69,71,2.82,Furthest
8387,July,2021,Harrison,MS,Passenger,2,0,2,52,54,3.7,Mid-Distance
8388,July,2021,Platte,MO,Passenger,1,0,1,17,18,5.56,Furthest
8389,July,2021,Clallam,WA,Passenger,341,220,561,50460,51021,1.1,Washington
8390,July,2021,Lincoln,WA,Truck,0,0,0,4759,4759,0.0,Washington
8391,July,2021,Harris,TX,Passenger,1,1,2,185,187,1.07,Mid-Distance
8392,July,2021,Powhatan,VA,Passenger,1,0,1,1,2,50.0,Furthest
8393,July,2021,Onslow,NC,Passenger,0,1,1,178,179,0.56,Furthest
8394,July,2021,Salt Lake,UT,Passenger,0,1,1,162,163,0.61,Nearest
8395,July,2021,Douglas,WA,Passenger,100,51,151,28504,28655,0.53,Washington
8396,July,2021,Fresno,CA,Passenger,1,0,1,165,166,0.6,Nearest
8397,July,2021,Oldham,KY,Passenger,0,1,1,4,5,20.0,Furthest
8398,July,2021,San Mateo,CA,Passenger,1,0,1,95,96,1.04,Nearest
8399,July,2021,Denver,CO,Passenger,1,0,1,116,117,0.85,Mid-Distance
8400,July,2021,San Juan,WA,Truck,0,0,0,5955,5955,0.0,Washington
8401,July,2021,Fairbanks North Star,AK,Passenger,0,1,1,83,84,1.19,Nearest
8402,July,2021,Multnomah,OR,Passenger,2,6,8,634,642,1.25,Nearest
8403,July,2021,Sarasota,FL,Passenger,2,0,2,27,29,6.9,Furthest
8404,July,2021,Adams,WA,Truck,0,0,0,5392,5392,0.0,Washington
8405,July,2021,Wahkiakum,WA,Passenger,15,8,23,3091,3114,0.74,Washington
8406,July,2021,Yakima,WA,Passenger,236,161,397,169309,169706,0.23,Washington
8407,July,2021,New London,CT,Passenger,1,2,3,216,219,1.37,Furthest
8408,July,2021,Lee,FL,Passenger,1,0,1,33,34,2.94,Furthest
8409,July,2021,El Paso,CO,Passenger,3,0,3,666,669,0.45,Mid-Distance
8410,July,2021,Carroll,MD,Passenger,0,1,1,19,20,5.0,Furthest
8411,July,2021,Chelan,WA,Passenger,350,101,451,54716,55167,0.82,Washington
8412,July,2021,Howard,MD,Passenger,0,1,1,59,60,1.67,Furthest
8413,July,2021,Stevens,WA,Truck,0,0,0,18921,18921,0.0,Washington
8414,July,2021,Washington,MD,Passenger,2,0,2,13,15,13.33,Furthest
8415,July,2021,Albemarle,VA,Passenger,1,0,1,19,20,5.0,Furthest
8416,July,2021,Manassas,VA,Passenger,0,1,1,7,8,12.5,Furthest
8417,July,2021,RÃ­o Grande,PR,Passenger,1,0,1,0,1,100.0,Mid-Distance
8418,July,2021,Whitman,WA,Truck,0,0,0,8590,8590,0.0,Washington
8419,July,2021,Portsmouth,VA,Passenger,0,1,1,78,79,1.27,Furthest
8420,July,2021,Kings,CA,Passenger,1,0,1,319,320,0.31,Nearest
8421,July,2021,Stevens,WA,Passenger,49,46,95,30404,30499,0.31,Washington
8422,July,2021,Rockdale,GA,Passenger,1,0,1,9,10,10.0,Furthest
8423,July,2021,Montgomery,OH,Passenger,0,1,1,55,56,1.79,Furthest
8424,July,2021,Maricopa,AZ,Passenger,6,3,9,1118,1127,0.8,Nearest
8425,July,2021,Clackamas,OR,Passenger,2,0,2,173,175,1.14,Nearest
8426,July,2021,Charleston,SC,Passenger,1,1,2,82,84,2.38,Furthest
8427,July,2021,Mason,WA,Truck,0,0,0,21344,21344,0.0,Washington
8428,July,2021,Grant,WA,Passenger,120,90,210,66913,67123,0.31,Washington
8429,July,2021,Hidalgo,TX,Passenger,0,1,1,54,55,1.82,Mid-Distance
8430,July,2021,Lewis,WA,Passenger,165,144,309,59658,59967,0.52,Washington
8431,July,2021,Ray,MO,Passenger,0,1,1,1,2,50.0,Furthest
8432,July,2021,Clark,WA,Truck,0,0,0,84269,84269,0.0,Washington
8433,July,2021,Baltimore,MD,Passenger,1,0,1,97,98,1.02,Furthest
8434,July,2021,Santa Cruz,CA,Passenger,1,0,1,24,25,4.0,Nearest
8435,July,2021,Los Angeles,CA,Passenger,10,11,21,871,892,2.35,Nearest
8436,July,2021,Yamhill,OR,Passenger,1,0,1,34,35,2.86,Nearest
8437,July,2021,Rockingham,NH,Passenger,1,0,1,21,22,4.55,Furthest
8438,July,2021,Alameda,CA,Passenger,4,0,4,231,235,1.7,Nearest
8439,July,2021,Okanogan,WA,Passenger,65,43,108,26539,26647,0.41,Washington
8440,July,2021,Orange,FL,Passenger,1,0,1,107,108,0.93,Furthest
8441,July,2021,Wahkiakum,WA,Truck,0,0,0,1793,1793,0.0,Washington
8442,July,2021,Loudoun,VA,Passenger,1,0,1,72,73,1.37,Furthest
8443,July,2021,Broward,FL,Passenger,2,0,2,107,109,1.83,Furthest
8444,July,2021,Williamson,TX,Passenger,0,2,2,103,105,1.9,Mid-Distance
8445,July,2021,Juneau,AK,Passenger,0,1,1,26,27,3.7,Nearest
8446,July,2021,Boulder,CO,Passenger,0,1,1,39,40,2.5,Mid-Distance
8447,July,2021,Dallas,TX,Passenger,1,0,1,148,149,0.67,Mid-Distance
8448,July,2021,Harnett,NC,Passenger,1,1,2,167,169,1.18,Furthest
8449,July,2021,Sedgwick,KS,Passenger,1,1,2,81,83,2.41,Mid-Distance
8450,July,2021,Prince William,VA,Passenger,1,1,2,201,203,0.99,Furthest
8451,July,2021,Pacific,WA,Passenger,46,53,99,16030,16129,0.61,Washington
8452,July,2021,Klickitat,WA,Truck,0,0,0,8313,8313,0.0,Washington
8453,July,2021,Lewis,WA,Truck,0,0,0,26765,26765,0.0,Washington
8454,July,2021,Kitsap,WA,Truck,0,0,0,54423,54423,0.0,Washington
8455,July,2021,Kings,NY,Passenger,1,0,1,65,66,1.52,Furthest
8456,July,2021,Leavenworth,KS,Passenger,0,1,1,116,117,0.85,Mid-Distance
8457,July,2021,Thurston,WA,Truck,0,0,0,56500,56500,0.0,Washington
8458,July,2021,Lincoln,WA,Passenger,6,15,21,7722,7743,0.27,Washington
8459,July,2021,Owyhee,ID,Passenger,1,0,1,2,3,33.33,Nearest
8460,July,2021,Rogers,OK,Passenger,1,0,1,3,4,25.0,Mid-Distance
8461,July,2021,Adams,WA,Passenger,16,12,28,13038,13066,0.21,Washington
8462,July,2021,Grays Harbor,WA,Truck,0,0,0,21418,21418,0.0,Washington
8463,July,2021,New York,NY,Passenger,1,0,1,42,43,2.33,Furthest
8464,July,2021,Kern,CA,Passenger,0,1,1,210,211,0.47,Nearest
8465,July,2021,Ferry,WA,Passenger,9,3,12,4379,4391,0.27,Washington
8466,July,2021,Anchorage,AK,Passenger,1,0,1,131,132,0.76,Nearest
8467,July,2021,Placer,CA,Passenger,2,0,2,75,77,2.6,Nearest
8468,July,2021,Jefferson,NY,Passenger,0,1,1,213,214,0.47,Furthest
8469,July,2021,Fort Bend,TX,Passenger,1,0,1,36,37,2.7,Mid-Distance
8470,July,2021,Frederick,MD,Passenger,1,1,2,68,70,2.86,Furthest
8471,July,2021,Sumter,SC,Passenger,0,1,1,37,38,2.63,Furthest
8472,July,2021,Danville,VA,Passenger,1,0,1,0,1,100.0,Furthest
8473,July,2021,Asotin,WA,Passenger,21,17,38,12708,12746,0.3,Washington
8474,July,2021,Skamania,WA,Truck,0,0,0,4027,4027,0.0,Washington
8475,July,2021,Thurston,WA,Passenger,1660,892,2552,197867,200419,1.27,Washington
8476,July,2021,Kitsap,WA,Passenger,1911,871,2782,180648,183430,1.52,Washington
8477,July,2021,Cowlitz,WA,Truck,0,0,0,29116,29116,0.0,Washington
8478,July,2021,Grant,WA,Truck,0,0,0,27936,27936,0.0,Washington
8479,July,2021,San Francisco,CA,Passenger,0,1,1,84,85,1.18,Nearest
8480,July,2021,Skagit,WA,Passenger,608,281,889,91879,92768,0.96,Washington
8481,July,2021,Sacramento,CA,Passenger,2,0,2,213,215,0.93,Nearest
8482,July,2021,Lane,OR,Passenger,0,1,1,120,121,0.83,Nearest
8483,July,2021,Las Animas,CO,Passenger,1,0,1,0,1,100.0,Mid-Distance
8484,July,2021,Douglas,WA,Truck,0,0,0,12696,12696,0.0,Washington
8485,July,2021,Pierce,WA,Passenger,3637,2018,5655,559608,565263,1.0,Washington
8486,July,2021,Island,WA,Passenger,625,316,941,63232,64173,1.47,Washington
8487,July,2021,Flathead,MT,Passenger,1,0,1,42,43,2.33,Nearest
8488,July,2021,Lake,FL,Passenger,1,0,1,22,23,4.35,Furthest
8489,July,2021,Arapahoe,CO,Passenger,1,0,1,106,107,0.93,Mid-Distance
8490,July,2021,Denton,TX,Passenger,1,0,1,80,81,1.23,Mid-Distance
8491,July,2021,Anne Arundel,MD,Passenger,4,3,7,384,391,1.79,Furthest
8492,July,2021,Williams,ND,Passenger,0,1,1,7,8,12.5,Mid-Distance
8493,July,2021,Franklin,WA,Truck,0,0,0,20725,20725,0.0,Washington
8494,July,2021,Chelan,WA,Truck,0,0,0,23102,23102,0.0,Washington
8495,July,2021,Benton,WA,Passenger,540,397,937,136282,137219,0.68,Washington
8496,July,2021,Snohomish,WA,Truck,1,0,1,126198,126199,0.0,Washington
8497,July,2021,Cumberland,NC,Passenger,0,2,2,416,418,0.48,Furthest
8498,July,2021,Pima,AZ,Passenger,2,1,3,267,270,1.11,Nearest
8499,July,2021,Bexar,TX,Passenger,3,4,7,514,521,1.34,Mid-Distance
8500,July,2021,Pierce,WA,Truck,0,0,0,145859,145859,0.0,Washington
8501,July,2021,Camden,NJ,Passenger,0,1,1,14,15,6.67,Furthest
8502,July,2021,Whatcom,WA,Truck,4,0,4,43871,43875,0.01,Washington
8503,July,2021,Goochland,VA,Passenger,4,2,6,214,220,2.73,Furthest
8504,July,2021,Wichita,TX,Passenger,1,0,1,40,41,2.44,Mid-Distance
8505,July,2021,Columbia,WA,Truck,0,0,0,1555,1555,0.0,Washington
8506,July,2021,Kauai,HI,Passenger,1,0,1,17,18,5.56,Nearest
8507,July,2021,Montgomery,MD,Passenger,3,1,4,212,216,1.85,Furthest
8508,July,2021,Suffolk,MA,Passenger,0,2,2,31,33,6.06,Furthest
8509,July,2021,Collin,TX,Passenger,1,1,2,105,107,1.87,Mid-Distance
8510,July,2021,Lake,IL,Passenger,2,0,2,156,158,1.27,Mid-Distance
8511,July,2021,Skamania,WA,Passenger,51,36,87,8410,8497,1.02,Washington
8512,July,2021,DeKalb,GA,Passenger,1,0,1,58,59,1.69,Furthest
8513,July,2021,Sevier,AR,Passenger,0,1,1,0,1,100.0,Mid-Distance
8514,July,2021,Penobscot,ME,Passenger,0,1,1,8,9,11.11,Furthest
8515,July,2021,Norfolk,VA,Passenger,3,3,6,313,319,1.88,Furthest
8516,July,2021,Hennepin,MN,Passenger,3,0,3,72,75,4.0,Mid-Distance
8517,July,2021,Plaquemines,LA,Passenger,0,1,1,16,17,5.88,Mid-Distance
8518,July,2021,Douglas,NE,Passenger,1,1,2,51,53,3.77,Mid-Distance
8519,July,2021,St. Louis,MO,Passenger,1,0,1,80,81,1.23,Furthest
8520,July,2021,Allegheny,PA,Passenger,1,1,2,62,64,3.12,Furthest
8521,July,2021,King,WA,Truck,5,1,6,184354,184360,0.0,Washington
8522,July,2021,Alexandria,VA,Passenger,2,0,2,122,124,1.61,Furthest
8523,July,2021,Riverside,CA,Passenger,5,1,6,537,543,1.1,Nearest
8524,July,2021,Garfield,WA,Passenger,0,3,3,1375,1378,0.22,Washington
8525,July,2021,Pennington,SD,Passenger,1,0,1,31,32,3.12,Mid-Distance
8526,July,2021,Saginaw,MI,Passenger,1,0,1,6,7,14.29,Furthest
8527,July,2021,Clallam,WA,Truck,1,0,1,22036,22037,0.0,Washington
8528,July,2021,Kittitas,WA,Passenger,166,68,234,29980,30214,0.77,Washington
8529,July,2021,Calvert,MD,Passenger,0,2,2,88,90,2.22,Furthest
8530,July,2021,Richmond,NY,Passenger,1,0,1,9,10,10.0,Furthest
8531,July,2021,St. Mary's,MD,Passenger,1,0,1,205,206,0.49,Furthest
8532,July,2021,Middlesex,MA,Passenger,1,1,2,93,95,2.11,Furthest
8533,July,2021,Nueces,TX,Passenger,1,0,1,69,70,1.43,Mid-Distance
8534,July,2021,Missoula,MT,Passenger,1,0,1,54,55,1.82,Nearest
8535,July,2021,Stafford,VA,Passenger,2,1,3,98,101,2.97,Furthest
8536,July,2021,Saratoga,NY,Passenger,1,0,1,42,43,2.33,Furthest
8537,July,2021,Miami-Dade,FL,Passenger,1,0,1,97,98,1.02,Furthest
8538,July,2021,Asotin,WA,Truck,0,0,0,6768,6768,0.0,Washington
8539,July,2021,Yakima,WA,Truck,0,0,0,61720,61720,0.0,Washington
8540,July,2021,Greene,MO,Passenger,0,1,1,29,30,3.33,Furthest
8541,July,2021,Wilson,TX,Passenger,0,1,1,3,4,25.0,Mid-Distance
8542,July,2021,Okaloosa,FL,Passenger,0,1,1,114,115,0.87,Furthest
8543,July,2021,King,WA,Passenger,31555,9349,40904,1366948,1407852,2.91,Washington
8544,July,2021,Columbia,WA,Passenger,6,2,8,2472,2480,0.32,Washington
8545,July,2021,Philadelphia,PA,Passenger,1,0,1,44,45,2.22,Furthest
8546,July,2021,Pacific,WA,Truck,0,0,0,7961,7961,0.0,Washington
8547,July,2021,Hudson,NJ,Passenger,1,0,1,42,43,2.33,Furthest
8548,July,2021,Contra Costa,CA,Passenger,2,3,5,262,267,1.87,Nearest
8549,July,2021,New Haven,CT,Passenger,0,2,2,28,30,6.67,Furthest
8550,July,2021,Clark,NV,Passenger,4,2,6,602,608,0.99,Nearest
8551,July,2021,Hawaii,HI,Passenger,1,0,1,44,45,2.22,Nearest
8552,July,2021,Hillsborough,FL,Passenger,0,1,1,145,146,0.68,Furthest
8553,July,2021,Moore,NC,Passenger,0,1,1,130,131,0.76,Furthest
8554,July,2021,Bucks,PA,Passenger,1,0,1,15,16,6.25,Furthest
8555,July,2021,Suffolk,VA,Passenger,1,0,1,125,126,0.79,Furthest
8556,July,2021,Gwinnett,GA,Passenger,1,0,1,61,62,1.61,Furthest
8557,July,2021,Orange,CA,Passenger,5,3,8,407,415,1.93,Nearest
8558,July,2021,Polk,FL,Passenger,1,0,1,55,56,1.79,Furthest
8559,July,2021,Clark,WA,Passenger,2977,1459,4436,322390,326826,1.36,Washington
8560,July,2021,Pend Oreille,WA,Truck,0,0,0,5747,5747,0.0,Washington
8561,July,2021,Prince George's,MD,Passenger,2,1,3,139,142,2.11,Furthest
8562,July,2021,Wilson,NC,Passenger,1,0,1,0,1,100.0,Furthest
8563,July,2021,Richmond,GA,Passenger,0,1,1,74,75,1.33,Furthest
8564,July,2021,Shelby,OH,Passenger,0,1,1,1,2,50.0,Furthest
8565,July,2021,Washington,OR,Passenger,1,0,1,377,378,0.26,Nearest
8566,July,2021,Spartanburg,SC,Passenger,0,1,1,51,52,1.92,Furthest
8567,July,2021,Whatcom,WA,Passenger,1475,618,2093,150663,152756,1.37,Washington
8568,July,2021,Sonoma,CA,Passenger,0,1,1,79,80,1.25,Nearest
8569,July,2021,Klamath,OR,Passenger,1,0,1,28,29,3.45,Nearest
8570,July,2021,Grays Harbor,WA,Passenger,176,146,322,49519,49841,0.65,Washington
8571,July,2021,Ferry,WA,Truck,0,0,0,3646,3646,0.0,Washington
8572,July,2021,Houston,GA,Passenger,1,0,1,46,47,2.13,Furthest
8573,July,2021,Milwaukee,WI,Passenger,1,0,1,38,39,2.56,Mid-Distance
8574,July,2021,Duval,FL,Passenger,0,2,2,330,332,0.6,Furthest
8575,July,2021,Champaign,IL,Passenger,1,0,1,11,12,8.33,Mid-Distance
8576,July,2021,Carroll,NH,Passenger,0,1,1,5,6,16.67,Furthest
8577,July,2021,Douglas,CO,Passenger,0,1,1,77,78,1.28,Mid-Distance
8578,July,2021,Randolph,NC,Passenger,1,0,1,5,6,16.67,Furthest
8579,July,2021,District of Columbia,DC,Passenger,5,1,6,199,205,2.93,Furthest
8580,July,2021,San Joaquin,CA,Passenger,1,0,1,101,102,0.98,Nearest
8581,July,2021,Carson City,NV,Passenger,1,0,1,10,11,9.09,Nearest
8583,July,2021,Travis,TX,Passenger,3,3,6,153,159,3.77,Mid-Distance
8584,July,2021,El Dorado,CA,Passenger,1,0,1,30,31,3.23,Nearest
8585,July,2021,Fairfax,VA,Passenger,4,4,8,679,687,1.16,Furthest
8586,July,2021,Whitman,WA,Passenger,61,49,110,21944,22054,0.5,Washington
8587,July,2021,Allen,IN,Passenger,1,0,1,15,16,6.25,Furthest
8588,July,2021,Klickitat,WA,Passenger,77,50,127,15342,15469,0.82,Washington
8589,July,2021,Cowlitz,WA,Passenger,229,146,375,72247,72622,0.52,Washington
8590,July,2021,Erie,NY,Passenger,1,0,1,37,38,2.63,Furthest
8591,July,2021,Walla Walla,WA,Truck,0,0,0,14055,14055,0.0,Washington
8592,July,2021,Santa Clara,CA,Passenger,8,2,10,247,257,3.89,Nearest
8593,July,2021,Island,WA,Truck,0,0,0,21573,21573,0.0,Washington
8594,July,2021,Monterey,CA,Passenger,0,1,1,143,144,0.69,Nearest
8595,July,2021,Nassau,NY,Passenger,2,0,2,26,28,7.14,Furthest
8596,July,2021,Garfield,WA,Truck,0,0,0,1004,1004,0.0,Washington
8597,July,2021,Boone,MO,Passenger,0,1,1,9,10,10.0,Furthest
8598,July,2021,DuPage,IL,Passenger,1,0,1,51,52,1.92,Mid-Distance
8599,July,2021,Arlington,VA,Passenger,0,1,1,135,136,0.74,Furthest
8600,July,2021,Cape May,NJ,Passenger,0,1,1,8,9,11.11,Furthest
8601,July,2021,Pinellas,FL,Passenger,0,1,1,93,94,1.06,Furthest
8602,July,2021,Montgomery,PA,Passenger,1,0,1,24,25,4.0,Furthest
8603,July,2021,Ventura,CA,Passenger,1,2,3,250,253,1.19,Nearest
8604,July,2021,Spokane,WA,Truck,0,0,0,102316,102316,0.0,Washington
8605,July,2021,Vigo,IN,Passenger,1,0,1,5,6,16.67,Furthest
8606,July,2021,Hamilton,IN,Passenger,2,0,2,31,33,6.06,Furthest
8607,July,2021,Bartow,GA,Passenger,0,1,1,3,4,25.0,Furthest
8608,July,2021,Chesapeake,VA,Passenger,0,4,4,387,391,1.02,Furthest
8609,July,2021,Skagit,WA,Truck,1,0,1,33023,33024,0.0,Washington
8610,July,2021,Essex,NJ,Passenger,1,0,1,10,11,9.09,Furthest
8611,July,2021,Kittitas,WA,Truck,0,0,0,14792,14792,0.0,Washington
8612,July,2021,Ulster,NY,Passenger,1,0,1,8,9,11.11,Furthest
8613,July,2021,Spokane,WA,Passenger,1119,653,1772,326073,327845,0.54,Washington
8614,July,2021,Pend Oreille,WA,Passenger,15,7,22,9264,9286,0.24,Washington
8615,July,2021,St. Clair,IL,Passenger,2,0,2,134,136,1.47,Mid-Distance
8616,July,2021,El Paso,TX,Passenger,3,0,3,365,368,0.82,Mid-Distance
8617,July,2021,Franklin,WA,Passenger,134,97,231,62058,62289,0.37,Washington
8618,July,2021,Walla Walla,WA,Passenger,115,76,191,36567,36758,0.52,Washington
8619,July,2021,Burlington,NJ,Passenger,0,1,1,126,127,0.79,Furthest
8620,July,2021,Jones,GA,Passenger,1,0,1,1,2,50.0,Furthest
8621,July,2021,Cook,IL,Passenger,1,0,1,196,197,0.51,Mid-Distance
8622,July,2021,Richland,SC,Passenger,0,1,1,134,135,0.74,Furthest
8623,July,2021,Virginia Beach,VA,Passenger,2,0,2,611,613,0.33,Furthest
8624,July,2021,Jefferson,WA,Passenger,339,183,522,24889,25411,2.05,Washington
8625,July,2022,Norfolk,VA,Passenger,2,3,5,277,282,1.77,Furthest
8626,July,2022,Pacific,WA,Truck,0,0,0,7881,7881,0.0,Washington
8627,July,2022,Hidalgo,TX,Passenger,0,1,1,53,54,1.85,Mid-Distance
8628,July,2022,Rock Island,IL,Passenger,0,1,1,14,15,6.67,Mid-Distance
8629,July,2022,Tarrant,TX,Passenger,1,0,1,100,101,0.99,Mid-Distance
8630,July,2022,Clackamas,OR,Passenger,2,0,2,135,137,1.46,Nearest
8631,July,2022,Clark,WA,Passenger,4229,1806,6035,315632,321667,1.88,Washington
8632,July,2022,Prince George's,MD,Passenger,3,1,4,114,118,3.39,Furthest
8633,July,2022,Moore,NC,Passenger,0,1,1,110,111,0.9,Furthest
8634,July,2022,Cowlitz,WA,Truck,2,0,2,28483,28485,0.01,Washington
8635,July,2022,Grays Harbor,WA,Passenger,214,162,376,48927,49303,0.76,Washington
8636,July,2022,Alexandria,VA,Passenger,3,0,3,106,109,2.75,Furthest
8637,July,2022,Boulder,CO,Passenger,1,0,1,32,33,3.03,Mid-Distance
8638,July,2022,Collin,TX,Passenger,2,0,2,75,77,2.6,Mid-Distance
8639,July,2022,Pend Oreille,WA,Passenger,18,12,30,9043,9073,0.33,Washington
8640,July,2022,Santa Clara,CA,Passenger,10,2,12,207,219,5.48,Nearest
8641,July,2022,Prince William,VA,Passenger,0,1,1,185,186,0.54,Furthest
8642,July,2022,Benton,WA,Passenger,780,462,1242,135328,136570,0.91,Washington
8643,July,2022,Kings,CA,Passenger,2,1,3,297,300,1.0,Nearest
8644,July,2022,Berkeley,SC,Passenger,0,1,1,115,116,0.86,Furthest
8645,July,2022,Richmond,GA,Passenger,0,1,1,60,61,1.64,Furthest
8646,July,2022,Skamania,WA,Passenger,76,47,123,8163,8286,1.48,Washington
8647,July,2022,Harrison,MS,Passenger,1,0,1,39,40,2.5,Mid-Distance
8648,July,2022,Allegheny,PA,Passenger,1,1,2,51,53,3.77,Furthest
8649,July,2022,Lee,FL,Passenger,1,0,1,28,29,3.45,Furthest
8650,July,2022,Loudoun,VA,Passenger,2,1,3,63,66,4.55,Furthest
8651,July,2022,Clark,WA,Truck,9,0,9,82552,82561,0.01,Washington
8652,July,2022,Skagit,WA,Truck,5,0,5,32300,32305,0.02,Washington
8653,July,2022,Escambia,FL,Passenger,0,1,1,125,126,0.79,Furthest
8654,July,2022,Santa Cruz,CA,Passenger,1,0,1,21,22,4.55,Nearest
8655,July,2022,Spokane,WA,Truck,8,0,8,102044,102052,0.01,Washington
8656,July,2022,Lincoln,OR,Passenger,0,1,1,23,24,4.17,Nearest
8657,July,2022,Bexar,TX,Passenger,4,3,7,424,431,1.62,Mid-Distance
8658,July,2022,Albemarle,VA,Passenger,1,0,1,16,17,5.88,Furthest
8659,July,2022,Thurston,WA,Passenger,2242,1065,3307,193613,196920,1.68,Washington
8660,July,2022,Contra Costa,CA,Passenger,0,4,4,231,235,1.7,Nearest
8661,July,2022,Spokane,WA,Passenger,1676,864,2540,324816,327356,0.78,Washington
8662,July,2022,Douglas,NE,Passenger,1,2,3,38,41,7.32,Mid-Distance
8663,July,2022,Clallam,WA,Passenger,432,246,678,49651,50329,1.35,Washington
8664,July,2022,Lake,FL,Passenger,1,0,1,16,17,5.88,Furthest
8665,July,2022,Asotin,WA,Passenger,24,19,43,12650,12693,0.34,Washington
8666,July,2022,New London,CT,Passenger,2,5,7,187,194,3.61,Furthest
8667,July,2022,Dorchester,SC,Passenger,1,0,1,49,50,2.0,Furthest
8668,July,2022,Louisa,VA,Passenger,0,1,1,1,2,50.0,Furthest
8669,July,2022,Chesapeake,VA,Passenger,3,3,6,320,326,1.84,Furthest
8670,July,2022,Kern,CA,Passenger,0,1,1,186,187,0.53,Nearest
8671,July,2022,Whitman,WA,Truck,2,0,2,8570,8572,0.02,Washington
8672,July,2022,Owyhee,ID,Passenger,1,0,1,2,3,33.33,Nearest
8673,July,2022,Ferry,WA,Truck,0,0,0,3566,3566,0.0,Washington
8674,July,2022,Hillsborough,FL,Passenger,0,1,1,116,117,0.85,Furthest
8675,July,2022,Sheridan,WY,Passenger,1,0,1,7,8,12.5,Nearest
8676,July,2022,Richmond,NY,Passenger,1,0,1,6,7,14.29,Furthest
8677,July,2022,Multnomah,OR,Passenger,0,3,3,503,506,0.59,Nearest
8678,July,2022,Hoke,NC,Passenger,1,0,1,64,65,1.54,Furthest
8679,July,2022,Columbia,WA,Truck,0,0,0,1577,1577,0.0,Washington
8680,July,2022,Danville,VA,Passenger,1,0,1,0,1,100.0,Furthest
8681,July,2022,Monterey,CA,Passenger,1,1,2,124,126,1.59,Nearest
8682,July,2022,Walla Walla,WA,Passenger,175,99,274,35828,36102,0.76,Washington
8683,July,2022,Sedgwick,KS,Passenger,1,1,2,70,72,2.78,Mid-Distance
8684,July,2022,Hawaii,HI,Passenger,1,0,1,34,35,2.86,Nearest
8685,July,2022,Essex,NJ,Passenger,2,0,2,9,11,18.18,Furthest
8686,July,2022,Stevens,WA,Truck,1,0,1,18912,18913,0.01,Washington
8687,July,2022,Arlington,VA,Passenger,1,0,1,121,122,0.82,Furthest
8688,July,2022,San Mateo,CA,Passenger,2,0,2,75,77,2.6,Nearest
8689,July,2022,Harris,TX,Passenger,1,0,1,127,128,0.78,Mid-Distance
8690,July,2022,Lewis,WA,Truck,0,0,0,26347,26347,0.0,Washington
8691,July,2022,Bell,TX,Passenger,1,0,1,301,302,0.33,Mid-Distance
8692,July,2022,Los Angeles,CA,Passenger,8,8,16,730,746,2.14,Nearest
8693,July,2022,Jefferson,WA,Passenger,442,219,661,24548,25209,2.62,Washington
8694,July,2022,Kitsap,WA,Truck,13,0,13,53416,53429,0.02,Washington
8695,July,2022,Walla Walla,WA,Truck,1,0,1,13918,13919,0.01,Washington
8696,July,2022,Spartanburg,SC,Passenger,0,1,1,37,38,2.63,Furthest
8697,July,2022,Ulster,NY,Passenger,1,0,1,8,9,11.11,Furthest
8698,July,2022,St. Clair,IL,Passenger,2,0,2,115,117,1.71,Mid-Distance
8699,July,2022,Randolph,NC,Passenger,1,0,1,5,6,16.67,Furthest
8700,July,2022,Alameda,CA,Passenger,4,0,4,177,181,2.21,Nearest
8701,July,2022,Snohomish,WA,Truck,27,0,27,123535,123562,0.02,Washington
8702,July,2022,Adams,CO,Passenger,1,0,1,38,39,2.56,Mid-Distance
8703,July,2022,Lane,OR,Passenger,0,1,1,88,89,1.12,Nearest
8704,July,2022,Suffolk,VA,Passenger,1,0,1,119,120,0.83,Furthest
8705,July,2022,Placer,CA,Passenger,2,0,2,64,66,3.03,Nearest
8706,July,2022,Stevens,WA,Passenger,72,54,126,30084,30210,0.42,Washington
8707,July,2022,Whitman,WA,Passenger,88,60,148,21969,22117,0.67,Washington
8708,July,2022,Marin,CA,Passenger,0,1,1,27,28,3.57,Nearest
8709,July,2022,Pierce,WA,Passenger,5245,2337,7582,543947,551529,1.37,Washington
8710,July,2022,Wood,OH,Passenger,0,1,1,3,4,25.0,Furthest
8711,July,2022,Hennepin,MN,Passenger,1,0,1,45,46,2.17,Mid-Distance
8712,July,2022,Goochland,VA,Passenger,2,1,3,109,112,2.68,Furthest
8713,July,2022,Wake,NC,Passenger,1,0,1,78,79,1.27,Furthest
8714,July,2022,San Juan,WA,Truck,4,0,4,5948,5952,0.07,Washington
8715,July,2022,Okanogan,WA,Truck,1,0,1,16589,16590,0.01,Washington
8716,July,2022,Carroll,NH,Passenger,0,1,1,5,6,16.67,Furthest
8717,July,2022,Burlington,NJ,Passenger,0,2,2,104,106,1.89,Furthest
8718,July,2022,Wahkiakum,WA,Truck,0,0,0,1801,1801,0.0,Washington
8719,July,2022,St. Mary's,MD,Passenger,1,0,1,184,185,0.54,Furthest
8720,July,2022,Larimer,CO,Passenger,1,0,1,44,45,2.22,Mid-Distance
8721,July,2022,Sevier,AR,Passenger,0,1,1,0,1,100.0,Mid-Distance
8722,July,2022,Middlesex,MA,Passenger,2,1,3,71,74,4.05,Furthest
8723,July,2022,Charles,MD,Passenger,1,1,2,56,58,3.45,Furthest
8724,July,2022,Whatcom,WA,Passenger,1864,754,2618,148809,151427,1.73,Washington
8725,July,2022,Lincoln,WA,Passenger,9,16,25,7715,7740,0.32,Washington
8726,July,2022,Queens,NY,Passenger,1,0,1,39,40,2.5,Furthest
8727,July,2022,Allen,IN,Passenger,1,0,1,13,14,7.14,Furthest
8728,July,2022,Bartow,GA,Passenger,0,1,1,3,4,25.0,Furthest
8729,July,2022,Nueces,TX,Passenger,1,1,2,52,54,3.7,Mid-Distance
8730,July,2022,Harnett,NC,Passenger,2,0,2,139,141,1.42,Furthest
8731,July,2022,Jefferson,NY,Passenger,0,1,1,199,200,0.5,Furthest
8732,July,2022,Franklin,WA,Passenger,203,110,313,61860,62173,0.5,Washington
8733,July,2022,Orange,CA,Passenger,6,2,8,328,336,2.38,Nearest
8734,July,2022,Ferry,WA,Passenger,21,4,25,4378,4403,0.57,Washington
8735,July,2022,Williams,ND,Passenger,0,1,1,5,6,16.67,Mid-Distance
8736,July,2022,Maricopa,AZ,Passenger,7,1,8,845,853,0.94,Nearest
8737,July,2022,San Joaquin,CA,Passenger,1,1,2,81,83,2.41,Nearest
8738,July,2022,Arapahoe,CO,Passenger,0,1,1,76,77,1.3,Mid-Distance
8739,July,2022,New Haven,CT,Passenger,0,2,2,26,28,7.14,Furthest
8740,July,2022,Wahkiakum,WA,Passenger,24,12,36,3071,3107,1.16,Washington
8741,July,2022,Franklin,WA,Truck,1,0,1,20873,20874,0.0,Washington
8742,July,2022,Garfield,WA,Passenger,1,3,4,1326,1330,0.3,Washington
8743,July,2022,Grays Harbor,WA,Truck,2,0,2,21240,21242,0.01,Washington
8744,July,2022,Rockdale,GA,Passenger,1,0,1,7,8,12.5,Furthest
8745,July,2022,Wichita,TX,Passenger,1,0,1,38,39,2.56,Mid-Distance
8746,July,2022,Juneau,AK,Passenger,0,1,1,29,30,3.33,Nearest
8747,July,2022,Duval,FL,Passenger,1,2,3,263,266,1.13,Furthest
8748,July,2022,Manassas,VA,Passenger,0,1,1,8,9,11.11,Furthest
8749,July,2022,Frederick,MD,Passenger,1,0,1,60,61,1.64,Furthest
8750,July,2022,Kittitas,WA,Passenger,278,86,364,29692,30056,1.21,Washington
8751,July,2022,Lincoln,WA,Truck,0,0,0,4833,4833,0.0,Washington
8752,July,2022,Lake,IL,Passenger,2,0,2,129,131,1.53,Mid-Distance
8753,July,2022,Skagit,WA,Passenger,813,345,1158,89848,91006,1.27,Washington
8754,July,2022,Lewis,WA,Passenger,246,177,423,59694,60117,0.7,Washington
8755,July,2022,Philadelphia,PA,Passenger,1,0,1,34,35,2.86,Furthest
8756,July,2022,Garfield,WA,Truck,0,0,0,976,976,0.0,Washington
8757,July,2022,Gwinnett,GA,Passenger,1,0,1,48,49,2.04,Furthest
8758,July,2022,Saratoga,NY,Passenger,1,0,1,39,40,2.5,Furthest
8759,July,2022,Honolulu,HI,Passenger,4,3,7,312,319,2.19,Nearest
8760,July,2022,Coryell,TX,Passenger,1,0,1,91,92,1.09,Mid-Distance
8761,July,2022,Benton,WA,Truck,3,0,3,43487,43490,0.01,Washington
8762,July,2022,Salt Lake,UT,Passenger,1,1,2,118,120,1.67,Nearest
8763,July,2022,Pierce,WA,Truck,20,0,20,141272,141292,0.01,Washington
8764,July,2022,Grant,WA,Passenger,183,100,283,66683,66966,0.42,Washington
8765,July,2022,Howard,IN,Passenger,0,1,1,4,5,20.0,Furthest
8766,July,2022,Leavenworth,KS,Passenger,0,1,1,97,98,1.02,Mid-Distance
8767,July,2022,Chelan,WA,Passenger,478,125,603,54238,54841,1.1,Washington
8768,July,2022,Anchorage,AK,Passenger,1,0,1,114,115,0.87,Nearest
8769,July,2022,Fairfax,VA,Passenger,6,3,9,590,599,1.5,Furthest
8770,July,2022,Miami-Dade,FL,Passenger,1,0,1,75,76,1.32,Furthest
8771,July,2022,San Juan,WA,Passenger,521,160,681,14025,14706,4.63,Washington
8772,July,2022,Kittitas,WA,Truck,1,0,1,14616,14617,0.01,Washington
8773,July,2022,Wilson,TX,Passenger,0,1,1,2,3,33.33,Mid-Distance
8774,July,2022,Onslow,NC,Passenger,0,1,1,157,158,0.63,Furthest
8775,July,2022,DeKalb,GA,Passenger,1,0,1,45,46,2.17,Furthest
8776,July,2022,Cumberland,NC,Passenger,1,2,3,339,342,0.88,Furthest
8777,July,2022,Denton,TX,Passenger,1,0,1,61,62,1.61,Mid-Distance
8778,July,2022,Elmore,ID,Passenger,1,0,1,12,13,7.69,Nearest
8779,July,2022,Kauai,HI,Passenger,1,0,1,15,16,6.25,Nearest
8780,July,2022,Washington,MD,Passenger,2,0,2,15,17,11.76,Furthest
8781,July,2022,Ventura,CA,Passenger,2,1,3,222,225,1.33,Nearest
8782,July,2022,Thurston,WA,Truck,8,0,8,55356,55364,0.01,Washington
8783,July,2022,Columbia,WA,Passenger,7,0,7,2430,2437,0.29,Washington
8784,July,2022,San Diego,CA,Passenger,16,11,27,2199,2226,1.21,Nearest
8785,July,2022,Stafford,VA,Passenger,2,1,3,84,87,3.45,Furthest
8786,July,2022,Pacific,WA,Passenger,64,71,135,15841,15976,0.85,Washington
8787,July,2022,Nassau,NY,Passenger,2,0,2,23,25,8.0,Furthest
8788,July,2022,Okanogan,WA,Passenger,88,49,137,26298,26435,0.52,Washington
8789,July,2022,Cowlitz,WA,Passenger,349,171,520,70574,71094,0.73,Washington
8790,July,2022,Rockingham,NH,Passenger,1,0,1,14,15,6.67,Furthest
8791,July,2022,Douglas,WA,Truck,1,0,1,12747,12748,0.01,Washington
8792,July,2022,Yakima,WA,Passenger,353,198,551,166690,167241,0.33,Washington
8793,July,2022,Pennington,SD,Passenger,2,0,2,24,26,7.69,Mid-Distance
8794,July,2022,Portsmouth,VA,Passenger,0,1,1,73,74,1.35,Furthest
8795,July,2022,Plaquemines,LA,Passenger,1,1,2,16,18,11.11,Mid-Distance
8796,July,2022,Las Animas,CO,Passenger,1,0,1,1,2,50.0,Mid-Distance
8797,July,2022,Douglas,WA,Passenger,138,60,198,28404,28602,0.69,Washington
8798,July,2022,Penobscot,ME,Passenger,0,1,1,8,9,11.11,Furthest
8799,July,2022,Yellowstone,MT,Passenger,0,1,1,21,22,4.55,Nearest
8800,July,2022,Williamson,TX,Passenger,1,2,3,77,80,3.75,Mid-Distance
8801,July,2022,Klickitat,WA,Truck,0,0,0,8286,8286,0.0,Washington
8802,July,2022,Island,WA,Truck,6,0,6,21337,21343,0.03,Washington
8803,July,2022,St. Louis,MO,Passenger,1,0,1,59,60,1.67,Furthest
8804,July,2022,Fort Bend,TX,Passenger,1,0,1,24,25,4.0,Mid-Distance
8805,July,2022,Rogers,OK,Passenger,1,0,1,1,2,50.0,Mid-Distance
8806,July,2022,San Bernardino,CA,Passenger,1,1,2,310,312,0.64,Nearest
8807,July,2022,Hamilton,IN,Passenger,1,0,1,17,18,5.56,Furthest
8808,July,2022,Bryan,GA,Passenger,0,1,1,39,40,2.5,Furthest
8809,July,2022,Ray,MO,Passenger,0,1,1,1,2,50.0,Furthest
8810,July,2022,King,WA,Passenger,41908,11450,53358,1347349,1400707,3.81,Washington
8811,July,2022,Sumter,SC,Passenger,0,1,1,32,33,3.03,Furthest
8812,July,2022,Adams,WA,Truck,1,0,1,5458,5459,0.02,Washington
8813,July,2022,Sonoma,CA,Passenger,0,1,1,73,74,1.35,Nearest
8814,July,2022,Klickitat,WA,Passenger,106,56,162,15204,15366,1.05,Washington
8815,July,2022,Camden,NJ,Passenger,0,1,1,12,13,7.69,Furthest
8816,July,2022,Skamania,WA,Truck,0,0,0,3948,3948,0.0,Washington
8817,July,2022,Fairbanks North Star,AK,Passenger,0,1,1,70,71,1.41,Nearest
8818,July,2022,Chelan,WA,Truck,4,0,4,23054,23058,0.02,Washington
8819,July,2022,Cape May,NJ,Passenger,0,1,1,7,8,12.5,Furthest
8820,July,2022,Mason,WA,Truck,4,0,4,20985,20989,0.02,Washington
8821,July,2022,Houston,GA,Passenger,1,0,1,30,31,3.23,Furthest
8822,July,2022,Clallam,WA,Truck,3,0,3,21895,21898,0.01,Washington
8823,July,2022,Whatcom,WA,Truck,11,0,11,43223,43234,0.03,Washington
8824,July,2022,Douglas,CO,Passenger,0,1,1,68,69,1.45,Mid-Distance
8825,July,2022,Sarasota,FL,Passenger,2,0,2,22,24,8.33,Furthest
8826,July,2022,Hamilton,OH,Passenger,1,0,1,26,27,3.7,Furthest
8827,July,2022,Montgomery,AL,Passenger,0,1,1,33,34,2.94,Furthest
8828,July,2022,Mason,WA,Passenger,320,176,496,47125,47621,1.04,Washington
8829,July,2022,District of Columbia,DC,Passenger,4,0,4,167,171,2.34,Furthest
8830,July,2022,Adams,WA,Passenger,19,10,29,12942,12971,0.22,Washington
8831,July,2022,Virginia Beach,VA,Passenger,2,0,2,493,495,0.4,Furthest
8832,July,2022,Sacramento,CA,Passenger,3,0,3,188,191,1.57,Nearest
8833,July,2022,El Paso,TX,Passenger,2,0,2,317,319,0.63,Mid-Distance
8834,July,2022,Pend Oreille,WA,Truck,0,0,0,5648,5648,0.0,Washington
8835,July,2022,Oldham,KY,Passenger,0,1,1,4,5,20.0,Furthest
8836,July,2022,Calvert,MD,Passenger,0,2,2,75,77,2.6,Furthest
8837,July,2022,Okaloosa,FL,Passenger,0,1,1,97,98,1.02,Furthest
8838,July,2022,Travis,TX,Passenger,1,0,1,98,99,1.01,Mid-Distance
8839,July,2022,Asotin,WA,Truck,0,0,0,6688,6688,0.0,Washington
8841,July,2022,Pulaski,AR,Passenger,1,0,1,26,27,3.7,Mid-Distance
8842,July,2022,St. Tammany,LA,Passenger,1,0,1,33,34,2.94,Mid-Distance
8843,July,2022,Montgomery,MD,Passenger,4,2,6,191,197,3.05,Furthest
8844,July,2022,Hudson,NJ,Passenger,2,0,2,32,34,5.88,Furthest
8845,July,2022,Island,WA,Passenger,835,380,1215,61863,63078,1.93,Washington
8846,July,2022,Charleston,SC,Passenger,2,2,4,59,63,6.35,Furthest
8847,July,2022,Anne Arundel,MD,Passenger,4,4,8,330,338,2.37,Furthest
8848,July,2022,Orange,FL,Passenger,1,0,1,81,82,1.22,Furthest
8849,July,2022,Montgomery,PA,Passenger,1,0,1,20,21,4.76,Furthest
8850,July,2022,Sarpy,NE,Passenger,1,0,1,52,53,1.89,Mid-Distance
8851,July,2022,Cumberland,PA,Passenger,1,0,1,36,37,2.7,Furthest
8852,July,2022,Grant,WA,Truck,0,0,0,27963,27963,0.0,Washington
8853,July,2022,Geary,KS,Passenger,1,0,1,83,84,1.19,Mid-Distance
8854,July,2022,Riverside,CA,Passenger,7,1,8,439,447,1.79,Nearest
8855,July,2022,Cook,IL,Passenger,2,0,2,175,177,1.13,Mid-Distance
8856,July,2022,Yakima,WA,Truck,1,0,1,61344,61345,0.0,Washington
8857,July,2022,Kitsap,WA,Passenger,2463,1074,3537,178200,181737,1.95,Washington
8858,July,2022,Howard,MD,Passenger,0,1,1,52,53,1.89,Furthest
8859,July,2022,King,WA,Truck,123,2,125,180390,180515,0.07,Washington
8860,July,2022,Platte,MO,Passenger,1,0,1,21,22,4.55,Furthest
8861,July,2022,Jefferson,WA,Truck,3,0,3,9457,9460,0.03,Washington
8862,July,2022,Greene,MO,Passenger,0,1,1,19,20,5.0,Furthest
8863,July,2022,Broward,FL,Passenger,1,0,1,73,74,1.35,Furthest
8864,July,2022,El Paso,CO,Passenger,2,1,3,567,570,0.53,Mid-Distance
8865,July,2022,Snohomish,WA,Passenger,8662,2565,11227,531561,542788,2.07,Washington
8866,July,2022,Clark,NV,Passenger,4,2,6,485,491,1.22,Nearest
8867,July,2022,Carroll,MD,Passenger,0,1,1,16,17,5.88,Furthest
8868,July,2022,Galveston,TX,Passenger,0,1,1,18,19,5.26,Mid-Distance
8869,July,2022,Solano,CA,Passenger,1,0,1,154,155,0.65,Nearest
8870,July,2023,Madison,IL,Passenger,1,0,1,14,15,6.67,Mid-Distance
8871,July,2023,Oldham,KY,Passenger,0,1,1,3,4,25.0,Furthest
8872,July,2023,Arapahoe,CO,Passenger,1,1,2,55,57,3.51,Mid-Distance
8873,July,2023,Bell,TX,Passenger,1,0,1,213,214,0.47,Mid-Distance
8874,July,2023,San Bernardino,CA,Passenger,2,1,3,231,234,1.28,Nearest
8875,July,2023,Skagit,WA,Passenger,1139,417,1556,86446,88002,1.77,Washington
8876,July,2023,Grays Harbor,WA,Passenger,311,192,503,47081,47584,1.06,Washington
8877,July,2023,Chelan,WA,Truck,31,0,31,22570,22601,0.14,Washington
8878,July,2023,Yakima,WA,Truck,13,0,13,58999,59012,0.02,Washington
8879,July,2023,King,WA,Passenger,58610,14725,73335,1297605,1370940,5.35,Washington
8880,July,2023,Fairfax,VA,Passenger,5,3,8,487,495,1.62,Furthest
8881,July,2023,Yakima,WA,Passenger,511,253,764,161420,162184,0.47,Washington
8882,July,2023,Beaufort,SC,Passenger,1,0,1,19,20,5.0,Furthest
8883,July,2023,Stevens,WA,Truck,2,0,2,18253,18255,0.01,Washington
8884,July,2023,Pend Oreille,WA,Passenger,30,15,45,8645,8690,0.52,Washington
8885,July,2023,El Paso,CO,Passenger,3,1,4,425,429,0.93,Mid-Distance
8886,July,2023,Adams,CO,Passenger,1,0,1,21,22,4.55,Mid-Distance
8887,July,2023,Yellowstone,MT,Passenger,0,1,1,13,14,7.14,Nearest
8888,July,2023,San Diego,CA,Passenger,14,9,23,1711,1734,1.33,Nearest
8889,July,2023,Pierce,WA,Passenger,7775,2805,10580,516969,527549,2.01,Washington
8890,July,2023,Wahkiakum,WA,Passenger,27,17,44,2972,3016,1.46,Washington
8891,July,2023,Elmore,ID,Passenger,1,0,1,8,9,11.11,Nearest
8892,July,2023,Kent,DE,Passenger,1,0,1,38,39,2.56,Furthest
8893,July,2023,Pulaski,AR,Passenger,2,0,2,17,19,10.53,Mid-Distance
8894,July,2023,Virginia Beach,VA,Passenger,2,1,3,392,395,0.76,Furthest
8895,July,2023,Jefferson,WA,Truck,12,0,12,9094,9106,0.13,Washington
8896,July,2023,Whitman,WA,Truck,5,0,5,8455,8460,0.06,Washington
8897,July,2023,Wahkiakum,WA,Truck,3,0,3,1728,1731,0.17,Washington
8898,July,2023,Marin,CA,Passenger,0,1,1,26,27,3.7,Nearest
8899,July,2023,Travis,TX,Passenger,1,0,1,69,70,1.43,Mid-Distance
8900,July,2023,Columbia,WA,Passenger,10,1,11,2365,2376,0.46,Washington
8901,July,2023,Rockdale,GA,Passenger,1,0,1,3,4,25.0,Furthest
8902,July,2023,Rock Island,IL,Passenger,0,1,1,13,14,7.14,Mid-Distance
8903,July,2023,San Juan,WA,Passenger,622,165,787,13491,14278,5.51,Washington
8904,July,2023,Jefferson,WA,Passenger,571,261,832,23782,24614,3.38,Washington
8905,July,2023,Franklin,WA,Truck,6,0,6,20274,20280,0.03,Washington
8906,July,2023,Santa Cruz,CA,Passenger,1,0,1,11,12,8.33,Nearest
8907,July,2023,Lincoln,WA,Passenger,18,19,37,7476,7513,0.49,Washington
8908,July,2023,Allen,IN,Passenger,1,0,1,5,6,16.67,Furthest
8909,July,2023,Boulder,CO,Passenger,1,0,1,21,22,4.55,Mid-Distance
8910,July,2023,King,WA,Truck,780,2,782,170537,171319,0.46,Washington
8911,July,2023,Ventura,CA,Passenger,1,1,2,182,184,1.09,Nearest
8912,July,2023,Bexar,TX,Passenger,2,2,4,308,312,1.28,Mid-Distance
8913,July,2023,Lee,AL,Passenger,1,0,1,9,10,10.0,Furthest
8914,July,2023,Ray,MO,Passenger,0,1,1,0,1,100.0,Furthest
8915,July,2023,Houston,GA,Passenger,1,0,1,26,27,3.7,Furthest
8916,July,2023,Columbia,WA,Truck,0,0,0,1509,1509,0.0,Washington
8917,July,2023,Collin,TX,Passenger,1,0,1,29,30,3.33,Mid-Distance
8918,July,2023,Okanogan,WA,Passenger,128,62,190,25306,25496,0.75,Washington
8919,July,2023,Sedgwick,KS,Passenger,1,0,1,46,47,2.13,Mid-Distance
8920,July,2023,Kootenai,ID,Truck,1,0,1,20,21,4.76,Nearest
8921,July,2023,Montgomery,MD,Passenger,3,2,5,153,158,3.16,Furthest
8922,July,2023,Miami-Dade,FL,Passenger,1,0,1,47,48,2.08,Furthest
8923,July,2023,Clark,NV,Passenger,2,2,4,328,332,1.2,Nearest
8924,July,2023,Newport News,VA,Passenger,1,0,1,85,86,1.16,Furthest
8925,July,2023,Snohomish,WA,Truck,187,0,187,117767,117954,0.16,Washington
8926,July,2023,Alexandria,VA,Passenger,2,1,3,81,84,3.57,Furthest
8927,July,2023,El Paso,TX,Passenger,2,0,2,225,227,0.88,Mid-Distance
8928,July,2023,Camden,NJ,Passenger,0,1,1,10,11,9.09,Furthest
8929,July,2023,Clallam,WA,Passenger,563,289,852,47919,48771,1.75,Washington
8930,July,2023,Orange,CA,Passenger,6,2,8,246,254,3.15,Nearest
8931,July,2023,Prince George's,MD,Passenger,3,1,4,97,101,3.96,Furthest
8932,July,2023,Norfolk,VA,Passenger,2,2,4,238,242,1.65,Furthest
8933,July,2023,Chesapeake,VA,Passenger,1,3,4,250,254,1.57,Furthest
8934,July,2023,Asotin,WA,Passenger,35,23,58,12154,12212,0.47,Washington
8935,July,2023,DeKalb,GA,Passenger,1,0,1,30,31,3.23,Furthest
8936,July,2023,Asotin,WA,Truck,0,0,0,6500,6500,0.0,Washington
8937,July,2023,Whitman,WA,Passenger,159,77,236,21502,21738,1.09,Washington
8938,July,2023,Galveston,TX,Passenger,0,1,1,13,14,7.14,Mid-Distance
8939,July,2023,Loudoun,VA,Passenger,2,0,2,55,57,3.51,Furthest
8940,July,2023,Washington,MD,Passenger,1,0,1,12,13,7.69,Furthest
8941,July,2023,Kauai,HI,Passenger,0,1,1,13,14,7.14,Nearest
8942,July,2023,Sacramento,CA,Passenger,5,0,5,117,122,4.1,Nearest
8943,July,2023,Kitsap,WA,Passenger,3267,1302,4569,172227,176796,2.58,Washington
8944,July,2023,District of Columbia,DC,Passenger,5,0,5,135,140,3.57,Furthest
8945,July,2023,Yavapai,AZ,Passenger,1,0,1,17,18,5.56,Nearest
8946,July,2023,Lincoln,OR,Passenger,0,1,1,12,13,7.69,Nearest
8947,July,2023,Cowlitz,WA,Passenger,477,222,699,68070,68769,1.02,Washington
8948,July,2023,Charles,MD,Passenger,1,1,2,45,47,4.26,Furthest
8949,July,2023,Sheridan,WY,Passenger,1,0,1,5,6,16.67,Nearest
8950,July,2023,Solano,CA,Passenger,5,0,5,123,128,3.91,Nearest
8951,July,2023,Kittitas,WA,Passenger,358,104,462,28484,28946,1.6,Washington
8952,July,2023,Pend Oreille,WA,Truck,0,0,0,5446,5446,0.0,Washington
8953,July,2023,Alameda,CA,Passenger,3,0,3,132,135,2.22,Nearest
8954,July,2023,Cowlitz,WA,Truck,10,0,10,27395,27405,0.04,Washington
8955,July,2023,Gwinnett,GA,Passenger,1,0,1,33,34,2.94,Furthest
8956,July,2023,Mason,WA,Truck,11,0,11,19979,19990,0.06,Washington
8957,July,2023,St. Tammany,LA,Passenger,1,0,1,26,27,3.7,Mid-Distance
8958,July,2023,Broward,FL,Passenger,1,0,1,50,51,1.96,Furthest
8959,July,2023,Adams,WA,Truck,3,0,3,5136,5139,0.06,Washington
8960,July,2023,Douglas,WA,Passenger,213,65,278,28117,28395,0.98,Washington
8961,July,2023,Benton,WA,Truck,25,0,25,41955,41980,0.06,Washington
8962,July,2023,Jefferson,NY,Passenger,1,1,2,162,164,1.22,Furthest
8963,July,2023,Skamania,WA,Passenger,105,56,161,7814,7975,2.02,Washington
8964,July,2023,Frederick,MD,Passenger,1,1,2,45,47,4.26,Furthest
8965,July,2023,Wichita,TX,Passenger,2,0,2,29,31,6.45,Mid-Distance
8966,July,2023,Vernon,LA,Passenger,1,0,1,65,66,1.52,Mid-Distance
8967,July,2023,Fairfax,VA,Truck,1,0,1,77,78,1.28,Furthest
8968,July,2023,Rockingham,NH,Passenger,1,0,1,10,11,9.09,Furthest
8969,July,2023,Chelan,WA,Passenger,641,165,806,52924,53730,1.5,Washington
8970,July,2023,Leavenworth,KS,Passenger,0,1,1,86,87,1.15,Mid-Distance
8971,July,2023,Okanogan,WA,Truck,7,0,7,15946,15953,0.04,Washington
8972,July,2023,San Juan,WA,Truck,16,0,16,5767,5783,0.28,Washington
8973,July,2023,Goochland,VA,Passenger,0,1,1,22,23,4.35,Furthest
8974,July,2023,Ferry,WA,Truck,0,0,0,3476,3476,0.0,Washington
8975,July,2023,Emmet,MI,Passenger,0,1,1,0,1,100.0,Furthest
8976,July,2023,Clark,WA,Passenger,5943,2342,8285,305963,314248,2.64,Washington
8977,July,2023,Benton,OR,Passenger,1,0,1,27,28,3.57,Nearest
8978,July,2023,Lewis,WA,Truck,7,0,7,25247,25254,0.03,Washington
8979,July,2023,St. Louis,MO,Passenger,1,0,1,42,43,2.33,Furthest
8980,July,2023,Douglas,NE,Passenger,1,1,2,17,19,10.53,Mid-Distance
8981,July,2023,Lane,OR,Passenger,0,1,1,50,51,1.96,Nearest
8982,July,2023,Lake,IL,Passenger,3,0,3,99,102,2.94,Mid-Distance
8983,July,2023,Thurston,WA,Passenger,3153,1230,4383,185812,190195,2.3,Washington
8984,July,2023,Garfield,WA,Passenger,0,3,3,1282,1285,0.23,Washington
8985,July,2023,Lewis,WA,Passenger,328,217,545,57742,58287,0.94,Washington
8986,July,2023,Suffolk,VA,Passenger,1,0,1,87,88,1.14,Furthest
8987,July,2023,Klickitat,WA,Truck,11,0,11,8015,8026,0.14,Washington
8988,July,2023,Arlington,VA,Passenger,1,0,1,93,94,1.06,Furthest
8989,July,2023,Snohomish,WA,Passenger,13023,3087,16110,515187,531297,3.03,Washington
8990,July,2023,Spokane,WA,Passenger,2340,1124,3464,315617,319081,1.09,Washington
8991,July,2023,Island,WA,Truck,33,0,33,20607,20640,0.16,Washington
8992,July,2023,Harrison,MS,Passenger,1,0,1,25,26,3.85,Mid-Distance
8993,July,2023,Benton,WA,Passenger,1158,568,1726,131666,133392,1.29,Washington
8994,July,2023,Carroll,MD,Passenger,0,1,1,16,17,5.88,Furthest
8995,July,2023,Platte,MO,Passenger,1,0,1,16,17,5.88,Furthest
8996,July,2023,Calvert,MD,Passenger,1,1,2,66,68,2.94,Furthest
8997,July,2023,Maricopa,AZ,Passenger,6,3,9,510,519,1.73,Nearest
8998,July,2023,New London,CT,Passenger,1,4,5,159,164,3.05,Furthest
8999,July,2023,St. Clair,IL,Passenger,1,0,1,89,90,1.11,Mid-Distance
9000,July,2023,Mason,WA,Passenger,462,212,674,45044,45718,1.47,Washington
9001,July,2023,Ulster,NY,Passenger,1,0,1,4,5,20.0,Furthest
9002,July,2023,Garfield,WA,Truck,0,0,0,950,950,0.0,Washington
9003,July,2023,Champaign,IL,Passenger,1,0,1,7,8,12.5,Mid-Distance
9004,July,2023,Coryell,TX,Passenger,1,0,1,67,68,1.47,Mid-Distance
9005,July,2023,Plaquemines,LA,Passenger,1,1,2,12,14,14.29,Mid-Distance
9006,July,2023,Honolulu,HI,Passenger,2,3,5,211,216,2.31,Nearest
9007,July,2023,Placer,CA,Passenger,1,0,1,49,50,2.0,Nearest
9008,July,2023,Polk,OR,Passenger,0,1,1,13,14,7.14,Nearest
9009,July,2023,Charleston,SC,Passenger,1,2,3,42,45,6.67,Furthest
9010,July,2023,Pacific,WA,Truck,4,0,4,7654,7658,0.05,Washington
9011,July,2023,Napa,CA,Passenger,0,1,1,8,9,11.11,Nearest
9012,July,2023,Clallam,WA,Truck,19,0,19,21216,21235,0.09,Washington
9013,July,2023,Island,WA,Passenger,1106,442,1548,59897,61445,2.52,Washington
9014,July,2023,Walla Walla,WA,Truck,5,0,5,13311,13316,0.04,Washington
9015,July,2023,Grant,WA,Truck,12,0,12,27240,27252,0.04,Washington
9016,July,2023,Jackson,OK,Passenger,0,1,1,29,30,3.33,Mid-Distance
9017,July,2023,Harnett,NC,Passenger,4,0,4,111,115,3.48,Furthest
9018,July,2023,Clark,WA,Truck,102,0,102,79248,79350,0.13,Washington
9019,July,2023,Cumberland,PA,Passenger,1,0,1,25,26,3.85,Furthest
9020,July,2023,Klickitat,WA,Passenger,156,65,221,14764,14985,1.47,Washington
9022,July,2023,Onslow,NC,Passenger,0,1,1,129,130,0.77,Furthest
9023,July,2023,Douglas,CO,Passenger,0,1,1,44,45,2.22,Mid-Distance
9024,July,2023,Richmond,NY,Passenger,1,0,1,5,6,16.67,Furthest
9025,July,2023,Middlesex,MA,Passenger,2,1,3,53,56,5.36,Furthest
9026,July,2023,Ferry,WA,Passenger,21,4,25,4197,4222,0.59,Washington
9027,July,2023,Saratoga,NY,Passenger,1,1,2,27,29,6.9,Furthest
9028,July,2023,New Haven,CT,Passenger,0,2,2,19,21,9.52,Furthest
9029,July,2023,Cape May,NJ,Passenger,0,1,1,7,8,12.5,Furthest
9030,July,2023,Escambia,FL,Passenger,0,1,1,98,99,1.01,Furthest
9031,July,2023,Spokane,WA,Truck,42,0,42,99373,99415,0.04,Washington
9032,July,2023,Grant,WA,Passenger,287,131,418,65201,65619,0.64,Washington
9033,July,2023,Douglas,WA,Truck,5,0,5,12696,12701,0.04,Washington
9034,July,2023,Randolph,NC,Passenger,1,0,1,3,4,25.0,Furthest
9035,July,2023,Hidalgo,TX,Passenger,0,1,1,38,39,2.56,Mid-Distance
9036,July,2023,Pacific,WA,Passenger,78,88,166,15312,15478,1.07,Washington
9037,July,2023,Kittitas,WA,Truck,10,0,10,14172,14182,0.07,Washington
9038,July,2023,Wilson,TX,Passenger,0,1,1,2,3,33.33,Mid-Distance
9039,July,2023,Thurston,WA,Truck,64,0,64,52520,52584,0.12,Washington
9040,July,2023,Santa Clara,CA,Passenger,8,1,9,127,136,6.62,Nearest
9041,July,2023,Howard,MD,Passenger,0,1,1,38,39,2.56,Furthest
9042,July,2023,Contra Costa,CA,Passenger,0,3,3,172,175,1.71,Nearest
9043,July,2023,Sarpy,NE,Passenger,1,0,1,41,42,2.38,Mid-Distance
9044,July,2023,Skamania,WA,Truck,1,0,1,3727,3728,0.03,Washington
9045,July,2023,Whatcom,WA,Passenger,2522,891,3413,144372,147785,2.31,Washington
9046,July,2023,St. Mary's,MD,Passenger,1,0,1,158,159,0.63,Furthest
9047,July,2023,Berkeley,SC,Passenger,0,1,1,87,88,1.14,Furthest
9048,July,2023,Richmond,GA,Passenger,0,1,1,50,51,1.96,Furthest
9049,July,2023,Franklin,WA,Passenger,315,141,456,60118,60574,0.75,Washington
9050,July,2023,Kern,CA,Passenger,1,1,2,154,156,1.28,Nearest
9051,July,2023,Burlington,NJ,Passenger,0,2,2,80,82,2.44,Furthest
9052,July,2023,Monterey,CA,Passenger,1,0,1,94,95,1.05,Nearest
9053,July,2023,Whatcom,WA,Truck,63,0,63,41534,41597,0.15,Washington
9054,July,2023,Hudson,NJ,Passenger,1,0,1,13,14,7.14,Furthest
9055,July,2023,Kings,CA,Passenger,2,1,3,242,245,1.22,Nearest
9056,July,2023,Hennepin,MN,Passenger,1,0,1,23,24,4.17,Mid-Distance
9057,July,2023,Larimer,CO,Passenger,1,0,1,28,29,3.45,Mid-Distance
9058,July,2023,Portsmouth,VA,Passenger,0,1,1,56,57,1.75,Furthest
9059,July,2023,Lincoln,WA,Truck,0,0,0,4756,4756,0.0,Washington
9060,July,2023,Grays Harbor,WA,Truck,9,0,9,20411,20420,0.04,Washington
9061,July,2023,Dallas,TX,Passenger,1,0,1,62,63,1.59,Mid-Distance
9062,July,2023,Moore,NC,Passenger,0,1,1,95,96,1.04,Furthest
9063,July,2023,Stafford,VA,Passenger,3,1,4,65,69,5.8,Furthest
9064,July,2023,Hillsborough,FL,Passenger,0,1,1,86,87,1.15,Furthest
9065,July,2023,Kitsap,WA,Truck,80,0,80,51022,51102,0.16,Washington
9066,July,2023,Adams,WA,Passenger,24,12,36,12621,12657,0.28,Washington
9067,July,2023,Walla Walla,WA,Passenger,223,113,336,34442,34778,0.97,Washington
9068,July,2023,Cook,IL,Passenger,2,0,2,122,124,1.61,Mid-Distance
9069,July,2023,Sarasota,FL,Passenger,1,0,1,15,16,6.25,Furthest
9070,July,2023,Hamilton,OH,Passenger,1,0,1,24,25,4.0,Furthest
9071,July,2023,Stevens,WA,Passenger,117,69,186,28933,29119,0.64,Washington
9072,July,2023,Hamilton,OH,Truck,1,0,1,2,3,33.33,Furthest
9073,July,2023,Anne Arundel,MD,Passenger,6,4,10,262,272,3.68,Furthest
9074,July,2023,Riverside,CA,Passenger,6,0,6,325,331,1.81,Nearest
9075,July,2023,Salt Lake,UT,Passenger,0,1,1,77,78,1.28,Nearest
9076,July,2023,Williamson,TX,Passenger,0,1,1,38,39,2.56,Mid-Distance
9077,July,2023,Pierce,WA,Truck,166,0,166,132850,133016,0.12,Washington
9078,July,2023,Las Animas,CO,Passenger,1,0,1,0,1,100.0,Mid-Distance
9079,July,2023,Los Angeles,CA,Passenger,4,4,8,509,517,1.55,Nearest
9080,July,2023,Santa Barbara,CA,Passenger,1,0,1,57,58,1.72,Nearest
9081,July,2023,Hoke,NC,Passenger,1,0,1,47,48,2.08,Furthest
9082,July,2023,Hawaii,HI,Passenger,1,0,1,23,24,4.17,Nearest
9083,July,2023,Essex,NJ,Passenger,2,0,2,4,6,33.33,Furthest
9084,July,2023,Dorchester,SC,Passenger,1,0,1,33,34,2.94,Furthest
9085,July,2023,Skagit,WA,Truck,23,0,23,30998,31021,0.07,Washington
9086,July,2023,Multnomah,OR,Passenger,0,2,2,359,361,0.55,Nearest
9087,July,2023,Nueces,TX,Passenger,1,1,2,48,50,4.0,Mid-Distance
9088,July,2023,Sonoma,CA,Passenger,1,1,2,43,45,4.44,Nearest
9089,July,2023,Cumberland,NC,Passenger,1,2,3,268,271,1.11,Furthest
9090,June,2017,Franklin,MA,Passenger,0,1,1,4,5,20.0,Furthest
9091,June,2017,Prince George's,MD,Passenger,0,1,1,183,184,0.54,Furthest
9092,June,2017,Honolulu,HI,Passenger,3,2,5,591,596,0.84,Nearest
9093,June,2017,Ferry,WA,Truck,0,0,0,3537,3537,0.0,Washington
9094,June,2017,Saratoga,NY,Passenger,1,1,2,75,77,2.6,Furthest
9095,June,2017,Travis,TX,Passenger,0,1,1,191,192,0.52,Mid-Distance
9096,June,2017,Bergen,NJ,Passenger,0,2,2,31,33,6.06,Furthest
9097,June,2017,Hamilton,IN,Passenger,1,0,1,58,59,1.69,Furthest
9098,June,2017,Grays Harbor,WA,Passenger,35,31,66,44778,44844,0.15,Washington
9099,June,2017,Canyon,ID,Passenger,0,1,1,100,101,0.99,Nearest
9100,June,2017,Howard,MD,Passenger,0,2,2,93,95,2.11,Furthest
9101,June,2017,Morris,NJ,Passenger,1,0,1,24,25,4.0,Furthest
9102,June,2017,Kitsap,WA,Truck,1,0,1,52519,52520,0.0,Washington
9103,June,2017,Garfield,WA,Truck,0,0,0,940,940,0.0,Washington
9104,June,2017,Palm Beach,FL,Passenger,0,1,1,98,99,1.01,Furthest
9105,June,2017,Douglas,WA,Truck,0,0,0,11527,11527,0.0,Washington
9106,June,2017,Snohomish,WA,Passenger,1793,903,2696,513181,515877,0.52,Washington
9107,June,2017,Douglas,WA,Passenger,34,26,60,26716,26776,0.22,Washington
9108,June,2017,Chelan,WA,Passenger,67,37,104,52044,52148,0.2,Washington
9109,June,2017,Moore,NC,Passenger,0,1,1,199,200,0.5,Furthest
9110,June,2017,Maui,HI,Passenger,1,0,1,69,70,1.43,Nearest
9111,June,2017,Missoula,MT,Passenger,1,0,1,72,73,1.37,Nearest
9112,June,2017,Bexar,TX,Passenger,1,1,2,938,940,0.21,Mid-Distance
9113,June,2017,Whitman,WA,Truck,0,0,0,8429,8429,0.0,Washington
9114,June,2017,Clallam,WA,Truck,0,0,0,21016,21016,0.0,Washington
9115,June,2017,Franklin,WA,Truck,0,0,0,18122,18122,0.0,Washington
9116,June,2017,Prince William,VA,Passenger,0,3,3,270,273,1.1,Furthest
9117,June,2017,Santa Clara,CA,Passenger,5,2,7,400,407,1.72,Nearest
9118,June,2017,Snohomish,WA,Truck,1,0,1,121886,121887,0.0,Washington
9119,June,2017,Twin Falls,ID,Passenger,0,1,1,23,24,4.17,Nearest
9120,June,2017,Pinal,AZ,Passenger,2,0,2,243,245,0.82,Nearest
9121,June,2017,Walla Walla,WA,Truck,0,0,0,13205,13205,0.0,Washington
9122,June,2017,Ramsey,MN,Passenger,1,0,1,41,42,2.38,Mid-Distance
9123,June,2017,Alameda,CA,Passenger,1,1,2,365,367,0.54,Nearest
9124,June,2017,San Juan,WA,Passenger,107,40,147,13551,13698,1.07,Washington
9125,June,2017,Kitsap,WA,Passenger,605,319,924,173378,174302,0.53,Washington
9126,June,2017,Cape May,NJ,Passenger,0,1,1,19,20,5.0,Furthest
9127,June,2017,Orange,CA,Passenger,3,1,4,627,631,0.63,Nearest
9128,June,2017,Volusia,FL,Passenger,0,1,1,47,48,2.08,Furthest
9129,June,2017,New Haven,CT,Passenger,0,1,1,57,58,1.72,Furthest
9130,June,2017,DeKalb,GA,Passenger,1,0,1,85,86,1.16,Furthest
9131,June,2017,Hawaii,HI,Passenger,1,0,1,81,82,1.22,Nearest
9132,June,2017,Pacific,WA,Truck,0,0,0,7471,7471,0.0,Washington
9133,June,2017,Wahkiakum,WA,Passenger,0,2,2,2832,2834,0.07,Washington
9134,June,2017,Norfolk,VA,Passenger,1,1,2,316,318,0.63,Furthest
9135,June,2017,Kittitas,WA,Truck,0,0,0,13560,13560,0.0,Washington
9136,June,2017,Cumberland,NC,Passenger,1,0,1,584,585,0.17,Furthest
9137,June,2017,Stevens,WA,Passenger,8,23,31,31384,31415,0.1,Washington
9138,June,2017,Skamania,WA,Truck,0,0,0,3892,3892,0.0,Washington
9139,June,2017,Arlington,VA,Passenger,1,1,2,167,169,1.18,Furthest
9140,June,2017,Anne Arundel,MD,Passenger,0,1,1,499,500,0.2,Furthest
9141,June,2017,Albemarle,VA,Passenger,0,1,1,32,33,3.03,Furthest
9142,June,2017,Pima,AZ,Passenger,1,2,3,430,433,0.69,Nearest
9143,June,2017,Norfolk,MA,Passenger,1,0,1,39,40,2.5,Furthest
9144,June,2017,Grays Harbor,WA,Truck,0,0,0,19888,19888,0.0,Washington
9145,June,2017,Manassas,VA,Passenger,0,1,1,9,10,10.0,Furthest
9146,June,2017,Okanogan,WA,Truck,0,0,0,16204,16204,0.0,Washington
9147,June,2017,Kent,MI,Passenger,0,1,1,37,38,2.63,Furthest
9148,June,2017,Salt Lake,UT,Passenger,0,1,1,266,267,0.37,Nearest
9149,June,2017,Lewis,WA,Truck,0,0,0,24838,24838,0.0,Washington
9150,June,2017,Klickitat,WA,Truck,0,0,0,7971,7971,0.0,Washington
9151,June,2017,Polk,FL,Passenger,1,0,1,64,65,1.54,Furthest
9152,June,2017,Tarrant,TX,Passenger,1,0,1,252,253,0.4,Mid-Distance
9153,June,2017,Asotin,WA,Truck,0,0,0,6502,6502,0.0,Washington
9154,June,2017,Juneau,AK,Passenger,0,1,1,45,46,2.17,Nearest
9156,June,2017,Skagit,WA,Passenger,140,103,243,88070,88313,0.28,Washington
9157,June,2017,Manatee,FL,Passenger,1,0,1,46,47,2.13,Furthest
9158,June,2017,Spokane,WA,Passenger,253,208,461,296812,297273,0.16,Washington
9159,June,2017,Cowlitz,WA,Truck,0,0,0,27913,27913,0.0,Washington
9160,June,2017,Whatcom,WA,Passenger,462,175,637,143061,143698,0.44,Washington
9161,June,2017,Monterey,CA,Passenger,0,1,1,206,207,0.48,Nearest
9162,June,2017,Whatcom,WA,Truck,2,0,2,41620,41622,0.0,Washington
9163,June,2017,Dallas,TX,Passenger,0,1,1,186,187,0.53,Mid-Distance
9164,June,2017,St. Lucie,FL,Passenger,1,0,1,33,34,2.94,Furthest
9165,June,2017,Franklin,WA,Passenger,26,45,71,55615,55686,0.13,Washington
9166,June,2017,Jefferson,NY,Passenger,1,1,2,252,254,0.79,Furthest
9167,June,2017,Nassau,NY,Passenger,0,1,1,39,40,2.5,Furthest
9168,June,2017,Walla Walla,WA,Passenger,25,26,51,34843,34894,0.15,Washington
9169,June,2017,Essex,NJ,Passenger,1,0,1,14,15,6.67,Furthest
9170,June,2017,Hardin,KY,Passenger,0,1,1,121,122,0.82,Furthest
9171,June,2017,Shelby,TN,Passenger,0,1,1,110,111,0.9,Furthest
9172,June,2017,Ferry,WA,Passenger,1,1,2,4394,4396,0.05,Washington
9173,June,2017,Jefferson,WA,Passenger,104,61,165,23850,24015,0.69,Washington
9174,June,2017,Marin,CA,Passenger,1,0,1,59,60,1.67,Nearest
9175,June,2017,Mason,WA,Truck,0,0,0,19273,19273,0.0,Washington
9176,June,2017,Madison,ID,Passenger,1,0,1,39,40,2.5,Nearest
9177,June,2017,Pierce,WA,Truck,0,0,0,137535,137535,0.0,Washington
9178,June,2017,Mason,WA,Passenger,56,68,124,43451,43575,0.28,Washington
9179,June,2017,Cowlitz,WA,Passenger,50,60,110,69653,69763,0.16,Washington
9180,June,2017,King,WA,Passenger,10028,4104,14132,1375372,1389504,1.02,Washington
9181,June,2017,Nueces,TX,Passenger,0,1,1,96,97,1.03,Mid-Distance
9182,June,2017,Clark,WA,Truck,0,0,0,77648,77648,0.0,Washington
9183,June,2017,Whitman,WA,Passenger,10,20,30,22038,22068,0.14,Washington
9184,June,2017,Charles,MD,Passenger,0,1,1,88,89,1.12,Furthest
9185,June,2017,El Paso,CO,Passenger,2,1,3,805,808,0.37,Mid-Distance
9186,June,2017,Pend Oreille,WA,Passenger,3,4,7,9316,9323,0.08,Washington
9187,June,2017,Orange,FL,Passenger,1,1,2,134,136,1.47,Furthest
9188,June,2017,Sangamon,IL,Passenger,1,0,1,11,12,8.33,Mid-Distance
9189,June,2017,Garfield,WA,Passenger,0,0,0,1295,1295,0.0,Washington
9190,June,2017,Flathead,MT,Passenger,1,0,1,61,62,1.61,Nearest
9191,June,2017,Portsmouth,VA,Passenger,0,1,1,68,69,1.45,Furthest
9192,June,2017,Okaloosa,FL,Passenger,1,0,1,183,184,0.54,Furthest
9193,June,2017,Montgomery,MD,Passenger,1,0,1,306,307,0.33,Furthest
9194,June,2017,Cascade,MT,Passenger,0,1,1,59,60,1.67,Nearest
9195,June,2017,Riverside,CA,Passenger,1,1,2,808,810,0.25,Nearest
9196,June,2017,Asotin,WA,Passenger,6,3,9,12427,12436,0.07,Washington
9197,June,2017,Nantucket,MA,Passenger,1,0,1,3,4,25.0,Furthest
9198,June,2017,Jackson,MO,Passenger,1,0,1,60,61,1.64,Furthest
9199,June,2017,Orleans,LA,Passenger,0,1,1,46,47,2.13,Mid-Distance
9200,June,2017,Marion,OR,Passenger,1,0,1,165,166,0.6,Nearest
9201,June,2017,Carroll,NH,Passenger,0,1,1,1,2,50.0,Furthest
9202,June,2017,Skamania,WA,Passenger,9,7,16,8566,8582,0.19,Washington
9203,June,2017,Montgomery,TN,Passenger,1,0,1,283,284,0.35,Furthest
9204,June,2017,Wahkiakum,WA,Truck,0,0,0,1644,1644,0.0,Washington
9205,June,2017,Tuolumne,CA,Passenger,0,1,1,14,15,6.67,Nearest
9206,June,2017,Cobb,GA,Passenger,0,1,1,76,77,1.3,Furthest
9207,June,2017,Deschutes,OR,Passenger,1,0,1,196,197,0.51,Nearest
9208,June,2017,Franklin,OH,Passenger,0,1,1,122,123,0.81,Furthest
9209,June,2017,Los Angeles,CA,Passenger,3,1,4,1294,1298,0.31,Nearest
9210,June,2017,Grant,WA,Truck,0,0,0,25220,25220,0.0,Washington
9211,June,2017,Dale,AL,Passenger,0,1,1,64,65,1.54,Furthest
9212,June,2017,DeKalb,IN,Passenger,1,0,1,1,2,50.0,Furthest
9213,June,2017,Allegheny,PA,Passenger,1,0,1,93,94,1.06,Furthest
9214,June,2017,Utah,UT,Passenger,0,1,1,156,157,0.64,Nearest
9215,June,2017,Latah,ID,Passenger,0,1,1,103,104,0.96,Nearest
9216,June,2017,Lincoln,WA,Truck,0,0,0,4429,4429,0.0,Washington
9217,June,2017,Lumpkin,GA,Passenger,1,0,1,9,10,10.0,Furthest
9218,June,2017,Ventura,CA,Passenger,0,1,1,356,357,0.28,Nearest
9219,June,2017,Lee,AL,Passenger,1,0,1,36,37,2.7,Furthest
9220,June,2017,Lane,OR,Passenger,0,1,1,237,238,0.42,Nearest
9221,June,2017,Santa Rosa,FL,Passenger,1,0,1,113,114,0.88,Furthest
9222,June,2017,San Juan,WA,Truck,0,0,0,5535,5535,0.0,Washington
9223,June,2017,Dakota,MN,Passenger,0,1,1,37,38,2.63,Mid-Distance
9224,June,2017,San Diego,CA,Passenger,5,1,6,2725,2731,0.22,Nearest
9225,June,2017,Santa Fe,NM,Passenger,0,1,1,46,47,2.13,Mid-Distance
9226,June,2017,Clark,NV,Passenger,1,2,3,829,832,0.36,Nearest
9227,June,2017,Multnomah,OR,Passenger,1,3,4,998,1002,0.4,Nearest
9228,June,2017,Okanogan,WA,Passenger,4,17,21,25707,25728,0.08,Washington
9229,June,2017,Grant,WA,Passenger,20,27,47,60844,60891,0.08,Washington
9230,June,2017,Klickitat,WA,Passenger,22,24,46,14799,14845,0.31,Washington
9231,June,2017,Skagit,WA,Truck,1,0,1,31458,31459,0.0,Washington
9232,June,2017,Yakima,WA,Truck,0,0,0,57351,57351,0.0,Washington
9233,June,2017,Benton,WA,Truck,0,0,0,40055,40055,0.0,Washington
9234,June,2017,Benton,WA,Passenger,148,143,291,128515,128806,0.23,Washington
9235,June,2017,Adams,WA,Passenger,2,3,5,12204,12209,0.04,Washington
9236,June,2017,Virginia Beach,VA,Passenger,2,1,3,652,655,0.46,Furthest
9237,June,2017,Tulare,CA,Passenger,1,0,1,198,199,0.5,Nearest
9238,June,2017,Harnett,NC,Passenger,1,0,1,258,259,0.39,Furthest
9239,June,2017,Island,WA,Truck,0,0,0,20501,20501,0.0,Washington
9240,June,2017,Maricopa,AZ,Passenger,2,0,2,1748,1750,0.11,Nearest
9241,June,2017,Adams,WA,Truck,0,0,0,5106,5106,0.0,Washington
9242,June,2017,Yakima,WA,Passenger,45,57,102,159401,159503,0.06,Washington
9243,June,2017,Wayne,MI,Passenger,0,1,1,69,70,1.43,Furthest
9244,June,2017,Sedgwick,KS,Passenger,0,1,1,110,111,0.9,Mid-Distance
9245,June,2017,Clackamas,OR,Passenger,0,1,1,292,293,0.34,Nearest
9246,June,2017,District of Columbia,DC,Passenger,0,3,3,218,221,1.36,Furthest
9247,June,2017,Kittitas,WA,Passenger,21,17,38,27579,27617,0.14,Washington
9248,June,2017,Dane,WI,Passenger,1,0,1,103,104,0.96,Mid-Distance
9249,June,2017,Columbia,WA,Passenger,1,1,2,2353,2355,0.08,Washington
9250,June,2017,Lewis,WA,Passenger,51,34,85,55546,55631,0.15,Washington
9251,June,2017,Stevens,WA,Truck,0,0,0,18273,18273,0.0,Washington
9252,June,2017,Hamilton,TN,Passenger,1,0,1,19,20,5.0,Furthest
9253,June,2017,Columbia,WA,Truck,0,0,0,1531,1531,0.0,Washington
9254,June,2017,King,WA,Truck,8,1,9,187744,187753,0.0,Washington
9255,June,2017,Fairfax,VA,Passenger,2,2,4,858,862,0.46,Furthest
9256,June,2017,Pierce,WA,Passenger,956,842,1798,524957,526755,0.34,Washington
9257,June,2017,Gwinnett,GA,Passenger,0,1,1,84,85,1.18,Furthest
9258,June,2017,Pacific,WA,Passenger,10,7,17,15145,15162,0.11,Washington
9259,June,2017,Montgomery,PA,Passenger,1,0,1,40,41,2.44,Furthest
9260,June,2017,Chelan,WA,Truck,0,0,0,21303,21303,0.0,Washington
9261,June,2017,New London,CT,Passenger,1,1,2,253,255,0.78,Furthest
9262,June,2017,Jefferson,WA,Truck,0,0,0,9424,9424,0.0,Washington
9263,June,2017,Northampton,PA,Passenger,1,0,1,147,148,0.68,Furthest
9264,June,2017,Richmond,GA,Passenger,0,1,1,89,90,1.11,Furthest
9265,June,2017,Pend Oreille,WA,Truck,0,0,0,5574,5574,0.0,Washington
9266,June,2017,Island,WA,Passenger,117,136,253,60111,60364,0.42,Washington
9267,June,2017,Duval,FL,Passenger,1,1,2,383,385,0.52,Furthest
9268,June,2017,Thurston,WA,Truck,0,0,0,53295,53295,0.0,Washington
9269,June,2017,Fulton,GA,Passenger,1,0,1,115,116,0.86,Furthest
9270,June,2017,Spokane,WA,Truck,1,0,1,90624,90625,0.0,Washington
9271,June,2017,Sumter,FL,Passenger,0,1,1,10,11,9.09,Furthest
9272,June,2017,Thurston,WA,Passenger,398,336,734,186654,187388,0.39,Washington
9273,June,2017,Lincoln,WA,Passenger,2,5,7,7527,7534,0.09,Washington
9274,June,2017,Clark,WA,Passenger,787,504,1291,299553,300844,0.43,Washington
9275,June,2017,San Mateo,CA,Passenger,0,1,1,151,152,0.66,Nearest
9276,June,2017,Clallam,WA,Passenger,90,76,166,48373,48539,0.34,Washington
9277,June,2018,Spokane,WA,Passenger,340,316,656,303132,303788,0.22,Washington
9278,June,2018,Norfolk,MA,Passenger,1,0,1,38,39,2.56,Furthest
9279,June,2018,Garfield,WA,Truck,0,0,0,950,950,0.0,Washington
9280,June,2018,Lewis,WA,Truck,0,0,0,25481,25481,0.0,Washington
9281,June,2018,DeKalb,GA,Passenger,1,0,1,80,81,1.23,Furthest
9282,June,2018,Dale,AL,Passenger,0,1,1,58,59,1.69,Furthest
9283,June,2018,Clark,NV,Passenger,1,2,3,742,745,0.4,Nearest
9284,June,2018,Volusia,FL,Passenger,0,1,1,33,34,2.94,Furthest
9285,June,2018,Lumpkin,GA,Passenger,1,0,1,7,8,12.5,Furthest
9286,June,2018,Pierce,WA,Passenger,1228,1173,2401,532275,534676,0.45,Washington
9287,June,2018,District of Columbia,DC,Passenger,0,3,3,188,191,1.57,Furthest
9288,June,2018,Clallam,WA,Truck,0,0,0,21442,21442,0.0,Washington
9289,June,2018,Hardin,KY,Passenger,0,1,1,120,121,0.83,Furthest
9290,June,2018,Bexar,TX,Passenger,2,4,6,750,756,0.79,Mid-Distance
9291,June,2018,Nantucket,MA,Passenger,1,0,1,4,5,20.0,Furthest
9292,June,2018,Jefferson,WA,Truck,0,0,0,9548,9548,0.0,Washington
9293,June,2018,Moore,NC,Passenger,0,1,1,194,195,0.51,Furthest
9294,June,2018,King,WA,Passenger,13167,5678,18845,1371166,1390011,1.36,Washington
9295,June,2018,Richland,SC,Passenger,0,1,1,169,170,0.59,Furthest
9296,June,2018,Multnomah,OR,Passenger,3,4,7,801,808,0.87,Nearest
9297,June,2018,Tuolumne,CA,Passenger,0,1,1,11,12,8.33,Nearest
9298,June,2018,Skagit,WA,Truck,1,0,1,32042,32043,0.0,Washington
9299,June,2018,Lincoln,WA,Truck,0,0,0,4559,4559,0.0,Washington
9300,June,2018,Camden,NJ,Passenger,0,1,1,33,34,2.94,Furthest
9301,June,2018,Clark,WA,Passenger,1009,719,1728,307969,309697,0.56,Washington
9302,June,2018,Contra Costa,CA,Passenger,0,1,1,452,453,0.22,Nearest
9303,June,2018,Santa Clara,CA,Passenger,7,0,7,375,382,1.83,Nearest
9304,June,2018,Lee,AL,Passenger,1,0,1,35,36,2.78,Furthest
9305,June,2018,Los Angeles,CA,Passenger,7,4,11,1150,1161,0.95,Nearest
9306,June,2018,Maricopa,AZ,Passenger,2,1,3,1583,1586,0.19,Nearest
9307,June,2018,Santa Rosa,FL,Passenger,1,0,1,96,97,1.03,Furthest
9308,June,2018,Pierce,WA,Truck,0,0,0,137831,137831,0.0,Washington
9309,June,2018,Manatee,FL,Passenger,1,0,1,37,38,2.63,Furthest
9310,June,2018,Flathead,MT,Passenger,1,0,1,50,51,1.96,Nearest
9311,June,2018,Broward,FL,Passenger,1,1,2,131,133,1.5,Furthest
9312,June,2018,Wahkiakum,WA,Passenger,1,2,3,2915,2918,0.1,Washington
9313,June,2018,Island,WA,Passenger,197,188,385,62531,62916,0.61,Washington
9314,June,2018,Tarrant,TX,Passenger,1,0,1,219,220,0.45,Mid-Distance
9315,June,2018,Alameda,CA,Passenger,0,1,1,347,348,0.29,Nearest
9316,June,2018,Orange,FL,Passenger,2,1,3,174,177,1.69,Furthest
9317,June,2018,Pima,AZ,Passenger,1,1,2,411,413,0.48,Nearest
9318,June,2018,Adams,WA,Passenger,5,5,10,12616,12626,0.08,Washington
9319,June,2018,Dakota,MN,Passenger,0,2,2,38,40,5.0,Mid-Distance
9320,June,2018,Beaufort,SC,Passenger,1,0,1,38,39,2.56,Furthest
9321,June,2018,Allegheny,PA,Passenger,1,0,1,77,78,1.28,Furthest
9322,June,2018,Garfield,WA,Passenger,1,1,2,1316,1318,0.15,Washington
9323,June,2018,Saratoga,NY,Passenger,1,1,2,64,66,3.03,Furthest
9324,June,2018,Sacramento,CA,Passenger,1,0,1,299,300,0.33,Nearest
9325,June,2018,Lewis,WA,Passenger,80,59,139,57688,57827,0.24,Washington
9326,June,2018,Snohomish,WA,Truck,1,0,1,121653,121654,0.0,Washington
9327,June,2018,Franklin,WA,Truck,0,0,0,18663,18663,0.0,Washington
9328,June,2018,Ferry,WA,Passenger,3,3,6,4425,4431,0.14,Washington
9329,June,2018,Hennepin,MN,Passenger,1,0,1,108,109,0.92,Mid-Distance
9330,June,2018,DeKalb,IN,Passenger,1,0,1,1,2,50.0,Furthest
9331,June,2018,Stevens,WA,Passenger,11,25,36,31637,31673,0.11,Washington
9332,June,2018,Pacific,WA,Passenger,17,20,37,15572,15609,0.24,Washington
9333,June,2018,Cook,IL,Passenger,1,0,1,265,266,0.38,Mid-Distance
9334,June,2018,Columbia,WA,Passenger,2,2,4,2424,2428,0.16,Washington
9335,June,2018,New Haven,CT,Passenger,0,1,1,49,50,2.0,Furthest
9336,June,2018,Anne Arundel,MD,Passenger,0,1,1,449,450,0.22,Furthest
9337,June,2018,Dallas,TX,Passenger,0,1,1,191,192,0.52,Mid-Distance
9338,June,2018,Fulton,GA,Passenger,1,1,2,101,103,1.94,Furthest
9339,June,2018,Fairfax,VA,Passenger,2,2,4,831,835,0.48,Furthest
9340,June,2018,Douglas,WA,Truck,0,0,0,11947,11947,0.0,Washington
9341,June,2018,Franklin,MA,Passenger,0,1,1,1,2,50.0,Furthest
9342,June,2018,Manassas,VA,Passenger,0,1,1,9,10,10.0,Furthest
9343,June,2018,Orange,CA,Passenger,4,1,5,556,561,0.89,Nearest
9344,June,2018,Kitsap,WA,Truck,1,0,1,53204,53205,0.0,Washington
9345,June,2018,Canyon,ID,Passenger,0,1,1,91,92,1.09,Nearest
9346,June,2018,Monroe,IL,Passenger,1,0,1,5,6,16.67,Mid-Distance
9347,June,2018,Queens,NY,Passenger,1,0,1,61,62,1.61,Furthest
9348,June,2018,Kootenai,ID,Passenger,0,1,1,219,220,0.45,Nearest
9349,June,2018,Thurston,WA,Truck,0,0,0,54326,54326,0.0,Washington
9350,June,2018,Richmond,GA,Passenger,0,1,1,90,91,1.1,Furthest
9351,June,2018,San Francisco,CA,Passenger,1,1,2,129,131,1.53,Nearest
9352,June,2018,Klamath,OR,Passenger,1,0,1,35,36,2.78,Nearest
9353,June,2018,Washtenaw,MI,Passenger,1,0,1,38,39,2.56,Furthest
9354,June,2018,Caddo,LA,Passenger,0,1,1,23,24,4.17,Mid-Distance
9355,June,2018,Stevens,WA,Truck,0,0,0,18609,18609,0.0,Washington
9356,June,2018,Okanogan,WA,Passenger,9,19,28,25958,25986,0.11,Washington
9357,June,2018,Gwinnett,GA,Passenger,0,1,1,81,82,1.22,Furthest
9358,June,2018,Carroll,NH,Passenger,0,1,1,1,2,50.0,Furthest
9359,June,2018,Mason,WA,Truck,0,0,0,19955,19955,0.0,Washington
9360,June,2018,Tulsa,OK,Passenger,0,1,1,48,49,2.04,Mid-Distance
9361,June,2018,Ramsey,MN,Passenger,1,0,1,39,40,2.5,Mid-Distance
9362,June,2018,Kittitas,WA,Truck,0,0,0,14056,14056,0.0,Washington
9363,June,2018,Norfolk,VA,Passenger,2,2,4,329,333,1.2,Furthest
9364,June,2018,Garfield,OK,Passenger,1,0,1,17,18,5.56,Mid-Distance
9365,June,2018,Lane,OR,Passenger,0,1,1,184,185,0.54,Nearest
9366,June,2018,Prince William,VA,Passenger,0,4,4,263,267,1.5,Furthest
9367,June,2018,St. Mary's,MD,Passenger,1,0,1,216,217,0.46,Furthest
9368,June,2018,Skagit,WA,Passenger,206,166,372,90487,90859,0.41,Washington
9369,June,2018,San Diego,CA,Passenger,7,1,8,2582,2590,0.31,Nearest
9370,June,2018,El Paso,TX,Passenger,1,0,1,518,519,0.19,Mid-Distance
9371,June,2018,Madison,ID,Passenger,1,0,1,39,40,2.5,Nearest
9372,June,2018,Ferry,WA,Truck,0,0,0,3512,3512,0.0,Washington
9373,June,2018,Chelan,WA,Passenger,110,53,163,53555,53718,0.3,Washington
9374,June,2018,Mason,WA,Passenger,82,92,174,45712,45886,0.38,Washington
9375,June,2018,Okanogan,WA,Truck,0,0,0,16431,16431,0.0,Washington
9376,June,2018,Clay,FL,Passenger,0,1,1,94,95,1.05,Furthest
9377,June,2018,Grays Harbor,WA,Truck,0,0,0,20226,20226,0.0,Washington
9378,June,2018,Kittitas,WA,Passenger,47,32,79,28926,29005,0.27,Washington
9379,June,2018,Hamilton,IN,Passenger,1,0,1,46,47,2.13,Furthest
9380,June,2018,Yakima,WA,Truck,0,0,0,58487,58487,0.0,Washington
9381,June,2018,Ada,ID,Passenger,0,2,2,322,324,0.62,Nearest
9382,June,2018,Duval,FL,Passenger,1,2,3,382,385,0.78,Furthest
9383,June,2018,Maui,HI,Passenger,1,0,1,55,56,1.79,Nearest
9384,June,2018,Hawaii,HI,Passenger,1,0,1,71,72,1.39,Nearest
9385,June,2018,Charleston,SC,Passenger,1,0,1,125,126,0.79,Furthest
9386,June,2018,Yakima,WA,Passenger,60,88,148,163780,163928,0.09,Washington
9387,June,2018,Asotin,WA,Passenger,9,6,15,12602,12617,0.12,Washington
9388,June,2018,Nassau,NY,Passenger,2,0,2,37,39,5.13,Furthest
9389,June,2018,Grant,WA,Passenger,31,45,76,63139,63215,0.12,Washington
9390,June,2018,Whatcom,WA,Passenger,631,301,932,147658,148590,0.63,Washington
9391,June,2018,Sedgwick,KS,Passenger,0,1,1,99,100,1.0,Mid-Distance
9392,June,2018,New London,CT,Passenger,0,1,1,252,253,0.4,Furthest
9393,June,2018,Pend Oreille,WA,Truck,0,0,0,5682,5682,0.0,Washington
9394,June,2018,Montgomery,PA,Passenger,2,0,2,34,36,5.56,Furthest
9395,June,2018,Kitsap,WA,Passenger,796,460,1256,178527,179783,0.7,Washington
9396,June,2018,Charles,MD,Passenger,0,1,1,82,83,1.2,Furthest
9397,June,2018,Whitman,WA,Passenger,19,28,47,22602,22649,0.21,Washington
9398,June,2018,St. Lucie,FL,Passenger,1,0,1,28,29,3.45,Furthest
9399,June,2018,Pend Oreille,WA,Passenger,5,5,10,9547,9557,0.1,Washington
9400,June,2018,Arlington,VA,Passenger,1,2,3,172,175,1.71,Furthest
9401,June,2018,Northampton,PA,Passenger,0,1,1,66,67,1.49,Furthest
9402,June,2018,Riverside,CA,Passenger,2,2,4,699,703,0.57,Nearest
9403,June,2018,Frederick,MD,Passenger,0,1,1,85,86,1.16,Furthest
9404,June,2018,Shelby,TN,Passenger,0,1,1,102,103,0.97,Furthest
9405,June,2018,San Mateo,CA,Passenger,1,1,2,131,133,1.5,Nearest
9406,June,2018,Juneau,AK,Passenger,0,1,1,47,48,2.08,Nearest
9407,June,2018,Morris,NJ,Passenger,1,0,1,18,19,5.26,Furthest
9408,June,2018,Columbia,WA,Truck,0,0,0,1527,1527,0.0,Washington
9409,June,2018,Marin,CA,Passenger,1,0,1,55,56,1.79,Nearest
9410,June,2018,San Juan,WA,Passenger,145,61,206,14069,14275,1.44,Washington
9411,June,2018,Nueces,TX,Passenger,1,1,2,89,91,2.2,Mid-Distance
9412,June,2018,Collin,TX,Passenger,1,0,1,153,154,0.65,Mid-Distance
9413,June,2018,Lincoln,WA,Passenger,2,6,8,7685,7693,0.1,Washington
9415,June,2018,Deschutes,OR,Passenger,1,0,1,168,169,0.59,Nearest
9416,June,2018,Monterey,CA,Passenger,0,1,1,185,186,0.54,Nearest
9417,June,2018,Benton,WA,Truck,0,0,0,41024,41024,0.0,Washington
9418,June,2018,Marion,IN,Passenger,1,0,1,117,118,0.85,Furthest
9419,June,2018,Klickitat,WA,Passenger,25,30,55,15166,15221,0.36,Washington
9420,June,2018,Prince George,VA,Passenger,0,1,1,74,75,1.33,Furthest
9421,June,2018,Chelan,WA,Truck,0,0,0,21872,21872,0.0,Washington
9422,June,2018,Virginia Beach,VA,Passenger,2,1,3,689,692,0.43,Furthest
9423,June,2018,Okaloosa,FL,Passenger,1,0,1,171,172,0.58,Furthest
9424,June,2018,Essex,NJ,Passenger,1,0,1,11,12,8.33,Furthest
9425,June,2018,Pinal,AZ,Passenger,2,0,2,204,206,0.97,Nearest
9426,June,2018,Cowlitz,WA,Passenger,55,74,129,71731,71860,0.18,Washington
9427,June,2018,Adams,WA,Truck,0,0,0,5165,5165,0.0,Washington
9428,June,2018,Portsmouth,VA,Passenger,0,1,1,73,74,1.35,Furthest
9429,June,2018,Kent,MI,Passenger,0,1,1,27,28,3.57,Furthest
9430,June,2018,Orleans,LA,Passenger,0,1,1,47,48,2.08,Mid-Distance
9431,June,2018,Howard,MD,Passenger,0,1,1,88,89,1.12,Furthest
9432,June,2018,Santa Fe,NM,Passenger,0,1,1,43,44,2.27,Mid-Distance
9433,June,2018,Benton,WA,Passenger,192,199,391,131476,131867,0.3,Washington
9434,June,2018,Skamania,WA,Truck,0,0,0,3946,3946,0.0,Washington
9435,June,2018,Montgomery,MD,Passenger,1,0,1,284,285,0.35,Furthest
9436,June,2018,Montgomery,TX,Passenger,1,0,1,63,64,1.56,Mid-Distance
9437,June,2018,Brevard,FL,Passenger,0,1,1,94,95,1.05,Furthest
9438,June,2018,St. Clair,IL,Passenger,0,1,1,153,154,0.65,Mid-Distance
9439,June,2018,King,WA,Truck,7,1,8,183054,183062,0.0,Washington
9440,June,2018,Klickitat,WA,Truck,0,0,0,8117,8117,0.0,Washington
9441,June,2018,Grays Harbor,WA,Passenger,52,58,110,46575,46685,0.24,Washington
9442,June,2018,Walla Walla,WA,Truck,0,0,0,13416,13416,0.0,Washington
9443,June,2018,Pacific,WA,Truck,0,0,0,7600,7600,0.0,Washington
9444,June,2018,Polk,FL,Passenger,1,0,1,66,67,1.49,Furthest
9445,June,2018,Wahkiakum,WA,Truck,0,0,0,1675,1675,0.0,Washington
9446,June,2018,Clackamas,OR,Passenger,0,1,1,226,227,0.44,Nearest
9447,June,2018,Jefferson,CO,Passenger,0,1,1,65,66,1.52,Mid-Distance
9448,June,2018,Sumter,FL,Passenger,0,1,1,9,10,10.0,Furthest
9449,June,2018,Travis,TX,Passenger,0,1,1,187,188,0.53,Mid-Distance
9450,June,2018,San Juan,WA,Truck,0,0,0,5713,5713,0.0,Washington
9451,June,2018,Franklin,WA,Passenger,39,66,105,57858,57963,0.18,Washington
9452,June,2018,Clark,WA,Truck,0,0,0,79122,79122,0.0,Washington
9453,June,2018,Whitman,WA,Truck,0,0,0,8493,8493,0.0,Washington
9454,June,2018,El Paso,CO,Passenger,2,1,3,752,755,0.4,Mid-Distance
9455,June,2018,Cowlitz,WA,Truck,0,0,0,28460,28460,0.0,Washington
9456,June,2018,Asotin,WA,Truck,0,0,0,6616,6616,0.0,Washington
9457,June,2018,Cochise,AZ,Passenger,0,1,1,122,123,0.81,Nearest
9458,June,2018,Walla Walla,WA,Passenger,34,43,77,35660,35737,0.22,Washington
9459,June,2018,Douglas,WA,Passenger,43,31,74,27649,27723,0.27,Washington
9460,June,2018,Cape May,NJ,Passenger,0,1,1,21,22,4.55,Furthest
9461,June,2018,Washoe,NV,Passenger,1,0,1,118,119,0.84,Nearest
9462,June,2018,Island,WA,Truck,0,0,0,20955,20955,0.0,Washington
9463,June,2018,Skamania,WA,Passenger,11,9,20,8660,8680,0.23,Washington
9464,June,2018,Latah,ID,Passenger,0,1,1,74,75,1.33,Nearest
9465,June,2018,Jefferson,WA,Passenger,144,97,241,24453,24694,0.98,Washington
9466,June,2018,Grant,WA,Truck,0,0,0,25921,25921,0.0,Washington
9467,June,2018,DuPage,IL,Passenger,1,0,1,62,63,1.59,Mid-Distance
9468,June,2018,Lee,FL,Passenger,1,0,1,56,57,1.75,Furthest
9469,June,2018,Utah,UT,Passenger,0,1,1,132,133,0.75,Nearest
9470,June,2018,Spokane,WA,Truck,1,0,1,92636,92637,0.0,Washington
9471,June,2018,Clallam,WA,Passenger,124,112,236,49911,50147,0.47,Washington
9472,June,2018,Sangamon,IL,Passenger,1,0,1,11,12,8.33,Mid-Distance
9473,June,2018,Snohomish,WA,Passenger,2349,1262,3611,521519,525130,0.69,Washington
9474,June,2018,Washington,OR,Passenger,0,1,1,480,481,0.21,Nearest
9475,June,2018,Honolulu,HI,Passenger,1,2,3,523,526,0.57,Nearest
9476,June,2018,Palm Beach,FL,Passenger,0,1,1,83,84,1.19,Furthest
9477,June,2018,Prince George's,MD,Passenger,1,1,2,184,186,1.08,Furthest
9478,June,2018,Ventura,CA,Passenger,0,2,2,321,323,0.62,Nearest
9479,June,2018,Twin Falls,ID,Passenger,0,1,1,22,23,4.35,Nearest
9480,June,2018,Thurston,WA,Passenger,572,481,1053,193030,194083,0.54,Washington
9481,June,2018,Williamson,TX,Passenger,0,1,1,161,162,0.62,Mid-Distance
9482,June,2018,Jefferson,NY,Passenger,0,1,1,223,224,0.45,Furthest
9483,June,2018,Whatcom,WA,Truck,2,0,2,42285,42287,0.0,Washington
9484,June,2019,Santa Clara,CA,Passenger,5,2,7,364,371,1.89,Nearest
9485,June,2019,Brevard,FL,Passenger,0,1,1,85,86,1.16,Furthest
9486,June,2019,Polk,FL,Passenger,1,0,1,68,69,1.45,Furthest
9487,June,2019,Santa Fe,NM,Passenger,0,1,1,39,40,2.5,Mid-Distance
9488,June,2019,Clark,NV,Passenger,3,2,5,690,695,0.72,Nearest
9489,June,2019,Franklin,WA,Passenger,52,70,122,59912,60034,0.2,Washington
9490,June,2019,Williamson,TX,Passenger,0,1,1,142,143,0.7,Mid-Distance
9491,June,2019,Norfolk,MA,Passenger,1,0,1,37,38,2.63,Furthest
9492,June,2019,Dallas,TX,Passenger,1,0,1,202,203,0.49,Mid-Distance
9493,June,2019,Mason,WA,Passenger,124,122,246,47188,47434,0.52,Washington
9494,June,2019,Marion,OR,Passenger,1,0,1,117,118,0.85,Nearest
9495,June,2019,Santa Cruz,CA,Passenger,1,0,1,41,42,2.38,Nearest
9496,June,2019,Chelan,WA,Truck,0,0,0,22281,22281,0.0,Washington
9497,June,2019,Ramsey,MN,Passenger,1,0,1,43,44,2.27,Mid-Distance
9498,June,2019,Alexandria,VA,Passenger,1,0,1,147,148,0.68,Furthest
9499,June,2019,Montgomery,MD,Passenger,1,0,1,277,278,0.36,Furthest
9500,June,2019,Saratoga,NY,Passenger,1,0,1,54,55,1.82,Furthest
9501,June,2019,Montgomery,AL,Passenger,0,1,1,43,44,2.27,Furthest
9502,June,2019,Stevens,WA,Passenger,19,31,50,31694,31744,0.16,Washington
9503,June,2019,Washtenaw,MI,Passenger,1,0,1,40,41,2.44,Furthest
9504,June,2019,Douglas,WA,Truck,0,0,0,12182,12182,0.0,Washington
9505,June,2019,Deschutes,OR,Passenger,2,0,2,156,158,1.27,Nearest
9506,June,2019,Solano,CA,Passenger,1,0,1,211,212,0.47,Nearest
9507,June,2019,Kootenai,ID,Passenger,1,1,2,220,222,0.9,Nearest
9508,June,2019,Collin,TX,Passenger,1,1,2,129,131,1.53,Mid-Distance
9509,June,2019,Skagit,WA,Truck,1,0,1,32442,32443,0.0,Washington
9510,June,2019,Contra Costa,CA,Passenger,2,2,4,386,390,1.03,Nearest
9511,June,2019,Tarrant,TX,Passenger,2,0,2,202,204,0.98,Mid-Distance
9512,June,2019,Portsmouth,VA,Passenger,0,1,1,75,76,1.32,Furthest
9513,June,2019,San Mateo,CA,Passenger,2,1,3,115,118,2.54,Nearest
9514,June,2019,District of Columbia,DC,Passenger,1,1,2,205,207,0.97,Furthest
9515,June,2019,Klamath,OR,Passenger,1,0,1,38,39,2.56,Nearest
9516,June,2019,Chelan,WA,Passenger,157,68,225,54354,54579,0.41,Washington
9517,June,2019,Skamania,WA,Truck,0,0,0,4062,4062,0.0,Washington
9518,June,2019,Clark,WA,Truck,0,0,0,80332,80332,0.0,Washington
9519,June,2019,Benton,WA,Passenger,259,279,538,133796,134334,0.4,Washington
9520,June,2019,Ferry,WA,Passenger,5,2,7,4388,4395,0.16,Washington
9521,June,2019,Prince George's,MD,Passenger,1,1,2,179,181,1.1,Furthest
9522,June,2019,Kent,MI,Passenger,0,1,1,21,22,4.55,Furthest
9523,June,2019,Kittitas,WA,Truck,0,0,0,14422,14422,0.0,Washington
9524,June,2019,Pend Oreille,WA,Truck,0,0,0,5732,5732,0.0,Washington
9525,June,2019,Guadalupe,TX,Passenger,1,0,1,73,74,1.35,Mid-Distance
9526,June,2019,Charles,MD,Passenger,0,1,1,87,88,1.14,Furthest
9527,June,2019,Palm Beach,FL,Passenger,0,1,1,85,86,1.16,Furthest
9528,June,2019,Douglas,NE,Passenger,0,1,1,62,63,1.59,Mid-Distance
9529,June,2019,Maui,HI,Passenger,1,0,1,45,46,2.17,Nearest
9530,June,2019,Spokane,WA,Passenger,539,433,972,311797,312769,0.31,Washington
9531,June,2019,DeKalb,IN,Passenger,1,0,1,1,2,50.0,Furthest
9532,June,2019,Putnam,TN,Passenger,0,1,1,3,4,25.0,Furthest
9533,June,2019,Adams,WA,Passenger,5,6,11,12757,12768,0.09,Washington
9534,June,2019,King,WA,Passenger,19080,7013,26093,1389199,1415292,1.84,Washington
9535,June,2019,Adams,WA,Truck,0,0,0,5128,5128,0.0,Washington
9536,June,2019,Klickitat,WA,Truck,0,0,0,8251,8251,0.0,Washington
9537,June,2019,San Diego,CA,Passenger,10,3,13,2686,2699,0.48,Nearest
9539,June,2019,Shasta,CA,Passenger,1,0,1,42,43,2.33,Nearest
9540,June,2019,Wahkiakum,WA,Passenger,2,2,4,3009,3013,0.13,Washington
9541,June,2019,Okanogan,WA,Passenger,22,25,47,26076,26123,0.18,Washington
9542,June,2019,Multnomah,OR,Passenger,5,5,10,736,746,1.34,Nearest
9543,June,2019,Kitsap,WA,Truck,1,0,1,54095,54096,0.0,Washington
9544,June,2019,Riverside,CA,Passenger,2,2,4,655,659,0.61,Nearest
9545,June,2019,Oklahoma,OK,Passenger,0,1,1,124,125,0.8,Mid-Distance
9546,June,2019,Cascade,MT,Passenger,0,1,1,61,62,1.61,Nearest
9547,June,2019,Garfield,WA,Truck,0,0,0,964,964,0.0,Washington
9548,June,2019,Ventura,CA,Passenger,0,2,2,314,316,0.63,Nearest
9549,June,2019,San Joaquin,CA,Passenger,1,0,1,126,127,0.79,Nearest
9550,June,2019,Klickitat,WA,Passenger,35,32,67,15557,15624,0.43,Washington
9551,June,2019,Anne Arundel,MD,Passenger,1,2,3,440,443,0.68,Furthest
9552,June,2019,Fresno,CA,Passenger,1,0,1,190,191,0.52,Nearest
9553,June,2019,Hennepin,MN,Passenger,2,1,3,102,105,2.86,Mid-Distance
9554,June,2019,Skamania,WA,Passenger,23,18,41,8725,8766,0.47,Washington
9555,June,2019,DeKalb,GA,Passenger,1,0,1,79,80,1.25,Furthest
9556,June,2019,Randolph,NC,Passenger,1,0,1,6,7,14.29,Furthest
9557,June,2019,Asotin,WA,Truck,0,0,0,6667,6667,0.0,Washington
9558,June,2019,Rogers,OK,Passenger,1,0,1,5,6,16.67,Mid-Distance
9559,June,2019,Wahkiakum,WA,Truck,0,0,0,1755,1755,0.0,Washington
9560,June,2019,Island,WA,Passenger,317,240,557,63386,63943,0.87,Washington
9561,June,2019,Lewis,WA,Truck,0,0,0,25951,25951,0.0,Washington
9562,June,2019,Columbia,WA,Truck,0,0,0,1532,1532,0.0,Washington
9563,June,2019,Loudoun,VA,Passenger,1,0,1,96,97,1.03,Furthest
9564,June,2019,Lewis,WA,Passenger,99,92,191,59123,59314,0.32,Washington
9565,June,2019,Sarasota,FL,Passenger,1,0,1,24,25,4.0,Furthest
9566,June,2019,Shelby,OH,Passenger,0,1,1,1,2,50.0,Furthest
9567,June,2019,Carroll,NH,Passenger,0,1,1,3,4,25.0,Furthest
9568,June,2019,Spokane,WA,Truck,1,0,1,94860,94861,0.0,Washington
9569,June,2019,Broward,FL,Passenger,2,1,3,125,128,2.34,Furthest
9570,June,2019,Placer,CA,Passenger,1,0,1,103,104,0.96,Nearest
9571,June,2019,Carson City,NV,Passenger,1,0,1,11,12,8.33,Nearest
9572,June,2019,Lincoln,WA,Truck,0,0,0,4676,4676,0.0,Washington
9573,June,2019,Pend Oreille,WA,Passenger,4,5,9,9531,9540,0.09,Washington
9574,June,2019,Norfolk,VA,Passenger,2,1,3,348,351,0.85,Furthest
9575,June,2019,Nantucket,MA,Passenger,1,0,1,2,3,33.33,Furthest
9576,June,2019,Arlington,VA,Passenger,0,2,2,158,160,1.25,Furthest
9577,June,2019,Thurston,WA,Passenger,875,639,1514,197699,199213,0.76,Washington
9578,June,2019,Pierce,WA,Truck,0,0,0,139794,139794,0.0,Washington
9579,June,2019,Stevens,WA,Truck,0,0,0,18659,18659,0.0,Washington
9580,June,2019,Howard,MD,Passenger,0,1,1,75,76,1.32,Furthest
9581,June,2019,Mason,WA,Truck,0,0,0,20361,20361,0.0,Washington
9582,June,2019,St. Mary's,MD,Passenger,1,0,1,212,213,0.47,Furthest
9583,June,2019,Prince William,VA,Passenger,1,3,4,249,253,1.58,Furthest
9584,June,2019,Wayne,MI,Passenger,0,1,1,66,67,1.49,Furthest
9585,June,2019,Thurston,WA,Truck,0,0,0,55124,55124,0.0,Washington
9586,June,2019,Bexar,TX,Passenger,3,5,8,664,672,1.19,Mid-Distance
9587,June,2019,Allegheny,PA,Passenger,1,0,1,78,79,1.27,Furthest
9588,June,2019,New London,CT,Passenger,0,2,2,239,241,0.83,Furthest
9589,June,2019,Tuolumne,CA,Passenger,0,1,1,12,13,7.69,Nearest
9590,June,2019,Asotin,WA,Passenger,12,8,20,12641,12661,0.16,Washington
9591,June,2019,Monroe,IL,Passenger,1,0,1,5,6,16.67,Mid-Distance
9592,June,2019,Cook,IL,Passenger,1,0,1,241,242,0.41,Mid-Distance
9593,June,2019,Travis,TX,Passenger,2,1,3,197,200,1.5,Mid-Distance
9594,June,2019,Garfield,WA,Passenger,1,1,2,1298,1300,0.15,Washington
9595,June,2019,Whatcom,WA,Passenger,853,428,1281,150709,151990,0.84,Washington
9596,June,2019,RÃ­o Grande,PR,Passenger,1,0,1,1,2,50.0,Mid-Distance
9597,June,2019,Ferry,WA,Truck,0,0,0,3570,3570,0.0,Washington
9598,June,2019,New Haven,CT,Passenger,0,2,2,48,50,4.0,Furthest
9599,June,2019,Penobscot,ME,Passenger,0,1,1,12,13,7.69,Furthest
9600,June,2019,Pacific,WA,Passenger,25,29,54,15975,16029,0.34,Washington
9601,June,2019,Pinellas,FL,Passenger,1,0,1,113,114,0.88,Furthest
9602,June,2019,Fairfax,VA,Passenger,3,2,5,772,777,0.64,Furthest
9603,June,2019,Moore,NC,Passenger,0,1,1,186,187,0.53,Furthest
9604,June,2019,Cape May,NJ,Passenger,0,1,1,15,16,6.25,Furthest
9605,June,2019,Grays Harbor,WA,Truck,0,0,0,20455,20455,0.0,Washington
9606,June,2019,Sedgwick,KS,Passenger,1,1,2,102,104,1.92,Mid-Distance
9607,June,2019,Harnett,NC,Passenger,1,1,2,217,219,0.91,Furthest
9608,June,2019,Kern,CA,Passenger,0,1,1,222,223,0.45,Nearest
9609,June,2019,Camden,NJ,Passenger,0,1,1,24,25,4.0,Furthest
9610,June,2019,Maricopa,AZ,Passenger,6,3,9,1526,1535,0.59,Nearest
9611,June,2019,Charleston,SC,Passenger,1,0,1,115,116,0.86,Furthest
9612,June,2019,Orange,CA,Passenger,6,1,7,528,535,1.31,Nearest
9613,June,2019,Bergen,NJ,Passenger,1,0,1,27,28,3.57,Furthest
9614,June,2019,Whitman,WA,Passenger,31,46,77,22712,22789,0.34,Washington
9615,June,2019,Washoe,NV,Passenger,2,0,2,114,116,1.72,Nearest
9616,June,2019,Los Angeles,CA,Passenger,8,5,13,1099,1112,1.17,Nearest
9617,June,2019,Grays Harbor,WA,Passenger,73,85,158,47923,48081,0.33,Washington
9618,June,2019,Jefferson,CO,Passenger,0,2,2,57,59,3.39,Mid-Distance
9619,June,2019,Clark,WA,Passenger,1538,926,2464,313856,316320,0.78,Washington
9620,June,2019,Clallam,WA,Passenger,173,141,314,50501,50815,0.62,Washington
9621,June,2019,Mecklenburg,NC,Passenger,1,0,1,86,87,1.15,Furthest
9622,June,2019,Denver,CO,Passenger,1,0,1,133,134,0.75,Mid-Distance
9623,June,2019,Grant,WA,Truck,0,0,0,26631,26631,0.0,Washington
9624,June,2019,Houston,GA,Passenger,1,0,1,54,55,1.82,Furthest
9625,June,2019,Pinal,AZ,Passenger,2,0,2,195,197,1.02,Nearest
9626,June,2019,Clallam,WA,Truck,1,0,1,21740,21741,0.0,Washington
9627,June,2019,San Juan,WA,Truck,0,0,0,5866,5866,0.0,Washington
9628,June,2019,Okanogan,WA,Truck,0,0,0,16482,16482,0.0,Washington
9629,June,2019,Wilson,TX,Passenger,0,1,1,6,7,14.29,Mid-Distance
9630,June,2019,Jefferson,WA,Passenger,197,119,316,24995,25311,1.25,Washington
9631,June,2019,Middlesex,MA,Passenger,1,1,2,117,119,1.68,Furthest
9632,June,2019,Nueces,TX,Passenger,1,1,2,99,101,1.98,Mid-Distance
9633,June,2019,Calvert,MD,Passenger,0,2,2,87,89,2.25,Furthest
9634,June,2019,Whatcom,WA,Truck,2,0,2,42910,42912,0.0,Washington
9635,June,2019,Lake,FL,Passenger,1,0,1,19,20,5.0,Furthest
9636,June,2019,Cowlitz,WA,Truck,0,0,0,28865,28865,0.0,Washington
9637,June,2019,Goochland,VA,Passenger,1,1,2,257,259,0.77,Furthest
9638,June,2019,Pacific,WA,Truck,0,0,0,7654,7654,0.0,Washington
9639,June,2019,Suffolk,MA,Passenger,0,1,1,39,40,2.5,Furthest
9640,June,2019,Yakima,WA,Passenger,105,104,209,165147,165356,0.13,Washington
9641,June,2019,Twin Falls,ID,Passenger,0,1,1,23,24,4.17,Nearest
9642,June,2019,Richland,SC,Passenger,0,1,1,160,161,0.62,Furthest
9643,June,2019,Sumter,FL,Passenger,0,1,1,10,11,9.09,Furthest
9644,June,2019,Jefferson,NY,Passenger,0,2,2,214,216,0.93,Furthest
9645,June,2019,Skagit,WA,Passenger,298,200,498,91940,92438,0.54,Washington
9646,June,2019,Nassau,NY,Passenger,4,0,4,38,42,9.52,Furthest
9647,June,2019,Vigo,IN,Passenger,1,0,1,6,7,14.29,Furthest
9648,June,2019,Pierce,WA,Passenger,1808,1556,3364,543069,546433,0.62,Washington
9649,June,2019,Harris,TX,Passenger,1,1,2,246,248,0.81,Mid-Distance
9650,June,2019,Ada,ID,Passenger,0,2,2,307,309,0.65,Nearest
9651,June,2019,San Juan,WA,Passenger,212,72,284,14409,14693,1.93,Washington
9652,June,2019,Snohomish,WA,Passenger,3473,1593,5066,531506,536572,0.94,Washington
9653,June,2019,Alameda,CA,Passenger,4,2,6,306,312,1.92,Nearest
9654,June,2019,Valencia,NM,Passenger,1,0,1,7,8,12.5,Mid-Distance
9655,June,2019,Bucks,PA,Passenger,1,0,1,19,20,5.0,Furthest
9656,June,2019,Fulton,GA,Passenger,1,2,3,105,108,2.78,Furthest
9657,June,2019,Kitsap,WA,Passenger,1050,605,1655,180817,182472,0.91,Washington
9658,June,2019,Cochise,AZ,Passenger,0,1,1,114,115,0.87,Nearest
9659,June,2019,Honolulu,HI,Passenger,3,3,6,501,507,1.18,Nearest
9660,June,2019,Montgomery,PA,Passenger,2,0,2,37,39,5.13,Furthest
9661,June,2019,Sangamon,IL,Passenger,1,0,1,6,7,14.29,Mid-Distance
9662,June,2019,Cumberland,NC,Passenger,0,2,2,503,505,0.4,Furthest
9663,June,2019,Larimer,CO,Passenger,1,0,1,58,59,1.69,Mid-Distance
9664,June,2019,Volusia,FL,Passenger,0,1,1,38,39,2.56,Furthest
9665,June,2019,Dale,AL,Passenger,0,1,1,59,60,1.67,Furthest
9666,June,2019,Franklin,MA,Passenger,0,1,1,1,2,50.0,Furthest
9667,June,2019,Yakima,WA,Truck,0,0,0,59138,59138,0.0,Washington
9668,June,2019,Lee,FL,Passenger,1,0,1,52,53,1.89,Furthest
9669,June,2019,Walla Walla,WA,Passenger,49,61,110,36186,36296,0.3,Washington
9670,June,2019,Pima,AZ,Passenger,0,1,1,393,394,0.25,Nearest
9671,June,2019,Jefferson,WA,Truck,0,0,0,9667,9667,0.0,Washington
9672,June,2019,Saginaw,MI,Passenger,1,0,1,11,12,8.33,Furthest
9673,June,2019,Manassas,VA,Passenger,0,1,1,9,10,10.0,Furthest
9674,June,2019,Clackamas,OR,Passenger,1,1,2,212,214,0.93,Nearest
9675,June,2019,Shelby,TN,Passenger,0,1,1,92,93,1.08,Furthest
9676,June,2019,El Paso,TX,Passenger,3,0,3,481,484,0.62,Mid-Distance
9677,June,2019,Island,WA,Truck,0,0,0,21261,21261,0.0,Washington
9678,June,2019,Santa Rosa,FL,Passenger,1,0,1,88,89,1.12,Furthest
9679,June,2019,Columbia,WA,Passenger,2,2,4,2450,2454,0.16,Washington
9680,June,2019,Virginia Beach,VA,Passenger,1,0,1,713,714,0.14,Furthest
9681,June,2019,San Francisco,CA,Passenger,2,1,3,105,108,2.78,Nearest
9682,June,2019,Walla Walla,WA,Truck,0,0,0,13593,13593,0.0,Washington
9683,June,2019,King,WA,Truck,5,1,6,182076,182082,0.0,Washington
9684,June,2019,Kittitas,WA,Passenger,81,38,119,29608,29727,0.4,Washington
9685,June,2019,Owyhee,ID,Passenger,1,0,1,5,6,16.67,Nearest
9686,June,2019,Frederick,MD,Passenger,1,1,2,79,81,2.47,Furthest
9687,June,2019,Manatee,FL,Passenger,1,0,1,32,33,3.03,Furthest
9688,June,2019,Lincoln,WA,Passenger,2,8,10,7776,7786,0.13,Washington
9689,June,2019,Spartanburg,SC,Passenger,0,1,1,36,37,2.7,Furthest
9690,June,2019,Flathead,MT,Passenger,1,0,1,62,63,1.59,Nearest
9691,June,2019,El Paso,CO,Passenger,2,1,3,731,734,0.41,Mid-Distance
9692,June,2019,St. Clair,IL,Passenger,0,1,1,163,164,0.61,Mid-Distance
9693,June,2019,Oldham,KY,Passenger,0,1,1,5,6,16.67,Furthest
9694,June,2019,Clay,FL,Passenger,0,1,1,88,89,1.12,Furthest
9695,June,2019,Benton,WA,Truck,0,0,0,41914,41914,0.0,Washington
9696,June,2019,Richmond,GA,Passenger,0,1,1,93,94,1.06,Furthest
9697,June,2019,DuPage,IL,Passenger,2,0,2,61,63,3.17,Mid-Distance
9698,June,2019,Whitman,WA,Truck,0,0,0,8584,8584,0.0,Washington
9699,June,2019,Cowlitz,WA,Passenger,98,108,206,73013,73219,0.28,Washington
9700,June,2019,Albemarle,VA,Passenger,1,0,1,23,24,4.17,Furthest
9701,June,2019,Franklin,WA,Truck,0,0,0,19271,19271,0.0,Washington
9702,June,2019,Dakota,MN,Passenger,0,1,1,37,38,2.63,Mid-Distance
9703,June,2019,Juneau,AK,Passenger,0,2,2,30,32,6.25,Nearest
9704,June,2019,Grant,WA,Passenger,41,61,102,64706,64808,0.16,Washington
9705,June,2019,Duval,FL,Passenger,1,2,3,373,376,0.8,Furthest
9706,June,2019,Caddo,LA,Passenger,0,1,1,22,23,4.35,Mid-Distance
9707,June,2019,Snohomish,WA,Truck,0,0,0,122375,122375,0.0,Washington
9708,June,2019,Montgomery,TX,Passenger,2,0,2,60,62,3.23,Mid-Distance
9709,June,2019,Tulsa,OK,Passenger,1,1,2,46,48,4.17,Mid-Distance
9710,June,2019,Douglas,WA,Passenger,57,37,94,28032,28126,0.33,Washington
9711,June,2019,Berkshire,MA,Passenger,0,1,1,4,5,20.0,Furthest
9712,June,2019,Hawaii,HI,Passenger,1,0,1,57,58,1.72,Nearest
9713,June,2020,Pacific,WA,Passenger,33,33,66,15754,15820,0.42,Washington
9714,June,2020,Wahkiakum,WA,Truck,0,0,0,1737,1737,0.0,Washington
9715,June,2020,Utah,UT,Passenger,0,1,1,129,130,0.77,Nearest
9716,June,2020,Hennepin,MN,Passenger,3,0,3,85,88,3.41,Mid-Distance
9717,June,2020,Franklin,WA,Passenger,60,76,136,60644,60780,0.22,Washington
9718,June,2020,King,WA,Passenger,24109,7712,31821,1371025,1402846,2.27,Washington
9719,June,2020,Island,WA,Truck,1,0,1,21212,21213,0.0,Washington
9720,June,2020,Chesapeake,VA,Passenger,0,2,2,417,419,0.48,Furthest
9721,June,2020,Monroe,IL,Passenger,1,0,1,4,5,20.0,Mid-Distance
9722,June,2020,Allegheny,PA,Passenger,1,0,1,71,72,1.39,Furthest
9723,June,2020,Arapahoe,CO,Passenger,1,0,1,129,130,0.77,Mid-Distance
9724,June,2020,Boone,MO,Passenger,0,1,1,10,11,9.09,Furthest
9725,June,2020,Stafford,VA,Passenger,1,1,2,92,94,2.13,Furthest
9726,June,2020,Clark,WA,Truck,0,0,0,82225,82225,0.0,Washington
9727,June,2020,Shelby,TN,Passenger,0,1,1,87,88,1.14,Furthest
9728,June,2020,Hamilton,IN,Passenger,1,0,1,40,41,2.44,Furthest
9729,June,2020,New London,CT,Passenger,1,2,3,245,248,1.21,Furthest
9730,June,2020,Solano,CA,Passenger,1,0,1,209,210,0.48,Nearest
9731,June,2020,Pierce,WA,Passenger,2380,1692,4072,549665,553737,0.74,Washington
9732,June,2020,Fairfax,VA,Passenger,4,3,7,727,734,0.95,Furthest
9733,June,2020,San Joaquin,CA,Passenger,1,0,1,127,128,0.78,Nearest
9734,June,2020,San Juan,WA,Passenger,302,93,395,13968,14363,2.75,Washington
9735,June,2020,Cascade,MT,Passenger,0,1,1,53,54,1.85,Nearest
9736,June,2020,Spokane,WA,Passenger,730,487,1217,315451,316668,0.38,Washington
9737,June,2020,Williams,ND,Passenger,0,1,1,11,12,8.33,Mid-Distance
9738,June,2020,Lewis,WA,Passenger,102,111,213,58176,58389,0.36,Washington
9739,June,2020,Cumberland,NC,Passenger,0,3,3,460,463,0.65,Furthest
9740,June,2020,Cowlitz,WA,Truck,0,0,0,28868,28868,0.0,Washington
9741,June,2020,Queens,NY,Passenger,1,0,1,50,51,1.96,Furthest
9742,June,2020,Honolulu,HI,Passenger,4,2,6,441,447,1.34,Nearest
9743,June,2020,Island,WA,Passenger,420,268,688,62807,63495,1.08,Washington
9744,June,2020,Douglas,NE,Passenger,0,1,1,52,53,1.89,Mid-Distance
9745,June,2020,Montgomery,OH,Passenger,0,1,1,48,49,2.04,Furthest
9746,June,2020,Ferry,WA,Passenger,5,3,8,4330,4338,0.18,Washington
9747,June,2020,Oldham,KY,Passenger,0,1,1,4,5,20.0,Furthest
9748,June,2020,Grant,WA,Truck,0,0,0,27083,27083,0.0,Washington
9749,June,2020,Loudoun,VA,Passenger,1,0,1,85,86,1.16,Furthest
9750,June,2020,Gwinnett,GA,Passenger,1,0,1,73,74,1.35,Furthest
9751,June,2020,Washington,OR,Passenger,1,0,1,436,437,0.23,Nearest
9752,June,2020,Mason,WA,Passenger,159,135,294,47272,47566,0.62,Washington
9753,June,2020,Monterey,CA,Passenger,0,1,1,163,164,0.61,Nearest
9754,June,2020,Riverside,CA,Passenger,3,1,4,619,623,0.64,Nearest
9755,June,2020,Skamania,WA,Truck,0,0,0,4011,4011,0.0,Washington
9756,June,2020,Norfolk,VA,Passenger,2,2,4,344,348,1.15,Furthest
9757,June,2020,Bexar,TX,Passenger,3,5,8,599,607,1.32,Mid-Distance
9758,June,2020,Kitsap,WA,Truck,0,0,0,54064,54064,0.0,Washington
9759,June,2020,Cape May,NJ,Passenger,0,1,1,13,14,7.14,Furthest
9760,June,2020,Portsmouth,VA,Passenger,0,1,1,76,77,1.3,Furthest
9761,June,2020,Denver,CO,Passenger,1,0,1,116,117,0.85,Mid-Distance
9763,June,2020,Lake,IL,Passenger,1,0,1,163,164,0.61,Mid-Distance
9764,June,2020,Kittitas,WA,Passenger,99,47,146,29805,29951,0.49,Washington
9765,June,2020,Lincoln,WA,Passenger,5,12,17,7624,7641,0.22,Washington
9766,June,2020,Brevard,FL,Passenger,0,1,1,83,84,1.19,Furthest
9767,June,2020,Calvert,MD,Passenger,0,2,2,90,92,2.17,Furthest
9768,June,2020,Denton,TX,Passenger,1,0,1,87,88,1.14,Mid-Distance
9769,June,2020,Rockingham,NH,Passenger,1,0,1,23,24,4.17,Furthest
9770,June,2020,Chelan,WA,Passenger,231,78,309,54185,54494,0.57,Washington
9771,June,2020,Ulster,NY,Passenger,1,0,1,7,8,12.5,Furthest
9772,June,2020,Frederick,MD,Passenger,1,1,2,75,77,2.6,Furthest
9773,June,2020,Broward,FL,Passenger,2,1,3,109,112,2.68,Furthest
9774,June,2020,Clay,FL,Passenger,0,1,1,81,82,1.22,Furthest
9775,June,2020,Ventura,CA,Passenger,1,2,3,278,281,1.07,Nearest
9776,June,2020,Stevens,WA,Truck,0,0,0,18645,18645,0.0,Washington
9777,June,2020,Benton,WA,Truck,0,0,0,42703,42703,0.0,Washington
9778,June,2020,Collin,TX,Passenger,1,1,2,118,120,1.67,Mid-Distance
9779,June,2020,Charleston,SC,Passenger,1,0,1,103,104,0.96,Furthest
9780,June,2020,Erie,NY,Passenger,1,0,1,43,44,2.27,Furthest
9781,June,2020,King,WA,Truck,5,1,6,182171,182177,0.0,Washington
9782,June,2020,Harris,TX,Passenger,1,0,1,227,228,0.44,Mid-Distance
9783,June,2020,San Francisco,CA,Passenger,1,1,2,93,95,2.11,Nearest
9784,June,2020,Williamson,TX,Passenger,0,2,2,138,140,1.43,Mid-Distance
9785,June,2020,Dallas,TX,Passenger,1,0,1,193,194,0.52,Mid-Distance
9786,June,2020,Montgomery,TX,Passenger,1,0,1,50,51,1.96,Mid-Distance
9787,June,2020,Dakota,MN,Passenger,0,1,1,33,34,2.94,Mid-Distance
9788,June,2020,Kootenai,ID,Passenger,1,0,1,219,220,0.45,Nearest
9789,June,2020,San Diego,CA,Passenger,14,5,19,2757,2776,0.68,Nearest
9790,June,2020,Fresno,CA,Passenger,1,0,1,180,181,0.55,Nearest
9791,June,2020,Skagit,WA,Truck,1,0,1,32470,32471,0.0,Washington
9792,June,2020,Owyhee,ID,Passenger,1,0,1,3,4,25.0,Nearest
9793,June,2020,Pinal,AZ,Passenger,1,0,1,180,181,0.55,Nearest
9794,June,2020,Pend Oreille,WA,Truck,0,0,0,5760,5760,0.0,Washington
9795,June,2020,Flathead,MT,Passenger,1,0,1,59,60,1.67,Nearest
9796,June,2020,Bartow,GA,Passenger,0,1,1,4,5,20.0,Furthest
9797,June,2020,St. Clair,IL,Passenger,1,0,1,137,138,0.72,Mid-Distance
9798,June,2020,Garfield,WA,Truck,0,0,0,974,974,0.0,Washington
9799,June,2020,Carson City,NV,Passenger,1,0,1,10,11,9.09,Nearest
9800,June,2020,Columbia,WA,Passenger,4,3,7,2415,2422,0.29,Washington
9801,June,2020,Fort Bend,TX,Passenger,1,0,1,46,47,2.13,Mid-Distance
9802,June,2020,Clackamas,OR,Passenger,2,0,2,196,198,1.01,Nearest
9803,June,2020,Harnett,NC,Passenger,1,0,1,200,201,0.5,Furthest
9804,June,2020,Osceola,FL,Passenger,1,0,1,38,39,2.56,Furthest
9805,June,2020,Jones,GA,Passenger,1,0,1,1,2,50.0,Furthest
9806,June,2020,Kern,CA,Passenger,0,1,1,224,225,0.44,Nearest
9807,June,2020,Suffolk,MA,Passenger,0,2,2,35,37,5.41,Furthest
9808,June,2020,Mason,WA,Truck,0,0,0,20604,20604,0.0,Washington
9809,June,2020,Skagit,WA,Passenger,407,221,628,91153,91781,0.68,Washington
9810,June,2020,Stevens,WA,Passenger,36,33,69,30654,30723,0.22,Washington
9811,June,2020,Yakima,WA,Passenger,132,119,251,165352,165603,0.15,Washington
9812,June,2020,Anne Arundel,MD,Passenger,0,1,1,417,418,0.24,Furthest
9813,June,2020,Prince William,VA,Passenger,2,3,5,219,224,2.23,Furthest
9814,June,2020,Cowlitz,WA,Passenger,138,115,253,72319,72572,0.35,Washington
9815,June,2020,Adams,WA,Truck,0,0,0,5263,5263,0.0,Washington
9816,June,2020,Franklin,WA,Truck,0,0,0,19973,19973,0.0,Washington
9817,June,2020,Arlington,VA,Passenger,0,2,2,149,151,1.32,Furthest
9818,June,2020,Spokane,WA,Truck,1,0,1,98330,98331,0.0,Washington
9819,June,2020,Benton,WA,Passenger,359,321,680,134227,134907,0.5,Washington
9820,June,2020,Kent,MI,Passenger,0,1,1,23,24,4.17,Furthest
9821,June,2020,Asotin,WA,Truck,0,0,0,6638,6638,0.0,Washington
9822,June,2020,Duval,FL,Passenger,0,2,2,359,361,0.55,Furthest
9823,June,2020,Thurston,WA,Passenger,1143,736,1879,196906,198785,0.95,Washington
9824,June,2020,Sumter,FL,Passenger,0,1,1,9,10,10.0,Furthest
9825,June,2020,Middlesex,MA,Passenger,1,1,2,94,96,2.08,Furthest
9826,June,2020,Washoe,NV,Passenger,1,0,1,103,104,0.96,Nearest
9827,June,2020,Sacramento,CA,Passenger,1,0,1,264,265,0.38,Nearest
9828,June,2020,Santa Cruz,CA,Passenger,1,0,1,32,33,3.03,Nearest
9829,June,2020,Richland,SC,Passenger,0,1,1,154,155,0.65,Furthest
9830,June,2020,Klickitat,WA,Passenger,53,41,94,15173,15267,0.62,Washington
9831,June,2020,Fulton,GA,Passenger,1,2,3,100,103,2.91,Furthest
9832,June,2020,Clark,WA,Passenger,2014,1058,3072,317682,320754,0.96,Washington
9833,June,2020,Los Angeles,CA,Passenger,7,11,18,984,1002,1.8,Nearest
9834,June,2020,Howard,MD,Passenger,0,1,1,72,73,1.37,Furthest
9835,June,2020,Alameda,CA,Passenger,2,0,2,268,270,0.74,Nearest
9836,June,2020,Pierce,WA,Truck,0,0,0,142167,142167,0.0,Washington
9837,June,2020,Maricopa,AZ,Passenger,5,6,11,1410,1421,0.77,Nearest
9838,June,2020,Goochland,VA,Passenger,2,1,3,256,259,1.16,Furthest
9839,June,2020,Boulder,CO,Passenger,0,1,1,43,44,2.27,Mid-Distance
9840,June,2020,St. Mary's,MD,Passenger,1,0,1,219,220,0.45,Furthest
9841,June,2020,RÃ­o Grande,PR,Passenger,1,0,1,1,2,50.0,Mid-Distance
9842,June,2020,District of Columbia,DC,Passenger,2,1,3,205,208,1.44,Furthest
9843,June,2020,Valencia,NM,Passenger,1,0,1,5,6,16.67,Mid-Distance
9844,June,2020,Pend Oreille,WA,Passenger,7,6,13,9243,9256,0.14,Washington
9845,June,2020,Okanogan,WA,Truck,0,0,0,16445,16445,0.0,Washington
9846,June,2020,Jefferson,WA,Passenger,236,139,375,24797,25172,1.49,Washington
9847,June,2020,Grays Harbor,WA,Passenger,106,111,217,48145,48362,0.45,Washington
9848,June,2020,Walla Walla,WA,Truck,0,0,0,13745,13745,0.0,Washington
9849,June,2020,Albemarle,VA,Passenger,1,0,1,21,22,4.55,Furthest
9850,June,2020,Travis,TX,Passenger,2,1,3,177,180,1.67,Mid-Distance
9851,June,2020,DeKalb,GA,Passenger,1,0,1,80,81,1.23,Furthest
9852,June,2020,Alexandria,VA,Passenger,1,0,1,140,141,0.71,Furthest
9853,June,2020,Fairbanks North Star,AK,Passenger,0,1,1,96,97,1.03,Nearest
9854,June,2020,Tulsa,OK,Passenger,1,1,2,43,45,4.44,Mid-Distance
9855,June,2020,Palm Beach,FL,Passenger,0,1,1,79,80,1.25,Furthest
9856,June,2020,Moore,NC,Passenger,0,2,2,161,163,1.23,Furthest
9857,June,2020,Thurston,WA,Truck,0,0,0,55742,55742,0.0,Washington
9858,June,2020,Montgomery,PA,Passenger,1,0,1,30,31,3.23,Furthest
9859,June,2020,Lake,FL,Passenger,1,0,1,22,23,4.35,Furthest
9860,June,2020,Jefferson,WA,Truck,0,0,0,9533,9533,0.0,Washington
9861,June,2020,Sedgwick,KS,Passenger,1,1,2,92,94,2.13,Mid-Distance
9862,June,2020,El Paso,CO,Passenger,2,0,2,715,717,0.28,Mid-Distance
9863,June,2020,San Mateo,CA,Passenger,0,1,1,110,111,0.9,Nearest
9864,June,2020,Whatcom,WA,Truck,3,0,3,43006,43009,0.01,Washington
9865,June,2020,Vigo,IN,Passenger,1,0,1,5,6,16.67,Furthest
9866,June,2020,Jefferson,NY,Passenger,0,1,1,210,211,0.47,Furthest
9867,June,2020,Greene,MO,Passenger,0,1,1,32,33,3.03,Furthest
9868,June,2020,Pacific,WA,Truck,0,0,0,7699,7699,0.0,Washington
9869,June,2020,Camden,NJ,Passenger,0,1,1,21,22,4.55,Furthest
9870,June,2020,Bucks,PA,Passenger,1,0,1,19,20,5.0,Furthest
9871,June,2020,Powhatan,VA,Passenger,1,0,1,0,1,100.0,Furthest
9872,June,2020,Whatcom,WA,Passenger,1064,498,1562,149248,150810,1.04,Washington
9873,June,2020,Shelby,OH,Passenger,0,1,1,1,2,50.0,Furthest
9874,June,2020,Multnomah,OR,Passenger,4,7,11,709,720,1.53,Nearest
9875,June,2020,Asotin,WA,Passenger,16,12,28,12321,12349,0.23,Washington
9876,June,2020,New Haven,CT,Passenger,0,2,2,38,40,5.0,Furthest
9877,June,2020,Sarasota,FL,Passenger,2,0,2,25,27,7.41,Furthest
9878,June,2020,DeKalb,IN,Passenger,1,0,1,1,2,50.0,Furthest
9879,June,2020,Whitman,WA,Passenger,44,48,92,22140,22232,0.41,Washington
9880,June,2020,Ramsey,MN,Passenger,1,0,1,39,40,2.5,Mid-Distance
9881,June,2020,Santa Clara,CA,Passenger,7,2,9,298,307,2.93,Nearest
9882,June,2020,Klamath,OR,Passenger,1,0,1,33,34,2.94,Nearest
9883,June,2020,Kitsap,WA,Passenger,1330,686,2016,179815,181831,1.11,Washington
9884,June,2020,Hawaii,HI,Passenger,1,0,1,56,57,1.75,Nearest
9885,June,2020,San Juan,WA,Truck,0,0,0,5854,5854,0.0,Washington
9886,June,2020,Deschutes,OR,Passenger,3,0,3,133,136,2.21,Nearest
9887,June,2020,Charles,MD,Passenger,1,1,2,73,75,2.67,Furthest
9888,June,2020,Adams,WA,Passenger,9,7,16,12786,12802,0.12,Washington
9889,June,2020,Houston,GA,Passenger,1,0,1,56,57,1.75,Furthest
9890,June,2020,Contra Costa,CA,Passenger,3,3,6,314,320,1.88,Nearest
9891,June,2020,Randolph,NC,Passenger,1,0,1,6,7,14.29,Furthest
9892,June,2020,Lewis,WA,Truck,0,0,0,26209,26209,0.0,Washington
9893,June,2020,Yakima,WA,Truck,0,0,0,59894,59894,0.0,Washington
9894,June,2020,Whitman,WA,Truck,0,0,0,8508,8508,0.0,Washington
9895,June,2020,Ada,ID,Passenger,0,1,1,270,271,0.37,Nearest
9896,June,2020,Montgomery,AL,Passenger,0,1,1,39,40,2.5,Furthest
9897,June,2020,Shasta,CA,Passenger,1,0,1,36,37,2.7,Nearest
9898,June,2020,Klickitat,WA,Truck,0,0,0,8102,8102,0.0,Washington
9899,June,2020,Ferry,WA,Truck,0,0,0,3555,3555,0.0,Washington
9900,June,2020,St. Louis,MO,Passenger,1,0,1,97,98,1.02,Furthest
9901,June,2020,Prince George's,MD,Passenger,1,1,2,163,165,1.21,Furthest
9902,June,2020,Wahkiakum,WA,Passenger,6,6,12,2991,3003,0.4,Washington
9903,June,2020,Orange,CA,Passenger,7,2,9,492,501,1.8,Nearest
9904,June,2020,Douglas,WA,Passenger,71,40,111,28002,28113,0.39,Washington
9905,June,2020,Grays Harbor,WA,Truck,0,0,0,20910,20910,0.0,Washington
9906,June,2020,Polk,FL,Passenger,1,0,1,64,65,1.54,Furthest
9907,June,2020,Nassau,NY,Passenger,4,0,4,29,33,12.12,Furthest
9908,June,2020,Grant,WA,Passenger,59,71,130,65239,65369,0.2,Washington
9909,June,2020,Lincoln,WA,Truck,0,0,0,4624,4624,0.0,Washington
9910,June,2020,Kittitas,WA,Truck,0,0,0,14591,14591,0.0,Washington
9911,June,2020,Clallam,WA,Truck,1,0,1,21760,21761,0.0,Washington
9912,June,2020,Saginaw,MI,Passenger,1,0,1,10,11,9.09,Furthest
9913,June,2020,Clallam,WA,Passenger,228,168,396,50092,50488,0.78,Washington
9914,June,2020,El Paso,TX,Passenger,3,0,3,421,424,0.71,Mid-Distance
9915,June,2020,Jefferson,CO,Passenger,0,1,1,59,60,1.67,Mid-Distance
9916,June,2020,Twin Falls,ID,Passenger,0,1,1,24,25,4.0,Nearest
9917,June,2020,Garfield,WA,Passenger,0,1,1,1351,1352,0.07,Washington
9918,June,2020,Guadalupe,TX,Passenger,1,0,1,64,65,1.54,Mid-Distance
9919,June,2020,DuPage,IL,Passenger,3,0,3,58,61,4.92,Mid-Distance
9920,June,2020,Snohomish,WA,Truck,0,0,0,123942,123942,0.0,Washington
9921,June,2020,Nassau,FL,Passenger,1,0,1,36,37,2.7,Furthest
9922,June,2020,Richmond,GA,Passenger,0,1,1,84,85,1.18,Furthest
9923,June,2020,Pima,AZ,Passenger,3,1,4,339,343,1.17,Nearest
9924,June,2020,Larimer,CO,Passenger,1,0,1,51,52,1.92,Mid-Distance
9925,June,2020,Juneau,AK,Passenger,0,2,2,28,30,6.67,Nearest
9926,June,2020,Lee,FL,Passenger,1,0,1,50,51,1.96,Furthest
9927,June,2020,Salt Lake,UT,Passenger,0,1,1,194,195,0.51,Nearest
9928,June,2020,Putnam,TN,Passenger,0,1,1,3,4,25.0,Furthest
9929,June,2020,Nueces,TX,Passenger,1,0,1,82,83,1.2,Mid-Distance
9930,June,2020,Columbia,WA,Truck,0,0,0,1532,1532,0.0,Washington
9931,June,2020,Okaloosa,FL,Passenger,0,1,1,137,138,0.72,Furthest
9932,June,2020,Pinellas,FL,Passenger,1,1,2,109,111,1.8,Furthest
9933,June,2020,Virginia Beach,VA,Passenger,1,0,1,666,667,0.15,Furthest
9934,June,2020,Manassas,VA,Passenger,0,1,1,4,5,20.0,Furthest
9935,June,2020,Snohomish,WA,Passenger,4434,1765,6199,534548,540747,1.15,Washington
9936,June,2020,Penobscot,ME,Passenger,0,1,1,13,14,7.14,Furthest
9937,June,2020,Douglas,WA,Truck,0,0,0,12308,12308,0.0,Washington
9938,June,2020,Rogers,OK,Passenger,1,0,1,5,6,16.67,Mid-Distance
9939,June,2020,Suffolk,VA,Passenger,1,0,1,127,128,0.78,Furthest
9940,June,2020,Skamania,WA,Passenger,31,18,49,8481,8530,0.57,Washington
9941,June,2020,Walla Walla,WA,Passenger,73,62,135,35832,35967,0.38,Washington
9942,June,2020,Spartanburg,SC,Passenger,0,1,1,46,47,2.13,Furthest
9943,June,2020,Harrison,MS,Passenger,1,0,1,53,54,1.85,Mid-Distance
9944,June,2020,Washtenaw,MI,Passenger,1,0,1,36,37,2.7,Furthest
9945,June,2020,Chelan,WA,Truck,0,0,0,22520,22520,0.0,Washington
9946,June,2020,Okanogan,WA,Passenger,36,33,69,25848,25917,0.27,Washington
9947,June,2020,Wilson,TX,Passenger,0,1,1,5,6,16.67,Mid-Distance
9948,June,2020,Clark,NV,Passenger,2,2,4,675,679,0.59,Nearest
9949,June,2020,Maui,HI,Passenger,1,0,1,31,32,3.12,Nearest
9950,June,2020,Hudson,NJ,Passenger,1,0,1,38,39,2.56,Furthest
9951,June,2020,Placer,CA,Passenger,2,0,2,89,91,2.2,Nearest
9952,June,2020,Carroll,NH,Passenger,0,1,1,4,5,20.0,Furthest
9953,June,2021,Gwinnett,GA,Passenger,1,0,1,62,63,1.59,Furthest
9954,June,2021,Duval,FL,Passenger,0,2,2,335,337,0.59,Furthest
9955,June,2021,Jefferson,WA,Passenger,331,184,515,24891,25406,2.03,Washington
9956,June,2021,Ventura,CA,Passenger,1,2,3,255,258,1.16,Nearest
9957,June,2021,Douglas,NE,Passenger,1,1,2,50,52,3.85,Mid-Distance
9958,June,2021,Snohomish,WA,Passenger,5886,2048,7934,540300,548234,1.45,Washington
9959,June,2021,Stevens,WA,Passenger,45,45,90,30479,30569,0.29,Washington
9960,June,2021,Carroll,MD,Passenger,0,1,1,18,19,5.26,Furthest
9961,June,2021,Mason,WA,Truck,0,0,0,21335,21335,0.0,Washington
9962,June,2021,Chelan,WA,Passenger,336,99,435,54745,55180,0.79,Washington
9963,June,2021,Snohomish,WA,Truck,1,0,1,126272,126273,0.0,Washington
9964,June,2021,Bucks,PA,Passenger,1,0,1,15,16,6.25,Furthest
9965,June,2021,Spokane,WA,Truck,0,0,0,102350,102350,0.0,Washington
9966,June,2021,Pima,AZ,Passenger,2,1,3,273,276,1.09,Nearest
9967,June,2021,Williams,ND,Passenger,0,1,1,7,8,12.5,Mid-Distance
9968,June,2021,Whatcom,WA,Passenger,1419,602,2021,150844,152865,1.32,Washington
9969,June,2021,San Mateo,CA,Passenger,1,0,1,99,100,1.0,Nearest
9970,June,2021,Pacific,WA,Passenger,45,53,98,16057,16155,0.61,Washington
9971,June,2021,King,WA,Passenger,30495,9167,39662,1368513,1408175,2.82,Washington
9972,June,2021,Chelan,WA,Truck,0,0,0,23127,23127,0.0,Washington
9973,June,2021,Miami-Dade,FL,Passenger,1,0,1,97,98,1.02,Furthest
9975,June,2021,Charleston,SC,Passenger,1,1,2,83,85,2.35,Furthest
9976,June,2021,Thurston,WA,Truck,0,0,0,56575,56575,0.0,Washington
9977,June,2021,Montgomery,PA,Passenger,1,0,1,24,25,4.0,Furthest
9978,June,2021,Grays Harbor,WA,Truck,0,0,0,21450,21450,0.0,Washington
9979,June,2021,Charles,MD,Passenger,1,1,2,69,71,2.82,Furthest
9980,June,2021,Cook,IL,Passenger,1,0,1,202,203,0.49,Mid-Distance
9981,June,2021,Asotin,WA,Passenger,20,17,37,12728,12765,0.29,Washington
9982,June,2021,Arlington,VA,Passenger,0,1,1,137,138,0.72,Furthest
9983,June,2021,Cape May,NJ,Passenger,0,1,1,8,9,11.11,Furthest
9984,June,2021,Okanogan,WA,Truck,0,0,0,16757,16757,0.0,Washington
9985,June,2021,Whatcom,WA,Truck,4,0,4,43913,43917,0.01,Washington
9986,June,2021,District of Columbia,DC,Passenger,5,1,6,199,205,2.93,Furthest
9987,June,2021,Sacramento,CA,Passenger,2,0,2,214,216,0.93,Nearest
9988,June,2021,Fairbanks North Star,AK,Passenger,0,1,1,85,86,1.16,Nearest
9989,June,2021,Pacific,WA,Truck,0,0,0,7965,7965,0.0,Washington
9990,June,2021,Philadelphia,PA,Passenger,1,0,1,47,48,2.08,Furthest
9991,June,2021,Carson City,NV,Passenger,1,0,1,10,11,9.09,Nearest
9992,June,2021,Wahkiakum,WA,Passenger,15,8,23,3109,3132,0.73,Washington
9993,June,2021,San Francisco,CA,Passenger,0,1,1,85,86,1.16,Nearest
9994,June,2021,Albemarle,VA,Passenger,1,0,1,19,20,5.0,Furthest
9995,June,2021,Skamania,WA,Truck,0,0,0,4029,4029,0.0,Washington
9996,June,2021,Howard,MD,Passenger,0,1,1,59,60,1.67,Furthest
9997,June,2021,Boone,MO,Passenger,0,1,1,9,10,10.0,Furthest
9998,June,2021,Hidalgo,TX,Passenger,0,1,1,56,57,1.75,Mid-Distance
9999,June,2021,Santa Clara,CA,Passenger,8,2,10,245,255,3.92,Nearest
10000,June,2021,Grant,WA,Truck,0,0,0,27912,27912,0.0,Washington
10001,June,2021,Benton,WA,Passenger,518,394,912,136405,137317,0.66,Washington
10002,June,2021,Prince George's,MD,Passenger,2,1,3,139,142,2.11,Furthest
10003,June,2021,Clark,WA,Truck,0,0,0,84343,84343,0.0,Washington
10004,June,2021,Orange,FL,Passenger,1,0,1,111,112,0.89,Furthest
10005,June,2021,Asotin,WA,Truck,0,0,0,6792,6792,0.0,Washington
10006,June,2021,Anchorage,AK,Passenger,1,0,1,133,134,0.75,Nearest
10007,June,2021,Montgomery,OH,Passenger,0,1,1,56,57,1.75,Furthest
10008,June,2021,Kern,CA,Passenger,0,1,1,211,212,0.47,Nearest
10009,June,2021,Ferry,WA,Passenger,9,3,12,4373,4385,0.27,Washington
10010,June,2021,Wilson,NC,Passenger,1,0,1,0,1,100.0,Furthest
10011,June,2021,Franklin,WA,Passenger,123,97,220,62016,62236,0.35,Washington
10012,June,2021,Dakota,MN,Passenger,0,1,1,25,26,3.85,Mid-Distance
10013,June,2021,Cumberland,NC,Passenger,0,2,2,420,422,0.47,Furthest
10014,June,2021,Salt Lake,UT,Passenger,0,1,1,167,168,0.6,Nearest
10015,June,2021,Bartow,GA,Passenger,0,1,1,3,4,25.0,Furthest
10016,June,2021,Riverside,CA,Passenger,5,1,6,544,550,1.09,Nearest
10017,June,2021,Shelby,OH,Passenger,0,1,1,1,2,50.0,Furthest
10018,June,2021,Cowlitz,WA,Passenger,224,142,366,72350,72716,0.5,Washington
10019,June,2021,Ray,MO,Passenger,0,1,1,1,2,50.0,Furthest
10020,June,2021,Island,WA,Passenger,617,317,934,63262,64196,1.45,Washington
10021,June,2021,Missoula,MT,Passenger,1,0,1,60,61,1.64,Nearest
10022,June,2021,Danville,VA,Passenger,1,0,1,0,1,100.0,Furthest
10023,June,2021,Boulder,CO,Passenger,0,1,1,44,45,2.22,Mid-Distance
10024,June,2021,Flathead,MT,Passenger,1,0,1,43,44,2.27,Nearest
10025,June,2021,RÃ­o Grande,PR,Passenger,1,0,1,0,1,100.0,Mid-Distance
10026,June,2021,Kitsap,WA,Truck,0,0,0,54475,54475,0.0,Washington
10027,June,2021,Randolph,NC,Passenger,1,0,1,7,8,12.5,Furthest
10028,June,2021,Ulster,NY,Passenger,1,0,1,8,9,11.11,Furthest
10029,June,2021,Harris,TX,Passenger,1,1,2,194,196,1.02,Mid-Distance
10030,June,2021,Richmond,GA,Passenger,0,1,1,77,78,1.28,Furthest
10031,June,2021,Loudoun,VA,Passenger,1,0,1,74,75,1.33,Furthest
10032,June,2021,Milwaukee,WI,Passenger,1,0,1,38,39,2.56,Mid-Distance
10033,June,2021,Nueces,TX,Passenger,1,0,1,73,74,1.35,Mid-Distance
10034,June,2021,El Paso,TX,Passenger,3,0,3,374,377,0.8,Mid-Distance
10035,June,2021,Ferry,WA,Truck,0,0,0,3641,3641,0.0,Washington
10036,June,2021,Wilson,TX,Passenger,0,1,1,3,4,25.0,Mid-Distance
10037,June,2021,Garfield,WA,Truck,0,0,0,998,998,0.0,Washington
10038,June,2021,Whitman,WA,Truck,0,0,0,8585,8585,0.0,Washington
10039,June,2021,Contra Costa,CA,Passenger,2,3,5,261,266,1.88,Nearest
10040,June,2021,Queens,NY,Passenger,2,0,2,49,51,3.92,Furthest
10041,June,2021,Pierce,WA,Truck,0,0,0,146075,146075,0.0,Washington
10042,June,2021,Okanogan,WA,Passenger,63,38,101,26512,26613,0.38,Washington
10043,June,2021,Hamilton,IN,Passenger,2,0,2,32,34,5.88,Furthest
10044,June,2021,Harrison,MS,Passenger,2,0,2,51,53,3.77,Mid-Distance
10045,June,2021,Jefferson,WA,Truck,0,0,0,9625,9625,0.0,Washington
10046,June,2021,Jones,GA,Passenger,1,0,1,1,2,50.0,Furthest
10047,June,2021,Pend Oreille,WA,Passenger,14,7,21,9267,9288,0.23,Washington
10048,June,2021,Kittitas,WA,Truck,0,0,0,14785,14785,0.0,Washington
10049,June,2021,DuPage,IL,Passenger,1,0,1,50,51,1.96,Mid-Distance
10050,June,2021,Skagit,WA,Truck,1,0,1,33029,33030,0.0,Washington
10051,June,2021,Honolulu,HI,Passenger,5,2,7,392,399,1.75,Nearest
10052,June,2021,Klickitat,WA,Truck,0,0,0,8301,8301,0.0,Washington
10053,June,2021,Douglas,WA,Passenger,93,48,141,28517,28658,0.49,Washington
10054,June,2021,Placer,CA,Passenger,2,0,2,77,79,2.53,Nearest
10055,June,2021,Los Angeles,CA,Passenger,10,11,21,878,899,2.34,Nearest
10056,June,2021,Montgomery,MD,Passenger,3,1,4,218,222,1.8,Furthest
10057,June,2021,Grant,WA,Passenger,107,89,196,66973,67169,0.29,Washington
10058,June,2021,Richmond,NY,Passenger,1,0,1,9,10,10.0,Furthest
10059,June,2021,Yakima,WA,Truck,0,0,0,61725,61725,0.0,Washington
10060,June,2021,Denver,CO,Passenger,1,0,1,118,119,0.84,Mid-Distance
10061,June,2021,Chesapeake,VA,Passenger,0,4,4,389,393,1.02,Furthest
10062,June,2021,Dallas,TX,Passenger,1,0,1,158,159,0.63,Mid-Distance
10063,June,2021,Wahkiakum,WA,Truck,0,0,0,1797,1797,0.0,Washington
10064,June,2021,El Paso,CO,Passenger,3,0,3,669,672,0.45,Mid-Distance
10065,June,2021,Middlesex,MA,Passenger,1,1,2,93,95,2.11,Furthest
10066,June,2021,Manassas,VA,Passenger,0,1,1,7,8,12.5,Furthest
10067,June,2021,Greene,MO,Passenger,0,1,1,29,30,3.33,Furthest
10068,June,2021,Kings,CA,Passenger,1,0,1,319,320,0.31,Nearest
10069,June,2021,Kings,NY,Passenger,1,0,1,67,68,1.47,Furthest
10070,June,2021,Sedgwick,KS,Passenger,1,1,2,83,85,2.35,Mid-Distance
10071,June,2021,Grays Harbor,WA,Passenger,168,144,312,49450,49762,0.63,Washington
10072,June,2021,Yakima,WA,Passenger,225,155,380,169332,169712,0.22,Washington
10073,June,2021,New York,NY,Passenger,1,0,1,44,45,2.22,Furthest
10074,June,2021,Franklin,WA,Truck,0,0,0,20697,20697,0.0,Washington
10075,June,2021,San Juan,WA,Passenger,431,135,566,14255,14821,3.82,Washington
10076,June,2021,Columbia,WA,Passenger,6,2,8,2468,2476,0.32,Washington
10077,June,2021,Suffolk,MA,Passenger,0,2,2,30,32,6.25,Furthest
10078,June,2021,Calvert,MD,Passenger,0,2,2,90,92,2.17,Furthest
10079,June,2021,Kittitas,WA,Passenger,160,67,227,29984,30211,0.75,Washington
10080,June,2021,Clallam,WA,Passenger,329,217,546,50489,51035,1.07,Washington
10081,June,2021,Broward,FL,Passenger,2,0,2,107,109,1.83,Furthest
10082,June,2021,Lewis,WA,Passenger,163,139,302,59680,59982,0.5,Washington
10083,June,2021,Clackamas,OR,Passenger,2,0,2,170,172,1.16,Nearest
10084,June,2021,St. Mary's,MD,Passenger,1,0,1,205,206,0.49,Furthest
10085,June,2021,Washington,OR,Passenger,1,0,1,383,384,0.26,Nearest
10086,June,2021,Clark,WA,Passenger,2841,1423,4264,322560,326824,1.3,Washington
10087,June,2021,Douglas,CO,Passenger,0,1,1,75,76,1.32,Mid-Distance
10088,June,2021,Houston,GA,Passenger,1,0,1,47,48,2.08,Furthest
10089,June,2021,Fort Bend,TX,Passenger,1,0,1,36,37,2.7,Mid-Distance
10090,June,2021,Monterey,CA,Passenger,0,1,1,147,148,0.68,Nearest
10091,June,2021,Nassau,NY,Passenger,2,0,2,26,28,7.14,Furthest
10092,June,2021,Whitman,WA,Passenger,58,47,105,21996,22101,0.48,Washington
10093,June,2021,Cowlitz,WA,Truck,0,0,0,29122,29122,0.0,Washington
10094,June,2021,Alameda,CA,Passenger,3,0,3,236,239,1.26,Nearest
10095,June,2021,Platte,MO,Passenger,1,0,1,17,18,5.56,Furthest
10096,June,2021,Adams,WA,Truck,0,0,0,5386,5386,0.0,Washington
10097,June,2021,Hillsborough,FL,Passenger,0,1,1,146,147,0.68,Furthest
10098,June,2021,Jefferson,NY,Passenger,0,1,1,214,215,0.47,Furthest
10099,June,2021,Norfolk,VA,Passenger,2,3,5,316,321,1.56,Furthest
10100,June,2021,Hudson,NJ,Passenger,1,0,1,42,43,2.33,Furthest
10101,June,2021,San Juan,WA,Truck,0,0,0,5942,5942,0.0,Washington
10102,June,2021,Kauai,HI,Passenger,1,0,1,17,18,5.56,Nearest
10103,June,2021,Lee,FL,Passenger,1,0,1,35,36,2.78,Furthest
10104,June,2021,Erie,NY,Passenger,1,0,1,37,38,2.63,Furthest
10105,June,2021,Vigo,IN,Passenger,1,0,1,5,6,16.67,Furthest
10106,June,2021,Adams,WA,Passenger,16,11,27,13035,13062,0.21,Washington
10107,June,2021,Richland,SC,Passenger,0,1,1,134,135,0.74,Furthest
10108,June,2021,Oldham,KY,Passenger,0,1,1,4,5,20.0,Furthest
10109,June,2021,Larimer,CO,Passenger,1,0,1,50,51,1.96,Mid-Distance
10110,June,2021,Pierce,WA,Passenger,3470,1997,5467,560461,565928,0.97,Washington
10111,June,2021,Penobscot,ME,Passenger,0,1,1,8,9,11.11,Furthest
10112,June,2021,Lewis,WA,Truck,0,0,0,26859,26859,0.0,Washington
10113,June,2021,Pinellas,FL,Passenger,0,1,1,93,94,1.06,Furthest
10114,June,2021,Harnett,NC,Passenger,1,1,2,167,169,1.18,Furthest
10115,June,2021,Goochland,VA,Passenger,4,2,6,217,223,2.69,Furthest
10116,June,2021,Champaign,IL,Passenger,1,0,1,11,12,8.33,Mid-Distance
10117,June,2021,Collin,TX,Passenger,1,1,2,109,111,1.8,Mid-Distance
10118,June,2021,Prince William,VA,Passenger,1,1,2,210,212,0.94,Furthest
10119,June,2021,Mason,WA,Passenger,215,140,355,48176,48531,0.73,Washington
10120,June,2021,Howard,IN,Passenger,0,1,1,5,6,16.67,Furthest
10121,June,2021,Rogers,OK,Passenger,1,0,1,3,4,25.0,Mid-Distance
10122,June,2021,Stafford,VA,Passenger,2,1,3,99,102,2.94,Furthest
10123,June,2021,Walla Walla,WA,Passenger,113,74,187,36614,36801,0.51,Washington
10124,June,2021,Lincoln,WA,Truck,0,0,0,4754,4754,0.0,Washington
10125,June,2021,Wichita,TX,Passenger,1,0,1,40,41,2.44,Mid-Distance
10126,June,2021,Sarasota,FL,Passenger,2,0,2,28,30,6.67,Furthest
10127,June,2021,Maui,HI,Passenger,1,0,1,26,27,3.7,Nearest
10128,June,2021,Rockingham,NH,Passenger,1,0,1,21,22,4.55,Furthest
10129,June,2021,Klickitat,WA,Passenger,70,51,121,15279,15400,0.79,Washington
10130,June,2021,Lane,OR,Passenger,0,1,1,125,126,0.79,Nearest
10131,June,2021,Williamson,TX,Passenger,0,2,2,105,107,1.87,Mid-Distance
10132,June,2021,Fresno,CA,Passenger,1,0,1,168,169,0.59,Nearest
10133,June,2021,Owyhee,ID,Passenger,1,0,1,3,4,25.0,Nearest
10134,June,2021,Powhatan,VA,Passenger,1,0,1,1,2,50.0,Furthest
10135,June,2021,Columbia,WA,Truck,0,0,0,1546,1546,0.0,Washington
10136,June,2021,Sumter,SC,Passenger,0,1,1,39,40,2.5,Furthest
10137,June,2021,Saginaw,MI,Passenger,1,0,1,6,7,14.29,Furthest
10138,June,2021,Yamhill,OR,Passenger,1,0,1,35,36,2.78,Nearest
10139,June,2021,Spokane,WA,Passenger,1069,646,1715,326466,328181,0.52,Washington
10140,June,2021,Travis,TX,Passenger,3,3,6,156,162,3.7,Mid-Distance
10141,June,2021,Clark,NV,Passenger,4,2,6,614,620,0.97,Nearest
10142,June,2021,Juneau,AK,Passenger,0,1,1,26,27,3.7,Nearest
10143,June,2021,Lake,IL,Passenger,2,0,2,157,159,1.26,Mid-Distance
10144,June,2021,Moore,NC,Passenger,0,1,1,129,130,0.77,Furthest
10145,June,2021,Pend Oreille,WA,Truck,0,0,0,5748,5748,0.0,Washington
10146,June,2021,Frederick,MD,Passenger,1,1,2,67,69,2.9,Furthest
10147,June,2021,Okaloosa,FL,Passenger,0,1,1,115,116,0.86,Furthest
10148,June,2021,Walla Walla,WA,Truck,0,0,0,14076,14076,0.0,Washington
10149,June,2021,Spartanburg,SC,Passenger,0,1,1,50,51,1.96,Furthest
10150,June,2021,Montgomery,TX,Passenger,1,1,2,39,41,4.88,Mid-Distance
10151,June,2021,Allegheny,PA,Passenger,1,1,2,62,64,3.12,Furthest
10152,June,2021,Orange,CA,Passenger,4,3,7,416,423,1.65,Nearest
10153,June,2021,San Joaquin,CA,Passenger,1,0,1,106,107,0.93,Nearest
10154,June,2021,Bexar,TX,Passenger,3,4,7,524,531,1.32,Mid-Distance
10155,June,2021,New London,CT,Passenger,1,2,3,221,224,1.34,Furthest
10156,June,2021,Skagit,WA,Passenger,589,274,863,91973,92836,0.93,Washington
10157,June,2021,King,WA,Truck,6,1,7,184630,184637,0.0,Washington
10158,June,2021,Carroll,NH,Passenger,0,1,1,5,6,16.67,Furthest
10159,June,2021,Alexandria,VA,Passenger,2,0,2,123,125,1.6,Furthest
10160,June,2021,Benton,WA,Truck,0,0,0,43627,43627,0.0,Washington
10161,June,2021,Camden,NJ,Passenger,0,1,1,15,16,6.25,Furthest
10162,June,2021,Sumter,FL,Passenger,0,1,1,8,9,11.11,Furthest
10163,June,2021,New Haven,CT,Passenger,0,2,2,28,30,6.67,Furthest
10164,June,2021,Polk,FL,Passenger,1,0,1,54,55,1.82,Furthest
10165,June,2021,Lake,FL,Passenger,1,0,1,22,23,4.35,Furthest
10166,June,2021,El Dorado,CA,Passenger,1,0,1,31,32,3.12,Nearest
10167,June,2021,Skamania,WA,Passenger,44,34,78,8407,8485,0.92,Washington
10168,June,2021,Thurston,WA,Passenger,1585,872,2457,198143,200600,1.22,Washington
10169,June,2021,Hennepin,MN,Passenger,3,0,3,75,78,3.85,Mid-Distance
10170,June,2021,Pennington,SD,Passenger,1,0,1,30,31,3.23,Mid-Distance
10171,June,2021,Douglas,WA,Truck,0,0,0,12685,12685,0.0,Washington
10172,June,2021,Stevens,WA,Truck,0,0,0,18947,18947,0.0,Washington
10173,June,2021,Kitsap,WA,Passenger,1851,859,2710,180524,183234,1.48,Washington
10174,June,2021,Washington,MD,Passenger,1,0,1,13,14,7.14,Furthest
10175,June,2021,Burlington,NJ,Passenger,0,1,1,129,130,0.77,Furthest
10176,June,2021,Plaquemines,LA,Passenger,0,1,1,16,17,5.88,Mid-Distance
10177,June,2021,Suffolk,VA,Passenger,1,0,1,125,126,0.79,Furthest
10178,June,2021,San Diego,CA,Passenger,16,6,22,2559,2581,0.85,Nearest
10179,June,2021,Leavenworth,KS,Passenger,0,1,1,116,117,0.85,Mid-Distance
10180,June,2021,Sevier,AR,Passenger,0,1,1,0,1,100.0,Mid-Distance
10181,June,2021,Multnomah,OR,Passenger,2,5,7,639,646,1.08,Nearest
10182,June,2021,St. Louis,MO,Passenger,1,0,1,81,82,1.22,Furthest
10183,June,2021,DeKalb,GA,Passenger,1,0,1,58,59,1.69,Furthest
10184,June,2021,Louisa,VA,Passenger,0,1,1,1,2,50.0,Furthest
10185,June,2021,Maricopa,AZ,Passenger,6,3,9,1153,1162,0.77,Nearest
10186,June,2021,Lincoln,WA,Passenger,5,13,18,7738,7756,0.23,Washington
10187,June,2021,Allen,IN,Passenger,1,0,1,15,16,6.25,Furthest
10188,June,2021,Hampshire,MA,Passenger,1,0,1,5,6,16.67,Furthest
10189,June,2021,Hawaii,HI,Passenger,1,0,1,46,47,2.13,Nearest
10190,June,2021,Clallam,WA,Truck,1,0,1,22026,22027,0.0,Washington
10191,June,2021,Arapahoe,CO,Passenger,1,0,1,110,111,0.9,Mid-Distance
10192,June,2021,Portsmouth,VA,Passenger,0,1,1,76,77,1.3,Furthest
10193,June,2021,Garfield,WA,Passenger,0,3,3,1375,1378,0.22,Washington
10194,June,2021,Virginia Beach,VA,Passenger,3,0,3,614,617,0.49,Furthest
10195,June,2021,Santa Cruz,CA,Passenger,1,0,1,25,26,3.85,Nearest
10196,June,2021,Fairfax,VA,Passenger,4,4,8,684,692,1.16,Furthest
10197,June,2021,Morris,NJ,Passenger,1,0,1,15,16,6.25,Furthest
10198,June,2021,Island,WA,Truck,0,0,0,21624,21624,0.0,Washington
10199,June,2021,Anne Arundel,MD,Passenger,4,2,6,388,394,1.52,Furthest
10200,June,2021,St. Clair,IL,Passenger,2,0,2,135,137,1.46,Mid-Distance
10201,June,2021,Klamath,OR,Passenger,1,0,1,29,30,3.33,Nearest
10202,June,2022,San Joaquin,CA,Passenger,1,1,2,85,87,2.3,Nearest
10203,June,2022,Broward,FL,Passenger,1,0,1,74,75,1.33,Furthest
10204,June,2022,Boulder,CO,Passenger,1,0,1,33,34,2.94,Mid-Distance
10205,June,2022,Clallam,WA,Truck,3,0,3,21937,21940,0.01,Washington
10206,June,2022,Fairfax,VA,Passenger,6,3,9,597,606,1.49,Furthest
10207,June,2022,Middlesex,MA,Passenger,2,1,3,73,76,3.95,Furthest
10208,June,2022,Albemarle,VA,Passenger,1,0,1,16,17,5.88,Furthest
10209,June,2022,San Mateo,CA,Passenger,2,0,2,78,80,2.5,Nearest
10210,June,2022,Montgomery,AL,Passenger,0,1,1,33,34,2.94,Furthest
10211,June,2022,Cumberland,NC,Passenger,1,2,3,351,354,0.85,Furthest
10212,June,2022,Hudson,NJ,Passenger,2,0,2,34,36,5.56,Furthest
10213,June,2022,Lane,OR,Passenger,0,1,1,88,89,1.12,Nearest
10214,June,2022,Sonoma,CA,Passenger,0,1,1,74,75,1.33,Nearest
10215,June,2022,Howard,IN,Passenger,0,1,1,4,5,20.0,Furthest
10216,June,2022,Denton,TX,Passenger,1,0,1,62,63,1.59,Mid-Distance
10217,June,2022,Whitman,WA,Truck,1,0,1,8572,8573,0.01,Washington
10218,June,2022,Yakima,WA,Truck,1,0,1,61408,61409,0.0,Washington
10219,June,2022,Los Angeles,CA,Passenger,8,8,16,745,761,2.1,Nearest
10220,June,2022,Lee,FL,Passenger,1,0,1,29,30,3.33,Furthest
10221,June,2022,Collin,TX,Passenger,2,0,2,79,81,2.47,Mid-Distance
10222,June,2022,Essex,NJ,Passenger,2,0,2,9,11,18.18,Furthest
10223,June,2022,Adams,WA,Truck,1,0,1,5468,5469,0.02,Washington
10224,June,2022,Ferry,WA,Passenger,19,4,23,4409,4432,0.52,Washington
10225,June,2022,Howard,MD,Passenger,0,1,1,54,55,1.82,Furthest
10226,June,2022,El Paso,CO,Passenger,3,1,4,588,592,0.68,Mid-Distance
10227,June,2022,Lewis,WA,Truck,0,0,0,26412,26412,0.0,Washington
10228,June,2022,Pima,AZ,Passenger,1,0,1,216,217,0.46,Nearest
10229,June,2022,Arlington,VA,Passenger,1,0,1,123,124,0.81,Furthest
10230,June,2022,San Diego,CA,Passenger,15,11,26,2238,2264,1.15,Nearest
10231,June,2022,Dorchester,SC,Passenger,1,0,1,53,54,1.85,Furthest
10232,June,2022,Island,WA,Passenger,818,379,1197,61948,63145,1.9,Washington
10233,June,2022,Kitsap,WA,Truck,4,0,4,53663,53667,0.01,Washington
10234,June,2022,Kauai,HI,Passenger,1,0,1,15,16,6.25,Nearest
10235,June,2022,Washington,MD,Passenger,2,0,2,15,17,11.76,Furthest
10236,June,2022,Lincoln,WA,Passenger,8,18,26,7710,7736,0.34,Washington
10237,June,2022,Stevens,WA,Truck,0,0,0,18951,18951,0.0,Washington
10238,June,2022,Oldham,KY,Passenger,0,1,1,4,5,20.0,Furthest
10239,June,2022,Allegheny,PA,Passenger,1,1,2,51,53,3.77,Furthest
10240,June,2022,Adams,WA,Passenger,17,10,27,12936,12963,0.21,Washington
10241,June,2022,Lake,IL,Passenger,2,0,2,134,136,1.47,Mid-Distance
10242,June,2022,Mason,WA,Truck,1,0,1,21067,21068,0.0,Washington
10243,June,2022,Okanogan,WA,Truck,1,0,1,16648,16649,0.01,Washington
10244,June,2022,Jefferson,WA,Passenger,434,217,651,24594,25245,2.58,Washington
10245,June,2022,Kern,CA,Passenger,0,1,1,186,187,0.53,Nearest
10246,June,2022,Island,WA,Truck,4,0,4,21382,21386,0.02,Washington
10247,June,2022,Monterey,CA,Passenger,1,1,2,126,128,1.56,Nearest
10248,June,2022,Bell,TX,Passenger,1,0,1,307,308,0.32,Mid-Distance
10249,June,2022,Thurston,WA,Passenger,2182,1055,3237,194425,197662,1.64,Washington
10250,June,2022,Rogers,OK,Passenger,1,0,1,1,2,50.0,Mid-Distance
10251,June,2022,Walla Walla,WA,Truck,0,0,0,13934,13934,0.0,Washington
10252,June,2022,Fairbanks North Star,AK,Passenger,0,1,1,72,73,1.37,Nearest
10253,June,2022,Whatcom,WA,Truck,7,0,7,43365,43372,0.02,Washington
10254,June,2022,Garfield,WA,Truck,0,0,0,984,984,0.0,Washington
10255,June,2022,Clark,NV,Passenger,4,2,6,502,508,1.18,Nearest
10256,June,2022,Camden,NJ,Passenger,0,1,1,13,14,7.14,Furthest
10257,June,2022,Mason,WA,Passenger,311,177,488,47350,47838,1.02,Washington
10258,June,2022,St. Tammany,LA,Passenger,1,0,1,33,34,2.94,Mid-Distance
10259,June,2022,Cook,IL,Passenger,2,0,2,182,184,1.09,Mid-Distance
10260,June,2022,Pennington,SD,Passenger,2,0,2,26,28,7.14,Mid-Distance
10261,June,2022,Sacramento,CA,Passenger,3,0,3,187,190,1.58,Nearest
10262,June,2022,Riverside,CA,Passenger,8,1,9,449,458,1.97,Nearest
10263,June,2022,Benton,WA,Truck,3,0,3,43576,43579,0.01,Washington
10264,June,2022,Douglas,CO,Passenger,0,1,1,70,71,1.41,Mid-Distance
10265,June,2022,Carson City,NV,Passenger,1,0,1,7,8,12.5,Nearest
10266,June,2022,Spokane,WA,Truck,1,0,1,102259,102260,0.0,Washington
10267,June,2022,Douglas,WA,Truck,0,0,0,12790,12790,0.0,Washington
10268,June,2022,Duval,FL,Passenger,1,2,3,267,270,1.11,Furthest
10269,June,2022,San Luis Obispo,CA,Passenger,1,0,1,53,54,1.85,Nearest
10270,June,2022,Hillsborough,FL,Passenger,0,1,1,119,120,0.83,Furthest
10271,June,2022,Danville,VA,Passenger,1,0,1,0,1,100.0,Furthest
10272,June,2022,Prince George's,MD,Passenger,3,1,4,118,122,3.28,Furthest
10273,June,2022,Maricopa,AZ,Passenger,7,2,9,873,882,1.02,Nearest
10274,June,2022,Harrison,MS,Passenger,1,0,1,42,43,2.33,Mid-Distance
10275,June,2022,Gwinnett,GA,Passenger,1,0,1,47,48,2.08,Furthest
10276,June,2022,Geary,KS,Passenger,1,0,1,83,84,1.19,Mid-Distance
10277,June,2022,Skamania,WA,Passenger,73,47,120,8213,8333,1.44,Washington
10278,June,2022,Wahkiakum,WA,Passenger,23,11,34,3072,3106,1.09,Washington
10279,June,2022,Pend Oreille,WA,Passenger,17,11,28,9056,9084,0.31,Washington
10280,June,2022,Wahkiakum,WA,Truck,0,0,0,1804,1804,0.0,Washington
10281,June,2022,Lincoln,OR,Passenger,0,1,1,26,27,3.7,Nearest
10282,June,2022,Las Animas,CO,Passenger,1,0,1,1,2,50.0,Mid-Distance
10284,June,2022,Loudoun,VA,Passenger,2,1,3,64,67,4.48,Furthest
10285,June,2022,Placer,CA,Passenger,2,0,2,65,67,2.99,Nearest
10286,June,2022,San Juan,WA,Passenger,513,157,670,14067,14737,4.55,Washington
10287,June,2022,Stevens,WA,Passenger,68,54,122,30173,30295,0.4,Washington
10288,June,2022,Platte,MO,Passenger,1,0,1,21,22,4.55,Furthest
10289,June,2022,San Bernardino,CA,Passenger,1,1,2,320,322,0.62,Nearest
10290,June,2022,Skagit,WA,Passenger,780,337,1117,90139,91256,1.22,Washington
10291,June,2022,Douglas,NE,Passenger,1,2,3,39,42,7.14,Mid-Distance
10292,June,2022,Pinellas,FL,Passenger,0,1,1,71,72,1.39,Furthest
10293,June,2022,Leavenworth,KS,Passenger,0,1,1,102,103,0.97,Mid-Distance
10294,June,2022,Skagit,WA,Truck,3,0,3,32352,32355,0.01,Washington
10295,June,2022,Clallam,WA,Passenger,421,249,670,49776,50446,1.33,Washington
10296,June,2022,Rock Island,IL,Passenger,0,1,1,14,15,6.67,Mid-Distance
10297,June,2022,New Haven,CT,Passenger,0,2,2,27,29,6.9,Furthest
10298,June,2022,Stafford,VA,Passenger,2,1,3,87,90,3.33,Furthest
10299,June,2022,Yellowstone,MT,Passenger,0,1,1,22,23,4.35,Nearest
10300,June,2022,Coryell,TX,Passenger,1,0,1,97,98,1.02,Mid-Distance
10301,June,2022,Galveston,TX,Passenger,0,1,1,18,19,5.26,Mid-Distance
10302,June,2022,Burlington,NJ,Passenger,0,2,2,108,110,1.82,Furthest
10303,June,2022,Nueces,TX,Passenger,1,1,2,52,54,3.7,Mid-Distance
10304,June,2022,Klickitat,WA,Truck,0,0,0,8294,8294,0.0,Washington
10305,June,2022,Orange,FL,Passenger,1,0,1,87,88,1.14,Furthest
10306,June,2022,Santa Clara,CA,Passenger,10,2,12,216,228,5.26,Nearest
10307,June,2022,Montgomery,TX,Passenger,1,0,1,28,29,3.45,Mid-Distance
10308,June,2022,Chelan,WA,Truck,3,0,3,23068,23071,0.01,Washington
10309,June,2022,Queens,NY,Passenger,1,0,1,38,39,2.56,Furthest
10310,June,2022,Boone,MO,Passenger,0,1,1,8,9,11.11,Furthest
10311,June,2022,Berkeley,SC,Passenger,0,1,1,117,118,0.85,Furthest
10312,June,2022,Richmond,NY,Passenger,1,0,1,6,7,14.29,Furthest
10313,June,2022,Okaloosa,FL,Passenger,0,1,1,98,99,1.01,Furthest
10314,June,2022,Cape May,NJ,Passenger,0,1,1,7,8,12.5,Furthest
10315,June,2022,Harris,TX,Passenger,1,0,1,136,137,0.73,Mid-Distance
10316,June,2022,Alexandria,VA,Passenger,3,0,3,108,111,2.7,Furthest
10317,June,2022,Jefferson,NY,Passenger,0,1,1,201,202,0.5,Furthest
10318,June,2022,Plaquemines,LA,Passenger,1,1,2,16,18,11.11,Mid-Distance
10319,June,2022,Allen,IN,Passenger,1,0,1,13,14,7.14,Furthest
10320,June,2022,Lincoln,WA,Truck,0,0,0,4832,4832,0.0,Washington
10321,June,2022,Williams,ND,Passenger,0,1,1,6,7,14.29,Mid-Distance
10322,June,2022,New London,CT,Passenger,2,5,7,183,190,3.68,Furthest
10323,June,2022,Sumter,SC,Passenger,0,1,1,32,33,3.03,Furthest
10324,June,2022,Sarasota,FL,Passenger,2,0,2,23,25,8.0,Furthest
10325,June,2022,Garfield,WA,Passenger,0,3,3,1322,1325,0.23,Washington
10326,June,2022,Franklin,WA,Truck,0,0,0,20900,20900,0.0,Washington
10327,June,2022,DuPage,IL,Passenger,1,0,1,45,46,2.17,Mid-Distance
10328,June,2022,King,WA,Truck,66,1,67,180923,180990,0.04,Washington
10329,June,2022,Benton,WA,Passenger,751,461,1212,135364,136576,0.89,Washington
10330,June,2022,Asotin,WA,Truck,0,0,0,6720,6720,0.0,Washington
10331,June,2022,Charles,MD,Passenger,1,1,2,55,57,3.51,Furthest
10332,June,2022,Penobscot,ME,Passenger,0,1,1,7,8,12.5,Furthest
10333,June,2022,Asotin,WA,Passenger,23,19,42,12740,12782,0.33,Washington
10334,June,2022,Montgomery,PA,Passenger,2,0,2,21,23,8.7,Furthest
10335,June,2022,Kittitas,WA,Truck,1,0,1,14655,14656,0.01,Washington
10336,June,2022,Moore,NC,Passenger,0,1,1,113,114,0.88,Furthest
10337,June,2022,Salt Lake,UT,Passenger,1,1,2,123,125,1.6,Nearest
10338,June,2022,St. Louis,MO,Passenger,1,0,1,61,62,1.61,Furthest
10339,June,2022,Pend Oreille,WA,Truck,0,0,0,5670,5670,0.0,Washington
10340,June,2022,Spartanburg,SC,Passenger,0,1,1,38,39,2.56,Furthest
10341,June,2022,King,WA,Passenger,40732,11318,52050,1349910,1401960,3.71,Washington
10342,June,2022,Sarpy,NE,Passenger,1,0,1,52,53,1.89,Mid-Distance
10343,June,2022,Pacific,WA,Truck,0,0,0,7916,7916,0.0,Washington
10344,June,2022,Calvert,MD,Passenger,0,2,2,76,78,2.56,Furthest
10345,June,2022,Owyhee,ID,Passenger,1,0,1,2,3,33.33,Nearest
10346,June,2022,Charleston,SC,Passenger,2,2,4,59,63,6.35,Furthest
10347,June,2022,Skamania,WA,Truck,0,0,0,3971,3971,0.0,Washington
10348,June,2022,Hennepin,MN,Passenger,1,0,1,46,47,2.13,Mid-Distance
10349,June,2022,El Paso,TX,Passenger,2,0,2,324,326,0.61,Mid-Distance
10350,June,2022,Kittitas,WA,Passenger,266,83,349,29763,30112,1.16,Washington
10351,June,2022,Montgomery,MD,Passenger,4,2,6,195,201,2.99,Furthest
10352,June,2022,Bexar,TX,Passenger,4,3,7,429,436,1.61,Mid-Distance
10353,June,2022,Okanogan,WA,Passenger,83,50,133,26390,26523,0.5,Washington
10354,June,2022,Chelan,WA,Passenger,461,126,587,54351,54938,1.07,Washington
10355,June,2022,Spokane,WA,Passenger,1602,848,2450,325470,327920,0.75,Washington
10356,June,2022,Wichita,TX,Passenger,1,0,1,38,39,2.56,Mid-Distance
10357,June,2022,Contra Costa,CA,Passenger,0,4,4,241,245,1.63,Nearest
10358,June,2022,Lake,FL,Passenger,1,0,1,18,19,5.26,Furthest
10359,June,2022,Ulster,NY,Passenger,1,0,1,9,10,10.0,Furthest
10360,June,2022,Grant,WA,Truck,0,0,0,28025,28025,0.0,Washington
10361,June,2022,Hamilton,OH,Passenger,1,0,1,27,28,3.57,Furthest
10362,June,2022,Carroll,NH,Passenger,0,1,1,5,6,16.67,Furthest
10363,June,2022,Kitsap,WA,Passenger,2393,1054,3447,178654,182101,1.89,Washington
10364,June,2022,Pierce,WA,Passenger,5062,2311,7373,546060,553433,1.33,Washington
10365,June,2022,Tarrant,TX,Passenger,1,0,1,107,108,0.93,Mid-Distance
10366,June,2022,Whitman,WA,Passenger,87,60,147,22018,22165,0.66,Washington
10367,June,2022,Travis,TX,Passenger,1,0,1,104,105,0.95,Mid-Distance
10368,June,2022,Snohomish,WA,Passenger,8361,2528,10889,532982,543871,2.0,Washington
10369,June,2022,Columbia,WA,Passenger,7,0,7,2444,2451,0.29,Washington
10370,June,2022,Elmore,ID,Passenger,1,0,1,12,13,7.69,Nearest
10371,June,2022,San Juan,WA,Truck,1,0,1,5986,5987,0.02,Washington
10372,June,2022,Walla Walla,WA,Passenger,172,101,273,35914,36187,0.75,Washington
10373,June,2022,Bartow,GA,Passenger,0,1,1,3,4,25.0,Furthest
10374,June,2022,Suffolk,VA,Passenger,1,0,1,121,122,0.82,Furthest
10375,June,2022,Randolph,NC,Passenger,1,0,1,5,6,16.67,Furthest
10376,June,2022,Saratoga,NY,Passenger,1,0,1,39,40,2.5,Furthest
10377,June,2022,Richmond,GA,Passenger,0,1,1,63,64,1.56,Furthest
10378,June,2022,Sheridan,WY,Passenger,1,0,1,6,7,14.29,Nearest
10379,June,2022,Goochland,VA,Passenger,2,2,4,114,118,3.39,Furthest
10380,June,2022,Rockingham,NH,Passenger,1,0,1,14,15,6.67,Furthest
10381,June,2022,Prince William,VA,Passenger,0,1,1,188,189,0.53,Furthest
10382,June,2022,Escambia,FL,Passenger,0,1,1,126,127,0.79,Furthest
10383,June,2022,Douglas,WA,Passenger,131,58,189,28498,28687,0.66,Washington
10384,June,2022,Grant,WA,Passenger,175,99,274,66817,67091,0.41,Washington
10385,June,2022,Louisa,VA,Passenger,0,1,1,1,2,50.0,Furthest
10386,June,2022,Clark,WA,Passenger,4095,1781,5876,316688,322564,1.82,Washington
10387,June,2022,Grays Harbor,WA,Truck,1,0,1,21324,21325,0.0,Washington
10388,June,2022,Wilson,TX,Passenger,0,1,1,2,3,33.33,Mid-Distance
10389,June,2022,Carroll,MD,Passenger,0,1,1,15,16,6.25,Furthest
10390,June,2022,Greene,MO,Passenger,0,1,1,20,21,4.76,Furthest
10391,June,2022,Richland,SC,Passenger,0,1,1,123,124,0.81,Furthest
10392,June,2022,DeKalb,GA,Passenger,1,0,1,46,47,2.13,Furthest
10393,June,2022,Sedgwick,KS,Passenger,1,1,2,74,76,2.63,Mid-Distance
10394,June,2022,Orange,CA,Passenger,5,2,7,338,345,2.03,Nearest
10395,June,2022,Multnomah,OR,Passenger,0,3,3,520,523,0.57,Nearest
10396,June,2022,Juneau,AK,Passenger,0,1,1,29,30,3.33,Nearest
10397,June,2022,Adams,CO,Passenger,1,0,1,37,38,2.63,Mid-Distance
10398,June,2022,Larimer,CO,Passenger,1,0,1,45,46,2.17,Mid-Distance
10399,June,2022,Hamilton,IN,Passenger,1,0,1,20,21,4.76,Furthest
10400,June,2022,Sevier,AR,Passenger,0,1,1,0,1,100.0,Mid-Distance
10401,June,2022,Philadelphia,PA,Passenger,1,0,1,33,34,2.94,Furthest
10402,June,2022,Clackamas,OR,Passenger,2,0,2,139,141,1.42,Nearest
10403,June,2022,Honolulu,HI,Passenger,4,4,8,315,323,2.48,Nearest
10404,June,2022,Norfolk,VA,Passenger,2,3,5,283,288,1.74,Furthest
10405,June,2022,Onslow,NC,Passenger,0,1,1,159,160,0.62,Furthest
10406,June,2022,Solano,CA,Passenger,1,0,1,157,158,0.63,Nearest
10407,June,2022,Anne Arundel,MD,Passenger,4,4,8,335,343,2.33,Furthest
10408,June,2022,Kings,CA,Passenger,2,1,3,298,301,1.0,Nearest
10409,June,2022,Cowlitz,WA,Truck,2,1,3,28556,28559,0.01,Washington
10410,June,2022,Cowlitz,WA,Passenger,336,172,508,70742,71250,0.71,Washington
10411,June,2022,Anchorage,AK,Passenger,1,0,1,116,117,0.85,Nearest
10412,June,2022,Marin,CA,Passenger,0,1,1,29,30,3.33,Nearest
10413,June,2022,Hidalgo,TX,Passenger,0,1,1,56,57,1.75,Mid-Distance
10414,June,2022,Whatcom,WA,Passenger,1814,737,2551,149016,151567,1.68,Washington
10415,June,2022,Grays Harbor,WA,Passenger,210,160,370,49043,49413,0.75,Washington
10416,June,2022,District of Columbia,DC,Passenger,4,0,4,171,175,2.29,Furthest
10417,June,2022,St. Clair,IL,Passenger,2,0,2,116,118,1.69,Mid-Distance
10418,June,2022,Klickitat,WA,Passenger,103,55,158,15251,15409,1.03,Washington
10419,June,2022,Frederick,MD,Passenger,1,1,2,61,63,3.17,Furthest
10420,June,2022,St. Mary's,MD,Passenger,1,0,1,191,192,0.52,Furthest
10421,June,2022,Williamson,TX,Passenger,1,2,3,78,81,3.7,Mid-Distance
10422,June,2022,Santa Cruz,CA,Passenger,1,0,1,22,23,4.35,Nearest
10423,June,2022,Portsmouth,VA,Passenger,0,1,1,75,76,1.32,Furthest
10424,June,2022,Ray,MO,Passenger,0,1,1,1,2,50.0,Furthest
10425,June,2022,Lewis,WA,Passenger,235,177,412,59751,60163,0.68,Washington
10426,June,2022,Virginia Beach,VA,Passenger,2,0,2,501,503,0.4,Furthest
10427,June,2022,Fort Bend,TX,Passenger,1,0,1,26,27,3.7,Mid-Distance
10428,June,2022,Clark,WA,Truck,7,0,7,82837,82844,0.01,Washington
10429,June,2022,Ferry,WA,Truck,0,0,0,3577,3577,0.0,Washington
10430,June,2022,Nassau,NY,Passenger,2,0,2,23,25,8.0,Furthest
10431,June,2022,Hawaii,HI,Passenger,1,0,1,36,37,2.7,Nearest
10432,June,2022,Chesapeake,VA,Passenger,2,3,5,330,335,1.49,Furthest
10433,June,2022,Franklin,WA,Passenger,186,109,295,62000,62295,0.47,Washington
10434,June,2022,Alameda,CA,Passenger,4,0,4,180,184,2.17,Nearest
10435,June,2022,Columbia,WA,Truck,0,0,0,1579,1579,0.0,Washington
10436,June,2022,Manassas,VA,Passenger,0,1,1,8,9,11.11,Furthest
10437,June,2022,Pierce,WA,Truck,6,0,6,141892,141898,0.0,Washington
10438,June,2022,Yakima,WA,Passenger,336,190,526,167038,167564,0.31,Washington
10439,June,2022,Fresno,CA,Passenger,1,0,1,134,135,0.74,Nearest
10440,June,2022,Wood,OH,Passenger,0,1,1,4,5,20.0,Furthest
10441,June,2022,Suffolk,MA,Passenger,0,1,1,19,20,5.0,Furthest
10442,June,2022,Wake,NC,Passenger,1,0,1,80,81,1.23,Furthest
10443,June,2022,Ventura,CA,Passenger,1,1,2,226,228,0.88,Nearest
10444,June,2022,Miami-Dade,FL,Passenger,1,0,1,77,78,1.28,Furthest
10445,June,2022,Arapahoe,CO,Passenger,0,1,1,77,78,1.28,Mid-Distance
10446,June,2022,Pacific,WA,Passenger,61,71,132,15895,16027,0.82,Washington
10447,June,2022,Thurston,WA,Truck,7,0,7,55513,55520,0.01,Washington
10448,June,2022,Snohomish,WA,Truck,12,0,12,123913,123925,0.01,Washington
10449,June,2022,Harnett,NC,Passenger,2,0,2,141,143,1.4,Furthest
10450,June,2022,Rockdale,GA,Passenger,1,0,1,8,9,11.11,Furthest
10451,June,2022,Jefferson,WA,Truck,2,0,2,9461,9463,0.02,Washington
10452,June,2022,Houston,GA,Passenger,1,0,1,30,31,3.23,Furthest
10453,June,2023,Thurston,WA,Truck,60,0,60,53269,53329,0.11,Washington
10454,June,2023,Santa Barbara,CA,Passenger,1,0,1,58,59,1.69,Nearest
10455,June,2023,Spokane,WA,Truck,40,0,40,100674,100714,0.04,Washington
10456,June,2023,Lincoln,WA,Truck,0,0,0,4817,4817,0.0,Washington
10457,June,2023,Clark,WA,Passenger,5813,2318,8131,309808,317939,2.56,Washington
10458,June,2023,Jefferson,NY,Passenger,1,1,2,165,167,1.2,Furthest
10459,June,2023,Middlesex,MA,Passenger,2,1,3,57,60,5.0,Furthest
10460,June,2023,Sarasota,FL,Passenger,1,0,1,15,16,6.25,Furthest
10461,June,2023,Ferry,WA,Passenger,21,4,25,4268,4293,0.58,Washington
10462,June,2023,Sonoma,CA,Passenger,1,1,2,45,47,4.26,Nearest
10463,June,2023,Grays Harbor,WA,Passenger,296,186,482,47792,48274,1.0,Washington
10464,June,2023,Island,WA,Passenger,1074,439,1513,60607,62120,2.44,Washington
10465,June,2023,Vernon,LA,Passenger,1,0,1,64,65,1.54,Mid-Distance
10466,June,2023,Boulder,CO,Passenger,1,0,1,22,23,4.35,Mid-Distance
10467,June,2023,San Juan,WA,Passenger,616,172,788,13654,14442,5.46,Washington
10468,June,2023,Virginia Beach,VA,Passenger,2,0,2,399,401,0.5,Furthest
10469,June,2023,Bell,TX,Passenger,1,0,1,223,224,0.45,Mid-Distance
10470,June,2023,Collin,TX,Passenger,1,0,1,33,34,2.94,Mid-Distance
10471,June,2023,Larimer,CO,Passenger,1,0,1,30,31,3.23,Mid-Distance
10472,June,2023,Ray,MO,Passenger,0,1,1,0,1,100.0,Furthest
10473,June,2023,Coryell,TX,Passenger,1,0,1,68,69,1.45,Mid-Distance
10474,June,2023,Island,WA,Truck,32,0,32,20856,20888,0.15,Washington
10475,June,2023,Adams,CO,Passenger,1,0,1,23,24,4.17,Mid-Distance
10476,June,2023,Platte,MO,Passenger,1,0,1,16,17,5.88,Furthest
10477,June,2023,Douglas,WA,Truck,5,0,5,12829,12834,0.04,Washington
10478,June,2023,Stevens,WA,Truck,1,0,1,18505,18506,0.01,Washington
10479,June,2023,Suffolk,VA,Passenger,1,0,1,95,96,1.04,Furthest
10480,June,2023,Maricopa,AZ,Passenger,6,3,9,531,540,1.67,Nearest
10481,June,2023,Santa Clara,CA,Passenger,8,1,9,137,146,6.16,Nearest
10482,June,2023,Whitman,WA,Truck,4,0,4,8514,8518,0.05,Washington
10483,June,2023,Garfield,WA,Truck,0,0,0,957,957,0.0,Washington
10484,June,2023,Wahkiakum,WA,Passenger,27,17,44,3011,3055,1.44,Washington
10485,June,2023,Miami-Dade,FL,Passenger,1,0,1,51,52,1.92,Furthest
10486,June,2023,Gwinnett,GA,Passenger,1,0,1,36,37,2.7,Furthest
10487,June,2023,San Bernardino,CA,Passenger,2,1,3,241,244,1.23,Nearest
10488,June,2023,Grant,WA,Passenger,277,126,403,66206,66609,0.61,Washington
10489,June,2023,Napa,CA,Passenger,0,1,1,8,9,11.11,Nearest
10490,June,2023,Rockingham,NH,Passenger,1,0,1,10,11,9.09,Furthest
10491,June,2023,San Diego,CA,Passenger,16,9,25,1770,1795,1.39,Nearest
10492,June,2023,Hillsborough,FL,Passenger,0,1,1,93,94,1.06,Furthest
10493,June,2023,Berkeley,SC,Passenger,0,1,1,90,91,1.1,Furthest
10494,June,2023,Douglas,CO,Passenger,0,1,1,45,46,2.17,Mid-Distance
10495,June,2023,Ferry,WA,Truck,0,0,0,3530,3530,0.0,Washington
10496,June,2023,Washington,MD,Passenger,1,0,1,12,13,7.69,Furthest
10497,June,2023,Clallam,WA,Truck,20,0,20,21479,21499,0.09,Washington
10498,June,2023,Solano,CA,Passenger,5,0,5,129,134,3.73,Nearest
10499,June,2023,Los Angeles,CA,Passenger,4,4,8,540,548,1.46,Nearest
10500,June,2023,Santa Cruz,CA,Passenger,1,0,1,12,13,7.69,Nearest
10501,June,2023,Yakima,WA,Passenger,501,257,758,163736,164494,0.46,Washington
10502,June,2023,Goochland,VA,Passenger,0,1,1,29,30,3.33,Furthest
10503,June,2023,Hudson,NJ,Passenger,1,0,1,13,14,7.14,Furthest
10504,June,2023,Richmond,NY,Passenger,1,0,1,6,7,14.29,Furthest
10505,June,2023,Franklin,WA,Truck,5,0,5,20588,20593,0.02,Washington
10506,June,2023,Harnett,NC,Passenger,4,0,4,114,118,3.39,Furthest
10507,June,2023,Hennepin,MN,Passenger,1,0,1,27,28,3.57,Mid-Distance
10508,June,2023,Lake,IL,Passenger,3,0,3,102,105,2.86,Mid-Distance
10509,June,2023,El Paso,TX,Passenger,2,0,2,238,240,0.83,Mid-Distance
10510,June,2023,Pend Oreille,WA,Truck,0,0,0,5519,5519,0.0,Washington
10511,June,2023,Fairbanks North Star,AK,Passenger,0,1,1,44,45,2.22,Nearest
10512,June,2023,Alameda,CA,Passenger,3,0,3,140,143,2.1,Nearest
10513,June,2023,District of Columbia,DC,Passenger,5,0,5,138,143,3.5,Furthest
10514,June,2023,Calvert,MD,Passenger,1,1,2,66,68,2.94,Furthest
10515,June,2023,Hamilton,OH,Passenger,1,0,1,24,25,4.0,Furthest
10516,June,2023,Skamania,WA,Truck,1,0,1,3776,3777,0.03,Washington
10517,June,2023,Snohomish,WA,Passenger,12560,3041,15601,521750,537351,2.9,Washington
10518,June,2023,Howard,MD,Passenger,0,1,1,40,41,2.44,Furthest
10519,June,2023,Ulster,NY,Passenger,1,0,1,4,5,20.0,Furthest
10520,June,2023,Rock Island,IL,Passenger,0,1,1,13,14,7.14,Mid-Distance
10521,June,2023,Contra Costa,CA,Passenger,0,3,3,182,185,1.62,Nearest
10522,June,2023,Dallas,TX,Passenger,1,0,1,67,68,1.47,Mid-Distance
10523,June,2023,Pacific,WA,Truck,4,0,4,7732,7736,0.05,Washington
10524,June,2023,Cumberland,PA,Passenger,1,0,1,26,27,3.7,Furthest
10525,June,2023,Hoke,NC,Passenger,1,0,1,50,51,1.96,Furthest
10526,June,2023,Fairfax,VA,Truck,1,0,1,81,82,1.22,Furthest
10527,June,2023,Stafford,VA,Passenger,3,1,4,68,72,5.56,Furthest
10528,June,2023,Sarpy,NE,Passenger,1,0,1,42,43,2.33,Mid-Distance
10529,June,2023,Arapahoe,CO,Passenger,1,1,2,59,61,3.28,Mid-Distance
10530,June,2023,Benton,WA,Passenger,1136,563,1699,133564,135263,1.26,Washington
10531,June,2023,Kern,CA,Passenger,1,1,2,158,160,1.25,Nearest
10532,June,2023,Richmond,GA,Passenger,0,1,1,54,55,1.82,Furthest
10533,June,2023,Ventura,CA,Passenger,1,1,2,185,187,1.07,Nearest
10534,June,2023,Asotin,WA,Truck,0,0,0,6592,6592,0.0,Washington
10535,June,2023,Madison,IL,Passenger,1,0,1,14,15,6.67,Mid-Distance
10536,June,2023,New London,CT,Passenger,1,4,5,163,168,2.98,Furthest
10537,June,2023,Moore,NC,Passenger,0,1,1,96,97,1.03,Furthest
10538,June,2023,Loudoun,VA,Passenger,2,0,2,55,57,3.51,Furthest
10539,June,2023,Burlington,NJ,Passenger,0,2,2,84,86,2.33,Furthest
10540,June,2023,Spokane,WA,Passenger,2298,1094,3392,319256,322648,1.05,Washington
10541,June,2023,San Juan,WA,Truck,11,0,11,5823,5834,0.19,Washington
10542,June,2023,Kitsap,WA,Passenger,3208,1283,4491,174228,178719,2.51,Washington
10543,June,2023,Adams,WA,Passenger,25,12,37,12863,12900,0.29,Washington
10544,June,2023,Oldham,KY,Passenger,0,1,1,3,4,25.0,Furthest
10545,June,2023,St. Tammany,LA,Passenger,1,0,1,28,29,3.45,Mid-Distance
10546,June,2023,Wahkiakum,WA,Truck,2,0,2,1746,1748,0.11,Washington
10547,June,2023,Mason,WA,Passenger,442,206,648,45684,46332,1.4,Washington
10548,June,2023,Jefferson,WA,Truck,12,0,12,9231,9243,0.13,Washington
10549,June,2023,Pend Oreille,WA,Passenger,30,13,43,8795,8838,0.49,Washington
10550,June,2023,Kent,DE,Passenger,1,0,1,41,42,2.38,Furthest
10551,June,2023,Benton,WA,Truck,24,0,24,42574,42598,0.06,Washington
10552,June,2023,Walla Walla,WA,Truck,5,0,5,13510,13515,0.04,Washington
10553,June,2023,Kittitas,WA,Truck,8,0,8,14383,14391,0.06,Washington
10554,June,2023,Skamania,WA,Passenger,104,59,163,7905,8068,2.02,Washington
10555,June,2023,Saratoga,NY,Passenger,1,1,2,27,29,6.9,Furthest
10556,June,2023,Stevens,WA,Passenger,112,68,180,29348,29528,0.61,Washington
10557,June,2023,Portsmouth,VA,Passenger,0,1,1,56,57,1.75,Furthest
10558,June,2023,Garfield,WA,Passenger,1,3,4,1291,1295,0.31,Washington
10559,June,2023,Lewis,WA,Truck,7,0,7,25651,25658,0.03,Washington
10560,June,2023,Adams,WA,Truck,3,0,3,5232,5235,0.06,Washington
10561,June,2023,Pacific,WA,Passenger,76,88,164,15453,15617,1.05,Washington
10562,June,2023,Cape May,NJ,Passenger,0,1,1,7,8,12.5,Furthest
10563,June,2023,Houston,GA,Passenger,1,0,1,26,27,3.7,Furthest
10564,June,2023,Escambia,FL,Passenger,0,1,1,99,100,1.0,Furthest
10565,June,2023,Galveston,TX,Passenger,0,1,1,13,14,7.14,Mid-Distance
10566,June,2023,Lincoln,WA,Passenger,16,18,34,7573,7607,0.45,Washington
10567,June,2023,Anne Arundel,MD,Passenger,5,4,9,270,279,3.23,Furthest
10568,June,2023,Yellowstone,MT,Passenger,0,1,1,13,14,7.14,Nearest
10569,June,2023,Leavenworth,KS,Passenger,0,1,1,88,89,1.12,Mid-Distance
10570,June,2023,Plaquemines,LA,Passenger,1,1,2,12,14,14.29,Mid-Distance
10571,June,2023,DeKalb,GA,Passenger,1,0,1,35,36,2.78,Furthest
10572,June,2023,Yavapai,AZ,Passenger,1,0,1,18,19,5.26,Nearest
10573,June,2023,Okanogan,WA,Truck,7,0,7,16188,16195,0.04,Washington
10574,June,2023,Las Animas,CO,Passenger,1,0,1,0,1,100.0,Mid-Distance
10575,June,2023,Arlington,VA,Passenger,1,0,1,95,96,1.04,Furthest
10576,June,2023,Beaufort,SC,Passenger,1,0,1,19,20,5.0,Furthest
10577,June,2023,Carroll,MD,Passenger,0,1,1,16,17,5.88,Furthest
10578,June,2023,Sedgwick,KS,Passenger,1,0,1,50,51,1.96,Mid-Distance
10579,June,2023,St. Clair,IL,Passenger,1,0,1,91,92,1.09,Mid-Distance
10580,June,2023,St. Louis,MO,Passenger,1,0,1,44,45,2.22,Furthest
10581,June,2023,Columbia,WA,Truck,0,0,0,1535,1535,0.0,Washington
10582,June,2023,Benton,OR,Passenger,1,0,1,29,30,3.33,Nearest
10583,June,2023,Jefferson,WA,Passenger,560,258,818,24060,24878,3.29,Washington
10584,June,2023,Riverside,CA,Passenger,6,0,6,337,343,1.75,Nearest
10585,June,2023,Hamilton,OH,Truck,1,0,1,2,3,33.33,Furthest
10586,June,2023,Bexar,TX,Passenger,2,2,4,317,321,1.25,Mid-Distance
10587,June,2023,Snohomish,WA,Truck,173,0,173,119726,119899,0.14,Washington
10589,June,2023,Allen,IN,Passenger,1,0,1,7,8,12.5,Furthest
10590,June,2023,Wichita,TX,Passenger,2,0,2,30,32,6.25,Mid-Distance
10591,June,2023,New Haven,CT,Passenger,0,2,2,20,22,9.09,Furthest
10592,June,2023,Clark,NV,Passenger,3,2,5,345,350,1.43,Nearest
10593,June,2023,Broward,FL,Passenger,1,0,1,52,53,1.89,Furthest
10594,June,2023,Columbia,WA,Passenger,11,1,12,2395,2407,0.5,Washington
10595,June,2023,Kings,CA,Passenger,2,1,3,246,249,1.2,Nearest
10596,June,2023,Pierce,WA,Passenger,7556,2770,10326,524039,534365,1.93,Washington
10597,June,2023,Dorchester,SC,Passenger,1,0,1,34,35,2.86,Furthest
10598,June,2023,Hidalgo,TX,Passenger,0,1,1,38,39,2.56,Mid-Distance
10599,June,2023,Onslow,NC,Passenger,0,1,1,131,132,0.76,Furthest
10600,June,2023,Champaign,IL,Passenger,1,0,1,7,8,12.5,Mid-Distance
10601,June,2023,Sheridan,WY,Passenger,1,0,1,5,6,16.67,Nearest
10602,June,2023,Williamson,TX,Passenger,0,1,1,43,44,2.27,Mid-Distance
10603,June,2023,Newport News,VA,Passenger,1,0,1,88,89,1.12,Furthest
10604,June,2023,Hawaii,HI,Passenger,1,0,1,25,26,3.85,Nearest
10605,June,2023,Charles,MD,Passenger,1,1,2,48,50,4.0,Furthest
10606,June,2023,Kitsap,WA,Truck,76,0,76,51739,51815,0.15,Washington
10607,June,2023,Frederick,MD,Passenger,1,1,2,47,49,4.08,Furthest
10608,June,2023,Clallam,WA,Passenger,545,283,828,48445,49273,1.68,Washington
10609,June,2023,Franklin,WA,Passenger,302,137,439,61004,61443,0.71,Washington
10610,June,2023,Lewis,WA,Passenger,327,206,533,58421,58954,0.9,Washington
10611,June,2023,Chesapeake,VA,Passenger,2,3,5,258,263,1.9,Furthest
10612,June,2023,Randolph,NC,Passenger,1,0,1,3,4,25.0,Furthest
10613,June,2023,Whatcom,WA,Passenger,2467,871,3338,145997,149335,2.24,Washington
10614,June,2023,Kootenai,ID,Truck,1,0,1,23,24,4.17,Nearest
10615,June,2023,Polk,OR,Passenger,0,1,1,14,15,6.67,Nearest
10616,June,2023,Multnomah,OR,Passenger,0,2,2,382,384,0.52,Nearest
10617,June,2023,Wilson,TX,Passenger,0,1,1,2,3,33.33,Mid-Distance
10618,June,2023,Mason,WA,Truck,11,0,11,20405,20416,0.05,Washington
10619,June,2023,Pierce,WA,Truck,163,0,163,135232,135395,0.12,Washington
10620,June,2023,Skagit,WA,Truck,21,0,21,31455,31476,0.07,Washington
10621,June,2023,Nueces,TX,Passenger,1,1,2,48,50,4.0,Mid-Distance
10622,June,2023,Alexandria,VA,Passenger,2,1,3,83,86,3.49,Furthest
10623,June,2023,Cumberland,NC,Passenger,1,2,3,276,279,1.08,Furthest
10624,June,2023,Cowlitz,WA,Truck,9,0,9,27797,27806,0.03,Washington
10625,June,2023,Camden,NJ,Passenger,0,1,1,12,13,7.69,Furthest
10626,June,2023,Skagit,WA,Passenger,1105,413,1518,87670,89188,1.7,Washington
10627,June,2023,Monterey,CA,Passenger,1,0,1,98,99,1.01,Nearest
10628,June,2023,Grays Harbor,WA,Truck,7,0,7,20684,20691,0.03,Washington
10629,June,2023,Kittitas,WA,Passenger,350,103,453,28878,29331,1.54,Washington
10630,June,2023,El Paso,CO,Passenger,3,1,4,441,445,0.9,Mid-Distance
10631,June,2023,Cook,IL,Passenger,2,0,2,127,129,1.55,Mid-Distance
10632,June,2023,Lane,OR,Passenger,0,1,1,55,56,1.79,Nearest
10633,June,2023,Elmore,ID,Passenger,1,0,1,8,9,11.11,Nearest
10634,June,2023,Chelan,WA,Truck,31,0,31,22830,22861,0.14,Washington
10635,June,2023,Whatcom,WA,Truck,58,0,58,42106,42164,0.14,Washington
10636,June,2023,Walla Walla,WA,Passenger,219,111,330,34992,35322,0.93,Washington
10637,June,2023,Clark,WA,Truck,97,0,97,80308,80405,0.12,Washington
10638,June,2023,Douglas,WA,Passenger,209,64,273,28488,28761,0.95,Washington
10639,June,2023,Prince George's,MD,Passenger,3,1,4,97,101,3.96,Furthest
10640,June,2023,Pulaski,AR,Passenger,3,0,3,17,20,15.0,Mid-Distance
10641,June,2023,Lee,AL,Passenger,1,0,1,11,12,8.33,Furthest
10642,June,2023,Yakima,WA,Truck,13,0,13,60023,60036,0.02,Washington
10643,June,2023,Okanogan,WA,Passenger,123,63,186,25802,25988,0.72,Washington
10644,June,2023,Kauai,HI,Passenger,1,1,2,14,16,12.5,Nearest
10645,June,2023,Rockdale,GA,Passenger,1,0,1,3,4,25.0,Furthest
10646,June,2023,Placer,CA,Passenger,1,0,1,50,51,1.96,Nearest
10647,June,2023,Geary,KS,Passenger,1,0,1,66,67,1.49,Mid-Distance
10648,June,2023,Montgomery,MD,Passenger,3,2,5,160,165,3.03,Furthest
10649,June,2023,Chelan,WA,Passenger,637,162,799,53633,54432,1.47,Washington
10650,June,2023,St. Mary's,MD,Passenger,1,0,1,158,159,0.63,Furthest
10651,June,2023,Sacramento,CA,Passenger,5,0,5,126,131,3.82,Nearest
10652,June,2023,Essex,NJ,Passenger,2,0,2,4,6,33.33,Furthest
10653,June,2023,Thurston,WA,Passenger,3092,1222,4314,188101,192415,2.24,Washington
10654,June,2023,Klickitat,WA,Truck,12,0,12,8137,8149,0.15,Washington
10655,June,2023,Travis,TX,Passenger,1,0,1,73,74,1.35,Mid-Distance
10656,June,2023,Grant,WA,Truck,11,0,11,27666,27677,0.04,Washington
10657,June,2023,Honolulu,HI,Passenger,2,3,5,225,230,2.17,Nearest
10658,June,2023,Douglas,NE,Passenger,1,1,2,22,24,8.33,Mid-Distance
10659,June,2023,Whitman,WA,Passenger,150,79,229,21790,22019,1.04,Washington
10660,June,2023,Norfolk,VA,Passenger,2,2,4,243,247,1.62,Furthest
10661,June,2023,Marin,CA,Passenger,0,1,1,26,27,3.7,Nearest
10662,June,2023,Lincoln,OR,Passenger,0,1,1,12,13,7.69,Nearest
10663,June,2023,Emmet,MI,Passenger,0,1,1,0,1,100.0,Furthest
10664,June,2023,King,WA,Passenger,56981,14563,71544,1312113,1383657,5.17,Washington
10665,June,2023,King,WA,Truck,723,2,725,173265,173990,0.42,Washington
10666,June,2023,Harrison,MS,Passenger,1,0,1,26,27,3.7,Mid-Distance
10667,June,2023,Fairfax,VA,Passenger,5,3,8,508,516,1.55,Furthest
10668,June,2023,Orange,CA,Passenger,6,2,8,249,257,3.11,Nearest
10669,June,2023,Jackson,OK,Passenger,0,1,1,30,31,3.23,Mid-Distance
10670,June,2023,Asotin,WA,Passenger,35,22,57,12311,12368,0.46,Washington
10671,June,2023,Klickitat,WA,Passenger,151,63,214,14939,15153,1.41,Washington
10672,June,2023,Charleston,SC,Passenger,1,2,3,45,48,6.25,Furthest
10673,June,2023,Cowlitz,WA,Passenger,470,215,685,68949,69634,0.98,Washington
10674,June,2023,Salt Lake,UT,Passenger,0,1,1,80,81,1.23,Nearest
10675,March,2017,Cape May,NJ,Passenger,0,1,1,18,19,5.26,Furthest
10676,March,2017,Pacific,WA,Passenger,6,8,14,15078,15092,0.09,Washington
10677,March,2017,Kittitas,WA,Passenger,17,16,33,27117,27150,0.12,Washington
10678,March,2017,Pima,AZ,Passenger,0,2,2,445,447,0.45,Nearest
10679,March,2017,Lincoln,WA,Truck,0,0,0,4469,4469,0.0,Washington
10680,March,2017,Portsmouth,VA,Passenger,0,1,1,67,68,1.47,Furthest
10681,March,2017,Skagit,WA,Truck,1,0,1,31426,31427,0.0,Washington
10682,March,2017,Virginia Beach,VA,Passenger,2,1,3,652,655,0.46,Furthest
10683,March,2017,Manatee,FL,Passenger,1,0,1,52,53,1.89,Furthest
10684,March,2017,Prince George's,MD,Passenger,0,1,1,183,184,0.54,Furthest
10685,March,2017,Clark,NV,Passenger,1,3,4,865,869,0.46,Nearest
10686,March,2017,Manassas,VA,Passenger,0,1,1,9,10,10.0,Furthest
10687,March,2017,Harnett,NC,Passenger,1,0,1,258,259,0.39,Furthest
10688,March,2017,El Paso,CO,Passenger,1,1,2,825,827,0.24,Mid-Distance
10689,March,2017,Charles,MD,Passenger,0,1,1,91,92,1.09,Furthest
10690,March,2017,Yakima,WA,Passenger,36,50,86,159228,159314,0.05,Washington
10691,March,2017,Cascade,MT,Passenger,0,1,1,60,61,1.64,Nearest
10692,March,2017,Wahkiakum,WA,Passenger,0,2,2,2849,2851,0.07,Washington
10693,March,2017,Pierce,WA,Passenger,876,784,1660,526368,528028,0.31,Washington
10694,March,2017,Howard,MD,Passenger,0,2,2,89,91,2.2,Furthest
10695,March,2017,Pacific,WA,Truck,0,0,0,7480,7480,0.0,Washington
10696,March,2017,Jackson,MO,Passenger,1,0,1,68,69,1.45,Furthest
10697,March,2017,Saratoga,NY,Passenger,1,1,2,77,79,2.53,Furthest
10698,March,2017,Yakima,WA,Truck,0,0,0,57266,57266,0.0,Washington
10699,March,2017,Cobb,GA,Passenger,0,1,1,79,80,1.25,Furthest
10700,March,2017,Franklin,MA,Passenger,0,1,1,4,5,20.0,Furthest
10701,March,2017,Dane,WI,Passenger,1,0,1,153,154,0.65,Mid-Distance
10702,March,2017,Nueces,TX,Passenger,0,1,1,100,101,0.99,Mid-Distance
10703,March,2017,Fulton,GA,Passenger,1,1,2,123,125,1.6,Furthest
10704,March,2017,Albemarle,VA,Passenger,0,1,1,30,31,3.23,Furthest
10705,March,2017,Montgomery,MD,Passenger,1,0,1,306,307,0.33,Furthest
10706,March,2017,Canyon,ID,Passenger,0,1,1,104,105,0.95,Nearest
10707,March,2017,Lane,OR,Passenger,0,1,1,257,258,0.39,Nearest
10708,March,2017,Monroe,NY,Passenger,1,0,1,29,30,3.33,Furthest
10709,March,2017,Grant,WA,Truck,0,0,0,25045,25045,0.0,Washington
10710,March,2017,Santa Fe,NM,Passenger,0,1,1,45,46,2.17,Mid-Distance
10711,March,2017,Clallam,WA,Truck,0,0,0,21041,21041,0.0,Washington
10712,March,2017,Anne Arundel,MD,Passenger,0,1,1,503,504,0.2,Furthest
10713,March,2017,San Mateo,CA,Passenger,0,1,1,157,158,0.63,Nearest
10714,March,2017,Cowlitz,WA,Truck,0,0,0,27906,27906,0.0,Washington
10715,March,2017,Los Angeles,CA,Passenger,3,1,4,1365,1369,0.29,Nearest
10716,March,2017,Ferry,WA,Passenger,2,1,3,4386,4389,0.07,Washington
10717,March,2017,Orange,CA,Passenger,2,1,3,659,662,0.45,Nearest
10718,March,2017,Sumter,FL,Passenger,0,1,1,10,11,9.09,Furthest
10719,March,2017,Kitsap,WA,Passenger,572,289,861,172480,173341,0.5,Washington
10720,March,2017,Douglas,OR,Passenger,0,1,1,75,76,1.32,Nearest
10721,March,2017,Spokane,WA,Passenger,232,202,434,295454,295888,0.15,Washington
10722,March,2017,Fairfax,VA,Passenger,2,2,4,867,871,0.46,Furthest
10723,March,2017,Klickitat,WA,Passenger,21,23,44,14774,14818,0.3,Washington
10724,March,2017,Lewis,WA,Passenger,45,34,79,55095,55174,0.14,Washington
10725,March,2017,Douglas,WA,Passenger,29,19,48,26592,26640,0.18,Washington
10726,March,2017,Utah,UT,Passenger,0,1,1,168,169,0.59,Nearest
10727,March,2017,Grant,WA,Passenger,17,21,38,60332,60370,0.06,Washington
10728,March,2017,Hawaii,HI,Passenger,1,0,1,87,88,1.14,Nearest
10729,March,2017,Adams,WA,Truck,0,0,0,5070,5070,0.0,Washington
10730,March,2017,Mason,WA,Truck,0,0,0,19230,19230,0.0,Washington
10731,March,2017,Grays Harbor,WA,Truck,0,0,0,19865,19865,0.0,Washington
10732,March,2017,Orleans,LA,Passenger,0,1,1,50,51,1.96,Mid-Distance
10733,March,2017,DeKalb,IN,Passenger,1,0,1,1,2,50.0,Furthest
10734,March,2017,Asotin,WA,Truck,0,0,0,6511,6511,0.0,Washington
10735,March,2017,King,WA,Passenger,9317,3787,13104,1382738,1395842,0.94,Washington
10736,March,2017,Dallas,TX,Passenger,1,1,2,206,208,0.96,Mid-Distance
10737,March,2017,Ferry,WA,Truck,0,0,0,3554,3554,0.0,Washington
10738,March,2017,San Juan,WA,Passenger,88,34,122,13420,13542,0.9,Washington
10739,March,2017,Columbia,WA,Truck,0,0,0,1529,1529,0.0,Washington
10740,March,2017,New London,CT,Passenger,1,1,2,263,265,0.75,Furthest
10741,March,2017,Clackamas,OR,Passenger,1,2,3,339,342,0.88,Nearest
10742,March,2017,Hamilton,IN,Passenger,1,0,1,64,65,1.54,Furthest
10743,March,2017,Pend Oreille,WA,Truck,0,0,0,5583,5583,0.0,Washington
10744,March,2017,Travis,TX,Passenger,0,1,1,192,193,0.52,Mid-Distance
10745,March,2017,Guilford,NC,Passenger,1,0,1,31,32,3.12,Furthest
10746,March,2017,Deschutes,OR,Passenger,1,0,1,202,203,0.49,Nearest
10747,March,2017,Lewis,NY,Passenger,0,1,1,10,11,9.09,Furthest
10748,March,2017,Dakota,MN,Passenger,0,1,1,41,42,2.38,Mid-Distance
10749,March,2017,Wahkiakum,WA,Truck,0,0,0,1635,1635,0.0,Washington
10750,March,2017,Clark,WA,Truck,0,0,0,77572,77572,0.0,Washington
10751,March,2017,Hardin,KY,Passenger,0,1,1,126,127,0.79,Furthest
10752,March,2017,Douglas,WA,Truck,0,0,0,11441,11441,0.0,Washington
10753,March,2017,Ventura,CA,Passenger,0,2,2,375,377,0.53,Nearest
10754,March,2017,Richmond,GA,Passenger,0,1,1,95,96,1.04,Furthest
10755,March,2017,Chelan,WA,Passenger,55,30,85,51678,51763,0.16,Washington
10756,March,2017,Tarrant,TX,Passenger,0,2,2,289,291,0.69,Mid-Distance
10757,March,2017,Muscogee,GA,Passenger,0,1,1,253,254,0.39,Furthest
10758,March,2017,Benton,WA,Passenger,140,139,279,127941,128220,0.22,Washington
10759,March,2017,Jefferson,NY,Passenger,1,1,2,260,262,0.76,Furthest
10760,March,2017,Nantucket,MA,Passenger,1,0,1,3,4,25.0,Furthest
10761,March,2017,Jefferson,WA,Truck,0,0,0,9447,9447,0.0,Washington
10762,March,2017,Marin,CA,Passenger,1,0,1,59,60,1.67,Nearest
10763,March,2017,Okanogan,WA,Truck,0,0,0,16304,16304,0.0,Washington
10764,March,2017,Stevens,WA,Passenger,6,20,26,31284,31310,0.08,Washington
10765,March,2017,Clallam,WA,Passenger,77,65,142,48078,48220,0.29,Washington
10766,March,2017,Duval,FL,Passenger,1,1,2,373,375,0.53,Furthest
10767,March,2017,San Juan,WA,Truck,0,0,0,5583,5583,0.0,Washington
10768,March,2017,Whatcom,WA,Passenger,416,156,572,142234,142806,0.4,Washington
10769,March,2017,Pinal,AZ,Passenger,2,0,2,263,265,0.75,Nearest
10770,March,2017,Montgomery,TN,Passenger,1,0,1,287,288,0.35,Furthest
10771,March,2017,Moore,NC,Passenger,0,1,1,208,209,0.48,Furthest
10772,March,2017,Missoula,MT,Passenger,1,0,1,80,81,1.23,Nearest
10773,March,2017,Island,WA,Truck,0,0,0,20500,20500,0.0,Washington
10774,March,2017,Okanogan,WA,Passenger,3,16,19,25642,25661,0.07,Washington
10775,March,2017,Nassau,NY,Passenger,0,1,1,40,41,2.44,Furthest
10776,March,2017,Essex,NJ,Passenger,1,0,1,16,17,5.88,Furthest
10777,March,2017,Chelan,WA,Truck,0,0,0,21220,21220,0.0,Washington
10778,March,2017,Grays Harbor,WA,Passenger,27,26,53,44419,44472,0.12,Washington
10779,March,2017,Franklin,WA,Truck,0,0,0,17960,17960,0.0,Washington
10780,March,2017,Norfolk,VA,Passenger,1,1,2,304,306,0.65,Furthest
10781,March,2017,Whatcom,WA,Truck,2,0,2,41393,41395,0.0,Washington
10782,March,2017,Gwinnett,GA,Passenger,0,1,1,84,85,1.18,Furthest
10783,March,2017,Northampton,PA,Passenger,2,0,2,209,211,0.95,Furthest
10784,March,2017,Lee,AL,Passenger,1,0,1,35,36,2.78,Furthest
10785,March,2017,Asotin,WA,Passenger,5,2,7,12335,12342,0.06,Washington
10786,March,2017,Benton,WA,Truck,0,0,0,39849,39849,0.0,Washington
10787,March,2017,Garfield,WA,Truck,0,0,0,940,940,0.0,Washington
10788,March,2017,Thurston,WA,Passenger,365,313,678,185430,186108,0.36,Washington
10789,March,2017,Shelby,TN,Passenger,0,1,1,110,111,0.9,Furthest
10790,March,2017,Wayne,MI,Passenger,0,1,1,71,72,1.39,Furthest
10791,March,2017,Clark,WA,Passenger,718,454,1172,298270,299442,0.39,Washington
10792,March,2017,Latah,ID,Passenger,0,1,1,121,122,0.82,Nearest
10793,March,2017,Hidalgo,TX,Passenger,0,1,1,97,98,1.02,Mid-Distance
10794,March,2017,Madison,ID,Passenger,1,0,1,44,45,2.22,Nearest
10795,March,2017,Dale,AL,Passenger,0,1,1,64,65,1.54,Furthest
10796,March,2017,Monterey,CA,Passenger,0,1,1,218,219,0.46,Nearest
10797,March,2017,Kittitas,WA,Truck,0,0,0,13423,13423,0.0,Washington
10798,March,2017,Thurston,WA,Truck,0,0,0,53299,53299,0.0,Washington
10799,March,2017,Pierce,WA,Truck,0,0,0,138175,138175,0.0,Washington
10800,March,2017,Whitman,WA,Passenger,9,18,27,21937,21964,0.12,Washington
10801,March,2017,Prince William,VA,Passenger,0,3,3,275,278,1.08,Furthest
10802,March,2017,DeKalb,GA,Passenger,1,0,1,84,85,1.18,Furthest
10803,March,2017,Cumberland,NC,Passenger,1,0,1,622,623,0.16,Furthest
10804,March,2017,Adams,WA,Passenger,2,4,6,12107,12113,0.05,Washington
10805,March,2017,Honolulu,HI,Passenger,4,2,6,616,622,0.96,Nearest
10806,March,2017,Skagit,WA,Passenger,118,91,209,87516,87725,0.24,Washington
10807,March,2017,Volusia,FL,Passenger,0,1,1,46,47,2.13,Furthest
10808,March,2017,Snohomish,WA,Truck,1,0,1,122199,122200,0.0,Washington
10809,March,2017,Bexar,TX,Passenger,1,2,3,1088,1091,0.27,Mid-Distance
10810,March,2017,Allegheny,PA,Passenger,1,0,1,91,92,1.09,Furthest
10811,March,2017,Middlesex,MA,Passenger,1,0,1,152,153,0.65,Furthest
10812,March,2017,Norfolk,MA,Passenger,1,0,1,37,38,2.63,Furthest
10813,March,2017,Walla Walla,WA,Truck,0,0,0,13186,13186,0.0,Washington
10814,March,2017,Klickitat,WA,Truck,0,0,0,7941,7941,0.0,Washington
10815,March,2017,Multnomah,OR,Passenger,0,3,3,1110,1113,0.27,Nearest
10816,March,2017,Snohomish,WA,Passenger,1656,849,2505,513393,515898,0.49,Washington
10817,March,2017,Stevens,WA,Truck,0,0,0,18309,18309,0.0,Washington
10818,March,2017,Salt Lake,UT,Passenger,0,1,1,309,310,0.32,Nearest
10819,March,2017,Marion,OR,Passenger,1,0,1,195,196,0.51,Nearest
10820,March,2017,Maricopa,AZ,Passenger,2,0,2,1827,1829,0.11,Nearest
10821,March,2017,King,WA,Truck,8,1,9,189758,189767,0.0,Washington
10822,March,2017,Walla Walla,WA,Passenger,20,22,42,34821,34863,0.12,Washington
10823,March,2017,Arlington,VA,Passenger,1,1,2,168,170,1.18,Furthest
10824,March,2017,New Haven,CT,Passenger,0,1,1,61,62,1.61,Furthest
10825,March,2017,Morris,NJ,Passenger,1,0,1,22,23,4.35,Furthest
10826,March,2017,Orange,FL,Passenger,1,1,2,152,154,1.3,Furthest
10827,March,2017,Franklin,WA,Passenger,26,47,73,55311,55384,0.13,Washington
10828,March,2017,Skamania,WA,Passenger,8,8,16,8529,8545,0.19,Washington
10829,March,2017,Garfield,WA,Passenger,0,0,0,1283,1283,0.0,Washington
10830,March,2017,San Diego,CA,Passenger,5,1,6,2806,2812,0.21,Nearest
10831,March,2017,Pend Oreille,WA,Passenger,1,4,5,9307,9312,0.05,Washington
10832,March,2017,Tulare,CA,Passenger,1,0,1,194,195,0.51,Nearest
10833,March,2017,Whitman,WA,Truck,0,0,0,8389,8389,0.0,Washington
10834,March,2017,Polk,FL,Passenger,1,0,1,66,67,1.49,Furthest
10835,March,2017,Franklin,OH,Passenger,0,1,1,115,116,0.86,Furthest
10836,March,2017,Alameda,CA,Passenger,3,1,4,383,387,1.03,Nearest
10837,March,2017,Hamilton,TN,Passenger,1,0,1,26,27,3.7,Furthest
10838,March,2017,Okaloosa,FL,Passenger,1,0,1,193,194,0.52,Furthest
10839,March,2017,St. Lucie,FL,Passenger,1,0,1,31,32,3.12,Furthest
10840,March,2017,Maui,HI,Passenger,1,0,1,71,72,1.39,Nearest
10841,March,2017,Columbia,WA,Passenger,0,1,1,2355,2356,0.04,Washington
10842,March,2017,Island,WA,Passenger,105,129,234,59602,59836,0.39,Washington
10843,March,2017,Riverside,CA,Passenger,1,1,2,828,830,0.24,Nearest
10844,March,2017,Lincoln,WA,Passenger,2,4,6,7506,7512,0.08,Washington
10845,March,2017,Santa Clara,CA,Passenger,6,2,8,415,423,1.89,Nearest
10846,March,2017,Cowlitz,WA,Passenger,51,48,99,69297,69396,0.14,Washington
10847,March,2017,Montgomery,PA,Passenger,1,0,1,42,43,2.33,Furthest
10848,March,2017,Juneau,AK,Passenger,0,1,1,53,54,1.85,Nearest
10849,March,2017,Bergen,NJ,Passenger,0,2,2,32,34,5.88,Furthest
10850,March,2017,Jefferson,WA,Passenger,94,57,151,23648,23799,0.63,Washington
10851,March,2017,Carroll,NH,Passenger,0,1,1,0,1,100.0,Furthest
10852,March,2017,Mason,WA,Passenger,50,65,115,42929,43044,0.27,Washington
10853,March,2017,Kitsap,WA,Truck,1,0,1,52317,52318,0.0,Washington
10854,March,2017,District of Columbia,DC,Passenger,0,3,3,224,227,1.32,Furthest
10855,March,2017,Lewis,WA,Truck,0,0,0,24813,24813,0.0,Washington
10856,March,2017,Spokane,WA,Truck,1,0,1,90256,90257,0.0,Washington
10857,March,2017,Skamania,WA,Truck,0,0,0,3882,3882,0.0,Washington
10858,March,2017,Oklahoma,OK,Passenger,0,1,1,168,169,0.59,Mid-Distance
10860,March,2018,Kittitas,WA,Truck,0,0,0,13984,13984,0.0,Washington
10861,March,2018,Thurston,WA,Passenger,518,432,950,191158,192108,0.49,Washington
10862,March,2018,Hardin,KY,Passenger,0,1,1,118,119,0.84,Furthest
10863,March,2018,Los Angeles,CA,Passenger,5,4,9,1180,1189,0.76,Nearest
10864,March,2018,Pend Oreille,WA,Passenger,4,3,7,9455,9462,0.07,Washington
10865,March,2018,El Paso,CO,Passenger,2,0,2,753,755,0.26,Mid-Distance
10866,March,2018,DuPage,IL,Passenger,1,0,1,65,66,1.52,Mid-Distance
10867,March,2018,Okanogan,WA,Truck,0,0,0,16333,16333,0.0,Washington
10868,March,2018,Chelan,WA,Truck,0,0,0,21720,21720,0.0,Washington
10870,March,2018,Anne Arundel,MD,Passenger,0,2,2,466,468,0.43,Furthest
10871,March,2018,Cowlitz,WA,Truck,0,0,0,28271,28271,0.0,Washington
10872,March,2018,Saratoga,NY,Passenger,1,1,2,66,68,2.94,Furthest
10873,March,2018,Pinal,AZ,Passenger,2,0,2,209,211,0.95,Nearest
10874,March,2018,Cowlitz,WA,Passenger,55,70,125,71222,71347,0.18,Washington
10875,March,2018,Stevens,WA,Truck,0,0,0,18427,18427,0.0,Washington
10876,March,2018,Whatcom,WA,Truck,2,0,2,42069,42071,0.0,Washington
10877,March,2018,Orleans,LA,Passenger,0,1,1,46,47,2.13,Mid-Distance
10878,March,2018,Pierce,WA,Passenger,1126,1053,2179,527857,530036,0.41,Washington
10879,March,2018,Flathead,MT,Passenger,1,0,1,51,52,1.92,Nearest
10880,March,2018,Montgomery,MD,Passenger,1,0,1,296,297,0.34,Furthest
10881,March,2018,Ferry,WA,Passenger,1,3,4,4404,4408,0.09,Washington
10882,March,2018,Walla Walla,WA,Truck,0,0,0,13311,13311,0.0,Washington
10883,March,2018,Pierce,WA,Truck,0,0,0,137102,137102,0.0,Washington
10884,March,2018,Lewis,WA,Truck,0,0,0,25255,25255,0.0,Washington
10885,March,2018,Lumpkin,GA,Passenger,1,0,1,7,8,12.5,Furthest
10886,March,2018,Santa Clara,CA,Passenger,6,1,7,377,384,1.82,Nearest
10887,March,2018,Riverside,CA,Passenger,2,2,4,706,710,0.56,Nearest
10888,March,2018,Ferry,WA,Truck,0,0,0,3504,3504,0.0,Washington
10889,March,2018,San Mateo,CA,Passenger,1,1,2,135,137,1.46,Nearest
10890,March,2018,DeKalb,GA,Passenger,1,0,1,81,82,1.22,Furthest
10891,March,2018,Canyon,ID,Passenger,0,1,1,94,95,1.05,Nearest
10892,March,2018,Douglas,WA,Passenger,42,33,75,27415,27490,0.27,Washington
10893,March,2018,Dale,AL,Passenger,0,1,1,62,63,1.59,Furthest
10894,March,2018,Monterey,CA,Passenger,0,2,2,190,192,1.04,Nearest
10895,March,2018,Jefferson,WA,Passenger,132,88,220,24289,24509,0.9,Washington
10896,March,2018,Montgomery,TX,Passenger,1,0,1,63,64,1.56,Mid-Distance
10897,March,2018,Nueces,TX,Passenger,1,1,2,94,96,2.08,Mid-Distance
10898,March,2018,Twin Falls,ID,Passenger,0,1,1,24,25,4.0,Nearest
10899,March,2018,Charles,MD,Passenger,0,1,1,81,82,1.22,Furthest
10900,March,2018,Columbia,WA,Truck,0,0,0,1532,1532,0.0,Washington
10901,March,2018,Montgomery,PA,Passenger,1,0,1,35,36,2.78,Furthest
10902,March,2018,Kittitas,WA,Passenger,40,30,70,28748,28818,0.24,Washington
10903,March,2018,Clark,WA,Truck,0,0,0,78628,78628,0.0,Washington
10904,March,2018,Travis,TX,Passenger,0,1,1,188,189,0.53,Mid-Distance
10905,March,2018,Jefferson,NY,Passenger,1,0,1,224,225,0.44,Furthest
10906,March,2018,Garfield,WA,Truck,0,0,0,952,952,0.0,Washington
10907,March,2018,Hamilton,IN,Passenger,1,0,1,49,50,2.0,Furthest
10908,March,2018,Asotin,WA,Passenger,8,5,13,12627,12640,0.1,Washington
10909,March,2018,Norfolk,MA,Passenger,1,0,1,37,38,2.63,Furthest
10910,March,2018,Prince George,VA,Passenger,0,1,1,74,75,1.33,Furthest
10911,March,2018,Cook,IL,Passenger,1,0,1,279,280,0.36,Mid-Distance
10912,March,2018,Clallam,WA,Truck,0,0,0,21314,21314,0.0,Washington
10913,March,2018,Santa Fe,NM,Passenger,0,1,1,41,42,2.38,Mid-Distance
10914,March,2018,New Haven,CT,Passenger,0,1,1,51,52,1.92,Furthest
10915,March,2018,Columbia,WA,Passenger,2,1,3,2409,2412,0.12,Washington
10916,March,2018,Sumter,FL,Passenger,0,1,1,10,11,9.09,Furthest
10917,March,2018,Whatcom,WA,Passenger,574,260,834,146117,146951,0.57,Washington
10918,March,2018,Alameda,CA,Passenger,0,1,1,353,354,0.28,Nearest
10919,March,2018,Whitman,WA,Passenger,18,23,41,22489,22530,0.18,Washington
10920,March,2018,Pend Oreille,WA,Truck,0,0,0,5658,5658,0.0,Washington
10921,March,2018,Tarrant,TX,Passenger,1,0,1,218,219,0.46,Mid-Distance
10922,March,2018,Klickitat,WA,Passenger,25,27,52,14973,15025,0.35,Washington
10923,March,2018,Skamania,WA,Passenger,12,8,20,8667,8687,0.23,Washington
10924,March,2018,Walla Walla,WA,Passenger,32,36,68,35462,35530,0.19,Washington
10925,March,2018,Douglas,WA,Truck,0,0,0,11857,11857,0.0,Washington
10926,March,2018,St. Clair,IL,Passenger,0,1,1,154,155,0.65,Mid-Distance
10927,March,2018,Yakima,WA,Truck,0,0,0,58175,58175,0.0,Washington
10928,March,2018,Utah,UT,Passenger,0,1,1,136,137,0.73,Nearest
10929,March,2018,Arlington,VA,Passenger,1,2,3,173,176,1.7,Furthest
10930,March,2018,Pacific,WA,Truck,0,0,0,7577,7577,0.0,Washington
10931,March,2018,Sangamon,IL,Passenger,1,0,1,11,12,8.33,Mid-Distance
10932,March,2018,Orange,CA,Passenger,3,1,4,570,574,0.7,Nearest
10933,March,2018,Cape May,NJ,Passenger,0,1,1,21,22,4.55,Furthest
10934,March,2018,San Diego,CA,Passenger,6,1,7,2555,2562,0.27,Nearest
10935,March,2018,Manassas,VA,Passenger,0,1,1,8,9,11.11,Furthest
10936,March,2018,Queens,NY,Passenger,1,0,1,63,64,1.56,Furthest
10937,March,2018,Yakima,WA,Passenger,63,81,144,162826,162970,0.09,Washington
10938,March,2018,Howard,MD,Passenger,0,1,1,87,88,1.14,Furthest
10939,March,2018,King,WA,Truck,7,1,8,183718,183726,0.0,Washington
10940,March,2018,Richmond,GA,Passenger,0,1,1,89,90,1.11,Furthest
10941,March,2018,Honolulu,HI,Passenger,2,2,4,546,550,0.73,Nearest
10942,March,2018,Island,WA,Truck,0,0,0,20857,20857,0.0,Washington
10943,March,2018,Maui,HI,Passenger,1,0,1,63,64,1.56,Nearest
10944,March,2018,Lane,OR,Passenger,0,1,1,188,189,0.53,Nearest
10945,March,2018,Hamilton,TN,Passenger,1,0,1,23,24,4.17,Furthest
10946,March,2018,Duval,FL,Passenger,1,2,3,374,377,0.8,Furthest
10947,March,2018,Morris,NJ,Passenger,1,0,1,19,20,5.0,Furthest
10948,March,2018,Pima,AZ,Passenger,1,1,2,414,416,0.48,Nearest
10949,March,2018,Mason,WA,Passenger,68,83,151,45217,45368,0.33,Washington
10950,March,2018,Skamania,WA,Truck,0,0,0,3925,3925,0.0,Washington
10951,March,2018,Adams,WA,Truck,0,0,0,5152,5152,0.0,Washington
10952,March,2018,Polk,FL,Passenger,1,0,1,62,63,1.59,Furthest
10953,March,2018,Juneau,AK,Passenger,0,1,1,44,45,2.22,Nearest
10954,March,2018,Broward,FL,Passenger,0,1,1,132,133,0.75,Furthest
10955,March,2018,Chelan,WA,Passenger,96,41,137,53348,53485,0.26,Washington
10956,March,2018,Sacramento,CA,Passenger,1,0,1,294,295,0.34,Nearest
10957,March,2018,Williamson,TX,Passenger,0,1,1,160,161,0.62,Mid-Distance
10958,March,2018,Lincoln,WA,Truck,0,0,0,4515,4515,0.0,Washington
10959,March,2018,Frederick,MD,Passenger,0,1,1,87,88,1.14,Furthest
10960,March,2018,Franklin,WA,Passenger,34,55,89,57213,57302,0.16,Washington
10961,March,2018,King,WA,Passenger,11972,5152,17124,1367947,1385071,1.24,Washington
10962,March,2018,DeKalb,IN,Passenger,1,0,1,1,2,50.0,Furthest
10963,March,2018,Pacific,WA,Passenger,15,18,33,15463,15496,0.21,Washington
10964,March,2018,Klickitat,WA,Truck,0,0,0,8045,8045,0.0,Washington
10965,March,2018,Santa Rosa,FL,Passenger,1,0,1,100,101,0.99,Furthest
10966,March,2018,San Juan,WA,Passenger,140,50,190,13939,14129,1.34,Washington
10967,March,2018,Prince William,VA,Passenger,0,4,4,266,270,1.48,Furthest
10968,March,2018,Maricopa,AZ,Passenger,2,1,3,1564,1567,0.19,Nearest
10969,March,2018,Kitsap,WA,Truck,1,0,1,52964,52965,0.0,Washington
10970,March,2018,Shelby,TN,Passenger,0,1,1,101,102,0.98,Furthest
10971,March,2018,Bexar,TX,Passenger,2,2,4,789,793,0.5,Mid-Distance
10972,March,2018,Garfield,WA,Passenger,1,0,1,1330,1331,0.08,Washington
10973,March,2018,Dakota,MN,Passenger,0,2,2,37,39,5.13,Mid-Distance
10974,March,2018,Madison,ID,Passenger,1,0,1,39,40,2.5,Nearest
10975,March,2018,Essex,NJ,Passenger,1,0,1,11,12,8.33,Furthest
10976,March,2018,Spokane,WA,Truck,1,0,1,91900,91901,0.0,Washington
10977,March,2018,Hawaii,HI,Passenger,1,0,1,78,79,1.27,Nearest
10978,March,2018,Multnomah,OR,Passenger,3,4,7,817,824,0.85,Nearest
10979,March,2018,Marion,IN,Passenger,1,0,1,116,117,0.85,Furthest
10980,March,2018,Grant,WA,Truck,0,0,0,25746,25746,0.0,Washington
10981,March,2018,Jefferson,WA,Truck,0,0,0,9515,9515,0.0,Washington
10982,March,2018,Snohomish,WA,Truck,1,0,1,121231,121232,0.0,Washington
10983,March,2018,San Juan,WA,Truck,0,0,0,5658,5658,0.0,Washington
10984,March,2018,Palm Beach,FL,Passenger,0,1,1,85,86,1.16,Furthest
10985,March,2018,Grays Harbor,WA,Truck,0,0,0,20078,20078,0.0,Washington
10986,March,2018,Asotin,WA,Truck,0,0,0,6593,6593,0.0,Washington
10987,March,2018,Grant,WA,Passenger,32,42,74,62599,62673,0.12,Washington
10988,March,2018,Mason,WA,Truck,0,0,0,19793,19793,0.0,Washington
10989,March,2018,Gwinnett,GA,Passenger,0,1,1,78,79,1.27,Furthest
10990,March,2018,Lincoln,WA,Passenger,2,5,7,7578,7585,0.09,Washington
10991,March,2018,Franklin,MA,Passenger,0,1,1,2,3,33.33,Furthest
10992,March,2018,Clay,FL,Passenger,0,1,1,102,103,0.97,Furthest
10993,March,2018,Norfolk,VA,Passenger,1,2,3,325,328,0.91,Furthest
10994,March,2018,Stevens,WA,Passenger,9,21,30,31603,31633,0.09,Washington
10995,March,2018,Garfield,OK,Passenger,1,0,1,21,22,4.55,Mid-Distance
10996,March,2018,Volusia,FL,Passenger,0,1,1,34,35,2.86,Furthest
10997,March,2018,Nantucket,MA,Passenger,1,0,1,4,5,20.0,Furthest
10998,March,2018,Dallas,TX,Passenger,0,1,1,187,188,0.53,Mid-Distance
10999,March,2018,Prince George's,MD,Passenger,0,1,1,182,183,0.55,Furthest
11000,March,2018,Montgomery,TN,Passenger,1,0,1,267,268,0.37,Furthest
11001,March,2018,Grays Harbor,WA,Passenger,45,46,91,46091,46182,0.2,Washington
11002,March,2018,Contra Costa,CA,Passenger,0,1,1,467,468,0.21,Nearest
11003,March,2018,Allegheny,PA,Passenger,1,0,1,77,78,1.28,Furthest
11004,March,2018,Lewis,WA,Passenger,55,47,102,57151,57253,0.18,Washington
11005,March,2018,Fulton,GA,Passenger,1,0,1,99,100,1.0,Furthest
11006,March,2018,Sedgwick,KS,Passenger,0,1,1,104,105,0.95,Mid-Distance
11007,March,2018,Manatee,FL,Passenger,1,0,1,37,38,2.63,Furthest
11008,March,2018,Kitsap,WA,Passenger,740,428,1168,176885,178053,0.66,Washington
11009,March,2018,Snohomish,WA,Passenger,2133,1159,3292,517925,521217,0.63,Washington
11010,March,2018,Brevard,FL,Passenger,0,1,1,100,101,0.99,Furthest
11011,March,2018,Washtenaw,MI,Passenger,1,0,1,39,40,2.5,Furthest
11012,March,2018,Nassau,NY,Passenger,1,0,1,35,36,2.78,Furthest
11013,March,2018,Moore,NC,Passenger,0,1,1,199,200,0.5,Furthest
11014,March,2018,Virginia Beach,VA,Passenger,2,1,3,682,685,0.44,Furthest
11015,March,2018,Okanogan,WA,Passenger,7,19,26,25733,25759,0.1,Washington
11016,March,2018,Fairfax,VA,Passenger,2,2,4,824,828,0.48,Furthest
11017,March,2018,Lee,AL,Passenger,1,0,1,33,34,2.94,Furthest
11018,March,2018,Marin,CA,Passenger,1,0,1,54,55,1.82,Nearest
11019,March,2018,Deschutes,OR,Passenger,1,0,1,172,173,0.58,Nearest
11020,March,2018,Kent,MI,Passenger,0,1,1,34,35,2.86,Furthest
11021,March,2018,Skagit,WA,Passenger,173,154,327,89895,90222,0.36,Washington
11022,March,2018,Clark,WA,Passenger,918,641,1559,306002,307561,0.51,Washington
11023,March,2018,Ramsey,MN,Passenger,1,0,1,37,38,2.63,Mid-Distance
11024,March,2018,Franklin,WA,Truck,0,0,0,18617,18617,0.0,Washington
11025,March,2018,Skagit,WA,Truck,1,0,1,31922,31923,0.0,Washington
11026,March,2018,Clark,NV,Passenger,1,2,3,744,747,0.4,Nearest
11027,March,2018,Richland,SC,Passenger,0,1,1,172,173,0.58,Furthest
11028,March,2018,Benton,WA,Passenger,176,187,363,130785,131148,0.28,Washington
11029,March,2018,New London,CT,Passenger,1,1,2,249,251,0.8,Furthest
11030,March,2018,Benton,WA,Truck,0,0,0,40794,40794,0.0,Washington
11031,March,2018,Island,WA,Passenger,175,178,353,62057,62410,0.57,Washington
11032,March,2018,Wahkiakum,WA,Passenger,1,2,3,2871,2874,0.1,Washington
11033,March,2018,Orange,FL,Passenger,2,1,3,169,172,1.74,Furthest
11034,March,2018,District of Columbia,DC,Passenger,0,3,3,195,198,1.52,Furthest
11035,March,2018,St. Lucie,FL,Passenger,1,0,1,27,28,3.57,Furthest
11036,March,2018,Caddo,LA,Passenger,0,1,1,22,23,4.35,Mid-Distance
11037,March,2018,Ada,ID,Passenger,0,2,2,336,338,0.59,Nearest
11038,March,2018,Adams,WA,Passenger,5,4,9,12470,12479,0.07,Washington
11039,March,2018,Spokane,WA,Passenger,304,273,577,301278,301855,0.19,Washington
11040,March,2018,Latah,ID,Passenger,0,1,1,78,79,1.27,Nearest
11041,March,2018,Ventura,CA,Passenger,0,1,1,327,328,0.3,Nearest
11042,March,2018,Whitman,WA,Truck,0,0,0,8453,8453,0.0,Washington
11043,March,2018,Okaloosa,FL,Passenger,1,0,1,175,176,0.57,Furthest
11044,March,2018,Northampton,PA,Passenger,0,1,1,63,64,1.56,Furthest
11045,March,2018,Portsmouth,VA,Passenger,0,1,1,72,73,1.37,Furthest
11046,March,2018,El Paso,TX,Passenger,1,0,1,524,525,0.19,Mid-Distance
11047,March,2018,Tuolumne,CA,Passenger,0,1,1,14,15,6.67,Nearest
11048,March,2018,Clallam,WA,Passenger,119,104,223,49504,49727,0.45,Washington
11049,March,2018,Thurston,WA,Truck,0,0,0,54007,54007,0.0,Washington
11050,March,2018,Carroll,NH,Passenger,0,1,1,1,2,50.0,Furthest
11051,March,2018,Jefferson,CO,Passenger,0,1,1,75,76,1.32,Mid-Distance
11052,March,2018,Wahkiakum,WA,Truck,0,0,0,1668,1668,0.0,Washington
11053,March,2019,Douglas,WA,Truck,0,0,0,12157,12157,0.0,Washington
11054,March,2019,DeKalb,IN,Passenger,1,0,1,1,2,50.0,Furthest
11055,March,2019,Guadalupe,TX,Passenger,1,0,1,77,78,1.28,Mid-Distance
11056,March,2019,Randolph,NC,Passenger,1,0,1,6,7,14.29,Furthest
11057,March,2019,Cook,IL,Passenger,1,0,1,244,245,0.41,Mid-Distance
11058,March,2019,Camden,NJ,Passenger,0,1,1,26,27,3.7,Furthest
11059,March,2019,Washtenaw,MI,Passenger,1,0,1,37,38,2.63,Furthest
11060,March,2019,Anne Arundel,MD,Passenger,0,2,2,452,454,0.44,Furthest
11061,March,2019,Grays Harbor,WA,Passenger,69,80,149,47589,47738,0.31,Washington
11062,March,2019,Portsmouth,VA,Passenger,0,1,1,76,77,1.3,Furthest
11063,March,2019,New London,CT,Passenger,0,2,2,249,251,0.8,Furthest
11064,March,2019,Lumpkin,GA,Passenger,1,0,1,6,7,14.29,Furthest
11065,March,2019,Owyhee,ID,Passenger,1,0,1,5,6,16.67,Nearest
11066,March,2019,Oldham,KY,Passenger,0,1,1,5,6,16.67,Furthest
11067,March,2019,Clark,WA,Truck,0,0,0,79992,79992,0.0,Washington
11068,March,2019,Pima,AZ,Passenger,1,1,2,401,403,0.5,Nearest
11069,March,2019,Kent,MI,Passenger,0,1,1,21,22,4.55,Furthest
11070,March,2019,Goochland,VA,Passenger,1,1,2,248,250,0.8,Furthest
11071,March,2019,Lee,FL,Passenger,1,0,1,52,53,1.89,Furthest
11072,March,2019,New Haven,CT,Passenger,0,2,2,49,51,3.92,Furthest
11073,March,2019,Cumberland,NC,Passenger,0,2,2,506,508,0.39,Furthest
11074,March,2019,El Paso,TX,Passenger,2,0,2,493,495,0.4,Mid-Distance
11075,March,2019,Sangamon,IL,Passenger,2,0,2,7,9,22.22,Mid-Distance
11076,March,2019,Montgomery,PA,Passenger,2,0,2,37,39,5.13,Furthest
11077,March,2019,Middlesex,MA,Passenger,1,1,2,118,120,1.67,Furthest
11078,March,2019,Kern,CA,Passenger,0,1,1,225,226,0.44,Nearest
11079,March,2019,Howard,MD,Passenger,0,1,1,78,79,1.27,Furthest
11080,March,2019,Wahkiakum,WA,Passenger,1,1,2,3008,3010,0.07,Washington
11081,March,2019,Jefferson,WA,Passenger,179,118,297,24880,25177,1.18,Washington
11082,March,2019,Mecklenburg,NC,Passenger,1,0,1,79,80,1.25,Furthest
11083,March,2019,Pinal,AZ,Passenger,2,0,2,198,200,1.0,Nearest
11084,March,2019,St. Clair,IL,Passenger,0,1,1,162,163,0.61,Mid-Distance
11085,March,2019,Kootenai,ID,Passenger,1,1,2,212,214,0.93,Nearest
11086,March,2019,Charleston,SC,Passenger,1,0,1,121,122,0.82,Furthest
11087,March,2019,Chelan,WA,Passenger,144,67,211,54156,54367,0.39,Washington
11088,March,2019,Snohomish,WA,Passenger,3195,1519,4714,527994,532708,0.88,Washington
11089,March,2019,San Juan,PR,Passenger,0,1,1,3,4,25.0,Mid-Distance
11090,March,2019,Los Angeles,CA,Passenger,7,5,12,1089,1101,1.09,Nearest
11091,March,2019,Clallam,WA,Truck,0,0,0,21617,21617,0.0,Washington
11092,March,2019,Columbia,WA,Truck,0,0,0,1527,1527,0.0,Washington
11093,March,2019,Lewis,WA,Truck,0,0,0,25755,25755,0.0,Washington
11094,March,2019,Honolulu,HI,Passenger,2,3,5,500,505,0.99,Nearest
11095,March,2019,Shasta,CA,Passenger,1,0,1,41,42,2.38,Nearest
11096,March,2019,King,WA,Truck,6,1,7,181762,181769,0.0,Washington
11097,March,2019,Clark,WA,Passenger,1358,881,2239,311974,314213,0.71,Washington
11098,March,2019,Fairfax,VA,Passenger,3,2,5,795,800,0.62,Furthest
11099,March,2019,Travis,TX,Passenger,2,1,3,202,205,1.46,Mid-Distance
11100,March,2019,Garfield,WA,Passenger,1,1,2,1310,1312,0.15,Washington
11101,March,2019,St. Mary's,MD,Passenger,1,0,1,213,214,0.47,Furthest
11103,March,2019,Whatcom,WA,Truck,2,0,2,42724,42726,0.0,Washington
11104,March,2019,Stevens,WA,Passenger,18,27,45,31632,31677,0.14,Washington
11105,March,2019,Santa Cruz,CA,Passenger,1,0,1,41,42,2.38,Nearest
11106,March,2019,Shelby,TN,Passenger,0,1,1,96,97,1.03,Furthest
11107,March,2019,St. Lucie,FL,Passenger,1,0,1,30,31,3.23,Furthest
11108,March,2019,Snohomish,WA,Truck,1,0,1,121910,121911,0.0,Washington
11109,March,2019,Skagit,WA,Truck,1,0,1,32255,32256,0.0,Washington
11110,March,2019,Pacific,WA,Passenger,23,26,49,15850,15899,0.31,Washington
11111,March,2019,Richmond,GA,Passenger,0,1,1,93,94,1.06,Furthest
11112,March,2019,San Diego,CA,Passenger,10,3,13,2649,2662,0.49,Nearest
11113,March,2019,Clark,NV,Passenger,3,2,5,706,711,0.7,Nearest
11114,March,2019,Chelan,WA,Truck,0,0,0,22127,22127,0.0,Washington
11115,March,2019,Benton,WA,Truck,0,0,0,41532,41532,0.0,Washington
11116,March,2019,Thurston,WA,Passenger,802,598,1400,196182,197582,0.71,Washington
11117,March,2019,Collin,TX,Passenger,1,1,2,134,136,1.47,Mid-Distance
11118,March,2019,Walla Walla,WA,Passenger,44,56,100,36067,36167,0.28,Washington
11119,March,2019,Spartanburg,SC,Passenger,0,1,1,33,34,2.94,Furthest
11120,March,2019,Alameda,CA,Passenger,3,2,5,317,322,1.55,Nearest
11121,March,2019,Yakima,WA,Passenger,89,102,191,164203,164394,0.12,Washington
11122,March,2019,Pend Oreille,WA,Truck,0,0,0,5721,5721,0.0,Washington
11123,March,2019,Ada,ID,Passenger,0,2,2,308,310,0.65,Nearest
11124,March,2019,Walla Walla,WA,Truck,0,0,0,13552,13552,0.0,Washington
11125,March,2019,Klamath,OR,Passenger,1,0,1,38,39,2.56,Nearest
11126,March,2019,Maricopa,AZ,Passenger,6,2,8,1544,1552,0.52,Nearest
11127,March,2019,DuPage,IL,Passenger,1,0,1,61,62,1.61,Mid-Distance
11128,March,2019,El Paso,CO,Passenger,3,2,5,752,757,0.66,Mid-Distance
11129,March,2019,Juneau,AK,Passenger,0,1,1,33,34,2.94,Nearest
11130,March,2019,Hennepin,MN,Passenger,2,0,2,103,105,1.9,Mid-Distance
11131,March,2019,DeKalb,GA,Passenger,1,0,1,80,81,1.23,Furthest
11132,March,2019,Kitsap,WA,Truck,1,0,1,53744,53745,0.0,Washington
11133,March,2019,Fresno,CA,Passenger,1,0,1,188,189,0.53,Nearest
11134,March,2019,Kittitas,WA,Truck,0,0,0,14249,14249,0.0,Washington
11135,March,2019,Arlington,VA,Passenger,1,2,3,162,165,1.82,Furthest
11136,March,2019,Bergen,NJ,Passenger,1,0,1,25,26,3.85,Furthest
11137,March,2019,Montgomery,MD,Passenger,1,0,1,274,275,0.36,Furthest
11138,March,2019,Fulton,GA,Passenger,1,2,3,110,113,2.65,Furthest
11139,March,2019,Volusia,FL,Passenger,0,1,1,36,37,2.7,Furthest
11140,March,2019,Columbia,WA,Passenger,2,2,4,2427,2431,0.16,Washington
11141,March,2019,Larimer,CO,Passenger,1,0,1,58,59,1.69,Mid-Distance
11142,March,2019,Okanogan,WA,Passenger,20,21,41,25907,25948,0.16,Washington
11143,March,2019,Island,WA,Truck,0,0,0,21186,21186,0.0,Washington
11144,March,2019,Sedgwick,KS,Passenger,0,1,1,103,104,0.96,Mid-Distance
11145,March,2019,Ferry,WA,Passenger,3,2,5,4362,4367,0.11,Washington
11146,March,2019,Clay,FL,Passenger,0,1,1,84,85,1.18,Furthest
11147,March,2019,Klickitat,WA,Truck,0,0,0,8207,8207,0.0,Washington
11148,March,2019,Calvert,MD,Passenger,0,1,1,87,88,1.14,Furthest
11149,March,2019,Twin Falls,ID,Passenger,0,1,1,21,22,4.55,Nearest
11150,March,2019,Wayne,MI,Passenger,0,1,1,68,69,1.45,Furthest
11151,March,2019,Cascade,MT,Passenger,0,1,1,55,56,1.79,Nearest
11152,March,2019,Riverside,CA,Passenger,2,2,4,662,666,0.6,Nearest
11153,March,2019,Skamania,WA,Truck,0,0,0,4017,4017,0.0,Washington
11154,March,2019,Suffolk,MA,Passenger,0,1,1,41,42,2.38,Furthest
11155,March,2019,Prince George's,MD,Passenger,1,1,2,182,184,1.09,Furthest
11156,March,2019,Flathead,MT,Passenger,1,0,1,60,61,1.64,Nearest
11157,March,2019,Island,WA,Passenger,300,234,534,63126,63660,0.84,Washington
11158,March,2019,Allegheny,PA,Passenger,1,0,1,85,86,1.16,Furthest
11159,March,2019,Tuolumne,CA,Passenger,0,1,1,12,13,7.69,Nearest
11160,March,2019,Asotin,WA,Truck,0,0,0,6632,6632,0.0,Washington
11161,March,2019,Caddo,LA,Passenger,0,1,1,23,24,4.17,Mid-Distance
11162,March,2019,Denver,CO,Passenger,1,0,1,132,133,0.75,Mid-Distance
11163,March,2019,Stevens,WA,Truck,0,0,0,18708,18708,0.0,Washington
11164,March,2019,Gwinnett,GA,Passenger,0,1,1,76,77,1.3,Furthest
11165,March,2019,Palm Beach,FL,Passenger,0,1,1,93,94,1.06,Furthest
11166,March,2019,San Juan,WA,Truck,0,0,0,5811,5811,0.0,Washington
11167,March,2019,Douglas,NE,Passenger,0,1,1,64,65,1.54,Mid-Distance
11168,March,2019,Vigo,IN,Passenger,1,0,1,5,6,16.67,Furthest
11169,March,2019,Wahkiakum,WA,Truck,0,0,0,1725,1725,0.0,Washington
11170,March,2019,Marion,OR,Passenger,1,0,1,116,117,0.85,Nearest
11171,March,2019,Tulsa,OK,Passenger,1,1,2,47,49,4.08,Mid-Distance
11172,March,2019,Richland,SC,Passenger,0,1,1,164,165,0.61,Furthest
11173,March,2019,Spokane,WA,Truck,1,0,1,94016,94017,0.0,Washington
11174,March,2019,San Francisco,CA,Passenger,2,1,3,111,114,2.63,Nearest
11175,March,2019,Cochise,AZ,Passenger,0,1,1,115,116,0.86,Nearest
11176,March,2019,Nassau,NY,Passenger,3,0,3,39,42,7.14,Furthest
11177,March,2019,Santa Clara,CA,Passenger,8,1,9,361,370,2.43,Nearest
11178,March,2019,Jefferson,WA,Truck,0,0,0,9645,9645,0.0,Washington
11179,March,2019,Lincoln,WA,Truck,0,0,0,4683,4683,0.0,Washington
11180,March,2019,Bexar,TX,Passenger,3,4,7,682,689,1.02,Mid-Distance
11181,March,2019,Thurston,WA,Truck,0,0,0,54948,54948,0.0,Washington
11182,March,2019,Klickitat,WA,Passenger,32,31,63,15424,15487,0.41,Washington
11183,March,2019,King,WA,Passenger,17678,6779,24457,1381383,1405840,1.74,Washington
11184,March,2019,Skagit,WA,Passenger,281,189,470,91327,91797,0.51,Washington
11185,March,2019,Orange,CA,Passenger,5,1,6,532,538,1.12,Nearest
11186,March,2019,Montgomery,AL,Passenger,0,1,1,43,44,2.27,Furthest
11187,March,2019,Manatee,FL,Passenger,1,0,1,32,33,3.03,Furthest
11188,March,2019,Virginia Beach,VA,Passenger,1,1,2,698,700,0.29,Furthest
11189,March,2019,Tarrant,TX,Passenger,2,0,2,201,203,0.99,Mid-Distance
11190,March,2019,Whitman,WA,Truck,0,0,0,8502,8502,0.0,Washington
11191,March,2019,Montgomery,TX,Passenger,2,0,2,61,63,3.17,Mid-Distance
11192,March,2019,Adams,WA,Truck,0,0,0,5105,5105,0.0,Washington
11193,March,2019,Manassas,VA,Passenger,0,1,1,9,10,10.0,Furthest
11194,March,2019,Whatcom,WA,Passenger,792,386,1178,149745,150923,0.78,Washington
11195,March,2019,Norfolk,MA,Passenger,1,0,1,36,37,2.7,Furthest
11196,March,2019,Monroe,IL,Passenger,1,0,1,4,5,20.0,Mid-Distance
11197,March,2019,Charles,MD,Passenger,0,1,1,78,79,1.27,Furthest
11198,March,2019,Carroll,NH,Passenger,0,1,1,2,3,33.33,Furthest
11199,March,2019,Sumter,FL,Passenger,0,1,1,10,11,9.09,Furthest
11200,March,2019,Rogers,OK,Passenger,1,0,1,4,5,20.0,Mid-Distance
11201,March,2019,Lincoln,WA,Passenger,3,6,9,7733,7742,0.12,Washington
11202,March,2019,Washoe,NV,Passenger,2,0,2,107,109,1.83,Nearest
11203,March,2019,Lee,AL,Passenger,1,0,1,35,36,2.78,Furthest
11204,March,2019,Franklin,WA,Passenger,52,68,120,59371,59491,0.2,Washington
11205,March,2019,Benton,WA,Passenger,236,251,487,132992,133479,0.36,Washington
11206,March,2019,Kittitas,WA,Passenger,71,37,108,29440,29548,0.37,Washington
11207,March,2019,Pierce,WA,Passenger,1635,1457,3092,539431,542523,0.57,Washington
11208,March,2019,Hawaii,HI,Passenger,1,0,1,61,62,1.61,Nearest
11209,March,2019,Harris,TX,Passenger,0,1,1,251,252,0.4,Mid-Distance
11210,March,2019,Spokane,WA,Passenger,491,393,884,307777,308661,0.29,Washington
11211,March,2019,Cape May,NJ,Passenger,0,1,1,19,20,5.0,Furthest
11212,March,2019,Asotin,WA,Passenger,12,9,21,12660,12681,0.17,Washington
11213,March,2019,Multnomah,OR,Passenger,4,5,9,747,756,1.19,Nearest
11214,March,2019,Clallam,WA,Passenger,154,129,283,50317,50600,0.56,Washington
11215,March,2019,District of Columbia,DC,Passenger,1,1,2,204,206,0.97,Furthest
11216,March,2019,Dale,AL,Passenger,0,1,1,56,57,1.75,Furthest
11217,March,2019,Brevard,FL,Passenger,0,1,1,87,88,1.14,Furthest
11218,March,2019,Okanogan,WA,Truck,0,0,0,16439,16439,0.0,Washington
11219,March,2019,San Mateo,CA,Passenger,2,1,3,126,129,2.33,Nearest
11220,March,2019,Frederick,MD,Passenger,1,1,2,81,83,2.41,Furthest
11221,March,2019,Prince William,VA,Passenger,0,4,4,257,261,1.53,Furthest
11222,March,2019,Polk,FL,Passenger,1,0,1,65,66,1.52,Furthest
11223,March,2019,Kitsap,WA,Passenger,997,569,1566,179919,181485,0.86,Washington
11224,March,2019,Grant,WA,Passenger,34,55,89,64210,64299,0.14,Washington
11225,March,2019,Douglas,WA,Passenger,53,34,87,27889,27976,0.31,Washington
11226,March,2019,Bucks,PA,Passenger,1,0,1,17,18,5.56,Furthest
11227,March,2019,Norfolk,VA,Passenger,2,2,4,350,354,1.13,Furthest
11228,March,2019,Ramsey,MN,Passenger,1,0,1,42,43,2.33,Mid-Distance
11229,March,2019,Mason,WA,Truck,0,0,0,20274,20274,0.0,Washington
11230,March,2019,Clackamas,OR,Passenger,1,1,2,205,207,0.97,Nearest
11231,March,2019,Santa Rosa,FL,Passenger,1,0,1,87,88,1.14,Furthest
11232,March,2019,Yakima,WA,Truck,0,0,0,58746,58746,0.0,Washington
11233,March,2019,Williamson,TX,Passenger,0,1,1,146,147,0.68,Mid-Distance
11234,March,2019,Pacific,WA,Truck,0,0,0,7655,7655,0.0,Washington
11235,March,2019,Hardin,KY,Passenger,0,1,1,103,104,0.96,Furthest
11236,March,2019,Grays Harbor,WA,Truck,0,0,0,20376,20376,0.0,Washington
11237,March,2019,Broward,FL,Passenger,2,1,3,126,129,2.33,Furthest
11238,March,2019,Dakota,MN,Passenger,0,2,2,35,37,5.41,Mid-Distance
11239,March,2019,Penobscot,ME,Passenger,0,1,1,13,14,7.14,Furthest
11240,March,2019,Santa Fe,NM,Passenger,0,1,1,39,40,2.5,Mid-Distance
11241,March,2019,Cowlitz,WA,Passenger,84,101,185,72544,72729,0.25,Washington
11242,March,2019,Skamania,WA,Passenger,21,15,36,8722,8758,0.41,Washington
11243,March,2019,Moore,NC,Passenger,0,1,1,178,179,0.56,Furthest
11244,March,2019,Contra Costa,CA,Passenger,1,2,3,394,397,0.76,Nearest
11245,March,2019,Valencia,NM,Passenger,1,0,1,9,10,10.0,Mid-Distance
11246,March,2019,Houston,GA,Passenger,1,0,1,55,56,1.79,Furthest
11247,March,2019,San Juan,WA,Passenger,197,70,267,14290,14557,1.83,Washington
11248,March,2019,Alexandria,VA,Passenger,1,0,1,156,157,0.64,Furthest
11249,March,2019,Carson City,NV,Passenger,1,0,1,14,15,6.67,Nearest
11250,March,2019,Jefferson,CO,Passenger,0,2,2,58,60,3.33,Mid-Distance
11251,March,2019,Duval,FL,Passenger,1,2,3,382,385,0.78,Furthest
11252,March,2019,Garfield,WA,Truck,0,0,0,954,954,0.0,Washington
11253,March,2019,Whitman,WA,Passenger,27,41,68,22715,22783,0.3,Washington
11254,March,2019,Jefferson,NY,Passenger,0,2,2,223,225,0.89,Furthest
11255,March,2019,Nantucket,MA,Passenger,1,0,1,4,5,20.0,Furthest
11256,March,2019,Berkshire,MA,Passenger,0,1,1,4,5,20.0,Furthest
11257,March,2019,Maui,HI,Passenger,1,0,1,49,50,2.0,Nearest
11258,March,2019,Franklin,MA,Passenger,0,1,1,1,2,50.0,Furthest
11259,March,2019,Deschutes,OR,Passenger,2,0,2,157,159,1.26,Nearest
11260,March,2019,Pierce,WA,Truck,0,0,0,139004,139004,0.0,Washington
11261,March,2019,Harnett,NC,Passenger,1,0,1,216,217,0.46,Furthest
11262,March,2019,Adams,WA,Passenger,4,6,10,12632,12642,0.08,Washington
11263,March,2019,Grant,WA,Truck,0,0,0,26337,26337,0.0,Washington
11264,March,2019,Pend Oreille,WA,Passenger,5,5,10,9474,9484,0.11,Washington
11265,March,2019,Lewis,WA,Passenger,95,90,185,58524,58709,0.32,Washington
11266,March,2019,Saratoga,NY,Passenger,1,0,1,58,59,1.69,Furthest
11267,March,2019,Albemarle,VA,Passenger,1,0,1,23,24,4.17,Furthest
11268,March,2019,Ferry,WA,Truck,0,0,0,3594,3594,0.0,Washington
11269,March,2019,Franklin,WA,Truck,0,0,0,19136,19136,0.0,Washington
11270,March,2019,Mason,WA,Passenger,114,117,231,46714,46945,0.49,Washington
11271,March,2019,Washington,OR,Passenger,0,1,1,463,464,0.22,Nearest
11272,March,2019,Cowlitz,WA,Truck,0,0,0,28781,28781,0.0,Washington
11273,March,2019,Ventura,CA,Passenger,0,2,2,311,313,0.64,Nearest
11274,March,2019,Nueces,TX,Passenger,1,1,2,93,95,2.11,Mid-Distance
11275,March,2020,Travis,TX,Passenger,2,1,3,185,188,1.6,Mid-Distance
11276,March,2020,El Paso,CO,Passenger,2,0,2,728,730,0.27,Mid-Distance
11277,March,2020,Ada,ID,Passenger,0,1,1,286,287,0.35,Nearest
11278,March,2020,New London,CT,Passenger,1,2,3,245,248,1.21,Furthest
11279,March,2020,Douglas,WA,Truck,0,0,0,12333,12333,0.0,Washington
11280,March,2020,Bexar,TX,Passenger,2,5,7,620,627,1.12,Mid-Distance
11281,March,2020,Adams,WA,Passenger,7,7,14,12891,12905,0.11,Washington
11283,March,2020,Walla Walla,WA,Passenger,68,63,131,36237,36368,0.36,Washington
11284,March,2020,Erie,NY,Passenger,1,0,1,44,45,2.22,Furthest
11285,March,2020,San Mateo,CA,Passenger,0,1,1,114,115,0.87,Nearest
11286,March,2020,Walla Walla,WA,Truck,0,0,0,13647,13647,0.0,Washington
11287,March,2020,Sacramento,CA,Passenger,1,0,1,271,272,0.37,Nearest
11288,March,2020,Larimer,CO,Passenger,1,0,1,55,56,1.79,Mid-Distance
11289,March,2020,Yakima,WA,Truck,0,0,0,59596,59596,0.0,Washington
11290,March,2020,Stevens,WA,Passenger,33,33,66,31263,31329,0.21,Washington
11291,March,2020,Clackamas,OR,Passenger,2,1,3,209,212,1.42,Nearest
11292,March,2020,Santa Cruz,CA,Passenger,1,0,1,37,38,2.63,Nearest
11293,March,2020,Oklahoma,OK,Passenger,0,1,1,129,130,0.77,Mid-Distance
11294,March,2020,Brevard,FL,Passenger,0,1,1,86,87,1.15,Furthest
11295,March,2020,Suffolk,VA,Passenger,1,0,1,124,125,0.8,Furthest
11296,March,2020,Cowlitz,WA,Truck,0,0,0,28852,28852,0.0,Washington
11297,March,2020,Sedgwick,KS,Passenger,1,1,2,93,95,2.11,Mid-Distance
11298,March,2020,Rockingham,NH,Passenger,1,0,1,27,28,3.57,Furthest
11299,March,2020,San Juan,WA,Truck,0,0,0,5932,5932,0.0,Washington
11300,March,2020,Hudson,NJ,Passenger,1,0,1,39,40,2.5,Furthest
11301,March,2020,Owyhee,ID,Passenger,1,0,1,3,4,25.0,Nearest
11302,March,2020,Mason,WA,Truck,0,0,0,20576,20576,0.0,Washington
11303,March,2020,Clark,NV,Passenger,3,2,5,682,687,0.73,Nearest
11304,March,2020,Riverside,CA,Passenger,3,1,4,639,643,0.62,Nearest
11305,March,2020,Lewis,WA,Passenger,105,108,213,59209,59422,0.36,Washington
11306,March,2020,Vigo,IN,Passenger,1,0,1,5,6,16.67,Furthest
11307,March,2020,Skagit,WA,Truck,1,0,1,32552,32553,0.0,Washington
11308,March,2020,Skagit,WA,Passenger,391,216,607,92155,92762,0.65,Washington
11309,March,2020,Boone,MO,Passenger,0,1,1,12,13,7.69,Furthest
11310,March,2020,El Paso,TX,Passenger,3,0,3,440,443,0.68,Mid-Distance
11311,March,2020,Osceola,FL,Passenger,1,0,1,41,42,2.38,Furthest
11312,March,2020,Virginia Beach,VA,Passenger,1,0,1,681,682,0.15,Furthest
11313,March,2020,Fairfax,VA,Passenger,4,3,7,747,754,0.93,Furthest
11314,March,2020,Pinal,AZ,Passenger,1,0,1,188,189,0.53,Nearest
11315,March,2020,Thurston,WA,Truck,0,0,0,55680,55680,0.0,Washington
11316,March,2020,Multnomah,OR,Passenger,4,7,11,731,742,1.48,Nearest
11317,March,2020,Prince George's,MD,Passenger,1,1,2,168,170,1.18,Furthest
11318,March,2020,Whatcom,WA,Truck,3,0,3,43025,43028,0.01,Washington
11319,March,2020,Placer,CA,Passenger,2,0,2,92,94,2.13,Nearest
11320,March,2020,Jones,GA,Passenger,1,0,1,1,2,50.0,Furthest
11321,March,2020,Polk,FL,Passenger,1,0,1,68,69,1.45,Furthest
11322,March,2020,Shasta,CA,Passenger,1,0,1,38,39,2.56,Nearest
11323,March,2020,Harnett,NC,Passenger,1,1,2,205,207,0.97,Furthest
11324,March,2020,Ferry,WA,Passenger,5,3,8,4365,4373,0.18,Washington
11325,March,2020,Palm Beach,FL,Passenger,0,2,2,80,82,2.44,Furthest
11326,March,2020,Howard,MD,Passenger,0,1,1,70,71,1.41,Furthest
11327,March,2020,Island,WA,Passenger,406,269,675,63248,63923,1.06,Washington
11328,March,2020,Jefferson,NY,Passenger,0,1,1,212,213,0.47,Furthest
11329,March,2020,Washtenaw,MI,Passenger,1,0,1,36,37,2.7,Furthest
11330,March,2020,Grant,WA,Passenger,58,71,129,65493,65622,0.2,Washington
11331,March,2020,Powhatan,VA,Passenger,1,0,1,0,1,100.0,Furthest
11332,March,2020,Tulsa,OK,Passenger,1,1,2,45,47,4.26,Mid-Distance
11333,March,2020,Sarasota,FL,Passenger,2,0,2,26,28,7.14,Furthest
11334,March,2020,Fresno,CA,Passenger,1,0,1,187,188,0.53,Nearest
11335,March,2020,Denver,CO,Passenger,1,0,1,121,122,0.82,Mid-Distance
11336,March,2020,Lewis,WA,Truck,0,0,0,26030,26030,0.0,Washington
11337,March,2020,Shelby,OH,Passenger,0,1,1,1,2,50.0,Furthest
11338,March,2020,Spokane,WA,Passenger,704,473,1177,317986,319163,0.37,Washington
11339,March,2020,Kitsap,WA,Passenger,1297,674,1971,181797,183768,1.07,Washington
11340,March,2020,Washoe,NV,Passenger,1,0,1,109,110,0.91,Nearest
11341,March,2020,Bucks,PA,Passenger,1,0,1,20,21,4.76,Furthest
11342,March,2020,Clallam,WA,Truck,1,0,1,21817,21818,0.0,Washington
11343,March,2020,Alexandria,VA,Passenger,1,0,1,142,143,0.7,Furthest
11344,March,2020,Alameda,CA,Passenger,3,1,4,280,284,1.41,Nearest
11345,March,2020,Arlington,VA,Passenger,0,2,2,155,157,1.27,Furthest
11346,March,2020,Pierce,WA,Truck,0,0,0,141601,141601,0.0,Washington
11347,March,2020,Goochland,VA,Passenger,2,1,3,260,263,1.14,Furthest
11348,March,2020,Washington,OR,Passenger,1,0,1,453,454,0.22,Nearest
11349,March,2020,Wahkiakum,WA,Passenger,6,5,11,3006,3017,0.36,Washington
11350,March,2020,Santa Clara,CA,Passenger,7,2,9,324,333,2.7,Nearest
11351,March,2020,Mason,WA,Passenger,153,135,288,47512,47800,0.6,Washington
11352,March,2020,Boulder,CO,Passenger,0,1,1,47,48,2.08,Mid-Distance
11353,March,2020,San Joaquin,CA,Passenger,1,0,1,132,133,0.75,Nearest
11354,March,2020,Whatcom,WA,Passenger,1057,490,1547,151217,152764,1.01,Washington
11355,March,2020,Snohomish,WA,Passenger,4370,1757,6127,537415,543542,1.13,Washington
11356,March,2020,Cowlitz,WA,Passenger,134,114,248,73167,73415,0.34,Washington
11357,March,2020,St. Clair,IL,Passenger,1,0,1,140,141,0.71,Mid-Distance
11358,March,2020,Thurston,WA,Passenger,1131,728,1859,198621,200480,0.93,Washington
11359,March,2020,Montgomery,AL,Passenger,0,1,1,38,39,2.56,Furthest
11360,March,2020,Prince William,VA,Passenger,2,3,5,228,233,2.15,Furthest
11361,March,2020,Lincoln,WA,Truck,0,0,0,4659,4659,0.0,Washington
11362,March,2020,Williams,ND,Passenger,0,1,1,13,14,7.14,Mid-Distance
11363,March,2020,Guadalupe,TX,Passenger,1,0,1,65,66,1.52,Mid-Distance
11364,March,2020,Ulster,NY,Passenger,1,0,1,8,9,11.11,Furthest
11365,March,2020,Calvert,MD,Passenger,0,2,2,90,92,2.17,Furthest
11366,March,2020,Nassau,NY,Passenger,4,0,4,35,39,10.26,Furthest
11367,March,2020,Broward,FL,Passenger,3,1,4,116,120,3.33,Furthest
11368,March,2020,Lake,FL,Passenger,1,0,1,21,22,4.55,Furthest
11369,March,2020,Saginaw,MI,Passenger,1,0,1,11,12,8.33,Furthest
11370,March,2020,Orange,CA,Passenger,7,2,9,500,509,1.77,Nearest
11371,March,2020,Camden,NJ,Passenger,0,2,2,20,22,9.09,Furthest
11372,March,2020,Douglas,NE,Passenger,0,1,1,56,57,1.75,Mid-Distance
11373,March,2020,Columbia,WA,Truck,0,0,0,1533,1533,0.0,Washington
11374,March,2020,Jefferson,WA,Passenger,234,141,375,25071,25446,1.47,Washington
11375,March,2020,Fairbanks North Star,AK,Passenger,0,1,1,98,99,1.01,Nearest
11376,March,2020,Charleston,SC,Passenger,1,0,1,107,108,0.93,Furthest
11377,March,2020,Pend Oreille,WA,Passenger,8,7,15,9369,9384,0.16,Washington
11378,March,2020,Snohomish,WA,Truck,0,0,0,123723,123723,0.0,Washington
11379,March,2020,Rogers,OK,Passenger,1,0,1,5,6,16.67,Mid-Distance
11380,March,2020,Chesapeake,VA,Passenger,0,2,2,427,429,0.47,Furthest
11381,March,2020,Adams,WA,Truck,0,0,0,5219,5219,0.0,Washington
11382,March,2020,Contra Costa,CA,Passenger,3,2,5,327,332,1.51,Nearest
11383,March,2020,King,WA,Passenger,23884,7720,31604,1397089,1428693,2.21,Washington
11384,March,2020,Clark,WA,Truck,0,0,0,82047,82047,0.0,Washington
11385,March,2020,Middlesex,MA,Passenger,1,1,2,102,104,1.92,Furthest
11386,March,2020,Franklin,WA,Passenger,58,77,135,61018,61153,0.22,Washington
11387,March,2020,Franklin,WA,Truck,0,0,0,19901,19901,0.0,Washington
11388,March,2020,Dakota,MN,Passenger,0,1,1,32,33,3.03,Mid-Distance
11389,March,2020,Flathead,MT,Passenger,1,0,1,64,65,1.54,Nearest
11390,March,2020,Randolph,NC,Passenger,1,0,1,7,8,12.5,Furthest
11391,March,2020,Benton,WA,Truck,0,0,0,42519,42519,0.0,Washington
11392,March,2020,Suffolk,MA,Passenger,0,2,2,37,39,5.13,Furthest
11393,March,2020,Moore,NC,Passenger,0,1,1,163,164,0.61,Furthest
11394,March,2020,Juneau,AK,Passenger,0,2,2,31,33,6.06,Nearest
11395,March,2020,Collin,TX,Passenger,1,1,2,126,128,1.56,Mid-Distance
11396,March,2020,Lee,FL,Passenger,1,0,1,51,52,1.92,Furthest
11397,March,2020,Carroll,NH,Passenger,0,1,1,4,5,20.0,Furthest
11398,March,2020,Klamath,OR,Passenger,1,0,1,36,37,2.7,Nearest
11399,March,2020,Nueces,TX,Passenger,1,0,1,83,84,1.19,Mid-Distance
11400,March,2020,Garfield,WA,Truck,0,0,0,976,976,0.0,Washington
11401,March,2020,Solano,CA,Passenger,1,0,1,212,213,0.47,Nearest
11402,March,2020,Loudoun,VA,Passenger,1,0,1,89,90,1.11,Furthest
11403,March,2020,Norfolk,VA,Passenger,2,2,4,349,353,1.13,Furthest
11404,March,2020,Carson City,NV,Passenger,1,0,1,11,12,8.33,Nearest
11405,March,2020,Honolulu,HI,Passenger,4,2,6,465,471,1.27,Nearest
11406,March,2020,Kootenai,ID,Passenger,1,1,2,228,230,0.87,Nearest
11407,March,2020,Klickitat,WA,Truck,0,0,0,8273,8273,0.0,Washington
11408,March,2020,Clay,FL,Passenger,0,1,1,83,84,1.19,Furthest
11409,March,2020,District of Columbia,DC,Passenger,1,1,2,206,208,0.96,Furthest
11410,March,2020,Pima,AZ,Passenger,3,1,4,358,362,1.1,Nearest
11411,March,2020,RÃ­o Grande,PR,Passenger,1,0,1,1,2,50.0,Mid-Distance
11412,March,2020,Sumter,FL,Passenger,0,1,1,9,10,10.0,Furthest
11413,March,2020,Skamania,WA,Passenger,29,18,47,8716,8763,0.54,Washington
11414,March,2020,Deschutes,OR,Passenger,3,0,3,143,146,2.05,Nearest
11415,March,2020,Shelby,TN,Passenger,0,1,1,89,90,1.11,Furthest
11416,March,2020,Grays Harbor,WA,Passenger,107,109,216,48321,48537,0.45,Washington
11417,March,2020,Wilson,TX,Passenger,0,1,1,7,8,12.5,Mid-Distance
11418,March,2020,Kittitas,WA,Truck,0,0,0,14621,14621,0.0,Washington
11419,March,2020,Greene,MO,Passenger,0,1,1,31,32,3.12,Furthest
11420,March,2020,Williamson,TX,Passenger,0,2,2,142,144,1.39,Mid-Distance
11421,March,2020,Montgomery,PA,Passenger,1,0,1,35,36,2.78,Furthest
11422,March,2020,Gwinnett,GA,Passenger,1,0,1,74,75,1.33,Furthest
11423,March,2020,Whitman,WA,Truck,0,0,0,8549,8549,0.0,Washington
11424,March,2020,Fulton,GA,Passenger,1,2,3,106,109,2.75,Furthest
11425,March,2020,Penobscot,ME,Passenger,0,1,1,15,16,6.25,Furthest
11426,March,2020,Queens,NY,Passenger,1,0,1,53,54,1.85,Furthest
11427,March,2020,Houston,GA,Passenger,1,0,1,57,58,1.72,Furthest
11428,March,2020,Putnam,TN,Passenger,0,1,1,3,4,25.0,Furthest
11429,March,2020,Douglas,WA,Passenger,71,40,111,28174,28285,0.39,Washington
11430,March,2020,Benton,WA,Passenger,344,319,663,135166,135829,0.49,Washington
11431,March,2020,Asotin,WA,Passenger,16,12,28,12596,12624,0.22,Washington
11432,March,2020,Pacific,WA,Passenger,29,34,63,16025,16088,0.39,Washington
11433,March,2020,Hennepin,MN,Passenger,3,1,4,94,98,4.08,Mid-Distance
11434,March,2020,Montgomery,OH,Passenger,0,1,1,46,47,2.13,Furthest
11435,March,2020,Jefferson,CO,Passenger,0,1,1,57,58,1.72,Mid-Distance
11436,March,2020,Kitsap,WA,Truck,1,0,1,54213,54214,0.0,Washington
11437,March,2020,Pierce,WA,Passenger,2310,1693,4003,551180,555183,0.72,Washington
11438,March,2020,Hamilton,IN,Passenger,1,0,1,40,41,2.44,Furthest
11439,March,2020,Skamania,WA,Truck,0,0,0,4082,4082,0.0,Washington
11440,March,2020,Cumberland,NC,Passenger,0,2,2,481,483,0.41,Furthest
11441,March,2020,Charles,MD,Passenger,0,1,1,74,75,1.33,Furthest
11442,March,2020,Dallas,TX,Passenger,1,0,1,200,201,0.5,Mid-Distance
11443,March,2020,Hawaii,HI,Passenger,1,0,1,60,61,1.64,Nearest
11444,March,2020,Pend Oreille,WA,Truck,0,0,0,5757,5757,0.0,Washington
11445,March,2020,San Juan,WA,Passenger,291,86,377,14281,14658,2.57,Washington
11446,March,2020,Island,WA,Truck,1,0,1,21265,21266,0.0,Washington
11447,March,2020,Okanogan,WA,Passenger,34,31,65,26068,26133,0.25,Washington
11448,March,2020,Frederick,MD,Passenger,1,1,2,79,81,2.47,Furthest
11449,March,2020,Richland,SC,Passenger,0,1,1,155,156,0.64,Furthest
11450,March,2020,Kent,MI,Passenger,0,1,1,23,24,4.17,Furthest
11451,March,2020,San Francisco,CA,Passenger,2,1,3,99,102,2.94,Nearest
11452,March,2020,Tarrant,TX,Passenger,1,0,1,179,180,0.56,Mid-Distance
11453,March,2020,Lincoln,WA,Passenger,2,12,14,7750,7764,0.18,Washington
11454,March,2020,Garfield,WA,Passenger,0,1,1,1350,1351,0.07,Washington
11455,March,2020,Cascade,MT,Passenger,0,1,1,55,56,1.79,Nearest
11456,March,2020,Grant,WA,Truck,0,0,0,27056,27056,0.0,Washington
11457,March,2020,Maricopa,AZ,Passenger,7,6,13,1457,1470,0.88,Nearest
11458,March,2020,Fort Bend,TX,Passenger,1,0,1,47,48,2.08,Mid-Distance
11459,March,2020,Montgomery,TX,Passenger,1,0,1,52,53,1.89,Mid-Distance
11460,March,2020,San Diego,CA,Passenger,12,5,17,2781,2798,0.61,Nearest
11461,March,2020,Klickitat,WA,Passenger,51,41,92,15597,15689,0.59,Washington
11462,March,2020,Maui,HI,Passenger,1,0,1,34,35,2.86,Nearest
11463,March,2020,Harris,TX,Passenger,1,0,1,236,237,0.42,Mid-Distance
11464,March,2020,Asotin,WA,Truck,0,0,0,6667,6667,0.0,Washington
11465,March,2020,Lake,IL,Passenger,1,0,1,166,167,0.6,Mid-Distance
11466,March,2020,Duval,FL,Passenger,0,2,2,363,365,0.55,Furthest
11467,March,2020,Oldham,KY,Passenger,0,1,1,4,5,20.0,Furthest
11468,March,2020,Anne Arundel,MD,Passenger,1,1,2,424,426,0.47,Furthest
11469,March,2020,Chelan,WA,Truck,0,0,0,22551,22551,0.0,Washington
11470,March,2020,St. Mary's,MD,Passenger,1,0,1,215,216,0.46,Furthest
11471,March,2020,Ferry,WA,Truck,0,0,0,3565,3565,0.0,Washington
11472,March,2020,Twin Falls,ID,Passenger,0,1,1,28,29,3.45,Nearest
11473,March,2020,Tuolumne,CA,Passenger,0,1,1,10,11,9.09,Nearest
11474,March,2020,Chelan,WA,Passenger,220,79,299,54482,54781,0.55,Washington
11475,March,2020,Columbia,WA,Passenger,3,3,6,2416,2422,0.25,Washington
11476,March,2020,Portsmouth,VA,Passenger,0,1,1,79,80,1.25,Furthest
11477,March,2020,DeKalb,IN,Passenger,1,0,1,1,2,50.0,Furthest
11478,March,2020,Stevens,WA,Truck,0,0,0,18700,18700,0.0,Washington
11479,March,2020,Pinellas,FL,Passenger,1,1,2,109,111,1.8,Furthest
11480,March,2020,Stafford,VA,Passenger,1,1,2,91,93,2.15,Furthest
11481,March,2020,Allegheny,PA,Passenger,1,0,1,74,75,1.33,Furthest
11482,March,2020,Spokane,WA,Truck,1,0,1,97458,97459,0.0,Washington
11483,March,2020,Ramsey,MN,Passenger,1,0,1,40,41,2.44,Mid-Distance
11484,March,2020,Whitman,WA,Passenger,42,46,88,22485,22573,0.39,Washington
11485,March,2020,Spartanburg,SC,Passenger,0,1,1,47,48,2.08,Furthest
11486,March,2020,St. Louis,MO,Passenger,1,0,1,100,101,0.99,Furthest
11487,March,2020,Wahkiakum,WA,Truck,0,0,0,1760,1760,0.0,Washington
11488,March,2020,Pacific,WA,Truck,0,0,0,7711,7711,0.0,Washington
11489,March,2020,Albemarle,VA,Passenger,1,0,1,21,22,4.55,Furthest
11490,March,2020,Kittitas,WA,Passenger,98,49,147,29998,30145,0.49,Washington
11491,March,2020,Kern,CA,Passenger,0,1,1,220,221,0.45,Nearest
11492,March,2020,Okanogan,WA,Truck,0,0,0,16458,16458,0.0,Washington
11493,March,2020,Harrison,MS,Passenger,1,0,1,58,59,1.69,Mid-Distance
11494,March,2020,Ventura,CA,Passenger,0,3,3,293,296,1.01,Nearest
11495,March,2020,Clallam,WA,Passenger,214,166,380,50661,51041,0.74,Washington
11496,March,2020,Valencia,NM,Passenger,1,0,1,5,6,16.67,Mid-Distance
11497,March,2020,Denton,TX,Passenger,1,0,1,92,93,1.08,Mid-Distance
11498,March,2020,Clark,WA,Passenger,1983,1061,3044,320288,323332,0.94,Washington
11499,March,2020,Cape May,NJ,Passenger,0,1,1,13,14,7.14,Furthest
11500,March,2020,Yakima,WA,Passenger,124,116,240,165838,166078,0.14,Washington
11501,March,2020,Arapahoe,CO,Passenger,1,0,1,141,142,0.7,Mid-Distance
11502,March,2020,Monroe,IL,Passenger,1,0,1,4,5,20.0,Mid-Distance
11503,March,2020,Richmond,GA,Passenger,0,1,1,89,90,1.11,Furthest
11504,March,2020,Cochise,AZ,Passenger,0,1,1,102,103,0.97,Nearest
11505,March,2020,Grays Harbor,WA,Truck,0,0,0,20787,20787,0.0,Washington
11506,March,2020,DuPage,IL,Passenger,3,0,3,61,64,4.69,Mid-Distance
11507,March,2020,New Haven,CT,Passenger,0,2,2,41,43,4.65,Furthest
11508,March,2020,DeKalb,GA,Passenger,1,0,1,81,82,1.22,Furthest
11509,March,2020,Jefferson,WA,Truck,0,0,0,9594,9594,0.0,Washington
11510,March,2020,King,WA,Truck,5,1,6,182420,182426,0.0,Washington
11511,March,2020,Los Angeles,CA,Passenger,7,11,18,1027,1045,1.72,Nearest
11512,March,2020,Manassas,VA,Passenger,0,1,1,5,6,16.67,Furthest
11513,March,2021,Richmond,GA,Passenger,0,1,1,75,76,1.32,Furthest
11514,March,2021,Sacramento,CA,Passenger,2,0,2,232,234,0.85,Nearest
11515,March,2021,San Francisco,CA,Passenger,1,1,2,90,92,2.17,Nearest
11516,March,2021,El Paso,CO,Passenger,3,0,3,681,684,0.44,Mid-Distance
11517,March,2021,Greene,MO,Passenger,0,1,1,31,32,3.12,Furthest
11518,March,2021,Houston,GA,Passenger,1,0,1,49,50,2.0,Furthest
11519,March,2021,Clallam,WA,Truck,1,0,1,21955,21956,0.0,Washington
11520,March,2021,Skagit,WA,Truck,1,0,1,32932,32933,0.0,Washington
11521,March,2021,Kent,MI,Passenger,0,1,1,26,27,3.7,Furthest
11522,March,2021,Ray,MO,Passenger,0,1,1,1,2,50.0,Furthest
11523,March,2021,District of Columbia,DC,Passenger,3,1,4,200,204,1.96,Furthest
11524,March,2021,Williams,ND,Passenger,0,1,1,10,11,9.09,Mid-Distance
11525,March,2021,Carroll,MD,Passenger,0,1,1,19,20,5.0,Furthest
11526,March,2021,Queens,NY,Passenger,2,0,2,49,51,3.92,Furthest
11527,March,2021,Yakima,WA,Passenger,188,135,323,168230,168553,0.19,Washington
11528,March,2021,Pacific,WA,Passenger,39,40,79,15920,15999,0.49,Washington
11529,March,2021,Pacific,WA,Truck,0,0,0,7879,7879,0.0,Washington
11530,March,2021,Charleston,SC,Passenger,2,0,2,84,86,2.33,Furthest
11531,March,2021,Anchorage,AK,Passenger,1,0,1,140,141,0.71,Nearest
11532,March,2021,San Juan,WA,Passenger,394,123,517,14117,14634,3.53,Washington
11533,March,2021,Okaloosa,FL,Passenger,0,1,1,127,128,0.78,Furthest
11534,March,2021,Tulsa,OK,Passenger,1,0,1,41,42,2.38,Mid-Distance
11535,March,2021,Sevier,AR,Passenger,0,1,1,0,1,100.0,Mid-Distance
11536,March,2021,Leavenworth,KS,Passenger,0,1,1,118,119,0.84,Mid-Distance
11537,March,2021,Moore,NC,Passenger,0,1,1,134,135,0.74,Furthest
11538,March,2021,Whatcom,WA,Truck,4,0,4,43783,43787,0.01,Washington
11539,March,2021,Multnomah,OR,Passenger,3,5,8,660,668,1.2,Nearest
11540,March,2021,Bartow,GA,Passenger,0,1,1,4,5,20.0,Furthest
11541,March,2021,Yamhill,OR,Passenger,1,0,1,37,38,2.63,Nearest
11542,March,2021,Fairfax,VA,Passenger,4,4,8,695,703,1.14,Furthest
11543,March,2021,Jones,GA,Passenger,1,0,1,1,2,50.0,Furthest
11544,March,2021,Alameda,CA,Passenger,3,0,3,251,254,1.18,Nearest
11545,March,2021,Lewis,WA,Passenger,130,134,264,59293,59557,0.44,Washington
11546,March,2021,Sedgwick,KS,Passenger,1,1,2,86,88,2.27,Mid-Distance
11547,March,2021,Ferry,WA,Truck,0,0,0,3623,3623,0.0,Washington
11548,March,2021,Prince George's,MD,Passenger,2,1,3,140,143,2.1,Furthest
11549,March,2021,Pennington,SD,Passenger,1,0,1,32,33,3.03,Mid-Distance
11550,March,2021,Thurston,WA,Passenger,1432,824,2256,197465,199721,1.13,Washington
11551,March,2021,Dakota,MN,Passenger,0,1,1,25,26,3.85,Mid-Distance
11552,March,2021,San Mateo,CA,Passenger,1,1,2,102,104,1.92,Nearest
11553,March,2021,Goochland,VA,Passenger,4,3,7,237,244,2.87,Furthest
11554,March,2021,Chelan,WA,Passenger,304,94,398,54537,54935,0.72,Washington
11555,March,2021,Kittitas,WA,Passenger,146,55,201,29891,30092,0.67,Washington
11556,March,2021,Kings,NY,Passenger,1,0,1,67,68,1.47,Furthest
11557,March,2021,Polk,FL,Passenger,1,0,1,53,54,1.85,Furthest
11558,March,2021,Klickitat,WA,Truck,0,0,0,8173,8173,0.0,Washington
11559,March,2021,Manassas,VA,Passenger,0,1,1,6,7,14.29,Furthest
11560,March,2021,Shelby,OH,Passenger,0,1,1,1,2,50.0,Furthest
11561,March,2021,Bucks,PA,Passenger,1,0,1,18,19,5.26,Furthest
11562,March,2021,Middlesex,MA,Passenger,1,1,2,93,95,2.11,Furthest
11563,March,2021,Island,WA,Truck,0,0,0,21460,21460,0.0,Washington
11564,March,2021,Douglas,NE,Passenger,1,1,2,49,51,3.92,Mid-Distance
11565,March,2021,Montgomery,TX,Passenger,1,1,2,43,45,4.44,Mid-Distance
11566,March,2021,Cape May,NJ,Passenger,0,1,1,8,9,11.11,Furthest
11567,March,2021,Grant,WA,Truck,0,0,0,27760,27760,0.0,Washington
11568,March,2021,Kitsap,WA,Truck,0,0,0,54392,54392,0.0,Washington
11569,March,2021,Jefferson,WA,Truck,0,0,0,9591,9591,0.0,Washington
11570,March,2021,Santa Cruz,CA,Passenger,1,0,1,29,30,3.33,Nearest
11571,March,2021,King,WA,Passenger,28522,8567,37089,1365152,1402241,2.64,Washington
11572,March,2021,Allegheny,PA,Passenger,1,1,2,65,67,2.99,Furthest
11573,March,2021,Snohomish,WA,Passenger,5384,1931,7315,538886,546201,1.34,Washington
11574,March,2021,Philadelphia,PA,Passenger,1,0,1,55,56,1.79,Furthest
11575,March,2021,Frederick,MD,Passenger,1,1,2,71,73,2.74,Furthest
11576,March,2021,Bexar,TX,Passenger,4,5,9,546,555,1.62,Mid-Distance
11577,March,2021,Spartanburg,SC,Passenger,0,1,1,50,51,1.96,Furthest
11578,March,2021,Walla Walla,WA,Truck,0,0,0,13966,13966,0.0,Washington
11579,March,2021,Skamania,WA,Truck,0,0,0,4027,4027,0.0,Washington
11580,March,2021,Lane,OR,Passenger,0,1,1,125,126,0.79,Nearest
11581,March,2021,St. Mary's,MD,Passenger,1,0,1,213,214,0.47,Furthest
11582,March,2021,Nassau,NY,Passenger,4,0,4,27,31,12.9,Furthest
11583,March,2021,Honolulu,HI,Passenger,5,2,7,407,414,1.69,Nearest
11584,March,2021,Washoe,NV,Passenger,1,0,1,96,97,1.03,Nearest
11585,March,2021,Ferry,WA,Passenger,10,3,13,4349,4362,0.3,Washington
11586,March,2021,Grays Harbor,WA,Passenger,150,131,281,49026,49307,0.57,Washington
11587,March,2021,Riverside,CA,Passenger,5,1,6,574,580,1.03,Nearest
11588,March,2021,DuPage,IL,Passenger,2,0,2,54,56,3.57,Mid-Distance
11589,March,2021,Kauai,HI,Passenger,1,0,1,15,16,6.25,Nearest
11590,March,2021,Nueces,TX,Passenger,1,0,1,79,80,1.25,Mid-Distance
11591,March,2021,St. Clair,IL,Passenger,1,0,1,138,139,0.72,Mid-Distance
11592,March,2021,Walla Walla,WA,Passenger,107,72,179,36286,36465,0.49,Washington
11593,March,2021,Lee,FL,Passenger,1,0,1,38,39,2.56,Furthest
11594,March,2021,San Diego,CA,Passenger,14,5,19,2637,2656,0.72,Nearest
11595,March,2021,Mason,WA,Truck,0,0,0,21168,21168,0.0,Washington
11596,March,2021,Yakima,WA,Truck,0,0,0,61384,61384,0.0,Washington
11597,March,2021,Kittitas,WA,Truck,0,0,0,14757,14757,0.0,Washington
11598,March,2021,Prince William,VA,Passenger,1,1,2,212,214,0.93,Furthest
11599,March,2021,Douglas,WA,Truck,0,0,0,12557,12557,0.0,Washington
11600,March,2021,Pima,AZ,Passenger,2,1,3,302,305,0.98,Nearest
11601,March,2021,Kitsap,WA,Passenger,1675,800,2475,179749,182224,1.36,Washington
11602,March,2021,Adams,WA,Truck,0,0,0,5375,5375,0.0,Washington
11603,March,2021,Fulton,GA,Passenger,0,2,2,81,83,2.41,Furthest
11604,March,2021,Maui,HI,Passenger,1,0,1,26,27,3.7,Nearest
11605,March,2021,DeKalb,GA,Passenger,1,0,1,63,64,1.56,Furthest
11606,March,2021,Cumberland,NC,Passenger,0,2,2,436,438,0.46,Furthest
11607,March,2021,Monroe,IL,Passenger,1,0,1,3,4,25.0,Mid-Distance
11608,March,2021,Howard,MD,Passenger,0,1,1,63,64,1.56,Furthest
11609,March,2021,Platte,MO,Passenger,1,0,1,19,20,5.0,Furthest
11610,March,2021,Franklin,WA,Truck,0,0,0,20608,20608,0.0,Washington
11611,March,2021,Hawaii,HI,Passenger,1,0,1,48,49,2.04,Nearest
11612,March,2021,Spokane,WA,Truck,0,0,0,101439,101439,0.0,Washington
11613,March,2021,Okanogan,WA,Truck,0,0,0,16672,16672,0.0,Washington
11614,March,2021,Garfield,WA,Truck,0,0,0,1012,1012,0.0,Washington
11615,March,2021,Maricopa,AZ,Passenger,5,4,9,1234,1243,0.72,Nearest
11616,March,2021,Larimer,CO,Passenger,1,0,1,53,54,1.85,Mid-Distance
11617,March,2021,Orange,FL,Passenger,1,0,1,112,113,0.88,Furthest
11618,March,2021,Salt Lake,UT,Passenger,0,1,1,171,172,0.58,Nearest
11619,March,2021,Harrison,MS,Passenger,2,0,2,51,53,3.77,Mid-Distance
11620,March,2021,Snohomish,WA,Truck,1,0,1,125936,125937,0.0,Washington
11621,March,2021,Washington,OR,Passenger,1,0,1,394,395,0.25,Nearest
11622,March,2021,El Dorado,CA,Passenger,1,0,1,30,31,3.23,Nearest
11623,March,2021,Arlington,VA,Passenger,0,1,1,136,137,0.73,Furthest
11624,March,2021,Orange,CA,Passenger,4,3,7,440,447,1.57,Nearest
11625,March,2021,Wichita,TX,Passenger,1,0,1,40,41,2.44,Mid-Distance
11626,March,2021,Boone,MO,Passenger,0,1,1,10,11,9.09,Furthest
11627,March,2021,Clark,WA,Truck,0,0,0,83850,83850,0.0,Washington
11628,March,2021,Lincoln,WA,Passenger,5,13,18,7691,7709,0.23,Washington
11629,March,2021,Cowlitz,WA,Truck,0,0,0,29052,29052,0.0,Washington
11630,March,2021,Douglas,CO,Passenger,0,1,1,77,78,1.28,Mid-Distance
11631,March,2021,Montgomery,OH,Passenger,0,1,1,55,56,1.79,Furthest
11632,March,2021,Skagit,WA,Passenger,539,260,799,91602,92401,0.86,Washington
11633,March,2021,Clallam,WA,Passenger,299,199,498,50123,50621,0.98,Washington
11634,March,2021,Portsmouth,VA,Passenger,0,1,1,76,77,1.3,Furthest
11635,March,2021,Hampshire,MA,Passenger,1,0,1,6,7,14.29,Furthest
11636,March,2021,Clackamas,OR,Passenger,3,0,3,175,178,1.69,Nearest
11637,March,2021,Clark,NV,Passenger,4,2,6,639,645,0.93,Nearest
11638,March,2021,Island,WA,Passenger,556,299,855,63006,63861,1.34,Washington
11639,March,2021,St. Louis,MO,Passenger,1,0,1,91,92,1.09,Furthest
11640,March,2021,Whitman,WA,Truck,0,0,0,8553,8553,0.0,Washington
11641,March,2021,Lewis,WA,Truck,0,0,0,26811,26811,0.0,Washington
11642,March,2021,Suffolk,VA,Passenger,1,0,1,124,125,0.8,Furthest
11643,March,2021,Stafford,VA,Passenger,2,1,3,97,100,3.0,Furthest
11644,March,2021,Fairbanks North Star,AK,Passenger,0,1,1,85,86,1.16,Nearest
11645,March,2021,Carroll,NH,Passenger,0,1,1,5,6,16.67,Furthest
11646,March,2021,Owyhee,ID,Passenger,1,0,1,3,4,25.0,Nearest
11647,March,2021,Montgomery,MD,Passenger,1,0,1,228,229,0.44,Furthest
11648,March,2021,Montgomery,PA,Passenger,1,0,1,24,25,4.0,Furthest
11649,March,2021,Jefferson,WA,Passenger,302,174,476,24829,25305,1.88,Washington
11650,March,2021,Ramsey,MN,Passenger,1,0,1,32,33,3.03,Mid-Distance
11651,March,2021,Hamilton,IN,Passenger,2,0,2,35,37,5.41,Furthest
11652,March,2021,Hudson,NJ,Passenger,1,0,1,41,42,2.38,Furthest
11653,March,2021,Placer,CA,Passenger,2,0,2,79,81,2.47,Nearest
11654,March,2021,Wahkiakum,WA,Truck,0,0,0,1788,1788,0.0,Washington
11655,March,2021,Nassau,FL,Passenger,1,0,1,32,33,3.03,Furthest
11656,March,2021,Franklin,WA,Passenger,100,88,188,61668,61856,0.3,Washington
11657,March,2021,Boulder,CO,Passenger,0,1,1,46,47,2.13,Mid-Distance
11658,March,2021,Douglas,WA,Passenger,86,47,133,28378,28511,0.47,Washington
11659,March,2021,Morris,NJ,Passenger,1,0,1,16,17,5.88,Furthest
11660,March,2021,San Joaquin,CA,Passenger,1,0,1,104,105,0.95,Nearest
11661,March,2021,RÃ­o Grande,PR,Passenger,1,0,1,1,2,50.0,Mid-Distance
11662,March,2021,Pinellas,FL,Passenger,1,1,2,95,97,2.06,Furthest
11663,March,2021,Putnam,TN,Passenger,0,1,1,0,1,100.0,Furthest
11664,March,2021,Norfolk,VA,Passenger,2,3,5,327,332,1.51,Furthest
11665,March,2021,Sumter,FL,Passenger,0,1,1,10,11,9.09,Furthest
11666,March,2021,Denver,CO,Passenger,1,0,1,112,113,0.88,Mid-Distance
11667,March,2021,San Juan,WA,Truck,0,0,0,5885,5885,0.0,Washington
11668,March,2021,New Haven,CT,Passenger,0,2,2,32,34,5.88,Furthest
11669,March,2021,Stevens,WA,Truck,0,0,0,18796,18796,0.0,Washington
11670,March,2021,King,WA,Truck,6,1,7,184559,184566,0.0,Washington
11671,March,2021,Duval,FL,Passenger,0,2,2,346,348,0.57,Furthest
11672,March,2021,Sarasota,FL,Passenger,2,0,2,26,28,7.14,Furthest
11673,March,2021,Contra Costa,CA,Passenger,3,4,7,273,280,2.5,Nearest
11674,March,2021,Santa Clara,CA,Passenger,8,2,10,261,271,3.69,Nearest
11675,March,2021,Whatcom,WA,Passenger,1298,576,1874,150446,152320,1.23,Washington
11676,March,2021,Flathead,MT,Passenger,1,0,1,45,46,2.17,Nearest
11677,March,2021,Grant,WA,Passenger,93,87,180,66441,66621,0.27,Washington
11678,March,2021,Camden,NJ,Passenger,0,1,1,14,15,6.67,Furthest
11679,March,2021,Fresno,CA,Passenger,1,0,1,167,168,0.6,Nearest
11680,March,2021,Howard,IN,Passenger,0,1,1,3,4,25.0,Furthest
11681,March,2021,Thurston,WA,Truck,0,0,0,56530,56530,0.0,Washington
11682,March,2021,Wahkiakum,WA,Passenger,9,7,16,3083,3099,0.52,Washington
11683,March,2021,Pierce,WA,Passenger,3126,1845,4971,556748,561719,0.88,Washington
11684,March,2021,Mason,WA,Passenger,185,137,322,47894,48216,0.67,Washington
11685,March,2021,Okanogan,WA,Passenger,57,35,92,26225,26317,0.35,Washington
11686,March,2021,Chesapeake,VA,Passenger,0,3,3,397,400,0.75,Furthest
11687,March,2021,New York,NY,Passenger,1,0,1,49,50,2.0,Furthest
11688,March,2021,Harnett,NC,Passenger,1,1,2,176,178,1.12,Furthest
11689,March,2021,Pierce,WA,Truck,0,0,0,145348,145348,0.0,Washington
11690,March,2021,Fort Bend,TX,Passenger,1,0,1,39,40,2.5,Mid-Distance
11691,March,2021,Oldham,KY,Passenger,0,1,1,4,5,20.0,Furthest
11692,March,2021,Spokane,WA,Passenger,952,584,1536,322674,324210,0.47,Washington
11693,March,2021,Clark,WA,Passenger,2578,1276,3854,320028,323882,1.19,Washington
11694,March,2021,Chelan,WA,Truck,0,0,0,22987,22987,0.0,Washington
11695,March,2021,Loudoun,VA,Passenger,1,0,1,72,73,1.37,Furthest
11696,March,2021,Arapahoe,CO,Passenger,1,0,1,115,116,0.86,Mid-Distance
11697,March,2021,Miami-Dade,FL,Passenger,1,0,1,97,98,1.02,Furthest
11698,March,2021,Vigo,IN,Passenger,1,0,1,5,6,16.67,Furthest
11699,March,2021,Columbia,WA,Passenger,5,4,9,2466,2475,0.36,Washington
11700,March,2021,Los Angeles,CA,Passenger,10,10,20,910,930,2.15,Nearest
11701,March,2021,Missoula,MT,Passenger,1,0,1,64,65,1.54,Nearest
11702,March,2021,Saginaw,MI,Passenger,2,0,2,10,12,16.67,Furthest
11703,March,2021,Utah,UT,Passenger,0,1,1,119,120,0.83,Nearest
11704,March,2021,Rockingham,NH,Passenger,1,0,1,23,24,4.17,Furthest
11705,March,2021,Benton,WA,Passenger,466,369,835,135501,136336,0.61,Washington
11706,March,2021,Harris,TX,Passenger,1,1,2,202,204,0.98,Mid-Distance
11707,March,2021,Monterey,CA,Passenger,0,1,1,147,148,0.68,Nearest
11708,March,2021,Collin,TX,Passenger,1,1,2,114,116,1.72,Mid-Distance
11709,March,2021,Klamath,OR,Passenger,1,0,1,29,30,3.33,Nearest
11710,March,2021,Powhatan,VA,Passenger,1,0,1,1,2,50.0,Furthest
11711,March,2021,Pend Oreille,WA,Truck,0,0,0,5724,5724,0.0,Washington
11712,March,2021,Washington,MD,Passenger,1,0,1,12,13,7.69,Furthest
11713,March,2021,Charles,MD,Passenger,1,1,2,70,72,2.78,Furthest
11714,March,2021,Cowlitz,WA,Passenger,197,133,330,72161,72491,0.46,Washington
11715,March,2021,Alexandria,VA,Passenger,2,0,2,131,133,1.5,Furthest
11716,March,2021,Penobscot,ME,Passenger,0,1,1,9,10,10.0,Furthest
11717,March,2021,Randolph,NC,Passenger,1,0,1,7,8,12.5,Furthest
11718,March,2021,Suffolk,MA,Passenger,0,2,2,33,35,5.71,Furthest
11719,March,2021,Williamson,TX,Passenger,0,2,2,113,115,1.74,Mid-Distance
11720,March,2021,Travis,TX,Passenger,2,3,5,163,168,2.98,Mid-Distance
11721,March,2021,Skamania,WA,Passenger,38,25,63,8308,8371,0.75,Washington
11722,March,2021,Deschutes,OR,Passenger,1,0,1,119,120,0.83,Nearest
11723,March,2021,Asotin,WA,Truck,0,0,0,6725,6725,0.0,Washington
11724,March,2021,Anne Arundel,MD,Passenger,4,1,5,395,400,1.25,Furthest
11725,March,2021,Jefferson,NY,Passenger,0,1,1,211,212,0.47,Furthest
11726,March,2021,Bradley,TN,Passenger,1,0,1,0,1,100.0,Furthest
11727,March,2021,Solano,CA,Passenger,1,0,1,195,196,0.51,Nearest
11728,March,2021,Juneau,AK,Passenger,0,1,1,26,27,3.7,Nearest
11729,March,2021,Lincoln,WA,Truck,0,0,0,4733,4733,0.0,Washington
11730,March,2021,Columbia,WA,Truck,0,0,0,1549,1549,0.0,Washington
11731,March,2021,Ulster,NY,Passenger,1,0,1,7,8,12.5,Furthest
11732,March,2021,Lake,FL,Passenger,1,0,1,21,22,4.55,Furthest
11733,March,2021,Benton,WA,Truck,0,0,0,43534,43534,0.0,Washington
11734,March,2021,Gwinnett,GA,Passenger,1,0,1,66,67,1.49,Furthest
11735,March,2021,Stevens,WA,Passenger,38,43,81,30317,30398,0.27,Washington
11736,March,2021,Pend Oreille,WA,Passenger,12,6,18,9281,9299,0.19,Washington
11737,March,2021,Hennepin,MN,Passenger,2,0,2,79,81,2.47,Mid-Distance
11738,March,2021,Kern,CA,Passenger,0,1,1,213,214,0.47,Nearest
11739,March,2021,Rogers,OK,Passenger,1,0,1,4,5,20.0,Mid-Distance
11740,March,2021,Ventura,CA,Passenger,1,1,2,265,267,0.75,Nearest
11741,March,2021,Milwaukee,WI,Passenger,1,0,1,38,39,2.56,Mid-Distance
11742,March,2021,Twin Falls,ID,Passenger,0,1,1,21,22,4.55,Nearest
11743,March,2021,Dallas,TX,Passenger,1,0,1,163,164,0.61,Mid-Distance
11744,March,2021,Carson City,NV,Passenger,1,0,1,12,13,7.69,Nearest
11745,March,2021,Wilson,TX,Passenger,0,1,1,4,5,20.0,Mid-Distance
11746,March,2021,Whitman,WA,Passenger,54,44,98,21932,22030,0.44,Washington
11747,March,2021,Garfield,WA,Passenger,0,2,2,1365,1367,0.15,Washington
11748,March,2021,Richland,SC,Passenger,0,1,1,137,138,0.72,Furthest
11749,March,2021,Adams,WA,Passenger,10,7,17,12997,13014,0.13,Washington
11750,March,2021,Broward,FL,Passenger,1,0,1,109,110,0.91,Furthest
11751,March,2021,El Paso,TX,Passenger,3,0,3,382,385,0.78,Mid-Distance
11752,March,2021,Erie,NY,Passenger,1,0,1,41,42,2.38,Furthest
11753,March,2021,Klickitat,WA,Passenger,65,46,111,15028,15139,0.73,Washington
11754,March,2021,Asotin,WA,Passenger,17,14,31,12569,12600,0.25,Washington
11755,March,2021,Lake,IL,Passenger,2,0,2,151,153,1.31,Mid-Distance
11756,March,2021,Virginia Beach,VA,Passenger,3,0,3,625,628,0.48,Furthest
11757,March,2021,Grays Harbor,WA,Truck,0,0,0,21269,21269,0.0,Washington
11758,March,2021,Calvert,MD,Passenger,0,2,2,85,87,2.3,Furthest
11759,March,2021,Plaquemines,LA,Passenger,0,1,1,15,16,6.25,Mid-Distance
11760,March,2021,Albemarle,VA,Passenger,1,0,1,21,22,4.55,Furthest
11761,March,2021,New London,CT,Passenger,1,2,3,223,226,1.33,Furthest
11763,March,2022,Wood,OH,Passenger,0,1,1,4,5,20.0,Furthest
11764,March,2022,Whatcom,WA,Truck,4,0,4,43546,43550,0.01,Washington
11765,March,2022,Powhatan,VA,Passenger,1,0,1,1,2,50.0,Furthest
11766,March,2022,Cowlitz,WA,Passenger,293,172,465,71084,71549,0.65,Washington
11767,March,2022,Wake,NC,Passenger,1,0,1,93,94,1.06,Furthest
11768,March,2022,Tarrant,TX,Passenger,1,0,1,122,123,0.81,Mid-Distance
11769,March,2022,Collin,TX,Passenger,2,0,2,95,97,2.06,Mid-Distance
11770,March,2022,Platte,MO,Passenger,1,0,1,18,19,5.26,Furthest
11771,March,2022,Nassau,NY,Passenger,2,0,2,24,26,7.69,Furthest
11772,March,2022,Okanogan,WA,Passenger,77,46,123,26522,26645,0.46,Washington
11773,March,2022,Leavenworth,KS,Passenger,0,1,1,101,102,0.98,Mid-Distance
11774,March,2022,San Bernardino,CA,Passenger,1,1,2,337,339,0.59,Nearest
11775,March,2022,Columbia,WA,Passenger,6,0,6,2448,2454,0.24,Washington
11776,March,2022,El Paso,CO,Passenger,3,1,4,617,621,0.64,Mid-Distance
11777,March,2022,Howard,IN,Passenger,0,1,1,6,7,14.29,Furthest
11778,March,2022,El Paso,TX,Passenger,2,0,2,343,345,0.58,Mid-Distance
11779,March,2022,RÃ­o Grande,PR,Passenger,1,0,1,0,1,100.0,Mid-Distance
11780,March,2022,Skagit,WA,Passenger,731,326,1057,90496,91553,1.15,Washington
11781,March,2022,Sedgwick,KS,Passenger,1,1,2,81,83,2.41,Mid-Distance
11782,March,2022,Kings,NY,Passenger,1,0,1,63,64,1.56,Furthest
11783,March,2022,Sarpy,NE,Passenger,1,0,1,52,53,1.89,Mid-Distance
11784,March,2022,Kern,CA,Passenger,0,1,1,190,191,0.52,Nearest
11785,March,2022,Alexandria,VA,Passenger,3,0,3,107,110,2.73,Furthest
11786,March,2022,Maricopa,AZ,Passenger,7,2,9,960,969,0.93,Nearest
11787,March,2022,Kittitas,WA,Passenger,225,74,299,29794,30093,0.99,Washington
11788,March,2022,Hillsborough,FL,Passenger,0,2,2,122,124,1.61,Furthest
11789,March,2022,San Mateo,CA,Passenger,2,0,2,76,78,2.56,Nearest
11790,March,2022,Hennepin,MN,Passenger,3,0,3,61,64,4.69,Mid-Distance
11791,March,2022,Pennington,SD,Passenger,2,0,2,28,30,6.67,Mid-Distance
11792,March,2022,Orange,CA,Passenger,4,2,6,362,368,1.63,Nearest
11793,March,2022,Richmond,GA,Passenger,0,1,1,69,70,1.43,Furthest
11794,March,2022,Burlington,NJ,Passenger,0,1,1,110,111,0.9,Furthest
11795,March,2022,Pend Oreille,WA,Truck,0,0,0,5689,5689,0.0,Washington
11796,March,2022,Frederick,MD,Passenger,1,1,2,67,69,2.9,Furthest
11797,March,2022,Solano,CA,Passenger,1,0,1,167,168,0.6,Nearest
11798,March,2022,Albemarle,VA,Passenger,1,0,1,17,18,5.56,Furthest
11799,March,2022,Ventura,CA,Passenger,2,1,3,234,237,1.27,Nearest
11800,March,2022,Larimer,CO,Passenger,1,0,1,50,51,1.96,Mid-Distance
11801,March,2022,Jefferson,WA,Passenger,408,207,615,24697,25312,2.43,Washington
11802,March,2022,Fresno,CA,Passenger,1,0,1,146,147,0.68,Nearest
11803,March,2022,Williamson,TX,Passenger,1,2,3,84,87,3.45,Mid-Distance
11804,March,2022,Walla Walla,WA,Truck,0,0,0,14031,14031,0.0,Washington
11805,March,2022,Montgomery,MD,Passenger,3,2,5,193,198,2.53,Furthest
11806,March,2022,Norfolk,VA,Passenger,3,3,6,298,304,1.97,Furthest
11807,March,2022,Cowlitz,WA,Truck,0,1,1,28868,28869,0.0,Washington
11808,March,2022,Ferry,WA,Truck,0,0,0,3571,3571,0.0,Washington
11809,March,2022,San Diego,CA,Passenger,14,8,22,2332,2354,0.93,Nearest
11810,March,2022,Jefferson,NY,Passenger,0,1,1,203,204,0.49,Furthest
11811,March,2022,Wilson,NC,Passenger,1,0,1,0,1,100.0,Furthest
11812,March,2022,Charleston,SC,Passenger,2,1,3,63,66,4.55,Furthest
11813,March,2022,Goochland,VA,Passenger,3,2,5,151,156,3.21,Furthest
11814,March,2022,Adams,WA,Truck,0,0,0,5488,5488,0.0,Washington
11815,March,2022,Thurston,WA,Truck,3,0,3,55747,55750,0.01,Washington
11816,March,2022,Clark,WA,Passenger,3744,1656,5400,318350,323750,1.67,Washington
11817,March,2022,Bartow,GA,Passenger,0,1,1,3,4,25.0,Furthest
11818,March,2022,Harris,TX,Passenger,1,0,1,145,146,0.68,Mid-Distance
11819,March,2022,Oldham,KY,Passenger,0,1,1,4,5,20.0,Furthest
11820,March,2022,Lake,IL,Passenger,3,0,3,143,146,2.05,Mid-Distance
11821,March,2022,Juneau,AK,Passenger,0,1,1,30,31,3.23,Nearest
11822,March,2022,Mason,WA,Passenger,286,171,457,47633,48090,0.95,Washington
11823,March,2022,Montgomery,PA,Passenger,2,0,2,22,24,8.33,Furthest
11824,March,2022,Douglas,WA,Truck,0,0,0,12726,12726,0.0,Washington
11825,March,2022,DeKalb,GA,Passenger,1,0,1,49,50,2.0,Furthest
11826,March,2022,Rockingham,NH,Passenger,1,0,1,17,18,5.56,Furthest
11827,March,2022,Queens,NY,Passenger,1,0,1,45,46,2.17,Furthest
11828,March,2022,Whitman,WA,Passenger,79,54,133,22044,22177,0.6,Washington
11829,March,2022,Richmond,NY,Passenger,1,0,1,6,7,14.29,Furthest
11830,March,2022,Prince William,VA,Passenger,0,1,1,196,197,0.51,Furthest
11831,March,2022,Pierce,WA,Passenger,4629,2234,6863,550172,557035,1.23,Washington
11832,March,2022,Travis,TX,Passenger,1,0,1,113,114,0.88,Mid-Distance
11833,March,2022,Clallam,WA,Truck,1,0,1,22058,22059,0.0,Washington
11834,March,2022,Fairfax,VA,Passenger,3,3,6,614,620,0.97,Furthest
11835,March,2022,Baltimore,MD,Passenger,1,0,1,76,77,1.3,Furthest
11836,March,2022,Wilson,TX,Passenger,0,1,1,2,3,33.33,Mid-Distance
11837,March,2022,Carroll,MD,Passenger,0,1,1,15,16,6.25,Furthest
11838,March,2022,Boulder,CO,Passenger,1,0,1,35,36,2.78,Mid-Distance
11839,March,2022,Danville,VA,Passenger,1,0,1,0,1,100.0,Furthest
11840,March,2022,Boone,MO,Passenger,0,1,1,9,10,10.0,Furthest
11841,March,2022,Arlington,VA,Passenger,1,0,1,128,129,0.78,Furthest
11842,March,2022,Riverside,CA,Passenger,7,1,8,467,475,1.68,Nearest
11843,March,2022,Asotin,WA,Truck,0,0,0,6757,6757,0.0,Washington
11844,March,2022,St. Mary's,MD,Passenger,1,0,1,198,199,0.5,Furthest
11845,March,2022,Stafford,VA,Passenger,2,1,3,88,91,3.3,Furthest
11846,March,2022,Hamilton,OH,Passenger,1,0,1,30,31,3.23,Furthest
11847,March,2022,Houston,GA,Passenger,1,0,1,38,39,2.56,Furthest
11848,March,2022,Benton,WA,Truck,1,0,1,43613,43614,0.0,Washington
11849,March,2022,Allegheny,PA,Passenger,1,1,2,53,55,3.64,Furthest
11850,March,2022,Benton,WA,Passenger,698,444,1142,135765,136907,0.83,Washington
11851,March,2022,Williams,ND,Passenger,0,1,1,7,8,12.5,Mid-Distance
11852,March,2022,Bell,TX,Passenger,1,0,1,328,329,0.3,Mid-Distance
11853,March,2022,Chesapeake,VA,Passenger,2,3,5,352,357,1.4,Furthest
11854,March,2022,Gwinnett,GA,Passenger,1,0,1,54,55,1.82,Furthest
11855,March,2022,Essex,NJ,Passenger,2,0,2,9,11,18.18,Furthest
11856,March,2022,Lake,FL,Passenger,1,0,1,21,22,4.55,Furthest
11857,March,2022,Harnett,NC,Passenger,2,0,2,139,141,1.42,Furthest
11858,March,2022,Walla Walla,WA,Passenger,157,91,248,36119,36367,0.68,Washington
11859,March,2022,Jefferson,WA,Truck,0,0,0,9544,9544,0.0,Washington
11860,March,2022,Orange,FL,Passenger,1,0,1,94,95,1.05,Furthest
11861,March,2022,Fairbanks North Star,AK,Passenger,0,1,1,76,77,1.3,Nearest
11862,March,2022,Grays Harbor,WA,Truck,0,0,0,21365,21365,0.0,Washington
11863,March,2022,Loudoun,VA,Passenger,1,1,2,66,68,2.94,Furthest
11864,March,2022,Yellowstone,MT,Passenger,0,1,1,28,29,3.45,Nearest
11865,March,2022,Skamania,WA,Truck,0,0,0,3973,3973,0.0,Washington
11866,March,2022,Dallas,TX,Passenger,1,0,1,117,118,0.85,Mid-Distance
11867,March,2022,Greene,MO,Passenger,0,1,1,23,24,4.17,Furthest
11868,March,2022,Los Angeles,CA,Passenger,8,7,15,793,808,1.86,Nearest
11869,March,2022,Onslow,NC,Passenger,0,1,1,164,165,0.61,Furthest
11870,March,2022,Carroll,NH,Passenger,0,1,1,5,6,16.67,Furthest
11871,March,2022,Denton,TX,Passenger,1,0,1,68,69,1.45,Mid-Distance
11872,March,2022,Cape May,NJ,Passenger,0,1,1,8,9,11.11,Furthest
11873,March,2022,Garfield,WA,Passenger,0,3,3,1332,1335,0.22,Washington
11874,March,2022,Elmore,ID,Passenger,1,0,1,14,15,6.67,Nearest
11875,March,2022,Duval,FL,Passenger,0,2,2,286,288,0.69,Furthest
11876,March,2022,San Juan,WA,Passenger,492,152,644,14129,14773,4.36,Washington
11877,March,2022,Multnomah,OR,Passenger,1,4,5,564,569,0.88,Nearest
11878,March,2022,Randolph,NC,Passenger,1,0,1,4,5,20.0,Furthest
11879,March,2022,Rock Island,IL,Passenger,0,1,1,15,16,6.25,Mid-Distance
11880,March,2022,Suffolk,VA,Passenger,1,0,1,119,120,0.83,Furthest
11881,March,2022,Owyhee,ID,Passenger,1,0,1,2,3,33.33,Nearest
11882,March,2022,Kittitas,WA,Truck,0,0,0,14720,14720,0.0,Washington
11883,March,2022,Cumberland,NC,Passenger,1,2,3,372,375,0.8,Furthest
11884,March,2022,Camden,NJ,Passenger,0,1,1,13,14,7.14,Furthest
11885,March,2022,Pima,AZ,Passenger,1,1,2,235,237,0.84,Nearest
11886,March,2022,Lewis,WA,Passenger,226,164,390,59495,59885,0.65,Washington
11887,March,2022,Howard,MD,Passenger,0,1,1,57,58,1.72,Furthest
11888,March,2022,Mason,WA,Truck,0,0,0,21168,21168,0.0,Washington
11889,March,2022,Montgomery,AL,Passenger,0,1,1,34,35,2.86,Furthest
11890,March,2022,Sonoma,CA,Passenger,0,1,1,74,75,1.33,Nearest
11891,March,2022,Miami-Dade,FL,Passenger,1,0,1,84,85,1.18,Furthest
11892,March,2022,Kings,CA,Passenger,2,1,3,305,308,0.97,Nearest
11893,March,2022,Shelby,OH,Passenger,0,1,1,2,3,33.33,Furthest
11894,March,2022,Columbia,WA,Truck,0,0,0,1589,1589,0.0,Washington
11895,March,2022,Placer,CA,Passenger,2,0,2,69,71,2.82,Nearest
11896,March,2022,Contra Costa,CA,Passenger,0,3,3,252,255,1.18,Nearest
11897,March,2022,St. Tammany,LA,Passenger,1,0,1,35,36,2.78,Mid-Distance
11898,March,2022,New London,CT,Passenger,1,5,6,202,208,2.88,Furthest
11899,March,2022,New York,NY,Passenger,1,0,1,35,36,2.78,Furthest
11900,March,2022,Harrison,MS,Passenger,2,0,2,44,46,4.35,Mid-Distance
11901,March,2022,Stevens,WA,Truck,0,0,0,19002,19002,0.0,Washington
11902,March,2022,Broward,FL,Passenger,2,0,2,83,85,2.35,Furthest
11903,March,2022,Washington,MD,Passenger,2,0,2,14,16,12.5,Furthest
11904,March,2022,Richland,SC,Passenger,0,1,1,128,129,0.78,Furthest
11905,March,2022,Allen,IN,Passenger,1,0,1,14,15,6.67,Furthest
11906,March,2022,Alameda,CA,Passenger,4,0,4,196,200,2.0,Nearest
11907,March,2022,Plaquemines,LA,Passenger,0,1,1,17,18,5.56,Mid-Distance
11908,March,2022,King,WA,Passenger,37937,10707,48644,1352308,1400952,3.47,Washington
11909,March,2022,Geary,KS,Passenger,1,0,1,88,89,1.12,Mid-Distance
11910,March,2022,Snohomish,WA,Passenger,7665,2362,10027,534917,544944,1.84,Washington
11911,March,2022,Lincoln,WA,Passenger,7,18,25,7668,7693,0.32,Washington
11912,March,2022,St. Louis,MO,Passenger,1,0,1,68,69,1.45,Furthest
11913,March,2022,Island,WA,Passenger,758,360,1118,62387,63505,1.76,Washington
11914,March,2022,Ferry,WA,Passenger,17,3,20,4431,4451,0.45,Washington
11915,March,2022,Hawaii,HI,Passenger,1,0,1,37,38,2.63,Nearest
11916,March,2022,Clallam,WA,Passenger,402,240,642,49973,50615,1.27,Washington
11917,March,2022,District of Columbia,DC,Passenger,4,0,4,184,188,2.13,Furthest
11918,March,2022,Penobscot,ME,Passenger,0,1,1,6,7,14.29,Furthest
11919,March,2022,Escambia,FL,Passenger,0,1,1,134,135,0.74,Furthest
11920,March,2022,Prince George's,MD,Passenger,2,1,3,130,133,2.26,Furthest
11921,March,2022,Rogers,OK,Passenger,1,0,1,2,3,33.33,Mid-Distance
11922,March,2022,Lane,OR,Passenger,0,1,1,102,103,0.97,Nearest
11923,March,2022,Klickitat,WA,Truck,0,0,0,8311,8311,0.0,Washington
11924,March,2022,Middlesex,MA,Passenger,1,1,2,80,82,2.44,Furthest
11925,March,2022,Carson City,NV,Passenger,1,0,1,7,8,12.5,Nearest
11926,March,2022,Santa Cruz,CA,Passenger,1,0,1,24,25,4.0,Nearest
11927,March,2022,Spartanburg,SC,Passenger,0,1,1,43,44,2.27,Furthest
11928,March,2022,Skagit,WA,Truck,1,0,1,32552,32553,0.0,Washington
11929,March,2022,Montgomery,TX,Passenger,1,0,1,31,32,3.12,Mid-Distance
11930,March,2022,San Juan,WA,Truck,1,0,1,5995,5996,0.02,Washington
11931,March,2022,Lincoln,OR,Passenger,0,1,1,30,31,3.23,Nearest
11932,March,2022,Chelan,WA,Passenger,437,122,559,54596,55155,1.01,Washington
11933,March,2022,Grays Harbor,WA,Passenger,205,157,362,49309,49671,0.73,Washington
11934,March,2022,Klickitat,WA,Passenger,96,54,150,15336,15486,0.97,Washington
11935,March,2022,Manassas,VA,Passenger,0,1,1,7,8,12.5,Furthest
11936,March,2022,Pend Oreille,WA,Passenger,16,10,26,9051,9077,0.29,Washington
11937,March,2022,Louisa,VA,Passenger,0,1,1,1,2,50.0,Furthest
11938,March,2022,Marin,CA,Passenger,0,1,1,30,31,3.23,Nearest
11939,March,2022,Sumter,SC,Passenger,0,1,1,32,33,3.03,Furthest
11940,March,2022,Franklin,WA,Passenger,179,106,285,62085,62370,0.46,Washington
11941,March,2022,Douglas,WA,Passenger,125,56,181,28528,28709,0.63,Washington
11942,March,2022,Fort Bend,TX,Passenger,1,0,1,32,33,3.03,Mid-Distance
11943,March,2022,Kauai,HI,Passenger,1,0,1,18,19,5.26,Nearest
11944,March,2022,Clark,WA,Truck,2,0,2,83493,83495,0.0,Washington
11945,March,2022,Rockdale,GA,Passenger,1,0,1,7,8,12.5,Furthest
11946,March,2022,Clackamas,OR,Passenger,2,0,2,149,151,1.32,Nearest
11947,March,2022,Island,WA,Truck,1,0,1,21479,21480,0.0,Washington
11948,March,2022,Salt Lake,UT,Passenger,1,1,2,141,143,1.4,Nearest
11949,March,2022,Adams,WA,Passenger,16,11,27,12982,13009,0.21,Washington
11950,March,2022,Pacific,WA,Truck,0,0,0,8008,8008,0.0,Washington
11951,March,2022,Santa Clara,CA,Passenger,9,1,10,225,235,4.26,Nearest
11952,March,2022,Bexar,TX,Passenger,4,4,8,461,469,1.71,Mid-Distance
11953,March,2022,Hidalgo,TX,Passenger,0,1,1,50,51,1.96,Mid-Distance
11954,March,2022,Snohomish,WA,Truck,4,0,4,124827,124831,0.0,Washington
11955,March,2022,Douglas,NE,Passenger,1,2,3,46,49,6.12,Mid-Distance
11956,March,2022,Sacramento,CA,Passenger,2,0,2,202,204,0.98,Nearest
11957,March,2022,Okaloosa,FL,Passenger,0,1,1,102,103,0.97,Furthest
11958,March,2022,Lee,FL,Passenger,1,0,1,28,29,3.45,Furthest
11959,March,2022,Wahkiakum,WA,Passenger,18,11,29,3077,3106,0.93,Washington
11960,March,2022,Hamilton,IN,Passenger,1,0,1,21,22,4.55,Furthest
11961,March,2022,Whatcom,WA,Passenger,1735,695,2430,149237,151667,1.6,Washington
11962,March,2022,New Haven,CT,Passenger,0,2,2,28,30,6.67,Furthest
11963,March,2022,Virginia Beach,VA,Passenger,2,0,2,540,542,0.37,Furthest
11964,March,2022,Garfield,WA,Truck,0,0,0,999,999,0.0,Washington
11965,March,2022,Sevier,AR,Passenger,0,1,1,0,1,100.0,Mid-Distance
11966,March,2022,Grant,WA,Truck,0,0,0,28046,28046,0.0,Washington
11967,March,2022,Pinellas,FL,Passenger,0,1,1,80,81,1.23,Furthest
11968,March,2022,Nueces,TX,Passenger,1,1,2,58,60,3.33,Mid-Distance
11969,March,2022,Douglas,CO,Passenger,0,1,1,74,75,1.33,Mid-Distance
11970,March,2022,Dorchester,SC,Passenger,1,0,1,58,59,1.69,Furthest
11971,March,2022,Franklin,WA,Truck,0,0,0,20940,20940,0.0,Washington
11972,March,2022,Suffolk,MA,Passenger,0,1,1,23,24,4.17,Furthest
11973,March,2022,Philadelphia,PA,Passenger,1,0,1,35,36,2.78,Furthest
11974,March,2022,Galveston,TX,Passenger,0,1,1,19,20,5.0,Mid-Distance
11975,March,2022,Yakima,WA,Passenger,312,181,493,167703,168196,0.29,Washington
11976,March,2022,Portsmouth,VA,Passenger,0,1,1,75,76,1.32,Furthest
11977,March,2022,Spokane,WA,Truck,0,0,0,102463,102463,0.0,Washington
11978,March,2022,Moore,NC,Passenger,0,1,1,121,122,0.82,Furthest
11979,March,2022,St. Clair,IL,Passenger,2,0,2,122,124,1.61,Mid-Distance
11980,March,2022,Adams,CO,Passenger,1,0,1,39,40,2.5,Mid-Distance
11981,March,2022,Ulster,NY,Passenger,1,0,1,9,10,10.0,Furthest
11982,March,2022,DuPage,IL,Passenger,1,0,1,47,48,2.08,Mid-Distance
11983,March,2022,Pacific,WA,Passenger,61,68,129,15997,16126,0.8,Washington
11984,March,2022,Cook,IL,Passenger,3,0,3,190,193,1.55,Mid-Distance
11985,March,2022,San Luis Obispo,CA,Passenger,1,0,1,55,56,1.79,Nearest
11986,March,2022,Yakima,WA,Truck,0,0,0,61589,61589,0.0,Washington
11987,March,2022,Asotin,WA,Passenger,22,18,40,12658,12698,0.32,Washington
11988,March,2022,Hudson,NJ,Passenger,2,0,2,34,36,5.56,Furthest
11989,March,2022,Wichita,TX,Passenger,1,0,1,39,40,2.5,Mid-Distance
11990,March,2022,Kitsap,WA,Passenger,2274,1006,3280,179292,182572,1.8,Washington
11991,March,2022,Sarasota,FL,Passenger,2,0,2,25,27,7.41,Furthest
11992,March,2022,Lewis,WA,Truck,0,0,0,26519,26519,0.0,Washington
11993,March,2022,Wahkiakum,WA,Truck,0,0,0,1814,1814,0.0,Washington
11994,March,2022,Skamania,WA,Passenger,65,45,110,8278,8388,1.31,Washington
11995,March,2022,Stevens,WA,Passenger,60,50,110,30089,30199,0.36,Washington
11996,March,2022,Thurston,WA,Passenger,2028,1000,3028,195451,198479,1.53,Washington
11997,March,2022,Saratoga,NY,Passenger,1,0,1,40,41,2.44,Furthest
11998,March,2022,Whitman,WA,Truck,0,0,0,8588,8588,0.0,Washington
11999,March,2022,Coryell,TX,Passenger,1,0,1,101,102,0.98,Mid-Distance
12000,March,2022,Chelan,WA,Truck,0,0,0,23048,23048,0.0,Washington
12001,March,2022,Calvert,MD,Passenger,0,2,2,76,78,2.56,Furthest
12002,March,2022,Anchorage,AK,Passenger,1,0,1,120,121,0.83,Nearest
12003,March,2022,King,WA,Truck,25,1,26,182051,182077,0.01,Washington
12004,March,2022,Clark,NV,Passenger,4,2,6,532,538,1.12,Nearest
12005,March,2022,Monterey,CA,Passenger,1,1,2,129,131,1.53,Nearest
12007,March,2022,Flathead,MT,Passenger,1,0,1,31,32,3.12,Nearest
12008,March,2022,Charles,MD,Passenger,0,1,1,59,60,1.67,Furthest
12009,March,2022,San Joaquin,CA,Passenger,1,1,2,88,90,2.22,Nearest
12010,March,2022,Honolulu,HI,Passenger,5,4,9,328,337,2.67,Nearest
12011,March,2022,Spokane,WA,Passenger,1443,799,2242,325888,328130,0.68,Washington
12012,March,2022,Anne Arundel,MD,Passenger,4,3,7,353,360,1.94,Furthest
12013,March,2022,Grant,WA,Passenger,151,100,251,66866,67117,0.37,Washington
12014,March,2022,Lincoln,WA,Truck,0,0,0,4834,4834,0.0,Washington
12015,March,2022,Ray,MO,Passenger,0,1,1,1,2,50.0,Furthest
12016,March,2022,Okanogan,WA,Truck,0,0,0,16693,16693,0.0,Washington
12017,March,2022,Las Animas,CO,Passenger,1,0,1,1,2,50.0,Mid-Distance
12018,March,2022,Pierce,WA,Truck,2,0,2,143506,143508,0.0,Washington
12019,March,2022,Kitsap,WA,Truck,1,0,1,53996,53997,0.0,Washington
12020,March,2023,Beaufort,SC,Passenger,1,0,1,17,18,5.56,Furthest
12021,March,2023,St. Tammany,LA,Passenger,1,0,1,30,31,3.23,Mid-Distance
12022,March,2023,El Paso,TX,Passenger,2,0,2,262,264,0.76,Mid-Distance
12023,March,2023,Benton,WA,Passenger,1041,531,1572,135436,137008,1.15,Washington
12024,March,2023,Frederick,MD,Passenger,1,0,1,53,54,1.85,Furthest
12025,March,2023,Okanogan,WA,Passenger,114,58,172,26014,26186,0.66,Washington
12026,March,2023,Moore,NC,Passenger,0,1,1,101,102,0.98,Furthest
12027,March,2023,Madison,IL,Passenger,1,0,1,16,17,5.88,Mid-Distance
12028,March,2023,Travis,TX,Passenger,1,0,1,76,77,1.3,Mid-Distance
12029,March,2023,Lee,AL,Passenger,1,0,1,11,12,8.33,Furthest
12030,March,2023,Yavapai,AZ,Passenger,1,0,1,22,23,4.35,Nearest
12031,March,2023,Riverside,CA,Passenger,6,0,6,375,381,1.57,Nearest
12032,March,2023,Los Angeles,CA,Passenger,4,5,9,602,611,1.47,Nearest
12033,March,2023,Norfolk,VA,Passenger,3,2,5,258,263,1.9,Furthest
12034,March,2023,Escambia,FL,Passenger,0,1,1,107,108,0.93,Furthest
12035,March,2023,Anne Arundel,MD,Passenger,4,4,8,288,296,2.7,Furthest
12036,March,2023,Grant,WA,Truck,8,0,8,28019,28027,0.03,Washington
12037,March,2023,Lake,IL,Passenger,1,0,1,113,114,0.88,Mid-Distance
12038,March,2023,Kittitas,WA,Passenger,325,94,419,29410,29829,1.4,Washington
12039,March,2023,Plaquemines,LA,Passenger,1,1,2,14,16,12.5,Mid-Distance
12040,March,2023,Nueces,TX,Passenger,0,1,1,49,50,2.0,Mid-Distance
12041,March,2023,Sumter,SC,Passenger,0,1,1,33,34,2.94,Furthest
12042,March,2023,Rock Island,IL,Passenger,0,1,1,14,15,6.67,Mid-Distance
12043,March,2023,Denton,TX,Passenger,1,0,1,43,44,2.27,Mid-Distance
12044,March,2023,Lewis,WA,Passenger,295,191,486,58567,59053,0.82,Washington
12045,March,2023,Klickitat,WA,Truck,6,0,6,8273,8279,0.07,Washington
12047,March,2023,Snohomish,WA,Truck,134,0,134,121787,121921,0.11,Washington
12048,March,2023,Columbia,WA,Passenger,8,1,9,2416,2425,0.37,Washington
12049,March,2023,Geary,KS,Passenger,1,0,1,70,71,1.41,Mid-Distance
12050,March,2023,Walla Walla,WA,Passenger,209,112,321,35444,35765,0.9,Washington
12051,March,2023,Grant,WA,Passenger,253,113,366,66819,67185,0.54,Washington
12052,March,2023,Arlington,VA,Passenger,1,0,1,102,103,0.97,Furthest
12053,March,2023,New Haven,CT,Passenger,0,2,2,22,24,8.33,Furthest
12054,March,2023,Cape May,NJ,Passenger,0,1,1,7,8,12.5,Furthest
12055,March,2023,Boulder,CO,Passenger,1,0,1,25,26,3.85,Mid-Distance
12056,March,2023,Newport News,VA,Passenger,1,0,1,91,92,1.09,Furthest
12057,March,2023,Ferry,WA,Truck,0,0,0,3563,3563,0.0,Washington
12058,March,2023,Harrison,MS,Passenger,1,0,1,30,31,3.23,Mid-Distance
12059,March,2023,Ventura,CA,Passenger,2,1,3,196,199,1.51,Nearest
12060,March,2023,Loudoun,VA,Passenger,3,0,3,56,59,5.08,Furthest
12061,March,2023,Dallas,TX,Passenger,1,0,1,74,75,1.33,Mid-Distance
12062,March,2023,Clallam,WA,Truck,17,0,17,21712,21729,0.08,Washington
12063,March,2023,Kern,CA,Passenger,1,1,2,178,180,1.11,Nearest
12064,March,2023,Island,WA,Passenger,987,421,1408,61377,62785,2.24,Washington
12065,March,2023,Allen,IN,Passenger,1,0,1,10,11,9.09,Furthest
12066,March,2023,Hudson,NJ,Passenger,1,0,1,18,19,5.26,Furthest
12067,March,2023,Nassau,NY,Passenger,1,0,1,21,22,4.55,Furthest
12068,March,2023,Sheridan,WY,Passenger,1,0,1,5,6,16.67,Nearest
12069,March,2023,Goochland,VA,Passenger,0,1,1,48,49,2.04,Furthest
12070,March,2023,Virginia Beach,VA,Passenger,2,0,2,432,434,0.46,Furthest
12071,March,2023,Hamilton,OH,Truck,1,0,1,2,3,33.33,Furthest
12072,March,2023,Hillsborough,FL,Passenger,0,1,1,102,103,0.97,Furthest
12073,March,2023,Stevens,WA,Truck,2,0,2,18741,18743,0.01,Washington
12074,March,2023,El Paso,CO,Passenger,3,1,4,481,485,0.82,Mid-Distance
12075,March,2023,Cowlitz,WA,Truck,7,0,7,28202,28209,0.02,Washington
12076,March,2023,Bartow,GA,Passenger,0,1,1,3,4,25.0,Furthest
12077,March,2023,King,WA,Truck,566,2,568,176388,176956,0.32,Washington
12078,March,2023,Sedgwick,KS,Passenger,1,1,2,56,58,3.45,Mid-Distance
12079,March,2023,Randolph,NC,Passenger,1,0,1,3,4,25.0,Furthest
12080,March,2023,Chelan,WA,Truck,23,0,23,23105,23128,0.1,Washington
12081,March,2023,San Bernardino,CA,Passenger,2,1,3,260,263,1.14,Nearest
12082,March,2023,Camden,NJ,Passenger,0,1,1,12,13,7.69,Furthest
12083,March,2023,Adams,WA,Passenger,23,11,34,13010,13044,0.26,Washington
12084,March,2023,Lane,OR,Passenger,0,1,1,65,66,1.52,Nearest
12085,March,2023,Sacramento,CA,Passenger,4,0,4,144,148,2.7,Nearest
12086,March,2023,Richmond,GA,Passenger,0,1,1,55,56,1.79,Furthest
12087,March,2023,Cowlitz,WA,Passenger,433,195,628,69990,70618,0.89,Washington
12088,March,2023,Columbia,WA,Truck,0,0,0,1572,1572,0.0,Washington
12089,March,2023,Bexar,TX,Passenger,3,3,6,350,356,1.69,Mid-Distance
12090,March,2023,San Diego,CA,Passenger,17,9,26,1922,1948,1.33,Nearest
12091,March,2023,Wahkiakum,WA,Passenger,25,16,41,3059,3100,1.32,Washington
12092,March,2023,Multnomah,OR,Passenger,0,2,2,413,415,0.48,Nearest
12093,March,2023,Harnett,NC,Passenger,3,0,3,122,125,2.4,Furthest
12094,March,2023,Grays Harbor,WA,Truck,2,0,2,20979,20981,0.01,Washington
12095,March,2023,Franklin,WA,Truck,5,0,5,20848,20853,0.02,Washington
12096,March,2023,Douglas,WA,Passenger,181,59,240,28627,28867,0.83,Washington
12097,March,2023,Kittitas,WA,Truck,7,0,7,14530,14537,0.05,Washington
12098,March,2023,Skagit,WA,Truck,17,0,17,31985,32002,0.05,Washington
12099,March,2023,Kauai,HI,Passenger,1,1,2,13,15,13.33,Nearest
12100,March,2023,Grays Harbor,WA,Passenger,278,179,457,48396,48853,0.94,Washington
12101,March,2023,Skagit,WA,Passenger,1026,382,1408,88921,90329,1.56,Washington
12102,March,2023,Kitsap,WA,Truck,58,0,58,52601,52659,0.11,Washington
12103,March,2023,Garfield,WA,Truck,0,0,0,977,977,0.0,Washington
12104,March,2023,Pierce,WA,Passenger,6832,2624,9456,533215,542671,1.74,Washington
12105,March,2023,Wichita,TX,Passenger,2,0,2,32,34,5.88,Mid-Distance
12106,March,2023,Cumberland,PA,Passenger,1,0,1,32,33,3.03,Furthest
12107,March,2023,Yellowstone,MT,Passenger,0,1,1,15,16,6.25,Nearest
12108,March,2023,Spokane,WA,Passenger,2099,1005,3104,322078,325182,0.95,Washington
12109,March,2023,Coryell,TX,Passenger,1,0,1,75,76,1.32,Mid-Distance
12110,March,2023,Adams,WA,Truck,2,0,2,5333,5335,0.04,Washington
12111,March,2023,Hennepin,MN,Passenger,1,0,1,30,31,3.23,Mid-Distance
12112,March,2023,Asotin,WA,Passenger,31,21,52,12420,12472,0.42,Washington
12113,March,2023,Howard,MD,Passenger,0,1,1,41,42,2.38,Furthest
12114,March,2023,Whatcom,WA,Truck,48,0,48,42816,42864,0.11,Washington
12115,March,2023,Cook,IL,Passenger,2,0,2,145,147,1.36,Mid-Distance
12116,March,2023,Sarasota,FL,Passenger,1,0,1,15,16,6.25,Furthest
12117,March,2023,Lincoln,WA,Truck,0,0,0,4848,4848,0.0,Washington
12118,March,2023,Clark,WA,Passenger,5285,2161,7446,313218,320664,2.32,Washington
12119,March,2023,Clark,NV,Passenger,3,2,5,388,393,1.27,Nearest
12120,March,2023,Stafford,VA,Passenger,3,1,4,74,78,5.13,Furthest
12121,March,2023,Placer,CA,Passenger,1,0,1,52,53,1.89,Nearest
12122,March,2023,Pacific,WA,Passenger,74,84,158,15627,15785,1.0,Washington
12123,March,2023,Harris,TX,Passenger,1,0,1,112,113,0.88,Mid-Distance
12124,March,2023,Skamania,WA,Passenger,95,53,148,8092,8240,1.8,Washington
12125,March,2023,Ulster,NY,Passenger,1,0,1,4,5,20.0,Furthest
12126,March,2023,Cumberland,NC,Passenger,1,2,3,293,296,1.01,Furthest
12127,March,2023,Benton,OR,Passenger,1,0,1,34,35,2.86,Nearest
12128,March,2023,Rockingham,NH,Passenger,1,0,1,10,11,9.09,Furthest
12129,March,2023,Okanogan,WA,Truck,3,0,3,16460,16463,0.02,Washington
12130,March,2023,Charleston,SC,Passenger,2,2,4,52,56,7.14,Furthest
12131,March,2023,Hidalgo,TX,Passenger,0,1,1,46,47,2.13,Mid-Distance
12132,March,2023,Mason,WA,Passenger,403,200,603,46356,46959,1.28,Washington
12133,March,2023,Pulaski,AR,Passenger,3,0,3,21,24,12.5,Mid-Distance
12134,March,2023,St. Louis,MO,Passenger,1,0,1,50,51,1.96,Furthest
12135,March,2023,Platte,MO,Passenger,1,0,1,16,17,5.88,Furthest
12136,March,2023,Marin,CA,Passenger,0,1,1,27,28,3.57,Nearest
12137,March,2023,Prince George's,MD,Passenger,2,1,3,108,111,2.7,Furthest
12138,March,2023,Orange,CA,Passenger,7,2,9,276,285,3.16,Nearest
12139,March,2023,Miami-Dade,FL,Passenger,1,0,1,57,58,1.72,Furthest
12140,March,2023,Jefferson,NY,Passenger,1,1,2,175,177,1.13,Furthest
12141,March,2023,Leavenworth,KS,Passenger,0,1,1,89,90,1.11,Mid-Distance
12142,March,2023,Honolulu,HI,Passenger,2,3,5,251,256,1.95,Nearest
12143,March,2023,Pacific,WA,Truck,3,0,3,7805,7808,0.04,Washington
12144,March,2023,San Juan,WA,Passenger,596,172,768,13839,14607,5.26,Washington
12145,March,2023,Ray,MO,Passenger,0,1,1,0,1,100.0,Furthest
12146,March,2023,Burlington,NJ,Passenger,0,2,2,90,92,2.17,Furthest
12147,March,2023,Fairbanks North Star,AK,Passenger,0,1,1,54,55,1.82,Nearest
12148,March,2023,Collin,TX,Passenger,2,0,2,41,43,4.65,Mid-Distance
12149,March,2023,Polk,OR,Passenger,0,1,1,16,17,5.88,Nearest
12150,March,2023,Okaloosa,FL,Passenger,0,1,1,88,89,1.12,Furthest
12151,March,2023,Chelan,WA,Passenger,582,150,732,54135,54867,1.33,Washington
12152,March,2023,Garfield,WA,Passenger,1,3,4,1323,1327,0.3,Washington
12153,March,2023,Louisa,VA,Passenger,0,1,1,1,2,50.0,Furthest
12154,March,2023,Santa Clara,CA,Passenger,8,2,10,151,161,6.21,Nearest
12155,March,2023,Elmore,ID,Passenger,1,0,1,9,10,10.0,Nearest
12156,March,2023,Lewis,WA,Truck,5,0,5,26061,26066,0.02,Washington
12157,March,2023,Champaign,IL,Passenger,1,0,1,8,9,11.11,Mid-Distance
12158,March,2023,Maricopa,AZ,Passenger,7,3,10,610,620,1.61,Nearest
12159,March,2023,Alameda,CA,Passenger,3,0,3,152,155,1.94,Nearest
12160,March,2023,Clark,WA,Truck,77,0,77,81356,81433,0.09,Washington
12161,March,2023,Island,WA,Truck,24,0,24,21070,21094,0.11,Washington
12162,March,2023,Saratoga,NY,Passenger,1,1,2,31,33,6.06,Furthest
12163,March,2023,Hawaii,HI,Passenger,1,0,1,23,24,4.17,Nearest
12164,March,2023,Salt Lake,UT,Passenger,0,1,1,92,93,1.08,Nearest
12165,March,2023,Emmet,MI,Passenger,0,1,1,0,1,100.0,Furthest
12166,March,2023,Sonoma,CA,Passenger,1,1,2,53,55,3.64,Nearest
12167,March,2023,Yakima,WA,Truck,9,0,9,60996,61005,0.01,Washington
12168,March,2023,Berkeley,SC,Passenger,0,1,1,101,102,0.98,Furthest
12169,March,2023,San Juan,WA,Truck,10,0,10,5884,5894,0.17,Washington
12170,March,2023,Thurston,WA,Passenger,2830,1176,4006,190713,194719,2.06,Washington
12171,March,2023,Ferry,WA,Passenger,19,4,23,4330,4353,0.53,Washington
12172,March,2023,Douglas,NE,Passenger,2,1,3,26,29,10.34,Mid-Distance
12173,March,2023,St. Clair,IL,Passenger,2,0,2,102,104,1.92,Mid-Distance
12174,March,2023,Adams,CO,Passenger,1,0,1,27,28,3.57,Mid-Distance
12175,March,2023,Pend Oreille,WA,Passenger,28,13,41,8917,8958,0.46,Washington
12176,March,2023,Houston,GA,Passenger,1,0,1,25,26,3.85,Furthest
12177,March,2023,Montgomery,MD,Passenger,3,3,6,171,177,3.39,Furthest
12178,March,2023,Skamania,WA,Truck,1,0,1,3842,3843,0.03,Washington
12179,March,2023,Stevens,WA,Passenger,103,60,163,29814,29977,0.54,Washington
12180,March,2023,Klickitat,WA,Passenger,133,59,192,15155,15347,1.25,Washington
12181,March,2023,Vernon,LA,Passenger,1,0,1,68,69,1.45,Mid-Distance
12182,March,2023,Sarpy,NE,Passenger,1,0,1,46,47,2.13,Mid-Distance
12183,March,2023,Kootenai,ID,Truck,1,0,1,27,28,3.57,Nearest
12184,March,2023,Mason,WA,Truck,11,0,11,20792,20803,0.05,Washington
12185,March,2023,Whitman,WA,Passenger,131,72,203,21998,22201,0.91,Washington
12186,March,2023,Snohomish,WA,Passenger,11288,2890,14178,528298,542476,2.61,Washington
12187,March,2023,Broward,FL,Passenger,1,0,1,56,57,1.75,Furthest
12188,March,2023,Yakima,WA,Passenger,458,238,696,165666,166362,0.42,Washington
12189,March,2023,DeKalb,GA,Passenger,1,0,1,38,39,2.56,Furthest
12190,March,2023,Calvert,MD,Passenger,0,2,2,72,74,2.7,Furthest
12191,March,2023,Santa Cruz,CA,Passenger,1,0,1,13,14,7.14,Nearest
12192,March,2023,Middlesex,MA,Passenger,2,1,3,57,60,5.0,Furthest
12193,March,2023,Napa,CA,Passenger,0,1,1,10,11,9.09,Nearest
12194,March,2023,Benton,WA,Truck,16,0,16,43262,43278,0.04,Washington
12195,March,2023,Hoke,NC,Passenger,1,0,1,57,58,1.72,Furthest
12196,March,2023,Jefferson,WA,Passenger,522,247,769,24231,25000,3.08,Washington
12197,March,2023,Jackson,OK,Passenger,0,1,1,30,31,3.23,Mid-Distance
12198,March,2023,Fairfax,VA,Passenger,5,3,8,533,541,1.48,Furthest
12199,March,2023,Franklin,WA,Passenger,284,129,413,61766,62179,0.66,Washington
12200,March,2023,Contra Costa,CA,Passenger,0,3,3,196,199,1.51,Nearest
12201,March,2023,New London,CT,Passenger,1,4,5,171,176,2.84,Furthest
12202,March,2023,Clallam,WA,Passenger,507,275,782,49127,49909,1.57,Washington
12203,March,2023,Richmond,NY,Passenger,1,0,1,6,7,14.29,Furthest
12204,March,2023,Arapahoe,CO,Passenger,1,1,2,66,68,2.94,Mid-Distance
12205,March,2023,Galveston,TX,Passenger,0,1,1,16,17,5.88,Mid-Distance
12206,March,2023,Washington,MD,Passenger,2,0,2,13,15,13.33,Furthest
12207,March,2023,Thurston,WA,Truck,52,0,52,54221,54273,0.1,Washington
12208,March,2023,Larimer,CO,Passenger,1,0,1,37,38,2.63,Mid-Distance
12209,March,2023,District of Columbia,DC,Passenger,4,0,4,149,153,2.61,Furthest
12210,March,2023,Kent,DE,Passenger,1,0,1,45,46,2.17,Furthest
12211,March,2023,Wahkiakum,WA,Truck,2,0,2,1779,1781,0.11,Washington
12212,March,2023,Carroll,MD,Passenger,0,1,1,17,18,5.56,Furthest
12213,March,2023,Rockdale,GA,Passenger,1,0,1,3,4,25.0,Furthest
12214,March,2023,Las Animas,CO,Passenger,1,0,1,0,1,100.0,Mid-Distance
12215,March,2023,Asotin,WA,Truck,0,0,0,6642,6642,0.0,Washington
12216,March,2023,Santa Barbara,CA,Passenger,1,0,1,62,63,1.59,Nearest
12217,March,2023,Onslow,NC,Passenger,0,1,1,138,139,0.72,Furthest
12218,March,2023,Whatcom,WA,Passenger,2264,837,3101,147416,150517,2.06,Washington
12219,March,2023,Williamson,TX,Passenger,0,1,1,54,55,1.82,Mid-Distance
12220,March,2023,Wilson,TX,Passenger,0,1,1,2,3,33.33,Mid-Distance
12221,March,2023,Chesapeake,VA,Passenger,2,3,5,279,284,1.76,Furthest
12222,March,2023,Lincoln,OR,Passenger,0,1,1,13,14,7.14,Nearest
12223,March,2023,Portsmouth,VA,Passenger,0,1,1,62,63,1.59,Furthest
12224,March,2023,Lincoln,WA,Passenger,18,16,34,7696,7730,0.44,Washington
12225,March,2023,Spokane,WA,Truck,30,0,30,101755,101785,0.03,Washington
12226,March,2023,Pierce,WA,Truck,126,0,126,137873,137999,0.09,Washington
12227,March,2023,Bell,TX,Passenger,1,0,1,248,249,0.4,Mid-Distance
12228,March,2023,Dorchester,SC,Passenger,1,0,1,40,41,2.44,Furthest
12229,March,2023,Monterey,CA,Passenger,1,1,2,110,112,1.79,Nearest
12230,March,2023,Alexandria,VA,Passenger,3,1,4,87,91,4.4,Furthest
12231,March,2023,St. Mary's,MD,Passenger,1,0,1,166,167,0.6,Furthest
12232,March,2023,Fairfax,VA,Truck,1,0,1,92,93,1.08,Furthest
12233,March,2023,Kitsap,WA,Passenger,2952,1199,4151,176394,180545,2.3,Washington
12234,March,2023,Jefferson,WA,Truck,9,0,9,9314,9323,0.1,Washington
12235,March,2023,Oldham,KY,Passenger,0,1,1,4,5,20.0,Furthest
12236,March,2023,Hamilton,OH,Passenger,1,0,1,24,25,4.0,Furthest
12237,March,2023,Pend Oreille,WA,Truck,0,0,0,5572,5572,0.0,Washington
12238,March,2023,Charles,MD,Passenger,1,1,2,49,51,3.92,Furthest
12239,March,2023,Montgomery,PA,Passenger,1,0,1,15,16,6.25,Furthest
12240,March,2023,Duval,FL,Passenger,1,0,1,229,230,0.43,Furthest
12241,March,2023,Suffolk,VA,Passenger,1,0,1,106,107,0.93,Furthest
12242,March,2023,King,WA,Passenger,51947,13141,65088,1321285,1386373,4.69,Washington
12243,March,2023,Douglas,CO,Passenger,0,1,1,54,55,1.82,Mid-Distance
12244,March,2023,Essex,NJ,Passenger,2,0,2,5,7,28.57,Furthest
12245,March,2023,Kings,CA,Passenger,2,1,3,268,271,1.11,Nearest
12246,March,2023,Gwinnett,GA,Passenger,1,0,1,42,43,2.33,Furthest
12247,March,2023,Whitman,WA,Truck,4,0,4,8597,8601,0.05,Washington
12248,March,2023,Solano,CA,Passenger,4,0,4,134,138,2.9,Nearest
12249,March,2023,Walla Walla,WA,Truck,5,0,5,13756,13761,0.04,Washington
12250,March,2023,Douglas,WA,Truck,6,0,6,12871,12877,0.05,Washington
12251,May,2017,Thurston,WA,Passenger,390,334,724,186064,186788,0.39,Washington
12252,May,2017,Klickitat,WA,Passenger,22,24,46,14787,14833,0.31,Washington
12253,May,2017,Dallas,TX,Passenger,0,1,1,187,188,0.53,Mid-Distance
12254,May,2017,Skamania,WA,Truck,0,0,0,3863,3863,0.0,Washington
12255,May,2017,King,WA,Passenger,9796,3990,13786,1377129,1390915,0.99,Washington
12256,May,2017,Lane,OR,Passenger,0,1,1,244,245,0.41,Nearest
12257,May,2017,Alameda,CA,Passenger,1,1,2,372,374,0.53,Nearest
12258,May,2017,Walla Walla,WA,Truck,0,0,0,13189,13189,0.0,Washington
12259,May,2017,Franklin,MA,Passenger,0,1,1,4,5,20.0,Furthest
12260,May,2017,Chelan,WA,Truck,0,0,0,21248,21248,0.0,Washington
12261,May,2017,Sumter,FL,Passenger,0,1,1,10,11,9.09,Furthest
12262,May,2017,Garfield,WA,Passenger,0,0,0,1287,1287,0.0,Washington
12263,May,2017,Pacific,WA,Passenger,9,7,16,15138,15154,0.11,Washington
12264,May,2017,Pend Oreille,WA,Truck,0,0,0,5564,5564,0.0,Washington
12265,May,2017,Latah,ID,Passenger,0,1,1,110,111,0.9,Nearest
12266,May,2017,Grays Harbor,WA,Truck,0,0,0,19898,19898,0.0,Washington
12267,May,2017,Grays Harbor,WA,Passenger,31,30,61,44516,44577,0.14,Washington
12268,May,2017,Montgomery,TN,Passenger,1,0,1,283,284,0.35,Furthest
12269,May,2017,Northampton,PA,Passenger,1,0,1,168,169,0.59,Furthest
12270,May,2017,Polk,FL,Passenger,1,0,1,66,67,1.49,Furthest
12271,May,2017,Adams,WA,Truck,0,0,0,5079,5079,0.0,Washington
12272,May,2017,Snohomish,WA,Passenger,1739,867,2606,512625,515231,0.51,Washington
12273,May,2017,Bergen,NJ,Passenger,0,2,2,31,33,6.06,Furthest
12274,May,2017,Kitsap,WA,Passenger,595,302,897,172845,173742,0.52,Washington
12275,May,2017,Pacific,WA,Truck,0,0,0,7463,7463,0.0,Washington
12276,May,2017,Dakota,MN,Passenger,0,1,1,40,41,2.44,Mid-Distance
12277,May,2017,Maricopa,AZ,Passenger,2,0,2,1783,1785,0.11,Nearest
12278,May,2017,Wahkiakum,WA,Passenger,0,2,2,2837,2839,0.07,Washington
12279,May,2017,Canyon,ID,Passenger,0,1,1,102,103,0.97,Nearest
12280,May,2017,Virginia Beach,VA,Passenger,2,1,3,655,658,0.46,Furthest
12281,May,2017,Hardin,KY,Passenger,0,1,1,122,123,0.81,Furthest
12282,May,2017,Essex,NJ,Passenger,1,0,1,15,16,6.25,Furthest
12283,May,2017,Twin Falls,ID,Passenger,0,1,1,22,23,4.35,Nearest
12284,May,2017,Montgomery,MD,Passenger,1,0,1,304,305,0.33,Furthest
12285,May,2017,Wahkiakum,WA,Truck,0,0,0,1643,1643,0.0,Washington
12286,May,2017,Shelby,TN,Passenger,0,1,1,109,110,0.91,Furthest
12287,May,2017,San Juan,WA,Truck,0,0,0,5541,5541,0.0,Washington
12288,May,2017,Lewis,WA,Passenger,49,33,82,55363,55445,0.15,Washington
12289,May,2017,Ramsey,MN,Passenger,1,0,1,42,43,2.33,Mid-Distance
12290,May,2017,Anne Arundel,MD,Passenger,0,1,1,503,504,0.2,Furthest
12291,May,2017,Missoula,MT,Passenger,1,0,1,74,75,1.33,Nearest
12292,May,2017,Prince George's,MD,Passenger,0,1,1,185,186,0.54,Furthest
12293,May,2017,Thurston,WA,Truck,0,0,0,53243,53243,0.0,Washington
12294,May,2017,Franklin,WA,Passenger,28,44,72,55459,55531,0.13,Washington
12295,May,2017,Carroll,NH,Passenger,0,1,1,0,1,100.0,Furthest
12296,May,2017,Albemarle,VA,Passenger,0,1,1,31,32,3.12,Furthest
12297,May,2017,Clark,WA,Truck,0,0,0,77598,77598,0.0,Washington
12298,May,2017,Benton,WA,Passenger,146,142,288,128293,128581,0.22,Washington
12299,May,2017,DeKalb,IN,Passenger,1,0,1,1,2,50.0,Furthest
12300,May,2017,Salt Lake,UT,Passenger,0,1,1,275,276,0.36,Nearest
12301,May,2017,Juneau,AK,Passenger,0,1,1,49,50,2.0,Nearest
12302,May,2017,Asotin,WA,Passenger,6,3,9,12376,12385,0.07,Washington
12303,May,2017,Cobb,GA,Passenger,0,1,1,77,78,1.28,Furthest
12304,May,2017,Stevens,WA,Truck,0,0,0,18254,18254,0.0,Washington
12305,May,2017,Harnett,NC,Passenger,1,0,1,263,264,0.38,Furthest
12306,May,2017,Ferry,WA,Truck,0,0,0,3544,3544,0.0,Washington
12307,May,2017,Charles,MD,Passenger,0,1,1,89,90,1.11,Furthest
12308,May,2017,Skagit,WA,Passenger,134,102,236,87854,88090,0.27,Washington
12309,May,2017,Cascade,MT,Passenger,0,1,1,61,62,1.61,Nearest
12310,May,2017,Stevens,WA,Passenger,8,23,31,31329,31360,0.1,Washington
12311,May,2017,Columbia,WA,Passenger,0,1,1,2359,2360,0.04,Washington
12312,May,2017,Norfolk,VA,Passenger,1,1,2,308,310,0.65,Furthest
12313,May,2017,Gwinnett,GA,Passenger,0,1,1,86,87,1.15,Furthest
12314,May,2017,Dane,WI,Passenger,1,0,1,121,122,0.82,Mid-Distance
12315,May,2017,Prince William,VA,Passenger,0,3,3,275,278,1.08,Furthest
12316,May,2017,Yakima,WA,Passenger,42,55,97,159375,159472,0.06,Washington
12317,May,2017,Morris,NJ,Passenger,1,0,1,24,25,4.0,Furthest
12318,May,2017,Lincoln,WA,Truck,0,0,0,4459,4459,0.0,Washington
12319,May,2017,New Haven,CT,Passenger,0,1,1,60,61,1.64,Furthest
12320,May,2017,Okanogan,WA,Truck,0,0,0,16215,16215,0.0,Washington
12321,May,2017,Lee,AL,Passenger,1,0,1,36,37,2.7,Furthest
12322,May,2017,Madison,ID,Passenger,1,0,1,41,42,2.38,Nearest
12323,May,2017,Arlington,VA,Passenger,1,1,2,167,169,1.18,Furthest
12324,May,2017,Pierce,WA,Truck,0,0,0,137682,137682,0.0,Washington
12325,May,2017,Benton,WA,Truck,0,0,0,39974,39974,0.0,Washington
12326,May,2017,Allegheny,PA,Passenger,1,0,1,93,94,1.06,Furthest
12327,May,2017,San Diego,CA,Passenger,5,1,6,2743,2749,0.22,Nearest
12328,May,2017,Santa Rosa,FL,Passenger,1,0,1,110,111,0.9,Furthest
12329,May,2017,Multnomah,OR,Passenger,1,3,4,1032,1036,0.39,Nearest
12330,May,2017,Yakima,WA,Truck,0,0,0,57281,57281,0.0,Washington
12331,May,2017,Douglas,WA,Truck,0,0,0,11484,11484,0.0,Washington
12332,May,2017,Richmond,GA,Passenger,0,1,1,93,94,1.06,Furthest
12333,May,2017,Los Angeles,CA,Passenger,3,1,4,1325,1329,0.3,Nearest
12334,May,2017,Nassau,NY,Passenger,0,1,1,39,40,2.5,Furthest
12335,May,2017,Pend Oreille,WA,Passenger,2,4,6,9313,9319,0.06,Washington
12336,May,2017,Pierce,WA,Passenger,933,823,1756,525215,526971,0.33,Washington
12337,May,2017,Orange,FL,Passenger,1,1,2,144,146,1.37,Furthest
12338,May,2017,Pinal,AZ,Passenger,2,0,2,253,255,0.78,Nearest
12340,May,2017,Columbia,WA,Truck,0,0,0,1537,1537,0.0,Washington
12341,May,2017,Hamilton,TN,Passenger,1,0,1,22,23,4.35,Furthest
12342,May,2017,Skamania,WA,Passenger,9,7,16,8532,8548,0.19,Washington
12343,May,2017,Mason,WA,Passenger,51,66,117,43298,43415,0.27,Washington
12344,May,2017,Franklin,OH,Passenger,0,1,1,123,124,0.81,Furthest
12345,May,2017,Portsmouth,VA,Passenger,0,1,1,68,69,1.45,Furthest
12346,May,2017,Kitsap,WA,Truck,1,0,1,52377,52378,0.0,Washington
12347,May,2017,Grant,WA,Truck,0,0,0,25222,25222,0.0,Washington
12348,May,2017,Klickitat,WA,Truck,0,0,0,7967,7967,0.0,Washington
12349,May,2017,Norfolk,MA,Passenger,1,0,1,39,40,2.5,Furthest
12350,May,2017,Adams,WA,Passenger,2,3,5,12197,12202,0.04,Washington
12351,May,2017,Santa Clara,CA,Passenger,5,2,7,402,409,1.71,Nearest
12352,May,2017,Chelan,WA,Passenger,60,36,96,51875,51971,0.18,Washington
12353,May,2017,Duval,FL,Passenger,1,1,2,379,381,0.52,Furthest
12354,May,2017,New London,CT,Passenger,1,1,2,252,254,0.79,Furthest
12355,May,2017,Utah,UT,Passenger,0,1,1,162,163,0.61,Nearest
12356,May,2017,San Juan,WA,Passenger,104,38,142,13498,13640,1.04,Washington
12357,May,2017,Montgomery,PA,Passenger,1,0,1,39,40,2.5,Furthest
12358,May,2017,Spokane,WA,Truck,1,0,1,90329,90330,0.0,Washington
12359,May,2017,Walla Walla,WA,Passenger,23,24,47,34853,34900,0.13,Washington
12360,May,2017,Cowlitz,WA,Truck,0,0,0,27873,27873,0.0,Washington
12361,May,2017,Whitman,WA,Passenger,10,20,30,21988,22018,0.14,Washington
12362,May,2017,San Mateo,CA,Passenger,0,1,1,157,158,0.63,Nearest
12363,May,2017,Riverside,CA,Passenger,1,1,2,821,823,0.24,Nearest
12364,May,2017,Cape May,NJ,Passenger,0,1,1,19,20,5.0,Furthest
12365,May,2017,Manassas,VA,Passenger,0,1,1,9,10,10.0,Furthest
12366,May,2017,Fairfax,VA,Passenger,2,2,4,861,865,0.46,Furthest
12367,May,2017,Hamilton,IN,Passenger,1,0,1,62,63,1.59,Furthest
12368,May,2017,Jackson,MO,Passenger,1,0,1,63,64,1.56,Furthest
12369,May,2017,Moore,NC,Passenger,0,1,1,201,202,0.5,Furthest
12370,May,2017,Monroe,NY,Passenger,1,0,1,26,27,3.7,Furthest
12371,May,2017,Franklin,WA,Truck,0,0,0,18090,18090,0.0,Washington
12372,May,2017,Clark,WA,Passenger,770,489,1259,298797,300056,0.42,Washington
12373,May,2017,Orleans,LA,Passenger,0,1,1,49,50,2.0,Mid-Distance
12374,May,2017,Kittitas,WA,Truck,0,0,0,13532,13532,0.0,Washington
12375,May,2017,Dale,AL,Passenger,0,1,1,64,65,1.54,Furthest
12376,May,2017,Grant,WA,Passenger,20,25,45,60675,60720,0.07,Washington
12377,May,2017,Muscogee,GA,Passenger,0,1,1,244,245,0.41,Furthest
12378,May,2017,Lewis,WA,Truck,0,0,0,24822,24822,0.0,Washington
12379,May,2017,Snohomish,WA,Truck,1,0,1,121865,121866,0.0,Washington
12380,May,2017,Jefferson,WA,Passenger,103,59,162,23819,23981,0.68,Washington
12381,May,2017,Monterey,CA,Passenger,0,1,1,209,210,0.48,Nearest
12382,May,2017,Volusia,FL,Passenger,0,1,1,45,46,2.17,Furthest
12383,May,2017,Okaloosa,FL,Passenger,1,0,1,185,186,0.54,Furthest
12384,May,2017,DeKalb,GA,Passenger,1,0,1,83,84,1.19,Furthest
12385,May,2017,Skagit,WA,Truck,1,0,1,31389,31390,0.0,Washington
12386,May,2017,Island,WA,Passenger,113,129,242,59919,60161,0.4,Washington
12387,May,2017,Okanogan,WA,Passenger,3,16,19,25686,25705,0.07,Washington
12388,May,2017,Flathead,MT,Passenger,1,0,1,63,64,1.56,Nearest
12389,May,2017,Whatcom,WA,Truck,2,0,2,41518,41520,0.0,Washington
12390,May,2017,Middlesex,MA,Passenger,1,0,1,146,147,0.68,Furthest
12391,May,2017,Saratoga,NY,Passenger,1,1,2,73,75,2.67,Furthest
12392,May,2017,Hawaii,HI,Passenger,1,0,1,86,87,1.15,Nearest
12393,May,2017,Whitman,WA,Truck,0,0,0,8394,8394,0.0,Washington
12394,May,2017,Cumberland,NC,Passenger,1,0,1,591,592,0.17,Furthest
12395,May,2017,Kent,MI,Passenger,0,1,1,35,36,2.78,Furthest
12396,May,2017,Nantucket,MA,Passenger,1,0,1,3,4,25.0,Furthest
12397,May,2017,Kittitas,WA,Passenger,22,17,39,27357,27396,0.14,Washington
12398,May,2017,Marin,CA,Passenger,1,0,1,58,59,1.69,Nearest
12399,May,2017,Tulare,CA,Passenger,1,0,1,193,194,0.52,Nearest
12400,May,2017,Lincoln,WA,Passenger,2,5,7,7507,7514,0.09,Washington
12401,May,2017,Honolulu,HI,Passenger,3,2,5,600,605,0.83,Nearest
12402,May,2017,Douglas,WA,Passenger,32,23,55,26684,26739,0.21,Washington
12403,May,2017,Clackamas,OR,Passenger,1,1,2,306,308,0.65,Nearest
12404,May,2017,St. Lucie,FL,Passenger,1,0,1,32,33,3.03,Furthest
12405,May,2017,Marion,OR,Passenger,1,0,1,173,174,0.57,Nearest
12406,May,2017,Mason,WA,Truck,0,0,0,19265,19265,0.0,Washington
12407,May,2017,Sedgwick,KS,Passenger,0,1,1,108,109,0.92,Mid-Distance
12408,May,2017,Palm Beach,FL,Passenger,0,1,1,98,99,1.01,Furthest
12409,May,2017,Cowlitz,WA,Passenger,52,50,102,69536,69638,0.15,Washington
12410,May,2017,Manatee,FL,Passenger,1,0,1,47,48,2.08,Furthest
12411,May,2017,Nueces,TX,Passenger,0,1,1,98,99,1.01,Mid-Distance
12412,May,2017,Pima,AZ,Passenger,0,2,2,444,446,0.45,Nearest
12413,May,2017,Travis,TX,Passenger,0,1,1,192,193,0.52,Mid-Distance
12414,May,2017,King,WA,Truck,8,1,9,188266,188275,0.0,Washington
12415,May,2017,Asotin,WA,Truck,0,0,0,6491,6491,0.0,Washington
12416,May,2017,Jefferson,WA,Truck,0,0,0,9440,9440,0.0,Washington
12417,May,2017,Jefferson,NY,Passenger,1,1,2,254,256,0.78,Furthest
12418,May,2017,District of Columbia,DC,Passenger,0,3,3,222,225,1.33,Furthest
12419,May,2017,Maui,HI,Passenger,1,0,1,73,74,1.35,Nearest
12420,May,2017,Whatcom,WA,Passenger,455,167,622,142686,143308,0.43,Washington
12421,May,2017,Ferry,WA,Passenger,1,1,2,4409,4411,0.05,Washington
12422,May,2017,Ventura,CA,Passenger,0,1,1,360,361,0.28,Nearest
12423,May,2017,Santa Fe,NM,Passenger,0,1,1,46,47,2.13,Mid-Distance
12424,May,2017,Fulton,GA,Passenger,1,0,1,117,118,0.85,Furthest
12425,May,2017,Spokane,WA,Passenger,245,211,456,296382,296838,0.15,Washington
12426,May,2017,Clallam,WA,Passenger,84,74,158,48203,48361,0.33,Washington
12427,May,2017,Wayne,MI,Passenger,0,1,1,68,69,1.45,Furthest
12428,May,2017,Island,WA,Truck,0,0,0,20531,20531,0.0,Washington
12429,May,2017,Clallam,WA,Truck,0,0,0,20959,20959,0.0,Washington
12430,May,2017,El Paso,CO,Passenger,2,1,3,808,811,0.37,Mid-Distance
12431,May,2017,Clark,NV,Passenger,1,2,3,848,851,0.35,Nearest
12432,May,2017,Deschutes,OR,Passenger,1,0,1,194,195,0.51,Nearest
12433,May,2017,Howard,MD,Passenger,0,2,2,90,92,2.17,Furthest
12434,May,2017,Hidalgo,TX,Passenger,0,1,1,99,100,1.0,Mid-Distance
12435,May,2017,Bexar,TX,Passenger,1,0,1,973,974,0.1,Mid-Distance
12436,May,2017,Garfield,WA,Truck,0,0,0,932,932,0.0,Washington
12437,May,2017,Orange,CA,Passenger,3,1,4,644,648,0.62,Nearest
12438,May,2018,Canyon,ID,Passenger,0,1,1,87,88,1.14,Nearest
12439,May,2018,Wahkiakum,WA,Truck,0,0,0,1674,1674,0.0,Washington
12440,May,2018,Whitman,WA,Truck,0,0,0,8470,8470,0.0,Washington
12441,May,2018,Duval,FL,Passenger,1,2,3,382,385,0.78,Furthest
12442,May,2018,Skagit,WA,Passenger,198,163,361,90254,90615,0.4,Washington
12443,May,2018,Nassau,NY,Passenger,1,0,1,36,37,2.7,Furthest
12444,May,2018,Lane,OR,Passenger,0,1,1,188,189,0.53,Nearest
12445,May,2018,Clackamas,OR,Passenger,0,1,1,227,228,0.44,Nearest
12446,May,2018,Montgomery,PA,Passenger,2,0,2,36,38,5.26,Furthest
12447,May,2018,Douglas,WA,Truck,0,0,0,11900,11900,0.0,Washington
12448,May,2018,Maui,HI,Passenger,1,0,1,58,59,1.69,Nearest
12449,May,2018,Monterey,CA,Passenger,0,1,1,187,188,0.53,Nearest
12450,May,2018,Tarrant,TX,Passenger,1,0,1,215,216,0.46,Mid-Distance
12451,May,2018,El Paso,TX,Passenger,1,0,1,522,523,0.19,Mid-Distance
12452,May,2018,Pend Oreille,WA,Passenger,4,5,9,9508,9517,0.09,Washington
12453,May,2018,Brevard,FL,Passenger,0,1,1,98,99,1.01,Furthest
12454,May,2018,Howard,MD,Passenger,0,1,1,86,87,1.15,Furthest
12455,May,2018,San Mateo,CA,Passenger,1,1,2,134,136,1.47,Nearest
12456,May,2018,Essex,NJ,Passenger,1,0,1,10,11,9.09,Furthest
12457,May,2018,Mason,WA,Passenger,77,93,170,45592,45762,0.37,Washington
12458,May,2018,Whatcom,WA,Passenger,612,281,893,147196,148089,0.6,Washington
12459,May,2018,Kittitas,WA,Truck,0,0,0,14024,14024,0.0,Washington
12460,May,2018,Nantucket,MA,Passenger,1,0,1,4,5,20.0,Furthest
12461,May,2018,El Paso,CO,Passenger,2,1,3,751,754,0.4,Mid-Distance
12462,May,2018,Norfolk,VA,Passenger,1,2,3,328,331,0.91,Furthest
12463,May,2018,Morris,NJ,Passenger,1,0,1,18,19,5.26,Furthest
12464,May,2018,Volusia,FL,Passenger,0,1,1,34,35,2.86,Furthest
12465,May,2018,Moore,NC,Passenger,0,1,1,196,197,0.51,Furthest
12466,May,2018,Okanogan,WA,Truck,0,0,0,16409,16409,0.0,Washington
12467,May,2018,Whitman,WA,Passenger,19,27,46,22578,22624,0.2,Washington
12468,May,2018,Okanogan,WA,Passenger,8,19,27,25886,25913,0.1,Washington
12470,May,2018,Beaufort,SC,Passenger,1,0,1,37,38,2.63,Furthest
12471,May,2018,Wahkiakum,WA,Passenger,1,2,3,2901,2904,0.1,Washington
12472,May,2018,Fulton,GA,Passenger,1,1,2,98,100,2.0,Furthest
12473,May,2018,Santa Clara,CA,Passenger,7,0,7,381,388,1.8,Nearest
12474,May,2018,Clark,WA,Passenger,963,696,1659,307153,308812,0.54,Washington
12475,May,2018,Cook,IL,Passenger,1,0,1,269,270,0.37,Mid-Distance
12476,May,2018,New London,CT,Passenger,0,1,1,252,253,0.4,Furthest
12477,May,2018,Manassas,VA,Passenger,0,1,1,9,10,10.0,Furthest
12478,May,2018,Nueces,TX,Passenger,1,1,2,92,94,2.13,Mid-Distance
12479,May,2018,Juneau,AK,Passenger,0,1,1,47,48,2.08,Nearest
12480,May,2018,Cowlitz,WA,Truck,0,0,0,28359,28359,0.0,Washington
12481,May,2018,Snohomish,WA,Truck,1,0,1,121479,121480,0.0,Washington
12482,May,2018,Washington,OR,Passenger,0,1,1,476,477,0.21,Nearest
12483,May,2018,Grays Harbor,WA,Passenger,50,55,105,46409,46514,0.23,Washington
12484,May,2018,Island,WA,Truck,0,0,0,20885,20885,0.0,Washington
12485,May,2018,Santa Rosa,FL,Passenger,1,0,1,97,98,1.02,Furthest
12486,May,2018,Columbia,WA,Passenger,2,1,3,2412,2415,0.12,Washington
12487,May,2018,Sumter,FL,Passenger,0,1,1,9,10,10.0,Furthest
12488,May,2018,Riverside,CA,Passenger,2,2,4,703,707,0.57,Nearest
12489,May,2018,Clark,NV,Passenger,1,2,3,744,747,0.4,Nearest
12490,May,2018,Hamilton,IN,Passenger,1,0,1,46,47,2.13,Furthest
12491,May,2018,New Haven,CT,Passenger,0,1,1,50,51,1.96,Furthest
12492,May,2018,Clark,WA,Truck,0,0,0,78917,78917,0.0,Washington
12493,May,2018,Ramsey,MN,Passenger,1,0,1,40,41,2.44,Mid-Distance
12494,May,2018,Walla Walla,WA,Passenger,34,42,76,35569,35645,0.21,Washington
12495,May,2018,Kitsap,WA,Passenger,780,453,1233,177900,179133,0.69,Washington
12496,May,2018,Lincoln,WA,Passenger,2,6,8,7644,7652,0.1,Washington
12497,May,2018,Caddo,LA,Passenger,0,1,1,22,23,4.35,Mid-Distance
12498,May,2018,Ferry,WA,Truck,0,0,0,3503,3503,0.0,Washington
12499,May,2018,Stevens,WA,Passenger,11,25,36,31564,31600,0.11,Washington
12500,May,2018,Washtenaw,MI,Passenger,1,0,1,38,39,2.56,Furthest
12501,May,2018,Thurston,WA,Passenger,548,468,1016,192389,193405,0.53,Washington
12502,May,2018,Pinal,AZ,Passenger,2,0,2,205,207,0.97,Nearest
12503,May,2018,Sacramento,CA,Passenger,1,0,1,301,302,0.33,Nearest
12504,May,2018,Arlington,VA,Passenger,1,2,3,171,174,1.72,Furthest
12505,May,2018,Lewis,WA,Passenger,78,54,132,57567,57699,0.23,Washington
12506,May,2018,Bexar,TX,Passenger,2,3,5,767,772,0.65,Mid-Distance
12507,May,2018,Lincoln,WA,Truck,0,0,0,4537,4537,0.0,Washington
12508,May,2018,Prince George's,MD,Passenger,1,1,2,183,185,1.08,Furthest
12509,May,2018,Skagit,WA,Truck,1,0,1,32044,32045,0.0,Washington
12510,May,2018,Kootenai,ID,Passenger,0,1,1,220,221,0.45,Nearest
12511,May,2018,Monroe,IL,Passenger,1,0,1,5,6,16.67,Mid-Distance
12512,May,2018,Charles,MD,Passenger,0,1,1,84,85,1.18,Furthest
12513,May,2018,Gwinnett,GA,Passenger,0,1,1,82,83,1.2,Furthest
12514,May,2018,Mason,WA,Truck,0,0,0,19874,19874,0.0,Washington
12515,May,2018,Grays Harbor,WA,Truck,0,0,0,20185,20185,0.0,Washington
12516,May,2018,Garfield,WA,Truck,0,0,0,956,956,0.0,Washington
12517,May,2018,Thurston,WA,Truck,0,0,0,54199,54199,0.0,Washington
12518,May,2018,Jefferson,NY,Passenger,1,1,2,226,228,0.88,Furthest
12519,May,2018,Ferry,WA,Passenger,2,3,5,4417,4422,0.11,Washington
12520,May,2018,Pierce,WA,Passenger,1185,1125,2310,530476,532786,0.43,Washington
12521,May,2018,Grant,WA,Truck,0,0,0,25863,25863,0.0,Washington
12522,May,2018,Allegheny,PA,Passenger,1,0,1,75,76,1.32,Furthest
12523,May,2018,Clallam,WA,Passenger,119,110,229,49783,50012,0.46,Washington
12524,May,2018,Portsmouth,VA,Passenger,0,1,1,72,73,1.37,Furthest
12525,May,2018,Jefferson,CO,Passenger,0,1,1,70,71,1.41,Mid-Distance
12526,May,2018,Klickitat,WA,Truck,0,0,0,8084,8084,0.0,Washington
12527,May,2018,Ada,ID,Passenger,0,2,2,331,333,0.6,Nearest
12528,May,2018,Klickitat,WA,Passenger,25,30,55,15106,15161,0.36,Washington
12529,May,2018,Pima,AZ,Passenger,1,1,2,412,414,0.48,Nearest
12530,May,2018,Santa Fe,NM,Passenger,0,1,1,42,43,2.33,Mid-Distance
12531,May,2018,Hawaii,HI,Passenger,1,0,1,74,75,1.33,Nearest
12532,May,2018,Snohomish,WA,Passenger,2281,1223,3504,520051,523555,0.67,Washington
12533,May,2018,Ventura,CA,Passenger,0,1,1,315,316,0.32,Nearest
12534,May,2018,Skamania,WA,Passenger,12,9,21,8704,8725,0.24,Washington
12535,May,2018,District of Columbia,DC,Passenger,0,3,3,190,193,1.55,Furthest
12536,May,2018,Pend Oreille,WA,Truck,0,0,0,5671,5671,0.0,Washington
12537,May,2018,Williamson,TX,Passenger,0,1,1,163,164,0.61,Mid-Distance
12538,May,2018,Latah,ID,Passenger,0,1,1,76,77,1.3,Nearest
12539,May,2018,Lumpkin,GA,Passenger,1,0,1,7,8,12.5,Furthest
12540,May,2018,Multnomah,OR,Passenger,3,4,7,807,814,0.86,Nearest
12541,May,2018,Cowlitz,WA,Passenger,58,75,133,71515,71648,0.19,Washington
12542,May,2018,DeKalb,IN,Passenger,1,0,1,1,2,50.0,Furthest
12543,May,2018,Frederick,MD,Passenger,0,1,1,86,87,1.15,Furthest
12544,May,2018,Garfield,WA,Passenger,1,1,2,1326,1328,0.15,Washington
12545,May,2018,Jefferson,WA,Passenger,138,91,229,24389,24618,0.93,Washington
12546,May,2018,Madison,ID,Passenger,1,0,1,38,39,2.56,Nearest
12547,May,2018,Broward,FL,Passenger,1,1,2,130,132,1.52,Furthest
12548,May,2018,Marin,CA,Passenger,1,0,1,56,57,1.75,Nearest
12549,May,2018,San Juan,WA,Truck,0,0,0,5702,5702,0.0,Washington
12550,May,2018,Franklin,MA,Passenger,0,1,1,2,3,33.33,Furthest
12551,May,2018,St. Lucie,FL,Passenger,1,0,1,28,29,3.45,Furthest
12552,May,2018,Spokane,WA,Truck,1,0,1,92371,92372,0.0,Washington
12553,May,2018,Hamilton,TN,Passenger,1,0,1,23,24,4.17,Furthest
12554,May,2018,Jefferson,WA,Truck,0,0,0,9539,9539,0.0,Washington
12555,May,2018,Asotin,WA,Passenger,8,6,14,12602,12616,0.11,Washington
12556,May,2018,Clallam,WA,Truck,0,0,0,21412,21412,0.0,Washington
12557,May,2018,Pacific,WA,Truck,0,0,0,7588,7588,0.0,Washington
12558,May,2018,Dallas,TX,Passenger,0,1,1,190,191,0.52,Mid-Distance
12559,May,2018,Grant,WA,Passenger,30,44,74,63010,63084,0.12,Washington
12560,May,2018,Manatee,FL,Passenger,1,0,1,37,38,2.63,Furthest
12561,May,2018,Chelan,WA,Truck,0,0,0,21823,21823,0.0,Washington
12562,May,2018,Island,WA,Passenger,187,177,364,62446,62810,0.58,Washington
12563,May,2018,Saratoga,NY,Passenger,1,1,2,64,66,3.03,Furthest
12564,May,2018,Okaloosa,FL,Passenger,1,0,1,171,172,0.58,Furthest
12565,May,2018,Hardin,KY,Passenger,0,1,1,119,120,0.83,Furthest
12566,May,2018,Prince George,VA,Passenger,0,1,1,73,74,1.35,Furthest
12567,May,2018,Adams,WA,Truck,0,0,0,5158,5158,0.0,Washington
12568,May,2018,Garfield,OK,Passenger,1,0,1,18,19,5.26,Mid-Distance
12569,May,2018,DuPage,IL,Passenger,1,0,1,64,65,1.54,Mid-Distance
12570,May,2018,Kittitas,WA,Passenger,44,32,76,28906,28982,0.26,Washington
12571,May,2018,Benton,WA,Truck,0,0,0,40984,40984,0.0,Washington
12572,May,2018,Franklin,WA,Truck,0,0,0,18644,18644,0.0,Washington
12573,May,2018,Northampton,PA,Passenger,0,1,1,64,65,1.54,Furthest
12574,May,2018,Yakima,WA,Passenger,62,84,146,163646,163792,0.09,Washington
12575,May,2018,Pacific,WA,Passenger,16,19,35,15552,15587,0.22,Washington
12576,May,2018,Utah,UT,Passenger,0,1,1,133,134,0.75,Nearest
12577,May,2018,King,WA,Passenger,12744,5480,18224,1369589,1387813,1.31,Washington
12578,May,2018,Montgomery,TX,Passenger,1,0,1,64,65,1.54,Mid-Distance
12579,May,2018,St. Clair,IL,Passenger,0,1,1,152,153,0.65,Mid-Distance
12580,May,2018,Palm Beach,FL,Passenger,0,1,1,83,84,1.19,Furthest
12581,May,2018,San Francisco,CA,Passenger,0,1,1,128,129,0.78,Nearest
12582,May,2018,Skamania,WA,Truck,0,0,0,3917,3917,0.0,Washington
12583,May,2018,San Diego,CA,Passenger,7,1,8,2576,2584,0.31,Nearest
12584,May,2018,Marion,IN,Passenger,1,0,1,117,118,0.85,Furthest
12585,May,2018,Benton,WA,Passenger,188,195,383,131301,131684,0.29,Washington
12586,May,2018,Deschutes,OR,Passenger,1,0,1,169,170,0.59,Nearest
12587,May,2018,Twin Falls,ID,Passenger,0,1,1,23,24,4.17,Nearest
12588,May,2018,Contra Costa,CA,Passenger,0,1,1,451,452,0.22,Nearest
12589,May,2018,Queens,NY,Passenger,1,0,1,63,64,1.56,Furthest
12590,May,2018,Orange,FL,Passenger,2,1,3,171,174,1.72,Furthest
12591,May,2018,Sedgwick,KS,Passenger,0,1,1,97,98,1.02,Mid-Distance
12592,May,2018,Kent,MI,Passenger,0,1,1,30,31,3.23,Furthest
12593,May,2018,Fairfax,VA,Passenger,2,2,4,834,838,0.48,Furthest
12594,May,2018,Franklin,WA,Passenger,38,63,101,57692,57793,0.17,Washington
12595,May,2018,Collin,TX,Passenger,1,0,1,152,153,0.65,Mid-Distance
12596,May,2018,Spokane,WA,Passenger,324,302,626,302459,303085,0.21,Washington
12597,May,2018,Shelby,TN,Passenger,0,1,1,103,104,0.96,Furthest
12598,May,2018,Travis,TX,Passenger,0,1,1,191,192,0.52,Mid-Distance
12599,May,2018,DeKalb,GA,Passenger,1,0,1,81,82,1.22,Furthest
12600,May,2018,Pierce,WA,Truck,0,0,0,137544,137544,0.0,Washington
12601,May,2018,King,WA,Truck,7,1,8,183157,183165,0.0,Washington
12602,May,2018,Prince William,VA,Passenger,0,4,4,266,270,1.48,Furthest
12603,May,2018,Carroll,NH,Passenger,0,1,1,1,2,50.0,Furthest
12604,May,2018,Dale,AL,Passenger,0,1,1,59,60,1.67,Furthest
12605,May,2018,Orange,CA,Passenger,4,1,5,562,567,0.88,Nearest
12606,May,2018,Montgomery,MD,Passenger,1,0,1,288,289,0.35,Furthest
12607,May,2018,Alameda,CA,Passenger,0,1,1,348,349,0.29,Nearest
12608,May,2018,Sangamon,IL,Passenger,1,0,1,11,12,8.33,Mid-Distance
12609,May,2018,Cape May,NJ,Passenger,0,1,1,21,22,4.55,Furthest
12610,May,2018,Stevens,WA,Truck,0,0,0,18590,18590,0.0,Washington
12611,May,2018,Virginia Beach,VA,Passenger,2,1,3,688,691,0.43,Furthest
12612,May,2018,Tulsa,OK,Passenger,0,1,1,48,49,2.04,Mid-Distance
12613,May,2018,Chelan,WA,Passenger,103,49,152,53497,53649,0.28,Washington
12614,May,2018,Klamath,OR,Passenger,1,0,1,34,35,2.86,Nearest
12615,May,2018,Tuolumne,CA,Passenger,0,1,1,12,13,7.69,Nearest
12616,May,2018,Whatcom,WA,Truck,2,0,2,42191,42193,0.0,Washington
12617,May,2018,Flathead,MT,Passenger,1,0,1,50,51,1.96,Nearest
12618,May,2018,Walla Walla,WA,Truck,0,0,0,13389,13389,0.0,Washington
12619,May,2018,San Juan,WA,Passenger,141,56,197,14046,14243,1.38,Washington
12620,May,2018,Polk,FL,Passenger,1,0,1,64,65,1.54,Furthest
12621,May,2018,Lee,FL,Passenger,1,0,1,57,58,1.72,Furthest
12622,May,2018,Douglas,WA,Passenger,44,31,75,27541,27616,0.27,Washington
12623,May,2018,Norfolk,MA,Passenger,1,0,1,37,38,2.63,Furthest
12624,May,2018,Los Angeles,CA,Passenger,7,4,11,1157,1168,0.94,Nearest
12625,May,2018,Columbia,WA,Truck,0,0,0,1526,1526,0.0,Washington
12626,May,2018,Dakota,MN,Passenger,0,2,2,37,39,5.13,Mid-Distance
12627,May,2018,Anne Arundel,MD,Passenger,0,2,2,445,447,0.45,Furthest
12628,May,2018,Richmond,GA,Passenger,0,1,1,91,92,1.09,Furthest
12629,May,2018,Yakima,WA,Truck,0,0,0,58338,58338,0.0,Washington
12630,May,2018,Orleans,LA,Passenger,0,1,1,46,47,2.13,Mid-Distance
12631,May,2018,Asotin,WA,Truck,0,0,0,6631,6631,0.0,Washington
12632,May,2018,Richland,SC,Passenger,0,1,1,171,172,0.58,Furthest
12633,May,2018,Clay,FL,Passenger,0,1,1,94,95,1.05,Furthest
12634,May,2018,Kitsap,WA,Truck,1,0,1,53093,53094,0.0,Washington
12635,May,2018,Lee,AL,Passenger,1,0,1,33,34,2.94,Furthest
12636,May,2018,Adams,WA,Passenger,5,5,10,12597,12607,0.08,Washington
12637,May,2018,Charleston,SC,Passenger,1,0,1,127,128,0.78,Furthest
12638,May,2018,Maricopa,AZ,Passenger,2,1,3,1575,1578,0.19,Nearest
12639,May,2018,Honolulu,HI,Passenger,2,2,4,529,533,0.75,Nearest
12640,May,2018,Lewis,WA,Truck,0,0,0,25406,25406,0.0,Washington
12641,May,2019,Albemarle,VA,Passenger,1,0,1,24,25,4.0,Furthest
12642,May,2019,Skagit,WA,Passenger,292,200,492,91700,92192,0.53,Washington
12643,May,2019,Cochise,AZ,Passenger,0,1,1,113,114,0.88,Nearest
12644,May,2019,Santa Clara,CA,Passenger,7,1,8,366,374,2.14,Nearest
12645,May,2019,Skamania,WA,Truck,0,0,0,4052,4052,0.0,Washington
12646,May,2019,Snohomish,WA,Passenger,3372,1572,4944,530335,535279,0.92,Washington
12647,May,2019,Sangamon,IL,Passenger,1,0,1,7,8,12.5,Mid-Distance
12648,May,2019,Calvert,MD,Passenger,0,2,2,88,90,2.22,Furthest
12649,May,2019,Asotin,WA,Passenger,12,8,20,12675,12695,0.16,Washington
12650,May,2019,Ada,ID,Passenger,0,2,2,309,311,0.64,Nearest
12651,May,2019,Grant,WA,Passenger,39,59,98,64561,64659,0.15,Washington
12652,May,2019,Kent,MI,Passenger,0,1,1,21,22,4.55,Furthest
12653,May,2019,Ramsey,MN,Passenger,1,0,1,42,43,2.33,Mid-Distance
12654,May,2019,Monroe,IL,Passenger,1,0,1,5,6,16.67,Mid-Distance
12655,May,2019,Orange,CA,Passenger,6,1,7,527,534,1.31,Nearest
12656,May,2019,St. Lucie,FL,Passenger,1,0,1,29,30,3.33,Furthest
12657,May,2019,Denver,CO,Passenger,1,0,1,131,132,0.76,Mid-Distance
12658,May,2019,Shasta,CA,Passenger,1,0,1,42,43,2.33,Nearest
12659,May,2019,Yakima,WA,Passenger,94,104,198,165012,165210,0.12,Washington
12660,May,2019,Placer,CA,Passenger,1,0,1,105,106,0.94,Nearest
12661,May,2019,Washoe,NV,Passenger,2,0,2,110,112,1.79,Nearest
12662,May,2019,Clay,FL,Passenger,0,1,1,87,88,1.14,Furthest
12663,May,2019,San Juan,WA,Passenger,207,71,278,14357,14635,1.9,Washington
12664,May,2019,District of Columbia,DC,Passenger,1,1,2,207,209,0.96,Furthest
12665,May,2019,Garfield,WA,Passenger,1,1,2,1293,1295,0.15,Washington
12666,May,2019,Duval,FL,Passenger,1,2,3,371,374,0.8,Furthest
12667,May,2019,Nassau,NY,Passenger,3,0,3,38,41,7.32,Furthest
12668,May,2019,Berkshire,MA,Passenger,0,1,1,4,5,20.0,Furthest
12669,May,2019,Caddo,LA,Passenger,0,1,1,24,25,4.0,Mid-Distance
12670,May,2019,Santa Rosa,FL,Passenger,1,0,1,88,89,1.12,Furthest
12671,May,2019,Polk,FL,Passenger,1,0,1,66,67,1.49,Furthest
12672,May,2019,Montgomery,AL,Passenger,0,1,1,43,44,2.27,Furthest
12673,May,2019,Prince George's,MD,Passenger,1,1,2,181,183,1.09,Furthest
12674,May,2019,Cumberland,NC,Passenger,0,2,2,501,503,0.4,Furthest
12675,May,2019,Carroll,NH,Passenger,0,1,1,3,4,25.0,Furthest
12676,May,2019,Harris,TX,Passenger,0,1,1,245,246,0.41,Mid-Distance
12677,May,2019,Hawaii,HI,Passenger,1,0,1,62,63,1.59,Nearest
12678,May,2019,Walla Walla,WA,Truck,0,0,0,13613,13613,0.0,Washington
12679,May,2019,Multnomah,OR,Passenger,5,5,10,746,756,1.32,Nearest
12680,May,2019,Lewis,WA,Passenger,97,93,190,59034,59224,0.32,Washington
12681,May,2019,Portsmouth,VA,Passenger,0,1,1,74,75,1.33,Furthest
12682,May,2019,Riverside,CA,Passenger,2,2,4,658,662,0.6,Nearest
12683,May,2019,Jefferson,NY,Passenger,0,2,2,216,218,0.92,Furthest
12684,May,2019,Dallas,TX,Passenger,1,0,1,203,204,0.49,Mid-Distance
12685,May,2019,Wahkiakum,WA,Passenger,2,2,4,3017,3021,0.13,Washington
12686,May,2019,Carson City,NV,Passenger,1,0,1,13,14,7.14,Nearest
12687,May,2019,Skamania,WA,Passenger,23,17,40,8719,8759,0.46,Washington
12688,May,2019,Marion,OR,Passenger,1,0,1,114,115,0.87,Nearest
12689,May,2019,Thurston,WA,Truck,0,0,0,55085,55085,0.0,Washington
12690,May,2019,Alexandria,VA,Passenger,1,0,1,147,148,0.68,Furthest
12691,May,2019,Grant,WA,Truck,0,0,0,26531,26531,0.0,Washington
12692,May,2019,Kittitas,WA,Passenger,72,35,107,29555,29662,0.36,Washington
12693,May,2019,Juneau,AK,Passenger,0,2,2,31,33,6.06,Nearest
12694,May,2019,Pima,AZ,Passenger,0,1,1,397,398,0.25,Nearest
12695,May,2019,Island,WA,Truck,0,0,0,21242,21242,0.0,Washington
12696,May,2019,Nueces,TX,Passenger,1,1,2,98,100,2.0,Mid-Distance
12697,May,2019,Alameda,CA,Passenger,3,2,5,308,313,1.6,Nearest
12698,May,2019,Larimer,CO,Passenger,1,0,1,58,59,1.69,Mid-Distance
12699,May,2019,Benton,WA,Passenger,253,272,525,133636,134161,0.39,Washington
12700,May,2019,Lumpkin,GA,Passenger,1,0,1,4,5,20.0,Furthest
12701,May,2019,Charles,MD,Passenger,0,1,1,84,85,1.18,Furthest
12702,May,2019,Chelan,WA,Truck,0,0,0,22243,22243,0.0,Washington
12703,May,2019,Benton,WA,Truck,0,0,0,41850,41850,0.0,Washington
12704,May,2019,Wilson,TX,Passenger,0,1,1,6,7,14.29,Mid-Distance
12705,May,2019,St. Mary's,MD,Passenger,1,0,1,211,212,0.47,Furthest
12706,May,2019,Deschutes,OR,Passenger,2,0,2,158,160,1.25,Nearest
12707,May,2019,Sumter,FL,Passenger,0,1,1,10,11,9.09,Furthest
12708,May,2019,Lee,FL,Passenger,1,0,1,50,51,1.96,Furthest
12709,May,2019,Montgomery,TX,Passenger,2,0,2,58,60,3.33,Mid-Distance
12710,May,2019,Brevard,FL,Passenger,0,1,1,85,86,1.16,Furthest
12711,May,2019,Columbia,WA,Passenger,2,2,4,2443,2447,0.16,Washington
12712,May,2019,Franklin,WA,Truck,0,0,0,19251,19251,0.0,Washington
12713,May,2019,Collin,TX,Passenger,1,1,2,130,132,1.52,Mid-Distance
12714,May,2019,Middlesex,MA,Passenger,1,1,2,117,119,1.68,Furthest
12715,May,2019,Pinellas,FL,Passenger,1,0,1,112,113,0.88,Furthest
12716,May,2019,Shelby,TN,Passenger,0,1,1,93,94,1.06,Furthest
12717,May,2019,Cowlitz,WA,Passenger,95,107,202,72910,73112,0.28,Washington
12718,May,2019,Lincoln,WA,Truck,0,0,0,4695,4695,0.0,Washington
12719,May,2019,Spartanburg,SC,Passenger,0,1,1,35,36,2.78,Furthest
12720,May,2019,Oldham,KY,Passenger,0,1,1,5,6,16.67,Furthest
12721,May,2019,Okanogan,WA,Passenger,21,23,44,26072,26116,0.17,Washington
12722,May,2019,Pierce,WA,Passenger,1751,1520,3271,542054,545325,0.6,Washington
12723,May,2019,Ferry,WA,Passenger,5,2,7,4381,4388,0.16,Washington
12724,May,2019,Saratoga,NY,Passenger,1,0,1,55,56,1.79,Furthest
12725,May,2019,Douglas,WA,Passenger,56,36,92,28005,28097,0.33,Washington
12726,May,2019,Stevens,WA,Truck,0,0,0,18677,18677,0.0,Washington
12727,May,2019,Ferry,WA,Truck,0,0,0,3589,3589,0.0,Washington
12728,May,2019,St. Clair,IL,Passenger,0,1,1,159,160,0.62,Mid-Distance
12729,May,2019,Snohomish,WA,Truck,1,0,1,122076,122077,0.0,Washington
12730,May,2019,Cape May,NJ,Passenger,0,1,1,15,16,6.25,Furthest
12731,May,2019,Flathead,MT,Passenger,1,0,1,61,62,1.61,Nearest
12732,May,2019,DeKalb,IN,Passenger,1,0,1,1,2,50.0,Furthest
12733,May,2019,New London,CT,Passenger,0,2,2,247,249,0.8,Furthest
12734,May,2019,Guadalupe,TX,Passenger,1,0,1,75,76,1.32,Mid-Distance
12735,May,2019,Loudoun,VA,Passenger,1,0,1,96,97,1.03,Furthest
12736,May,2019,Hennepin,MN,Passenger,2,0,2,103,105,1.9,Mid-Distance
12737,May,2019,Nantucket,MA,Passenger,1,0,1,2,3,33.33,Furthest
12738,May,2019,Adams,WA,Truck,0,0,0,5127,5127,0.0,Washington
12739,May,2019,Ventura,CA,Passenger,0,2,2,313,315,0.63,Nearest
12740,May,2019,Charleston,SC,Passenger,1,0,1,117,118,0.85,Furthest
12741,May,2019,Maui,HI,Passenger,1,0,1,46,47,2.13,Nearest
12742,May,2019,Santa Cruz,CA,Passenger,1,0,1,40,41,2.44,Nearest
12743,May,2019,Camden,NJ,Passenger,0,1,1,23,24,4.17,Furthest
12744,May,2019,Owyhee,ID,Passenger,1,0,1,5,6,16.67,Nearest
12745,May,2019,Palm Beach,FL,Passenger,0,1,1,89,90,1.11,Furthest
12746,May,2019,Cascade,MT,Passenger,0,1,1,59,60,1.67,Nearest
12747,May,2019,Los Angeles,CA,Passenger,8,5,13,1098,1111,1.17,Nearest
12748,May,2019,Lincoln,WA,Passenger,3,8,11,7772,7783,0.14,Washington
12749,May,2019,Manatee,FL,Passenger,1,0,1,31,32,3.12,Furthest
12750,May,2019,Cook,IL,Passenger,1,0,1,242,243,0.41,Mid-Distance
12751,May,2019,Thurston,WA,Passenger,844,630,1474,197138,198612,0.74,Washington
12752,May,2019,Allegheny,PA,Passenger,1,0,1,83,84,1.19,Furthest
12753,May,2019,Klamath,OR,Passenger,1,0,1,38,39,2.56,Nearest
12754,May,2019,Adams,WA,Passenger,5,6,11,12714,12725,0.09,Washington
12755,May,2019,Mason,WA,Passenger,121,120,241,47012,47253,0.51,Washington
12756,May,2019,Jefferson,WA,Truck,0,0,0,9668,9668,0.0,Washington
12757,May,2019,Whatcom,WA,Passenger,837,413,1250,150441,151691,0.82,Washington
12758,May,2019,Pacific,WA,Passenger,24,28,52,15952,16004,0.32,Washington
12759,May,2019,Arlington,VA,Passenger,1,2,3,158,161,1.86,Furthest
12760,May,2019,Klickitat,WA,Truck,0,0,0,8237,8237,0.0,Washington
12761,May,2019,Williamson,TX,Passenger,0,1,1,142,143,0.7,Mid-Distance
12762,May,2019,Clallam,WA,Truck,0,0,0,21746,21746,0.0,Washington
12763,May,2019,Anne Arundel,MD,Passenger,1,2,3,446,449,0.67,Furthest
12764,May,2019,Cowlitz,WA,Truck,0,0,0,28843,28843,0.0,Washington
12765,May,2019,Grays Harbor,WA,Truck,0,0,0,20457,20457,0.0,Washington
12766,May,2019,Asotin,WA,Truck,0,0,0,6652,6652,0.0,Washington
12767,May,2019,Clark,NV,Passenger,3,2,5,690,695,0.72,Nearest
12768,May,2019,Garfield,WA,Truck,0,0,0,954,954,0.0,Washington
12769,May,2019,Oklahoma,OK,Passenger,0,1,1,120,121,0.83,Mid-Distance
12770,May,2019,Dakota,MN,Passenger,0,2,2,37,39,5.13,Mid-Distance
12771,May,2019,Travis,TX,Passenger,2,1,3,201,204,1.47,Mid-Distance
12772,May,2019,Clackamas,OR,Passenger,1,1,2,212,214,0.93,Nearest
12773,May,2019,Columbia,WA,Truck,0,0,0,1532,1532,0.0,Washington
12774,May,2019,San Mateo,CA,Passenger,2,1,3,123,126,2.38,Nearest
12775,May,2019,Twin Falls,ID,Passenger,0,1,1,22,23,4.35,Nearest
12776,May,2019,Maricopa,AZ,Passenger,6,2,8,1536,1544,0.52,Nearest
12777,May,2019,Harnett,NC,Passenger,1,1,2,216,218,0.92,Furthest
12778,May,2019,Rogers,OK,Passenger,1,0,1,5,6,16.67,Mid-Distance
12779,May,2019,Frederick,MD,Passenger,1,1,2,80,82,2.44,Furthest
12780,May,2019,Contra Costa,CA,Passenger,2,2,4,383,387,1.03,Nearest
12782,May,2019,Whitman,WA,Passenger,31,45,76,22710,22786,0.33,Washington
12783,May,2019,Manassas,VA,Passenger,0,1,1,8,9,11.11,Furthest
12784,May,2019,Vigo,IN,Passenger,1,0,1,6,7,14.29,Furthest
12785,May,2019,Lewis,WA,Truck,0,0,0,25915,25915,0.0,Washington
12786,May,2019,Honolulu,HI,Passenger,2,3,5,500,505,0.99,Nearest
12787,May,2019,Skagit,WA,Truck,1,0,1,32417,32418,0.0,Washington
12788,May,2019,Yakima,WA,Truck,0,0,0,59084,59084,0.0,Washington
12789,May,2019,Penobscot,ME,Passenger,0,1,1,13,14,7.14,Furthest
12790,May,2019,Tulsa,OK,Passenger,1,1,2,44,46,4.35,Mid-Distance
12791,May,2019,Wahkiakum,WA,Truck,0,0,0,1743,1743,0.0,Washington
12792,May,2019,Stevens,WA,Passenger,20,29,49,31678,31727,0.15,Washington
12793,May,2019,Spokane,WA,Passenger,529,422,951,310923,311874,0.3,Washington
12794,May,2019,Douglas,NE,Passenger,0,1,1,63,64,1.56,Mid-Distance
12795,May,2019,Pend Oreille,WA,Truck,0,0,0,5743,5743,0.0,Washington
12796,May,2019,Lake,FL,Passenger,1,0,1,19,20,5.0,Furthest
12797,May,2019,Whatcom,WA,Truck,2,0,2,42822,42824,0.0,Washington
12798,May,2019,El Paso,TX,Passenger,3,0,3,481,484,0.62,Mid-Distance
12799,May,2019,DuPage,IL,Passenger,1,0,1,62,63,1.59,Mid-Distance
12800,May,2019,Clark,WA,Passenger,1475,913,2388,313255,315643,0.76,Washington
12801,May,2019,Norfolk,MA,Passenger,1,0,1,35,36,2.78,Furthest
12802,May,2019,Saginaw,MI,Passenger,1,0,1,10,11,9.09,Furthest
12803,May,2019,Santa Fe,NM,Passenger,0,1,1,40,41,2.44,Mid-Distance
12804,May,2019,Pinal,AZ,Passenger,2,0,2,194,196,1.02,Nearest
12805,May,2019,Dale,AL,Passenger,0,1,1,58,59,1.69,Furthest
12806,May,2019,Grays Harbor,WA,Passenger,73,84,157,47839,47996,0.33,Washington
12807,May,2019,Norfolk,VA,Passenger,2,2,4,346,350,1.14,Furthest
12808,May,2019,Chelan,WA,Passenger,153,67,220,54336,54556,0.4,Washington
12809,May,2019,San Diego,CA,Passenger,10,3,13,2672,2685,0.48,Nearest
12810,May,2019,San Francisco,CA,Passenger,2,1,3,107,110,2.73,Nearest
12811,May,2019,Richland,SC,Passenger,0,1,1,159,160,0.62,Furthest
12812,May,2019,Tarrant,TX,Passenger,2,0,2,203,205,0.98,Mid-Distance
12813,May,2019,Fairfax,VA,Passenger,3,2,5,779,784,0.64,Furthest
12814,May,2019,El Paso,CO,Passenger,2,1,3,741,744,0.4,Mid-Distance
12815,May,2019,Okanogan,WA,Truck,0,0,0,16506,16506,0.0,Washington
12816,May,2019,Franklin,WA,Passenger,52,70,122,59788,59910,0.2,Washington
12817,May,2019,Richmond,GA,Passenger,0,1,1,93,94,1.06,Furthest
12818,May,2019,Kitsap,WA,Truck,1,0,1,54018,54019,0.0,Washington
12819,May,2019,Island,WA,Passenger,315,234,549,63346,63895,0.86,Washington
12820,May,2019,Houston,GA,Passenger,1,0,1,54,55,1.82,Furthest
12821,May,2019,Pacific,WA,Truck,0,0,0,7661,7661,0.0,Washington
12822,May,2019,Moore,NC,Passenger,0,1,1,186,187,0.53,Furthest
12823,May,2019,Pierce,WA,Truck,0,0,0,139646,139646,0.0,Washington
12824,May,2019,Broward,FL,Passenger,2,1,3,125,128,2.34,Furthest
12825,May,2019,Washtenaw,MI,Passenger,1,0,1,38,39,2.56,Furthest
12826,May,2019,King,WA,Truck,5,1,6,181939,181945,0.0,Washington
12827,May,2019,Wayne,MI,Passenger,0,1,1,68,69,1.45,Furthest
12828,May,2019,Jefferson,CO,Passenger,0,2,2,58,60,3.33,Mid-Distance
12829,May,2019,Tuolumne,CA,Passenger,0,1,1,12,13,7.69,Nearest
12830,May,2019,Pend Oreille,WA,Passenger,4,5,9,9537,9546,0.09,Washington
12831,May,2019,Spokane,WA,Truck,1,0,1,94607,94608,0.0,Washington
12832,May,2019,Sedgwick,KS,Passenger,0,1,1,102,103,0.97,Mid-Distance
12833,May,2019,Clark,WA,Truck,0,0,0,80186,80186,0.0,Washington
12834,May,2019,Walla Walla,WA,Passenger,46,57,103,36164,36267,0.28,Washington
12835,May,2019,Fulton,GA,Passenger,1,2,3,107,110,2.73,Furthest
12836,May,2019,Bucks,PA,Passenger,1,0,1,18,19,5.26,Furthest
12837,May,2019,Lee,AL,Passenger,1,0,1,34,35,2.86,Furthest
12838,May,2019,Montgomery,PA,Passenger,2,0,2,37,39,5.13,Furthest
12839,May,2019,Goochland,VA,Passenger,1,1,2,257,259,0.77,Furthest
12840,May,2019,Prince William,VA,Passenger,1,4,5,250,255,1.96,Furthest
12841,May,2019,Suffolk,MA,Passenger,0,1,1,39,40,2.5,Furthest
12842,May,2019,San Juan,WA,Truck,0,0,0,5850,5850,0.0,Washington
12843,May,2019,Mason,WA,Truck,0,0,0,20364,20364,0.0,Washington
12844,May,2019,Valencia,NM,Passenger,1,0,1,7,8,12.5,Mid-Distance
12845,May,2019,Bexar,TX,Passenger,3,5,8,671,679,1.18,Mid-Distance
12846,May,2019,Fresno,CA,Passenger,1,0,1,188,189,0.53,Nearest
12847,May,2019,Howard,MD,Passenger,0,1,1,76,77,1.3,Furthest
12848,May,2019,Randolph,NC,Passenger,1,0,1,6,7,14.29,Furthest
12849,May,2019,Kittitas,WA,Truck,0,0,0,14377,14377,0.0,Washington
12850,May,2019,Kern,CA,Passenger,0,1,1,224,225,0.44,Nearest
12851,May,2019,Kitsap,WA,Passenger,1036,588,1624,180694,182318,0.89,Washington
12852,May,2019,Solano,CA,Passenger,1,0,1,215,216,0.46,Nearest
12853,May,2019,Jefferson,WA,Passenger,191,119,310,25001,25311,1.22,Washington
12854,May,2019,Franklin,MA,Passenger,0,1,1,1,2,50.0,Furthest
12855,May,2019,Volusia,FL,Passenger,0,1,1,38,39,2.56,Furthest
12856,May,2019,Bergen,NJ,Passenger,1,0,1,27,28,3.57,Furthest
12857,May,2019,Klickitat,WA,Passenger,35,33,68,15550,15618,0.44,Washington
12858,May,2019,DeKalb,GA,Passenger,1,0,1,79,80,1.25,Furthest
12859,May,2019,King,WA,Passenger,18616,6948,25564,1387314,1412878,1.81,Washington
12860,May,2019,San Joaquin,CA,Passenger,1,0,1,131,132,0.76,Nearest
12861,May,2019,Kootenai,ID,Passenger,1,1,2,217,219,0.91,Nearest
12862,May,2019,New Haven,CT,Passenger,0,2,2,48,50,4.0,Furthest
12863,May,2019,Clallam,WA,Passenger,167,137,304,50565,50869,0.6,Washington
12864,May,2019,Montgomery,MD,Passenger,1,0,1,277,278,0.36,Furthest
12865,May,2019,Whitman,WA,Truck,0,0,0,8549,8549,0.0,Washington
12866,May,2019,Douglas,WA,Truck,0,0,0,12182,12182,0.0,Washington
12867,May,2019,Virginia Beach,VA,Passenger,1,1,2,709,711,0.28,Furthest
12868,May,2019,Mecklenburg,NC,Passenger,1,0,1,82,83,1.2,Furthest
12869,May,2019,San Juan,PR,Passenger,0,1,1,3,4,25.0,Mid-Distance
12870,May,2020,Chelan,WA,Passenger,228,78,306,54111,54417,0.56,Washington
12871,May,2020,Contra Costa,CA,Passenger,3,2,5,318,323,1.55,Nearest
12872,May,2020,Spokane,WA,Truck,1,0,1,97688,97689,0.0,Washington
12873,May,2020,Erie,NY,Passenger,1,0,1,44,45,2.22,Furthest
12874,May,2020,Williams,ND,Passenger,0,1,1,11,12,8.33,Mid-Distance
12875,May,2020,Pacific,WA,Truck,0,0,0,7625,7625,0.0,Washington
12876,May,2020,Arlington,VA,Passenger,0,2,2,148,150,1.33,Furthest
12877,May,2020,Wahkiakum,WA,Passenger,6,6,12,2965,2977,0.4,Washington
12878,May,2020,Washoe,NV,Passenger,1,0,1,105,106,0.94,Nearest
12879,May,2020,Columbia,WA,Passenger,4,3,7,2405,2412,0.29,Washington
12880,May,2020,Calvert,MD,Passenger,0,2,2,88,90,2.22,Furthest
12881,May,2020,Hennepin,MN,Passenger,3,0,3,88,91,3.3,Mid-Distance
12882,May,2020,San Diego,CA,Passenger,14,5,19,2741,2760,0.69,Nearest
12883,May,2020,Monroe,IL,Passenger,1,0,1,4,5,20.0,Mid-Distance
12884,May,2020,Cascade,MT,Passenger,0,1,1,55,56,1.79,Nearest
12885,May,2020,Sedgwick,KS,Passenger,1,1,2,92,94,2.13,Mid-Distance
12886,May,2020,Sarasota,FL,Passenger,2,0,2,24,26,7.69,Furthest
12887,May,2020,Ramsey,MN,Passenger,1,0,1,39,40,2.5,Mid-Distance
12888,May,2020,Klamath,OR,Passenger,1,0,1,33,34,2.94,Nearest
12889,May,2020,Whatcom,WA,Passenger,1060,496,1556,149298,150854,1.03,Washington
12890,May,2020,Yakima,WA,Truck,0,0,0,59572,59572,0.0,Washington
12891,May,2020,Juneau,AK,Passenger,0,2,2,29,31,6.45,Nearest
12892,May,2020,Clark,NV,Passenger,3,2,5,674,679,0.74,Nearest
12893,May,2020,Hamilton,IN,Passenger,1,0,1,39,40,2.5,Furthest
12894,May,2020,Pierce,WA,Truck,0,0,0,141318,141318,0.0,Washington
12895,May,2020,Kern,CA,Passenger,0,1,1,225,226,0.44,Nearest
12896,May,2020,Pinal,AZ,Passenger,1,0,1,184,185,0.54,Nearest
12897,May,2020,Powhatan,VA,Passenger,1,0,1,0,1,100.0,Furthest
12898,May,2020,Snohomish,WA,Truck,0,0,0,123364,123364,0.0,Washington
12899,May,2020,Chelan,WA,Truck,0,0,0,22434,22434,0.0,Washington
12900,May,2020,Grant,WA,Passenger,59,70,129,65207,65336,0.2,Washington
12901,May,2020,Okanogan,WA,Truck,0,0,0,16391,16391,0.0,Washington
12902,May,2020,Suffolk,MA,Passenger,0,2,2,35,37,5.41,Furthest
12903,May,2020,Grays Harbor,WA,Passenger,106,111,217,48015,48232,0.45,Washington
12904,May,2020,Franklin,WA,Truck,0,0,0,19869,19869,0.0,Washington
12905,May,2020,Camden,NJ,Passenger,0,1,1,22,23,4.35,Furthest
12906,May,2020,Saginaw,MI,Passenger,1,0,1,10,11,9.09,Furthest
12907,May,2020,Houston,GA,Passenger,1,0,1,55,56,1.79,Furthest
12908,May,2020,Lewis,WA,Truck,0,0,0,26001,26001,0.0,Washington
12909,May,2020,Clark,WA,Passenger,2003,1055,3058,317495,320553,0.95,Washington
12910,May,2020,Randolph,NC,Passenger,1,0,1,7,8,12.5,Furthest
12911,May,2020,Larimer,CO,Passenger,1,0,1,51,52,1.92,Mid-Distance
12912,May,2020,Denton,TX,Passenger,1,0,1,89,90,1.11,Mid-Distance
12913,May,2020,Prince George's,MD,Passenger,1,1,2,161,163,1.23,Furthest
12914,May,2020,Ada,ID,Passenger,0,1,1,273,274,0.36,Nearest
12915,May,2020,DeKalb,IN,Passenger,1,0,1,1,2,50.0,Furthest
12916,May,2020,Hudson,NJ,Passenger,1,0,1,38,39,2.56,Furthest
12917,May,2020,San Mateo,CA,Passenger,0,1,1,113,114,0.88,Nearest
12918,May,2020,Kittitas,WA,Passenger,102,48,150,29778,29928,0.5,Washington
12919,May,2020,Franklin,WA,Passenger,58,75,133,60574,60707,0.22,Washington
12920,May,2020,Skamania,WA,Truck,0,0,0,4029,4029,0.0,Washington
12921,May,2020,Deschutes,OR,Passenger,3,0,3,134,137,2.19,Nearest
12922,May,2020,Frederick,MD,Passenger,1,1,2,75,77,2.6,Furthest
12923,May,2020,St. Louis,MO,Passenger,1,0,1,99,100,1.0,Furthest
12924,May,2020,Whatcom,WA,Truck,3,0,3,42847,42850,0.01,Washington
12925,May,2020,Maui,HI,Passenger,1,0,1,32,33,3.03,Nearest
12926,May,2020,Gwinnett,GA,Passenger,1,0,1,73,74,1.35,Furthest
12927,May,2020,Howard,MD,Passenger,0,1,1,71,72,1.39,Furthest
12928,May,2020,Polk,FL,Passenger,1,0,1,65,66,1.52,Furthest
12929,May,2020,RÃ­o Grande,PR,Passenger,1,0,1,1,2,50.0,Mid-Distance
12930,May,2020,Douglas,NE,Passenger,0,1,1,54,55,1.82,Mid-Distance
12931,May,2020,Shelby,OH,Passenger,0,1,1,1,2,50.0,Furthest
12932,May,2020,San Juan,WA,Passenger,298,91,389,14062,14451,2.69,Washington
12933,May,2020,Vigo,IN,Passenger,1,0,1,5,6,16.67,Furthest
12934,May,2020,Skagit,WA,Truck,1,0,1,32389,32390,0.0,Washington
12935,May,2020,Bexar,TX,Passenger,2,5,7,605,612,1.14,Mid-Distance
12936,May,2020,Travis,TX,Passenger,2,1,3,180,183,1.64,Mid-Distance
12937,May,2020,Montgomery,TX,Passenger,1,0,1,52,53,1.89,Mid-Distance
12938,May,2020,Utah,UT,Passenger,0,1,1,132,133,0.75,Nearest
12939,May,2020,Prince William,VA,Passenger,2,3,5,218,223,2.24,Furthest
12940,May,2020,Stevens,WA,Truck,0,0,0,18598,18598,0.0,Washington
12941,May,2020,Douglas,WA,Truck,0,0,0,12279,12279,0.0,Washington
12943,May,2020,Washtenaw,MI,Passenger,1,0,1,34,35,2.86,Furthest
12944,May,2020,DuPage,IL,Passenger,3,0,3,57,60,5.0,Mid-Distance
12945,May,2020,Sacramento,CA,Passenger,1,0,1,267,268,0.37,Nearest
12946,May,2020,Lake,IL,Passenger,1,0,1,163,164,0.61,Mid-Distance
12947,May,2020,Cape May,NJ,Passenger,0,1,1,13,14,7.14,Furthest
12948,May,2020,Broward,FL,Passenger,2,1,3,113,116,2.59,Furthest
12949,May,2020,Grays Harbor,WA,Truck,0,0,0,20770,20770,0.0,Washington
12950,May,2020,Collin,TX,Passenger,1,1,2,119,121,1.65,Mid-Distance
12951,May,2020,Pinellas,FL,Passenger,1,1,2,108,110,1.82,Furthest
12952,May,2020,Harnett,NC,Passenger,1,0,1,201,202,0.5,Furthest
12953,May,2020,Solano,CA,Passenger,1,0,1,206,207,0.48,Nearest
12954,May,2020,Spartanburg,SC,Passenger,0,1,1,47,48,2.08,Furthest
12955,May,2020,St. Clair,IL,Passenger,1,0,1,137,138,0.72,Mid-Distance
12956,May,2020,Fairfax,VA,Passenger,4,3,7,737,744,0.94,Furthest
12957,May,2020,New London,CT,Passenger,1,2,3,244,247,1.21,Furthest
12958,May,2020,Yakima,WA,Passenger,131,117,248,165018,165266,0.15,Washington
12959,May,2020,Tulsa,OK,Passenger,1,1,2,44,46,4.35,Mid-Distance
12960,May,2020,Grant,WA,Truck,0,0,0,26982,26982,0.0,Washington
12961,May,2020,Allegheny,PA,Passenger,1,0,1,72,73,1.37,Furthest
12962,May,2020,Dallas,TX,Passenger,1,0,1,197,198,0.51,Mid-Distance
12963,May,2020,El Paso,TX,Passenger,3,0,3,431,434,0.69,Mid-Distance
12964,May,2020,Wilson,TX,Passenger,0,1,1,6,7,14.29,Mid-Distance
12965,May,2020,Oldham,KY,Passenger,0,1,1,4,5,20.0,Furthest
12966,May,2020,Jefferson,WA,Passenger,233,141,374,24824,25198,1.48,Washington
12967,May,2020,Flathead,MT,Passenger,1,0,1,62,63,1.59,Nearest
12968,May,2020,Bartow,GA,Passenger,0,1,1,3,4,25.0,Furthest
12969,May,2020,Okanogan,WA,Passenger,34,33,67,25879,25946,0.26,Washington
12970,May,2020,Mason,WA,Passenger,157,137,294,47178,47472,0.62,Washington
12971,May,2020,Island,WA,Passenger,409,270,679,62803,63482,1.07,Washington
12972,May,2020,Guadalupe,TX,Passenger,1,0,1,65,66,1.52,Mid-Distance
12973,May,2020,Ulster,NY,Passenger,1,0,1,7,8,12.5,Furthest
12974,May,2020,New Haven,CT,Passenger,0,2,2,39,41,4.88,Furthest
12975,May,2020,Lake,FL,Passenger,1,0,1,20,21,4.76,Furthest
12976,May,2020,Clallam,WA,Truck,1,0,1,21671,21672,0.0,Washington
12977,May,2020,Jefferson,NY,Passenger,0,1,1,210,211,0.47,Furthest
12978,May,2020,Shasta,CA,Passenger,1,0,1,36,37,2.7,Nearest
12979,May,2020,Harris,TX,Passenger,1,0,1,230,231,0.43,Mid-Distance
12980,May,2020,Nueces,TX,Passenger,1,0,1,81,82,1.22,Mid-Distance
12981,May,2020,Douglas,WA,Passenger,69,40,109,27964,28073,0.39,Washington
12982,May,2020,Rockingham,NH,Passenger,1,0,1,26,27,3.7,Furthest
12983,May,2020,Denver,CO,Passenger,1,0,1,119,120,0.83,Mid-Distance
12984,May,2020,Fort Bend,TX,Passenger,1,0,1,46,47,2.13,Mid-Distance
12985,May,2020,Carson City,NV,Passenger,1,0,1,10,11,9.09,Nearest
12986,May,2020,Asotin,WA,Truck,0,0,0,6587,6587,0.0,Washington
12987,May,2020,Stafford,VA,Passenger,1,1,2,92,94,2.13,Furthest
12988,May,2020,Alexandria,VA,Passenger,1,0,1,140,141,0.71,Furthest
12989,May,2020,Multnomah,OR,Passenger,4,7,11,717,728,1.51,Nearest
12990,May,2020,Manassas,VA,Passenger,0,1,1,5,6,16.67,Furthest
12991,May,2020,Fulton,GA,Passenger,1,2,3,103,106,2.83,Furthest
12992,May,2020,Montgomery,OH,Passenger,0,1,1,47,48,2.08,Furthest
12993,May,2020,Mason,WA,Truck,0,0,0,20508,20508,0.0,Washington
12994,May,2020,Suffolk,VA,Passenger,1,0,1,122,123,0.81,Furthest
12995,May,2020,Ventura,CA,Passenger,1,2,3,283,286,1.05,Nearest
12996,May,2020,San Juan,WA,Truck,0,0,0,5860,5860,0.0,Washington
12997,May,2020,Whitman,WA,Truck,0,0,0,8514,8514,0.0,Washington
12998,May,2020,Garfield,WA,Passenger,0,1,1,1347,1348,0.07,Washington
12999,May,2020,Kootenai,ID,Passenger,1,0,1,223,224,0.45,Nearest
13000,May,2020,Orange,CA,Passenger,7,2,9,490,499,1.8,Nearest
13001,May,2020,Clay,FL,Passenger,0,1,1,80,81,1.23,Furthest
13002,May,2020,Cowlitz,WA,Passenger,136,115,251,72360,72611,0.35,Washington
13003,May,2020,Charleston,SC,Passenger,1,0,1,105,106,0.94,Furthest
13004,May,2020,Anne Arundel,MD,Passenger,0,1,1,411,412,0.24,Furthest
13005,May,2020,Klickitat,WA,Truck,0,0,0,8121,8121,0.0,Washington
13006,May,2020,Columbia,WA,Truck,0,0,0,1523,1523,0.0,Washington
13007,May,2020,Montgomery,PA,Passenger,1,0,1,30,31,3.23,Furthest
13008,May,2020,Hawaii,HI,Passenger,1,0,1,56,57,1.75,Nearest
13009,May,2020,Duval,FL,Passenger,0,2,2,356,358,0.56,Furthest
13010,May,2020,Dakota,MN,Passenger,0,1,1,32,33,3.03,Mid-Distance
13011,May,2020,Jefferson,CO,Passenger,0,1,1,58,59,1.69,Mid-Distance
13012,May,2020,Penobscot,ME,Passenger,0,1,1,15,16,6.25,Furthest
13013,May,2020,Santa Cruz,CA,Passenger,1,0,1,34,35,2.86,Nearest
13014,May,2020,Garfield,WA,Truck,0,0,0,967,967,0.0,Washington
13015,May,2020,Queens,NY,Passenger,1,0,1,51,52,1.92,Furthest
13016,May,2020,Brevard,FL,Passenger,0,1,1,84,85,1.18,Furthest
13017,May,2020,Whitman,WA,Passenger,45,48,93,22175,22268,0.42,Washington
13018,May,2020,Clark,WA,Truck,0,0,0,81892,81892,0.0,Washington
13019,May,2020,Valencia,NM,Passenger,1,0,1,5,6,16.67,Mid-Distance
13020,May,2020,DeKalb,GA,Passenger,1,0,1,79,80,1.25,Furthest
13021,May,2020,Moore,NC,Passenger,0,1,1,161,162,0.62,Furthest
13022,May,2020,Montgomery,AL,Passenger,0,1,1,39,40,2.5,Furthest
13023,May,2020,Clallam,WA,Passenger,222,165,387,50115,50502,0.77,Washington
13024,May,2020,Virginia Beach,VA,Passenger,1,0,1,669,670,0.15,Furthest
13025,May,2020,Maricopa,AZ,Passenger,5,6,11,1418,1429,0.77,Nearest
13026,May,2020,Boone,MO,Passenger,0,1,1,10,11,9.09,Furthest
13027,May,2020,Spokane,WA,Passenger,721,479,1200,315019,316219,0.38,Washington
13028,May,2020,Rogers,OK,Passenger,1,0,1,5,6,16.67,Mid-Distance
13029,May,2020,Thurston,WA,Truck,0,0,0,55495,55495,0.0,Washington
13030,May,2020,Kitsap,WA,Passenger,1312,678,1990,179656,181646,1.1,Washington
13031,May,2020,Adams,WA,Passenger,8,7,15,12719,12734,0.12,Washington
13032,May,2020,Snohomish,WA,Passenger,4402,1748,6150,533885,540035,1.14,Washington
13033,May,2020,Carroll,NH,Passenger,0,1,1,4,5,20.0,Furthest
13034,May,2020,Riverside,CA,Passenger,3,1,4,625,629,0.64,Nearest
13035,May,2020,Skamania,WA,Passenger,30,17,47,8525,8572,0.55,Washington
13036,May,2020,Lee,FL,Passenger,1,0,1,50,51,1.96,Furthest
13037,May,2020,Washington,OR,Passenger,1,0,1,442,443,0.23,Nearest
13038,May,2020,Nassau,NY,Passenger,4,0,4,33,37,10.81,Furthest
13039,May,2020,St. Mary's,MD,Passenger,1,0,1,216,217,0.46,Furthest
13040,May,2020,Owyhee,ID,Passenger,1,0,1,3,4,25.0,Nearest
13041,May,2020,Loudoun,VA,Passenger,1,0,1,88,89,1.12,Furthest
13042,May,2020,Cowlitz,WA,Truck,0,0,0,28759,28759,0.0,Washington
13043,May,2020,Lewis,WA,Passenger,99,108,207,58242,58449,0.35,Washington
13044,May,2020,Putnam,TN,Passenger,0,1,1,3,4,25.0,Furthest
13045,May,2020,Bucks,PA,Passenger,1,0,1,20,21,4.76,Furthest
13046,May,2020,Charles,MD,Passenger,1,1,2,73,75,2.67,Furthest
13047,May,2020,Jefferson,WA,Truck,0,0,0,9510,9510,0.0,Washington
13048,May,2020,King,WA,Truck,5,1,6,181412,181418,0.0,Washington
13049,May,2020,Richland,SC,Passenger,0,1,1,154,155,0.65,Furthest
13050,May,2020,Stevens,WA,Passenger,34,33,67,30736,30803,0.22,Washington
13051,May,2020,Kitsap,WA,Truck,0,0,0,53864,53864,0.0,Washington
13052,May,2020,District of Columbia,DC,Passenger,2,1,3,201,204,1.47,Furthest
13053,May,2020,Cumberland,NC,Passenger,0,3,3,466,469,0.64,Furthest
13054,May,2020,Clackamas,OR,Passenger,2,0,2,197,199,1.01,Nearest
13055,May,2020,Ferry,WA,Truck,0,0,0,3540,3540,0.0,Washington
13056,May,2020,Placer,CA,Passenger,2,0,2,87,89,2.25,Nearest
13057,May,2020,Richmond,GA,Passenger,0,1,1,86,87,1.15,Furthest
13058,May,2020,Harrison,MS,Passenger,1,0,1,55,56,1.79,Mid-Distance
13059,May,2020,Kent,MI,Passenger,0,1,1,23,24,4.17,Furthest
13060,May,2020,Adams,WA,Truck,0,0,0,5217,5217,0.0,Washington
13061,May,2020,Jones,GA,Passenger,1,0,1,1,2,50.0,Furthest
13062,May,2020,Kittitas,WA,Truck,0,0,0,14554,14554,0.0,Washington
13063,May,2020,San Francisco,CA,Passenger,1,1,2,96,98,2.04,Nearest
13064,May,2020,Island,WA,Truck,1,0,1,21136,21137,0.0,Washington
13065,May,2020,Middlesex,MA,Passenger,1,1,2,96,98,2.04,Furthest
13066,May,2020,Lincoln,WA,Truck,0,0,0,4618,4618,0.0,Washington
13067,May,2020,Fresno,CA,Passenger,1,0,1,183,184,0.54,Nearest
13068,May,2020,Pend Oreille,WA,Passenger,7,6,13,9217,9230,0.14,Washington
13069,May,2020,Honolulu,HI,Passenger,4,2,6,448,454,1.32,Nearest
13070,May,2020,Pima,AZ,Passenger,3,1,4,343,347,1.15,Nearest
13071,May,2020,Albemarle,VA,Passenger,1,0,1,20,21,4.76,Furthest
13072,May,2020,Pierce,WA,Passenger,2351,1675,4026,547592,551618,0.73,Washington
13073,May,2020,Portsmouth,VA,Passenger,0,1,1,76,77,1.3,Furthest
13074,May,2020,Thurston,WA,Passenger,1136,733,1869,196825,198694,0.94,Washington
13075,May,2020,King,WA,Passenger,24017,7688,31705,1374959,1406664,2.25,Washington
13076,May,2020,El Paso,CO,Passenger,2,0,2,717,719,0.28,Mid-Distance
13077,May,2020,Benton,WA,Truck,0,0,0,42474,42474,0.0,Washington
13078,May,2020,Twin Falls,ID,Passenger,0,1,1,26,27,3.7,Nearest
13079,May,2020,San Joaquin,CA,Passenger,1,0,1,127,128,0.78,Nearest
13080,May,2020,Fairbanks North Star,AK,Passenger,0,1,1,99,100,1.0,Nearest
13081,May,2020,Shelby,TN,Passenger,0,1,1,86,87,1.15,Furthest
13082,May,2020,Pend Oreille,WA,Truck,0,0,0,5741,5741,0.0,Washington
13083,May,2020,Santa Clara,CA,Passenger,7,2,9,304,313,2.88,Nearest
13084,May,2020,Boulder,CO,Passenger,0,1,1,45,46,2.17,Mid-Distance
13085,May,2020,Lincoln,WA,Passenger,4,12,16,7640,7656,0.21,Washington
13086,May,2020,Greene,MO,Passenger,0,1,1,30,31,3.23,Furthest
13087,May,2020,Wahkiakum,WA,Truck,0,0,0,1759,1759,0.0,Washington
13088,May,2020,Alameda,CA,Passenger,2,1,3,271,274,1.09,Nearest
13089,May,2020,Sumter,FL,Passenger,0,1,1,9,10,10.0,Furthest
13090,May,2020,Williamson,TX,Passenger,0,2,2,137,139,1.44,Mid-Distance
13091,May,2020,Osceola,FL,Passenger,1,0,1,39,40,2.5,Furthest
13092,May,2020,Goochland,VA,Passenger,2,1,3,258,261,1.15,Furthest
13093,May,2020,Chesapeake,VA,Passenger,0,2,2,420,422,0.47,Furthest
13094,May,2020,Palm Beach,FL,Passenger,0,1,1,80,81,1.23,Furthest
13095,May,2020,Walla Walla,WA,Passenger,70,62,132,35820,35952,0.37,Washington
13096,May,2020,Asotin,WA,Passenger,16,12,28,12338,12366,0.23,Washington
13097,May,2020,Benton,WA,Passenger,354,321,675,134165,134840,0.5,Washington
13098,May,2020,Skagit,WA,Passenger,400,216,616,91169,91785,0.67,Washington
13099,May,2020,Norfolk,VA,Passenger,2,2,4,345,349,1.15,Furthest
13100,May,2020,Arapahoe,CO,Passenger,1,0,1,132,133,0.75,Mid-Distance
13101,May,2020,Klickitat,WA,Passenger,53,40,93,15273,15366,0.61,Washington
13102,May,2020,Pacific,WA,Passenger,31,33,64,15703,15767,0.41,Washington
13103,May,2020,Walla Walla,WA,Truck,0,0,0,13670,13670,0.0,Washington
13104,May,2020,Los Angeles,CA,Passenger,7,11,18,991,1009,1.78,Nearest
13105,May,2020,Ferry,WA,Passenger,5,3,8,4331,4339,0.18,Washington
13106,May,2021,Erie,NY,Passenger,1,0,1,39,40,2.5,Furthest
13107,May,2021,Adams,WA,Truck,0,0,0,5374,5374,0.0,Washington
13108,May,2021,Ferry,WA,Passenger,9,3,12,4373,4385,0.27,Washington
13109,May,2021,Adams,WA,Passenger,11,9,20,13043,13063,0.15,Washington
13110,May,2021,Lincoln,WA,Passenger,5,13,18,7733,7751,0.23,Washington
13111,May,2021,Whatcom,WA,Passenger,1386,596,1982,150988,152970,1.3,Washington
13112,May,2021,San Joaquin,CA,Passenger,1,0,1,105,106,0.94,Nearest
13113,May,2021,Howard,IN,Passenger,0,1,1,3,4,25.0,Furthest
13114,May,2021,El Paso,TX,Passenger,3,0,3,375,378,0.79,Mid-Distance
13115,May,2021,Pend Oreille,WA,Truck,0,0,0,5748,5748,0.0,Washington
13116,May,2021,Kitsap,WA,Truck,0,0,0,54547,54547,0.0,Washington
13117,May,2021,Hamilton,IN,Passenger,2,0,2,33,35,5.71,Furthest
13118,May,2021,Richland,SC,Passenger,0,1,1,139,140,0.71,Furthest
13119,May,2021,Sarasota,FL,Passenger,2,0,2,27,29,6.9,Furthest
13120,May,2021,Clallam,WA,Truck,1,0,1,22005,22006,0.0,Washington
13121,May,2021,Platte,MO,Passenger,1,0,1,18,19,5.26,Furthest
13122,May,2021,Missoula,MT,Passenger,1,0,1,61,62,1.61,Nearest
13123,May,2021,Howard,MD,Passenger,0,1,1,61,62,1.61,Furthest
13124,May,2021,Multnomah,OR,Passenger,2,5,7,649,656,1.07,Nearest
13125,May,2021,Asotin,WA,Truck,0,0,0,6783,6783,0.0,Washington
13126,May,2021,Hampshire,MA,Passenger,1,0,1,6,7,14.29,Furthest
13127,May,2021,Jefferson,NY,Passenger,0,1,1,210,211,0.47,Furthest
13128,May,2021,Klamath,OR,Passenger,1,0,1,31,32,3.12,Nearest
13129,May,2021,Pennington,SD,Passenger,1,0,1,31,32,3.12,Mid-Distance
13130,May,2021,Benton,WA,Passenger,504,385,889,136106,136995,0.65,Washington
13131,May,2021,Montgomery,MD,Passenger,2,1,3,226,229,1.31,Furthest
13132,May,2021,Ray,MO,Passenger,0,1,1,1,2,50.0,Furthest
13133,May,2021,Portsmouth,VA,Passenger,0,1,1,77,78,1.28,Furthest
13134,May,2021,Owyhee,ID,Passenger,1,0,1,3,4,25.0,Nearest
13135,May,2021,Columbia,WA,Passenger,6,3,9,2476,2485,0.36,Washington
13136,May,2021,Kittitas,WA,Truck,0,0,0,14768,14768,0.0,Washington
13137,May,2021,Lewis,WA,Passenger,157,135,292,59809,60101,0.49,Washington
13138,May,2021,Pierce,WA,Passenger,3382,1941,5323,559989,565312,0.94,Washington
13139,May,2021,San Juan,WA,Passenger,423,131,554,14216,14770,3.75,Washington
13140,May,2021,Flathead,MT,Passenger,1,0,1,44,45,2.22,Nearest
13141,May,2021,Sumter,FL,Passenger,0,1,1,10,11,9.09,Furthest
13142,May,2021,Arapahoe,CO,Passenger,1,0,1,112,113,0.88,Mid-Distance
13143,May,2021,Klickitat,WA,Truck,0,0,0,8263,8263,0.0,Washington
13144,May,2021,Sumter,SC,Passenger,0,1,1,39,40,2.5,Furthest
13145,May,2021,Skamania,WA,Truck,0,0,0,4030,4030,0.0,Washington
13146,May,2021,Lake,FL,Passenger,1,0,1,22,23,4.35,Furthest
13147,May,2021,Bexar,TX,Passenger,3,4,7,530,537,1.3,Mid-Distance
13148,May,2021,New York,NY,Passenger,1,0,1,47,48,2.08,Furthest
13149,May,2021,Carroll,MD,Passenger,0,1,1,18,19,5.26,Furthest
13150,May,2021,Clackamas,OR,Passenger,2,0,2,172,174,1.15,Nearest
13151,May,2021,Milwaukee,WI,Passenger,1,0,1,38,39,2.56,Mid-Distance
13152,May,2021,Pinellas,FL,Passenger,0,1,1,94,95,1.05,Furthest
13153,May,2021,Denver,CO,Passenger,1,0,1,110,111,0.9,Mid-Distance
13154,May,2021,Harnett,NC,Passenger,1,1,2,172,174,1.15,Furthest
13155,May,2021,El Dorado,CA,Passenger,1,0,1,29,30,3.33,Nearest
13156,May,2021,Nassau,NY,Passenger,3,0,3,25,28,10.71,Furthest
13157,May,2021,San Francisco,CA,Passenger,1,1,2,87,89,2.25,Nearest
13158,May,2021,Montgomery,PA,Passenger,1,0,1,24,25,4.0,Furthest
13159,May,2021,Chelan,WA,Passenger,322,98,420,54729,55149,0.76,Washington
13160,May,2021,Montgomery,OH,Passenger,0,1,1,57,58,1.72,Furthest
13161,May,2021,Wilson,NC,Passenger,1,0,1,0,1,100.0,Furthest
13162,May,2021,Asotin,WA,Passenger,19,14,33,12700,12733,0.26,Washington
13163,May,2021,St. Clair,IL,Passenger,1,0,1,135,136,0.74,Mid-Distance
13164,May,2021,Cowlitz,WA,Passenger,218,136,354,72447,72801,0.49,Washington
13165,May,2021,Klickitat,WA,Passenger,66,47,113,15237,15350,0.74,Washington
13166,May,2021,Skagit,WA,Passenger,577,265,842,91964,92806,0.91,Washington
13167,May,2021,Walla Walla,WA,Passenger,110,72,182,36556,36738,0.5,Washington
13168,May,2021,Jones,GA,Passenger,1,0,1,1,2,50.0,Furthest
13169,May,2021,Nueces,TX,Passenger,1,0,1,77,78,1.28,Mid-Distance
13170,May,2021,Allen,IN,Passenger,1,0,1,16,17,5.88,Furthest
13171,May,2021,Clark,WA,Truck,0,0,0,84190,84190,0.0,Washington
13172,May,2021,Duval,FL,Passenger,0,2,2,334,336,0.6,Furthest
13173,May,2021,Williamson,TX,Passenger,0,2,2,106,108,1.85,Mid-Distance
13174,May,2021,Rogers,OK,Passenger,1,0,1,3,4,25.0,Mid-Distance
13175,May,2021,Powhatan,VA,Passenger,1,0,1,1,2,50.0,Furthest
13176,May,2021,Goochland,VA,Passenger,4,2,6,226,232,2.59,Furthest
13177,May,2021,Contra Costa,CA,Passenger,3,3,6,267,273,2.2,Nearest
13178,May,2021,Fresno,CA,Passenger,1,0,1,168,169,0.59,Nearest
13179,May,2021,Morris,NJ,Passenger,1,0,1,14,15,6.67,Furthest
13180,May,2021,Lincoln,WA,Truck,0,0,0,4754,4754,0.0,Washington
13181,May,2021,Columbia,WA,Truck,0,0,0,1552,1552,0.0,Washington
13182,May,2021,Arlington,VA,Passenger,0,1,1,137,138,0.72,Furthest
13183,May,2021,Thurston,WA,Truck,0,0,0,56635,56635,0.0,Washington
13184,May,2021,Yakima,WA,Passenger,211,145,356,169299,169655,0.21,Washington
13185,May,2021,Benton,WA,Truck,0,0,0,43665,43665,0.0,Washington
13186,May,2021,Ventura,CA,Passenger,1,1,2,262,264,0.76,Nearest
13187,May,2021,Hennepin,MN,Passenger,2,0,2,75,77,2.6,Mid-Distance
13188,May,2021,Stevens,WA,Passenger,42,45,87,30559,30646,0.28,Washington
13189,May,2021,Juneau,AK,Passenger,0,1,1,25,26,3.85,Nearest
13190,May,2021,Wahkiakum,WA,Passenger,13,7,20,3113,3133,0.64,Washington
13191,May,2021,Fairfax,VA,Passenger,4,4,8,687,695,1.15,Furthest
13192,May,2021,Garfield,WA,Passenger,0,2,2,1370,1372,0.15,Washington
13193,May,2021,Oldham,KY,Passenger,0,1,1,4,5,20.0,Furthest
13194,May,2021,Thurston,WA,Passenger,1543,852,2395,198108,200503,1.19,Washington
13195,May,2021,Philadelphia,PA,Passenger,1,0,1,48,49,2.04,Furthest
13196,May,2021,Kittitas,WA,Passenger,155,62,217,29978,30195,0.72,Washington
13197,May,2021,Santa Cruz,CA,Passenger,1,0,1,26,27,3.7,Nearest
13198,May,2021,Vigo,IN,Passenger,1,0,1,5,6,16.67,Furthest
13199,May,2021,Moore,NC,Passenger,0,1,1,132,133,0.75,Furthest
13200,May,2021,Riverside,CA,Passenger,5,1,6,551,557,1.08,Nearest
13201,May,2021,Lake,IL,Passenger,2,0,2,154,156,1.28,Mid-Distance
13202,May,2021,Harris,TX,Passenger,1,1,2,195,197,1.02,Mid-Distance
13203,May,2021,Skagit,WA,Truck,1,0,1,33056,33057,0.0,Washington
13204,May,2021,Middlesex,MA,Passenger,1,1,2,93,95,2.11,Furthest
13205,May,2021,Harrison,MS,Passenger,2,0,2,49,51,3.92,Mid-Distance
13206,May,2021,Charles,MD,Passenger,1,1,2,68,70,2.86,Furthest
13207,May,2021,New Haven,CT,Passenger,0,2,2,29,31,6.45,Furthest
13208,May,2021,Honolulu,HI,Passenger,5,2,7,397,404,1.73,Nearest
13209,May,2021,District of Columbia,DC,Passenger,5,1,6,196,202,2.97,Furthest
13210,May,2021,Maui,HI,Passenger,1,0,1,26,27,3.7,Nearest
13211,May,2021,Dallas,TX,Passenger,1,0,1,158,159,0.63,Mid-Distance
13212,May,2021,Deschutes,OR,Passenger,1,0,1,112,113,0.88,Nearest
13213,May,2021,Williams,ND,Passenger,0,1,1,7,8,12.5,Mid-Distance
13214,May,2021,Anchorage,AK,Passenger,1,0,1,137,138,0.72,Nearest
13215,May,2021,Allegheny,PA,Passenger,1,1,2,64,66,3.03,Furthest
13216,May,2021,Mason,WA,Passenger,207,136,343,48113,48456,0.71,Washington
13217,May,2021,San Diego,CA,Passenger,16,6,22,2601,2623,0.84,Nearest
13218,May,2021,Lee,FL,Passenger,1,0,1,36,37,2.7,Furthest
13219,May,2021,Prince George's,MD,Passenger,2,1,3,139,142,2.11,Furthest
13220,May,2021,Carson City,NV,Passenger,1,0,1,10,11,9.09,Nearest
13221,May,2021,Lane,OR,Passenger,0,1,1,126,127,0.79,Nearest
13222,May,2021,Pierce,WA,Truck,0,0,0,145896,145896,0.0,Washington
13223,May,2021,Okanogan,WA,Truck,0,0,0,16755,16755,0.0,Washington
13224,May,2021,Kings,NY,Passenger,1,0,1,66,67,1.49,Furthest
13225,May,2021,Kern,CA,Passenger,0,1,1,211,212,0.47,Nearest
13226,May,2021,Monterey,CA,Passenger,0,1,1,148,149,0.67,Nearest
13227,May,2021,Yakima,WA,Truck,0,0,0,61680,61680,0.0,Washington
13228,May,2021,Spokane,WA,Passenger,1030,624,1654,325579,327233,0.51,Washington
13229,May,2021,Placer,CA,Passenger,2,0,2,80,82,2.44,Nearest
13230,May,2021,Queens,NY,Passenger,2,0,2,48,50,4.0,Furthest
13231,May,2021,Suffolk,VA,Passenger,1,0,1,126,127,0.79,Furthest
13232,May,2021,Cumberland,NC,Passenger,0,2,2,427,429,0.47,Furthest
13233,May,2021,Boone,MO,Passenger,0,1,1,8,9,11.11,Furthest
13234,May,2021,Virginia Beach,VA,Passenger,3,0,3,619,622,0.48,Furthest
13235,May,2021,Sacramento,CA,Passenger,2,0,2,221,223,0.9,Nearest
13236,May,2021,Franklin,WA,Passenger,117,95,212,61959,62171,0.34,Washington
13237,May,2021,Santa Clara,CA,Passenger,8,3,11,255,266,4.14,Nearest
13238,May,2021,Miami-Dade,FL,Passenger,1,0,1,96,97,1.03,Furthest
13239,May,2021,Bartow,GA,Passenger,0,1,1,4,5,20.0,Furthest
13240,May,2021,Calvert,MD,Passenger,0,2,2,89,91,2.2,Furthest
13241,May,2021,Jefferson,WA,Truck,0,0,0,9616,9616,0.0,Washington
13242,May,2021,Albemarle,VA,Passenger,1,0,1,19,20,5.0,Furthest
13243,May,2021,Burlington,NJ,Passenger,0,1,1,129,130,0.77,Furthest
13244,May,2021,Grays Harbor,WA,Truck,0,0,0,21430,21430,0.0,Washington
13245,May,2021,Cowlitz,WA,Truck,0,0,0,29142,29142,0.0,Washington
13246,May,2021,San Mateo,CA,Passenger,1,0,1,102,103,0.97,Nearest
13247,May,2021,Pend Oreille,WA,Passenger,14,6,20,9275,9295,0.22,Washington
13248,May,2021,Douglas,NE,Passenger,1,1,2,49,51,3.92,Mid-Distance
13249,May,2021,Clark,NV,Passenger,4,2,6,618,624,0.96,Nearest
13250,May,2021,Washington,MD,Passenger,1,0,1,13,14,7.14,Furthest
13251,May,2021,Fort Bend,TX,Passenger,1,0,1,36,37,2.7,Mid-Distance
13252,May,2021,Charleston,SC,Passenger,2,0,2,83,85,2.35,Furthest
13253,May,2021,Broward,FL,Passenger,1,0,1,103,104,0.96,Furthest
13254,May,2021,Ferry,WA,Truck,0,0,0,3661,3661,0.0,Washington
13255,May,2021,RÃ­o Grande,PR,Passenger,1,0,1,1,2,50.0,Mid-Distance
13256,May,2021,Los Angeles,CA,Passenger,10,11,21,891,912,2.3,Nearest
13257,May,2021,Greene,MO,Passenger,0,1,1,30,31,3.23,Furthest
13258,May,2021,Camden,NJ,Passenger,0,1,1,15,16,6.25,Furthest
13259,May,2021,Garfield,WA,Truck,0,0,0,999,999,0.0,Washington
13260,May,2021,Cape May,NJ,Passenger,0,1,1,8,9,11.11,Furthest
13261,May,2021,Champaign,IL,Passenger,1,0,1,12,13,7.69,Mid-Distance
13262,May,2021,Nassau,FL,Passenger,1,0,1,30,31,3.23,Furthest
13263,May,2021,El Paso,CO,Passenger,3,0,3,675,678,0.44,Mid-Distance
13264,May,2021,Penobscot,ME,Passenger,0,1,1,9,10,10.0,Furthest
13265,May,2021,DeKalb,GA,Passenger,1,0,1,57,58,1.72,Furthest
13266,May,2021,Franklin,WA,Truck,0,0,0,20653,20653,0.0,Washington
13267,May,2021,Lewis,WA,Truck,0,0,0,26895,26895,0.0,Washington
13268,May,2021,Wichita,TX,Passenger,1,0,1,39,40,2.5,Mid-Distance
13269,May,2021,Salt Lake,UT,Passenger,0,1,1,173,174,0.57,Nearest
13270,May,2021,Douglas,WA,Truck,0,0,0,12664,12664,0.0,Washington
13271,May,2021,Wahkiakum,WA,Truck,0,0,0,1799,1799,0.0,Washington
13272,May,2021,DuPage,IL,Passenger,1,0,1,52,53,1.89,Mid-Distance
13273,May,2021,Plaquemines,LA,Passenger,0,1,1,16,17,5.88,Mid-Distance
13274,May,2021,Orange,CA,Passenger,4,3,7,425,432,1.62,Nearest
13275,May,2021,Prince William,VA,Passenger,1,1,2,212,214,0.93,Furthest
13276,May,2021,Norfolk,VA,Passenger,2,3,5,324,329,1.52,Furthest
13277,May,2021,Mason,WA,Truck,0,0,0,21339,21339,0.0,Washington
13278,May,2021,Polk,FL,Passenger,1,0,1,54,55,1.82,Furthest
13279,May,2021,Randolph,NC,Passenger,1,0,1,7,8,12.5,Furthest
13280,May,2021,Whitman,WA,Truck,0,0,0,8571,8571,0.0,Washington
13281,May,2021,New London,CT,Passenger,1,2,3,223,226,1.33,Furthest
13282,May,2021,King,WA,Truck,6,1,7,184688,184695,0.0,Washington
13283,May,2021,Stafford,VA,Passenger,2,1,3,98,101,2.97,Furthest
13284,May,2021,Island,WA,Passenger,599,310,909,63247,64156,1.42,Washington
13285,May,2021,Danville,VA,Passenger,1,0,1,0,1,100.0,Furthest
13286,May,2021,Houston,GA,Passenger,1,0,1,49,50,2.0,Furthest
13287,May,2021,Island,WA,Truck,0,0,0,21611,21611,0.0,Washington
13288,May,2021,Manassas,VA,Passenger,0,1,1,7,8,12.5,Furthest
13289,May,2021,Snohomish,WA,Passenger,5729,2002,7731,540294,548025,1.41,Washington
13290,May,2021,Alameda,CA,Passenger,3,0,3,237,240,1.25,Nearest
13291,May,2021,Bucks,PA,Passenger,1,0,1,16,17,5.88,Furthest
13292,May,2021,St. Mary's,MD,Passenger,1,0,1,208,209,0.48,Furthest
13293,May,2021,Louisa,VA,Passenger,0,1,1,1,2,50.0,Furthest
13294,May,2021,Maricopa,AZ,Passenger,5,4,9,1182,1191,0.76,Nearest
13296,May,2021,Saginaw,MI,Passenger,1,0,1,8,9,11.11,Furthest
13297,May,2021,Loudoun,VA,Passenger,1,0,1,74,75,1.33,Furthest
13298,May,2021,Douglas,WA,Passenger,92,47,139,28516,28655,0.49,Washington
13299,May,2021,Travis,TX,Passenger,3,3,6,160,166,3.61,Mid-Distance
13300,May,2021,Kitsap,WA,Passenger,1796,833,2629,180423,183052,1.44,Washington
13301,May,2021,Richmond,GA,Passenger,0,1,1,77,78,1.28,Furthest
13302,May,2021,Dakota,MN,Passenger,0,1,1,25,26,3.85,Mid-Distance
13303,May,2021,Rockingham,NH,Passenger,1,0,1,23,24,4.17,Furthest
13304,May,2021,Walla Walla,WA,Truck,0,0,0,14041,14041,0.0,Washington
13305,May,2021,Grant,WA,Truck,0,0,0,27874,27874,0.0,Washington
13306,May,2021,Washington,OR,Passenger,1,0,1,387,388,0.26,Nearest
13307,May,2021,Clallam,WA,Passenger,321,208,529,50426,50955,1.04,Washington
13308,May,2021,Boulder,CO,Passenger,0,1,1,45,46,2.17,Mid-Distance
13309,May,2021,Okaloosa,FL,Passenger,0,1,1,119,120,0.83,Furthest
13310,May,2021,Okanogan,WA,Passenger,61,37,98,26414,26512,0.37,Washington
13311,May,2021,San Juan,WA,Truck,0,0,0,5926,5926,0.0,Washington
13312,May,2021,Jefferson,WA,Passenger,322,181,503,24893,25396,1.98,Washington
13313,May,2021,Sevier,AR,Passenger,0,1,1,0,1,100.0,Mid-Distance
13314,May,2021,Leavenworth,KS,Passenger,0,1,1,118,119,0.84,Mid-Distance
13315,May,2021,Snohomish,WA,Truck,1,0,1,126365,126366,0.0,Washington
13316,May,2021,Grant,WA,Passenger,102,87,189,66863,67052,0.28,Washington
13317,May,2021,Ulster,NY,Passenger,1,0,1,8,9,11.11,Furthest
13318,May,2021,Spokane,WA,Truck,0,0,0,102090,102090,0.0,Washington
13319,May,2021,Shelby,OH,Passenger,0,1,1,1,2,50.0,Furthest
13320,May,2021,Tulsa,OK,Passenger,1,0,1,39,40,2.5,Mid-Distance
13321,May,2021,Larimer,CO,Passenger,1,0,1,51,52,1.92,Mid-Distance
13322,May,2021,Chesapeake,VA,Passenger,0,4,4,387,391,1.02,Furthest
13323,May,2021,Bradley,TN,Passenger,1,0,1,0,1,100.0,Furthest
13324,May,2021,King,WA,Passenger,30043,8922,38965,1368667,1407632,2.77,Washington
13325,May,2021,Skamania,WA,Passenger,43,32,75,8395,8470,0.89,Washington
13326,May,2021,Wilson,TX,Passenger,0,1,1,3,4,25.0,Mid-Distance
13327,May,2021,Yamhill,OR,Passenger,1,0,1,36,37,2.7,Nearest
13328,May,2021,Pacific,WA,Passenger,43,47,90,16070,16160,0.56,Washington
13329,May,2021,Douglas,CO,Passenger,0,1,1,74,75,1.33,Mid-Distance
13330,May,2021,Hillsborough,FL,Passenger,0,1,1,152,153,0.65,Furthest
13331,May,2021,Sedgwick,KS,Passenger,0,1,1,86,87,1.15,Mid-Distance
13332,May,2021,Whitman,WA,Passenger,60,44,104,22016,22120,0.47,Washington
13333,May,2021,Kauai,HI,Passenger,1,0,1,16,17,5.88,Nearest
13334,May,2021,Suffolk,MA,Passenger,0,2,2,33,35,5.71,Furthest
13335,May,2021,Orange,FL,Passenger,1,0,1,108,109,0.92,Furthest
13336,May,2021,Fairbanks North Star,AK,Passenger,0,1,1,84,85,1.18,Nearest
13337,May,2021,Hudson,NJ,Passenger,1,0,1,41,42,2.38,Furthest
13338,May,2021,Hawaii,HI,Passenger,1,0,1,47,48,2.08,Nearest
13339,May,2021,Gwinnett,GA,Passenger,1,0,1,63,64,1.56,Furthest
13340,May,2021,Carroll,NH,Passenger,0,1,1,5,6,16.67,Furthest
13341,May,2021,Pacific,WA,Truck,0,0,0,7939,7939,0.0,Washington
13342,May,2021,Anne Arundel,MD,Passenger,4,2,6,393,399,1.5,Furthest
13343,May,2021,Spartanburg,SC,Passenger,0,1,1,52,53,1.89,Furthest
13344,May,2021,St. Louis,MO,Passenger,1,0,1,81,82,1.22,Furthest
13345,May,2021,Clark,WA,Passenger,2757,1368,4125,321959,326084,1.27,Washington
13346,May,2021,Richmond,NY,Passenger,1,0,1,9,10,10.0,Furthest
13347,May,2021,Collin,TX,Passenger,1,1,2,113,115,1.74,Mid-Distance
13348,May,2021,Pima,AZ,Passenger,2,1,3,281,284,1.06,Nearest
13349,May,2021,Chelan,WA,Truck,0,0,0,23102,23102,0.0,Washington
13350,May,2021,Grays Harbor,WA,Passenger,161,139,300,49369,49669,0.6,Washington
13351,May,2021,Alexandria,VA,Passenger,2,0,2,130,132,1.52,Furthest
13352,May,2021,Whatcom,WA,Truck,4,0,4,43874,43878,0.01,Washington
13353,May,2021,Frederick,MD,Passenger,1,1,2,67,69,2.9,Furthest
13354,May,2021,Stevens,WA,Truck,0,0,0,18957,18957,0.0,Washington
13355,May,2021,Montgomery,TX,Passenger,1,1,2,43,45,4.44,Mid-Distance
13356,May,2022,Danville,VA,Passenger,1,0,1,0,1,100.0,Furthest
13357,May,2022,Kittitas,WA,Passenger,248,79,327,29757,30084,1.09,Washington
13358,May,2022,Baltimore,MD,Passenger,1,0,1,69,70,1.43,Furthest
13359,May,2022,Camden,NJ,Passenger,0,1,1,13,14,7.14,Furthest
13360,May,2022,Tarrant,TX,Passenger,1,0,1,110,111,0.9,Mid-Distance
13361,May,2022,Bartow,GA,Passenger,0,1,1,3,4,25.0,Furthest
13362,May,2022,Yellowstone,MT,Passenger,0,1,1,27,28,3.57,Nearest
13363,May,2022,New London,CT,Passenger,2,5,7,191,198,3.54,Furthest
13364,May,2022,Frederick,MD,Passenger,1,1,2,63,65,3.08,Furthest
13365,May,2022,Virginia Beach,VA,Passenger,2,0,2,511,513,0.39,Furthest
13366,May,2022,Duval,FL,Passenger,0,2,2,276,278,0.72,Furthest
13367,May,2022,Pima,AZ,Passenger,1,0,1,221,222,0.45,Nearest
13368,May,2022,Burlington,NJ,Passenger,0,2,2,109,111,1.8,Furthest
13369,May,2022,Skagit,WA,Passenger,759,332,1091,90123,91214,1.2,Washington
13370,May,2022,Spokane,WA,Truck,1,0,1,102240,102241,0.0,Washington
13371,May,2022,Maricopa,AZ,Passenger,7,2,9,913,922,0.98,Nearest
13372,May,2022,Lake,FL,Passenger,1,0,1,19,20,5.0,Furthest
13373,May,2022,Powhatan,VA,Passenger,1,0,1,1,2,50.0,Furthest
13374,May,2022,Wahkiakum,WA,Truck,0,0,0,1805,1805,0.0,Washington
13375,May,2022,Lee,FL,Passenger,1,0,1,29,30,3.33,Furthest
13376,May,2022,Boone,MO,Passenger,0,1,1,9,10,10.0,Furthest
13377,May,2022,Placer,CA,Passenger,2,0,2,64,66,3.03,Nearest
13378,May,2022,Asotin,WA,Passenger,23,19,42,12730,12772,0.33,Washington
13379,May,2022,Montgomery,MD,Passenger,4,2,6,197,203,2.96,Furthest
13380,May,2022,San Luis Obispo,CA,Passenger,1,0,1,54,55,1.82,Nearest
13381,May,2022,Kings,NY,Passenger,1,0,1,58,59,1.69,Furthest
13382,May,2022,Grays Harbor,WA,Passenger,205,158,363,49085,49448,0.73,Washington
13383,May,2022,Prince George's,MD,Passenger,2,1,3,119,122,2.46,Furthest
13384,May,2022,Hidalgo,TX,Passenger,0,1,1,52,53,1.89,Mid-Distance
13385,May,2022,Fresno,CA,Passenger,1,0,1,137,138,0.72,Nearest
13386,May,2022,Clark,NV,Passenger,4,2,6,511,517,1.16,Nearest
13387,May,2022,St. Mary's,MD,Passenger,1,0,1,190,191,0.52,Furthest
13388,May,2022,Spartanburg,SC,Passenger,0,1,1,40,41,2.44,Furthest
13389,May,2022,Chesapeake,VA,Passenger,2,3,5,335,340,1.47,Furthest
13390,May,2022,Multnomah,OR,Passenger,0,4,4,533,537,0.74,Nearest
13391,May,2022,Oldham,KY,Passenger,0,1,1,4,5,20.0,Furthest
13392,May,2022,Adams,WA,Passenger,16,10,26,12957,12983,0.2,Washington
13393,May,2022,Harnett,NC,Passenger,2,0,2,140,142,1.41,Furthest
13394,May,2022,Kitsap,WA,Passenger,2354,1031,3385,178653,182038,1.86,Washington
13395,May,2022,Wichita,TX,Passenger,1,0,1,38,39,2.56,Mid-Distance
13396,May,2022,Suffolk,VA,Passenger,1,0,1,119,120,0.83,Furthest
13397,May,2022,Collin,TX,Passenger,2,0,2,84,86,2.33,Mid-Distance
13398,May,2022,New Haven,CT,Passenger,0,2,2,27,29,6.9,Furthest
13399,May,2022,Geary,KS,Passenger,1,0,1,82,83,1.2,Mid-Distance
13400,May,2022,Owyhee,ID,Passenger,1,0,1,2,3,33.33,Nearest
13401,May,2022,Pacific,WA,Passenger,60,68,128,15915,16043,0.8,Washington
13402,May,2022,El Paso,CO,Passenger,3,1,4,590,594,0.67,Mid-Distance
13403,May,2022,El Paso,TX,Passenger,2,0,2,330,332,0.6,Mid-Distance
13404,May,2022,New York,NY,Passenger,1,0,1,33,34,2.94,Furthest
13405,May,2022,DeKalb,GA,Passenger,1,0,1,46,47,2.13,Furthest
13406,May,2022,Hudson,NJ,Passenger,2,0,2,34,36,5.56,Furthest
13407,May,2022,Elmore,ID,Passenger,1,0,1,12,13,7.69,Nearest
13408,May,2022,Sonoma,CA,Passenger,0,1,1,74,75,1.33,Nearest
13409,May,2022,Richmond,GA,Passenger,0,1,1,64,65,1.54,Furthest
13410,May,2022,Middlesex,MA,Passenger,1,1,2,74,76,2.63,Furthest
13411,May,2022,King,WA,Truck,43,1,44,181226,181270,0.02,Washington
13412,May,2022,Spokane,WA,Passenger,1543,832,2375,325374,327749,0.72,Washington
13413,May,2022,Rogers,OK,Passenger,1,0,1,1,2,50.0,Mid-Distance
13414,May,2022,Travis,TX,Passenger,1,0,1,106,107,0.93,Mid-Distance
13415,May,2022,Louisa,VA,Passenger,0,1,1,1,2,50.0,Furthest
13416,May,2022,Manassas,VA,Passenger,0,1,1,7,8,12.5,Furthest
13417,May,2022,Cumberland,NC,Passenger,1,2,3,359,362,0.83,Furthest
13418,May,2022,Santa Clara,CA,Passenger,10,1,11,216,227,4.85,Nearest
13419,May,2022,Washington,MD,Passenger,2,0,2,14,16,12.5,Furthest
13420,May,2022,Pennington,SD,Passenger,2,0,2,27,29,6.9,Mid-Distance
13421,May,2022,Kauai,HI,Passenger,1,0,1,16,17,5.88,Nearest
13422,May,2022,Miami-Dade,FL,Passenger,1,0,1,77,78,1.28,Furthest
13423,May,2022,San Juan,WA,Truck,1,0,1,5979,5980,0.02,Washington
13424,May,2022,Douglas,NE,Passenger,1,2,3,42,45,6.67,Mid-Distance
13425,May,2022,Plaquemines,LA,Passenger,1,1,2,16,18,11.11,Mid-Distance
13426,May,2022,Kitsap,WA,Truck,3,0,3,53699,53702,0.01,Washington
13427,May,2022,District of Columbia,DC,Passenger,5,0,5,177,182,2.75,Furthest
13428,May,2022,Sarpy,NE,Passenger,1,0,1,51,52,1.92,Mid-Distance
13429,May,2022,Houston,GA,Passenger,1,0,1,33,34,2.94,Furthest
13430,May,2022,Harris,TX,Passenger,2,0,2,140,142,1.41,Mid-Distance
13431,May,2022,Franklin,WA,Truck,0,0,0,20926,20926,0.0,Washington
13432,May,2022,Ray,MO,Passenger,0,1,1,1,2,50.0,Furthest
13433,May,2022,Howard,MD,Passenger,0,1,1,54,55,1.82,Furthest
13434,May,2022,Columbia,WA,Passenger,7,0,7,2441,2448,0.29,Washington
13435,May,2022,Pierce,WA,Truck,5,0,5,142329,142334,0.0,Washington
13436,May,2022,Adams,WA,Truck,0,0,0,5475,5475,0.0,Washington
13437,May,2022,Walla Walla,WA,Truck,0,0,0,13969,13969,0.0,Washington
13438,May,2022,Lincoln,WA,Truck,0,0,0,4839,4839,0.0,Washington
13439,May,2022,Clallam,WA,Passenger,410,244,654,49775,50429,1.3,Washington
13440,May,2022,Rockdale,GA,Passenger,1,0,1,8,9,11.11,Furthest
13441,May,2022,Douglas,WA,Truck,0,0,0,12770,12770,0.0,Washington
13442,May,2022,Clark,WA,Truck,5,0,5,82915,82920,0.01,Washington
13443,May,2022,Howard,IN,Passenger,0,1,1,4,5,20.0,Furthest
13445,May,2022,Anne Arundel,MD,Passenger,4,4,8,343,351,2.28,Furthest
13446,May,2022,Stevens,WA,Passenger,64,54,118,30097,30215,0.39,Washington
13447,May,2022,Philadelphia,PA,Passenger,1,0,1,34,35,2.86,Furthest
13448,May,2022,Bell,TX,Passenger,1,0,1,318,319,0.31,Mid-Distance
13449,May,2022,San Bernardino,CA,Passenger,1,1,2,323,325,0.62,Nearest
13450,May,2022,Richmond,NY,Passenger,1,0,1,6,7,14.29,Furthest
13451,May,2022,Jefferson,NY,Passenger,0,1,1,203,204,0.49,Furthest
13452,May,2022,Douglas,CO,Passenger,0,1,1,71,72,1.39,Mid-Distance
13453,May,2022,Richland,SC,Passenger,0,1,1,124,125,0.8,Furthest
13454,May,2022,Jefferson,WA,Truck,0,0,0,9493,9493,0.0,Washington
13455,May,2022,Sevier,AR,Passenger,0,1,1,0,1,100.0,Mid-Distance
13456,May,2022,Kittitas,WA,Truck,1,0,1,14675,14676,0.01,Washington
13457,May,2022,Harrison,MS,Passenger,2,0,2,44,46,4.35,Mid-Distance
13458,May,2022,Honolulu,HI,Passenger,5,4,9,319,328,2.74,Nearest
13459,May,2022,Contra Costa,CA,Passenger,0,4,4,251,255,1.57,Nearest
13460,May,2022,Fairbanks North Star,AK,Passenger,0,1,1,75,76,1.32,Nearest
13461,May,2022,Hawaii,HI,Passenger,1,0,1,35,36,2.78,Nearest
13462,May,2022,Okanogan,WA,Passenger,82,51,133,26409,26542,0.5,Washington
13463,May,2022,Pinellas,FL,Passenger,0,1,1,74,75,1.33,Furthest
13464,May,2022,Grant,WA,Passenger,166,97,263,66720,66983,0.39,Washington
13465,May,2022,Ulster,NY,Passenger,1,0,1,9,10,10.0,Furthest
13466,May,2022,Cowlitz,WA,Truck,1,1,2,28601,28603,0.01,Washington
13467,May,2022,Pend Oreille,WA,Truck,0,0,0,5629,5629,0.0,Washington
13468,May,2022,Lane,OR,Passenger,0,1,1,91,92,1.09,Nearest
13469,May,2022,Lake,IL,Passenger,3,0,3,139,142,2.11,Mid-Distance
13470,May,2022,Klickitat,WA,Passenger,99,54,153,15249,15402,0.99,Washington
13471,May,2022,Lewis,WA,Passenger,231,173,404,59518,59922,0.67,Washington
13472,May,2022,Ventura,CA,Passenger,1,1,2,229,231,0.87,Nearest
13473,May,2022,Moore,NC,Passenger,0,1,1,114,115,0.87,Furthest
13474,May,2022,Los Angeles,CA,Passenger,8,8,16,763,779,2.05,Nearest
13475,May,2022,Adams,CO,Passenger,1,0,1,38,39,2.56,Mid-Distance
13476,May,2022,Okanogan,WA,Truck,0,0,0,16665,16665,0.0,Washington
13477,May,2022,Broward,FL,Passenger,2,0,2,76,78,2.56,Furthest
13478,May,2022,Leavenworth,KS,Passenger,0,1,1,102,103,0.97,Mid-Distance
13479,May,2022,Orange,FL,Passenger,1,0,1,91,92,1.09,Furthest
13480,May,2022,Asotin,WA,Truck,0,0,0,6709,6709,0.0,Washington
13481,May,2022,Yakima,WA,Passenger,325,189,514,167089,167603,0.31,Washington
13482,May,2022,San Diego,CA,Passenger,14,9,23,2265,2288,1.01,Nearest
13483,May,2022,Onslow,NC,Passenger,0,1,1,158,159,0.63,Furthest
13484,May,2022,Albemarle,VA,Passenger,1,0,1,16,17,5.88,Furthest
13485,May,2022,Garfield,WA,Truck,0,0,0,981,981,0.0,Washington
13486,May,2022,Nassau,NY,Passenger,2,0,2,26,28,7.14,Furthest
13487,May,2022,Charleston,SC,Passenger,2,1,3,59,62,4.84,Furthest
13488,May,2022,Santa Cruz,CA,Passenger,1,0,1,23,24,4.17,Nearest
13489,May,2022,Bexar,TX,Passenger,4,3,7,434,441,1.59,Mid-Distance
13490,May,2022,Alameda,CA,Passenger,4,0,4,185,189,2.12,Nearest
13491,May,2022,Las Animas,CO,Passenger,1,0,1,1,2,50.0,Mid-Distance
13492,May,2022,St. Louis,MO,Passenger,1,0,1,64,65,1.54,Furthest
13493,May,2022,Clackamas,OR,Passenger,2,0,2,143,145,1.38,Nearest
13494,May,2022,Williams,ND,Passenger,0,1,1,6,7,14.29,Mid-Distance
13495,May,2022,Escambia,FL,Passenger,0,1,1,130,131,0.76,Furthest
13496,May,2022,Skamania,WA,Truck,0,0,0,3971,3971,0.0,Washington
13497,May,2022,Whitman,WA,Truck,0,0,0,8562,8562,0.0,Washington
13498,May,2022,Sumter,SC,Passenger,0,1,1,32,33,3.03,Furthest
13499,May,2022,Wahkiakum,WA,Passenger,22,10,32,3085,3117,1.03,Washington
13500,May,2022,Fairfax,VA,Passenger,6,3,9,607,616,1.46,Furthest
13501,May,2022,Arapahoe,CO,Passenger,0,1,1,77,78,1.28,Mid-Distance
13502,May,2022,Galveston,TX,Passenger,0,1,1,17,18,5.56,Mid-Distance
13503,May,2022,Portsmouth,VA,Passenger,0,1,1,74,75,1.33,Furthest
13504,May,2022,Orange,CA,Passenger,5,2,7,351,358,1.96,Nearest
13505,May,2022,Monterey,CA,Passenger,1,1,2,126,128,1.56,Nearest
13506,May,2022,Platte,MO,Passenger,1,0,1,21,22,4.55,Furthest
13507,May,2022,Nueces,TX,Passenger,1,1,2,54,56,3.57,Mid-Distance
13508,May,2022,Hillsborough,FL,Passenger,0,1,1,120,121,0.83,Furthest
13509,May,2022,Rockingham,NH,Passenger,1,0,1,15,16,6.25,Furthest
13510,May,2022,Kern,CA,Passenger,0,1,1,188,189,0.53,Nearest
13511,May,2022,San Mateo,CA,Passenger,2,0,2,79,81,2.47,Nearest
13512,May,2022,Rock Island,IL,Passenger,0,1,1,15,16,6.25,Mid-Distance
13513,May,2022,Coryell,TX,Passenger,1,0,1,98,99,1.01,Mid-Distance
13514,May,2022,Stafford,VA,Passenger,2,1,3,89,92,3.26,Furthest
13515,May,2022,Dorchester,SC,Passenger,1,0,1,55,56,1.79,Furthest
13516,May,2022,St. Tammany,LA,Passenger,1,0,1,34,35,2.86,Mid-Distance
13517,May,2022,Whatcom,WA,Passenger,1799,729,2528,148935,151463,1.67,Washington
13518,May,2022,Riverside,CA,Passenger,8,1,9,462,471,1.91,Nearest
13519,May,2022,Salt Lake,UT,Passenger,1,1,2,130,132,1.52,Nearest
13520,May,2022,Thurston,WA,Passenger,2127,1028,3155,194514,197669,1.6,Washington
13521,May,2022,Lincoln,OR,Passenger,0,1,1,26,27,3.7,Nearest
13522,May,2022,Lewis,WA,Truck,0,0,0,26423,26423,0.0,Washington
13523,May,2022,Queens,NY,Passenger,1,0,1,41,42,2.38,Furthest
13524,May,2022,Marin,CA,Passenger,0,1,1,29,30,3.33,Nearest
13525,May,2022,Snohomish,WA,Truck,6,0,6,124132,124138,0.0,Washington
13526,May,2022,Larimer,CO,Passenger,1,0,1,46,47,2.13,Mid-Distance
13527,May,2022,Pacific,WA,Truck,0,0,0,7950,7950,0.0,Washington
13528,May,2022,Douglas,WA,Passenger,131,58,189,28516,28705,0.66,Washington
13529,May,2022,Ferry,WA,Truck,0,0,0,3569,3569,0.0,Washington
13530,May,2022,Wilson,TX,Passenger,0,1,1,2,3,33.33,Mid-Distance
13531,May,2022,Randolph,NC,Passenger,1,0,1,5,6,16.67,Furthest
13532,May,2022,Gwinnett,GA,Passenger,1,0,1,49,50,2.0,Furthest
13533,May,2022,San Juan,WA,Passenger,499,152,651,14097,14748,4.41,Washington
13534,May,2022,Fort Bend,TX,Passenger,1,0,1,26,27,3.7,Mid-Distance
13535,May,2022,Lincoln,WA,Passenger,8,18,26,7692,7718,0.34,Washington
13536,May,2022,Okaloosa,FL,Passenger,0,1,1,96,97,1.03,Furthest
13537,May,2022,Wood,OH,Passenger,0,1,1,4,5,20.0,Furthest
13538,May,2022,Loudoun,VA,Passenger,2,1,3,63,66,4.55,Furthest
13539,May,2022,Pend Oreille,WA,Passenger,16,11,27,9013,9040,0.3,Washington
13540,May,2022,Benton,WA,Truck,2,0,2,43549,43551,0.0,Washington
13541,May,2022,San Joaquin,CA,Passenger,1,1,2,89,91,2.2,Nearest
13542,May,2022,Chelan,WA,Truck,2,0,2,23067,23069,0.01,Washington
13543,May,2022,Hamilton,IN,Passenger,1,0,1,20,21,4.76,Furthest
13544,May,2022,Jefferson,WA,Passenger,425,215,640,24617,25257,2.53,Washington
13545,May,2022,Denton,TX,Passenger,1,0,1,62,63,1.59,Mid-Distance
13546,May,2022,Sacramento,CA,Passenger,2,0,2,190,192,1.04,Nearest
13547,May,2022,DuPage,IL,Passenger,1,0,1,46,47,2.13,Mid-Distance
13548,May,2022,Chelan,WA,Passenger,450,126,576,54379,54955,1.05,Washington
13549,May,2022,Columbia,WA,Truck,0,0,0,1581,1581,0.0,Washington
13550,May,2022,Anchorage,AK,Passenger,1,0,1,119,120,0.83,Nearest
13551,May,2022,Essex,NJ,Passenger,2,0,2,9,11,18.18,Furthest
13552,May,2022,Thurston,WA,Truck,4,0,4,55452,55456,0.01,Washington
13553,May,2022,Pierce,WA,Passenger,4952,2291,7243,546758,554001,1.31,Washington
13554,May,2022,Solano,CA,Passenger,1,0,1,162,163,0.61,Nearest
13555,May,2022,Montgomery,PA,Passenger,2,0,2,20,22,9.09,Furthest
13556,May,2022,Skamania,WA,Passenger,70,45,115,8209,8324,1.38,Washington
13557,May,2022,Grays Harbor,WA,Truck,0,0,0,21307,21307,0.0,Washington
13558,May,2022,Whitman,WA,Passenger,84,58,142,22034,22176,0.64,Washington
13559,May,2022,Kings,CA,Passenger,2,1,3,298,301,1.0,Nearest
13560,May,2022,Franklin,WA,Passenger,181,110,291,62027,62318,0.47,Washington
13561,May,2022,Skagit,WA,Truck,2,0,2,32401,32403,0.01,Washington
13562,May,2022,Klickitat,WA,Truck,1,0,1,8293,8294,0.01,Washington
13563,May,2022,Grant,WA,Truck,0,0,0,27995,27995,0.0,Washington
13564,May,2022,Norfolk,VA,Passenger,3,3,6,289,295,2.03,Furthest
13565,May,2022,Cape May,NJ,Passenger,0,1,1,7,8,12.5,Furthest
13566,May,2022,Island,WA,Truck,1,0,1,21433,21434,0.0,Washington
13567,May,2022,Suffolk,MA,Passenger,0,1,1,21,22,4.55,Furthest
13568,May,2022,Garfield,WA,Passenger,0,3,3,1329,1332,0.23,Washington
13569,May,2022,St. Clair,IL,Passenger,2,0,2,118,120,1.67,Mid-Distance
13570,May,2022,Hennepin,MN,Passenger,2,0,2,53,55,3.64,Mid-Distance
13571,May,2022,Charles,MD,Passenger,1,1,2,54,56,3.57,Furthest
13572,May,2022,Snohomish,WA,Passenger,8141,2474,10615,533059,543674,1.95,Washington
13573,May,2022,Wake,NC,Passenger,1,0,1,86,87,1.15,Furthest
13574,May,2022,Allen,IN,Passenger,1,0,1,13,14,7.14,Furthest
13575,May,2022,Sedgwick,KS,Passenger,1,1,2,74,76,2.63,Mid-Distance
13576,May,2022,Cook,IL,Passenger,3,0,3,184,187,1.6,Mid-Distance
13577,May,2022,Ferry,WA,Passenger,20,4,24,4434,4458,0.54,Washington
13578,May,2022,Mason,WA,Truck,1,0,1,21058,21059,0.0,Washington
13579,May,2022,Montgomery,AL,Passenger,0,1,1,32,33,3.03,Furthest
13580,May,2022,Boulder,CO,Passenger,1,0,1,34,35,2.86,Mid-Distance
13581,May,2022,Carson City,NV,Passenger,1,0,1,8,9,11.11,Nearest
13582,May,2022,Juneau,AK,Passenger,0,1,1,29,30,3.33,Nearest
13583,May,2022,Island,WA,Passenger,797,373,1170,62040,63210,1.85,Washington
13584,May,2022,Prince William,VA,Passenger,0,1,1,191,192,0.52,Furthest
13585,May,2022,Clallam,WA,Truck,1,0,1,21957,21958,0.0,Washington
13586,May,2022,Mason,WA,Passenger,304,179,483,47338,47821,1.01,Washington
13587,May,2022,Williamson,TX,Passenger,1,2,3,81,84,3.57,Mid-Distance
13588,May,2022,Stevens,WA,Truck,0,0,0,18961,18961,0.0,Washington
13589,May,2022,Cowlitz,WA,Passenger,322,175,497,70710,71207,0.7,Washington
13590,May,2022,Montgomery,TX,Passenger,1,0,1,29,30,3.33,Mid-Distance
13591,May,2022,Arlington,VA,Passenger,1,0,1,124,125,0.8,Furthest
13592,May,2022,Penobscot,ME,Passenger,0,1,1,7,8,12.5,Furthest
13593,May,2022,Hamilton,OH,Passenger,1,0,1,28,29,3.45,Furthest
13594,May,2022,King,WA,Passenger,40013,11054,51067,1349163,1400230,3.65,Washington
13595,May,2022,Saratoga,NY,Passenger,1,0,1,38,39,2.56,Furthest
13596,May,2022,Goochland,VA,Passenger,3,2,5,130,135,3.7,Furthest
13597,May,2022,Carroll,MD,Passenger,0,1,1,15,16,6.25,Furthest
13598,May,2022,Alexandria,VA,Passenger,3,0,3,105,108,2.78,Furthest
13599,May,2022,Greene,MO,Passenger,0,1,1,23,24,4.17,Furthest
13600,May,2022,Calvert,MD,Passenger,0,2,2,76,78,2.56,Furthest
13601,May,2022,Yakima,WA,Truck,0,0,0,61425,61425,0.0,Washington
13602,May,2022,Walla Walla,WA,Passenger,171,97,268,35973,36241,0.74,Washington
13603,May,2022,Allegheny,PA,Passenger,1,1,2,52,54,3.7,Furthest
13604,May,2022,Sarasota,FL,Passenger,2,0,2,25,27,7.41,Furthest
13605,May,2022,Clark,WA,Passenger,3936,1735,5671,316813,322484,1.76,Washington
13606,May,2022,Carroll,NH,Passenger,0,1,1,5,6,16.67,Furthest
13607,May,2022,Benton,WA,Passenger,729,455,1184,135276,136460,0.87,Washington
13608,May,2022,Whatcom,WA,Truck,5,0,5,43377,43382,0.01,Washington
13609,May,2023,Loudoun,VA,Passenger,2,0,2,55,57,3.51,Furthest
13610,May,2023,Richmond,GA,Passenger,0,1,1,55,56,1.79,Furthest
13611,May,2023,Gwinnett,GA,Passenger,1,0,1,38,39,2.56,Furthest
13612,May,2023,New London,CT,Passenger,1,4,5,165,170,2.94,Furthest
13613,May,2023,Boulder,CO,Passenger,1,0,1,23,24,4.17,Mid-Distance
13614,May,2023,Maricopa,AZ,Passenger,7,3,10,551,561,1.78,Nearest
13615,May,2023,Bexar,TX,Passenger,3,3,6,328,334,1.8,Mid-Distance
13616,May,2023,Pulaski,AR,Passenger,3,0,3,21,24,12.5,Mid-Distance
13617,May,2023,King,WA,Truck,684,2,686,174691,175377,0.39,Washington
13618,May,2023,Denton,TX,Passenger,1,0,1,44,45,2.22,Mid-Distance
13619,May,2023,Larimer,CO,Passenger,1,0,1,33,34,2.94,Mid-Distance
13620,May,2023,Kern,CA,Passenger,1,1,2,164,166,1.2,Nearest
13621,May,2023,Sarpy,NE,Passenger,1,0,1,45,46,2.17,Mid-Distance
13622,May,2023,Dorchester,SC,Passenger,1,0,1,35,36,2.78,Furthest
13623,May,2023,St. Louis,MO,Passenger,1,0,1,47,48,2.08,Furthest
13624,May,2023,Adams,WA,Truck,2,0,2,5262,5264,0.04,Washington
13625,May,2023,Charleston,SC,Passenger,1,2,3,49,52,5.77,Furthest
13626,May,2023,Garfield,WA,Truck,0,0,0,964,964,0.0,Washington
13627,May,2023,Clark,NV,Passenger,4,2,6,361,367,1.63,Nearest
13628,May,2023,DeKalb,GA,Passenger,1,0,1,37,38,2.63,Furthest
13629,May,2023,Cumberland,NC,Passenger,1,2,3,280,283,1.06,Furthest
13630,May,2023,Anne Arundel,MD,Passenger,5,4,9,281,290,3.1,Furthest
13631,May,2023,Jackson,OK,Passenger,0,1,1,31,32,3.12,Mid-Distance
13632,May,2023,Walla Walla,WA,Passenger,215,115,330,35196,35526,0.93,Washington
13633,May,2023,San Bernardino,CA,Passenger,2,1,3,245,248,1.21,Nearest
13634,May,2023,Klickitat,WA,Truck,11,0,11,8198,8209,0.13,Washington
13635,May,2023,Prince George's,MD,Passenger,2,1,3,100,103,2.91,Furthest
13636,May,2023,St. Clair,IL,Passenger,1,0,1,95,96,1.04,Mid-Distance
13637,May,2023,Marin,CA,Passenger,0,1,1,27,28,3.57,Nearest
13638,May,2023,Wahkiakum,WA,Passenger,26,17,43,3018,3061,1.4,Washington
13639,May,2023,District of Columbia,DC,Passenger,5,0,5,144,149,3.36,Furthest
13640,May,2023,Chelan,WA,Truck,29,0,29,22965,22994,0.13,Washington
13641,May,2023,Yellowstone,MT,Passenger,0,1,1,16,17,5.88,Nearest
13642,May,2023,Beaufort,SC,Passenger,1,0,1,18,19,5.26,Furthest
13643,May,2023,Kitsap,WA,Truck,70,0,70,52120,52190,0.13,Washington
13644,May,2023,Spokane,WA,Truck,39,0,39,101203,101242,0.04,Washington
13645,May,2023,Fairfax,VA,Truck,1,0,1,84,85,1.18,Furthest
13646,May,2023,Arlington,VA,Passenger,1,0,1,96,97,1.03,Furthest
13647,May,2023,Stevens,WA,Passenger,110,64,174,29562,29736,0.59,Washington
13648,May,2023,Kings,CA,Passenger,2,1,3,255,258,1.16,Nearest
13649,May,2023,San Juan,WA,Passenger,611,173,784,13720,14504,5.41,Washington
13650,May,2023,El Paso,CO,Passenger,3,1,4,465,469,0.85,Mid-Distance
13651,May,2023,Frederick,MD,Passenger,1,1,2,48,50,4.0,Furthest
13652,May,2023,Harrison,MS,Passenger,1,0,1,28,29,3.45,Mid-Distance
13653,May,2023,Howard,MD,Passenger,0,1,1,40,41,2.44,Furthest
13654,May,2023,Wichita,TX,Passenger,2,0,2,29,31,6.45,Mid-Distance
13655,May,2023,Asotin,WA,Passenger,34,20,54,12351,12405,0.44,Washington
13656,May,2023,Carroll,MD,Passenger,0,1,1,16,17,5.88,Furthest
13657,May,2023,Calvert,MD,Passenger,1,1,2,69,71,2.82,Furthest
13658,May,2023,Whitman,WA,Truck,4,0,4,8547,8551,0.05,Washington
13659,May,2023,Snohomish,WA,Passenger,12139,2974,15113,524703,539816,2.8,Washington
13660,May,2023,Virginia Beach,VA,Passenger,2,0,2,409,411,0.49,Furthest
13661,May,2023,Onslow,NC,Passenger,0,1,1,133,134,0.75,Furthest
13662,May,2023,Chesapeake,VA,Passenger,2,3,5,263,268,1.87,Furthest
13663,May,2023,Sedgwick,KS,Passenger,1,0,1,52,53,1.89,Mid-Distance
13664,May,2023,Mason,WA,Passenger,429,206,635,45953,46588,1.36,Washington
13665,May,2023,Yavapai,AZ,Passenger,1,0,1,19,20,5.0,Nearest
13666,May,2023,Chelan,WA,Passenger,619,159,778,53890,54668,1.42,Washington
13667,May,2023,Hudson,NJ,Passenger,1,0,1,15,16,6.25,Furthest
13668,May,2023,Clark,WA,Truck,90,0,90,80813,80903,0.11,Washington
13669,May,2023,Portsmouth,VA,Passenger,0,1,1,57,58,1.72,Furthest
13670,May,2023,Pierce,WA,Passenger,7397,2707,10104,527950,538054,1.88,Washington
13671,May,2023,Franklin,WA,Truck,4,0,4,20695,20699,0.02,Washington
13672,May,2023,Kauai,HI,Passenger,1,1,2,13,15,13.33,Nearest
13673,May,2023,Whatcom,WA,Truck,57,0,57,42393,42450,0.13,Washington
13674,May,2023,Randolph,NC,Passenger,1,0,1,3,4,25.0,Furthest
13675,May,2023,Berkeley,SC,Passenger,0,1,1,93,94,1.06,Furthest
13676,May,2023,Moore,NC,Passenger,0,1,1,99,100,1.0,Furthest
13677,May,2023,Cook,IL,Passenger,2,0,2,131,133,1.5,Mid-Distance
13678,May,2023,Grant,WA,Passenger,275,122,397,66534,66931,0.59,Washington
13679,May,2023,Alexandria,VA,Passenger,3,1,4,84,88,4.55,Furthest
13680,May,2023,Jefferson,WA,Passenger,549,260,809,24141,24950,3.24,Washington
13681,May,2023,Whatcom,WA,Passenger,2374,867,3241,146794,150035,2.16,Washington
13683,May,2023,Middlesex,MA,Passenger,2,1,3,57,60,5.0,Furthest
13684,May,2023,Allen,IN,Passenger,1,0,1,8,9,11.11,Furthest
13685,May,2023,Skagit,WA,Passenger,1081,403,1484,88295,89779,1.65,Washington
13686,May,2023,Pend Oreille,WA,Truck,0,0,0,5568,5568,0.0,Washington
13687,May,2023,Yakima,WA,Truck,12,0,12,60495,60507,0.02,Washington
13688,May,2023,Washington,MD,Passenger,2,0,2,12,14,14.29,Furthest
13689,May,2023,Santa Cruz,CA,Passenger,1,0,1,12,13,7.69,Nearest
13690,May,2023,Platte,MO,Passenger,1,0,1,16,17,5.88,Furthest
13691,May,2023,Okanogan,WA,Truck,7,0,7,16336,16343,0.04,Washington
13692,May,2023,Honolulu,HI,Passenger,2,3,5,233,238,2.1,Nearest
13693,May,2023,Benton,WA,Passenger,1120,555,1675,134506,136181,1.23,Washington
13694,May,2023,Polk,OR,Passenger,0,1,1,14,15,6.67,Nearest
13695,May,2023,Skamania,WA,Truck,1,0,1,3802,3803,0.03,Washington
13696,May,2023,St. Mary's,MD,Passenger,1,0,1,161,162,0.62,Furthest
13697,May,2023,Ferry,WA,Passenger,20,4,24,4292,4316,0.56,Washington
13698,May,2023,New Haven,CT,Passenger,0,2,2,21,23,8.7,Furthest
13699,May,2023,Ray,MO,Passenger,0,1,1,0,1,100.0,Furthest
13700,May,2023,Galveston,TX,Passenger,0,1,1,15,16,6.25,Mid-Distance
13701,May,2023,Spokane,WA,Passenger,2227,1062,3289,320686,323975,1.02,Washington
13702,May,2023,Santa Barbara,CA,Passenger,1,0,1,60,61,1.64,Nearest
13703,May,2023,Whitman,WA,Passenger,144,76,220,21873,22093,1.0,Washington
13704,May,2023,Fairfax,VA,Passenger,5,3,8,520,528,1.52,Furthest
13705,May,2023,Jefferson,WA,Truck,12,0,12,9267,9279,0.13,Washington
13706,May,2023,Elmore,ID,Passenger,1,0,1,9,10,10.0,Nearest
13707,May,2023,Madison,IL,Passenger,1,0,1,14,15,6.67,Mid-Distance
13708,May,2023,Mason,WA,Truck,10,0,10,20553,20563,0.05,Washington
13709,May,2023,Newport News,VA,Passenger,1,0,1,89,90,1.11,Furthest
13710,May,2023,Lincoln,WA,Passenger,16,17,33,7646,7679,0.43,Washington
13711,May,2023,Clallam,WA,Passenger,533,280,813,48629,49442,1.64,Washington
13712,May,2023,Columbia,WA,Passenger,9,1,10,2407,2417,0.41,Washington
13713,May,2023,Arapahoe,CO,Passenger,1,1,2,63,65,3.08,Mid-Distance
13714,May,2023,St. Tammany,LA,Passenger,1,0,1,28,29,3.45,Mid-Distance
13715,May,2023,Lewis,WA,Truck,7,0,7,25864,25871,0.03,Washington
13716,May,2023,El Paso,TX,Passenger,2,0,2,248,250,0.8,Mid-Distance
13717,May,2023,Monterey,CA,Passenger,1,0,1,104,105,0.95,Nearest
13718,May,2023,Dallas,TX,Passenger,1,0,1,70,71,1.41,Mid-Distance
13719,May,2023,Grays Harbor,WA,Truck,6,0,6,20817,20823,0.03,Washington
13720,May,2023,Collin,TX,Passenger,1,0,1,36,37,2.7,Mid-Distance
13721,May,2023,Camden,NJ,Passenger,0,1,1,12,13,7.69,Furthest
13722,May,2023,Thurston,WA,Truck,57,0,57,53621,53678,0.11,Washington
13723,May,2023,Kootenai,ID,Truck,1,0,1,25,26,3.85,Nearest
13724,May,2023,Escambia,FL,Passenger,0,1,1,103,104,0.96,Furthest
13725,May,2023,Nueces,TX,Passenger,0,1,1,49,50,2.0,Mid-Distance
13726,May,2023,Sonoma,CA,Passenger,1,1,2,50,52,3.85,Nearest
13727,May,2023,Kent,DE,Passenger,1,0,1,43,44,2.27,Furthest
13728,May,2023,Pierce,WA,Truck,152,0,152,136292,136444,0.11,Washington
13729,May,2023,Franklin,WA,Passenger,300,136,436,61492,61928,0.7,Washington
13730,May,2023,Hidalgo,TX,Passenger,0,1,1,42,43,2.33,Mid-Distance
13731,May,2023,Multnomah,OR,Passenger,0,2,2,398,400,0.5,Nearest
13732,May,2023,Garfield,WA,Passenger,1,3,4,1303,1307,0.31,Washington
13733,May,2023,Los Angeles,CA,Passenger,4,4,8,565,573,1.4,Nearest
13734,May,2023,Island,WA,Truck,29,0,29,20927,20956,0.14,Washington
13735,May,2023,Cowlitz,WA,Truck,8,0,8,28004,28012,0.03,Washington
13736,May,2023,Plaquemines,LA,Passenger,1,1,2,12,14,14.29,Mid-Distance
13737,May,2023,Burlington,NJ,Passenger,0,2,2,87,89,2.25,Furthest
13738,May,2023,Alameda,CA,Passenger,3,0,3,147,150,2.0,Nearest
13739,May,2023,Jefferson,NY,Passenger,1,1,2,169,171,1.17,Furthest
13740,May,2023,Okanogan,WA,Passenger,123,62,185,25949,26134,0.71,Washington
13741,May,2023,Snohomish,WA,Truck,162,0,162,120661,120823,0.13,Washington
13742,May,2023,Miami-Dade,FL,Passenger,1,0,1,53,54,1.85,Furthest
13743,May,2023,San Juan,WA,Truck,12,0,12,5866,5878,0.2,Washington
13744,May,2023,Thurston,WA,Passenger,3033,1203,4236,189258,193494,2.19,Washington
13745,May,2023,Charles,MD,Passenger,1,1,2,47,49,4.08,Furthest
13746,May,2023,Walla Walla,WA,Truck,5,0,5,13644,13649,0.04,Washington
13747,May,2023,Montgomery,MD,Passenger,3,2,5,166,171,2.92,Furthest
13748,May,2023,Douglas,WA,Passenger,198,61,259,28577,28836,0.9,Washington
13749,May,2023,Lee,AL,Passenger,1,0,1,11,12,8.33,Furthest
13750,May,2023,Adams,WA,Passenger,25,12,37,12934,12971,0.29,Washington
13751,May,2023,Stevens,WA,Truck,1,0,1,18642,18643,0.01,Washington
13752,May,2023,Sheridan,WY,Passenger,1,0,1,5,6,16.67,Nearest
13753,May,2023,Hawaii,HI,Passenger,1,0,1,23,24,4.17,Nearest
13754,May,2023,Hamilton,OH,Truck,1,0,1,2,3,33.33,Furthest
13755,May,2023,Rock Island,IL,Passenger,0,1,1,13,14,7.14,Mid-Distance
13756,May,2023,Ferry,WA,Truck,0,0,0,3538,3538,0.0,Washington
13757,May,2023,Columbia,WA,Truck,0,0,0,1546,1546,0.0,Washington
13758,May,2023,Ulster,NY,Passenger,1,0,1,4,5,20.0,Furthest
13759,May,2023,Douglas,NE,Passenger,1,1,2,25,27,7.41,Mid-Distance
13760,May,2023,Clallam,WA,Truck,20,0,20,21594,21614,0.09,Washington
13761,May,2023,Nassau,NY,Passenger,1,0,1,21,22,4.55,Furthest
13762,May,2023,Stafford,VA,Passenger,3,1,4,71,75,5.33,Furthest
13763,May,2023,Bell,TX,Passenger,1,0,1,233,234,0.43,Mid-Distance
13764,May,2023,Las Animas,CO,Passenger,1,0,1,0,1,100.0,Mid-Distance
13765,May,2023,Pacific,WA,Passenger,76,90,166,15521,15687,1.06,Washington
13766,May,2023,Champaign,IL,Passenger,1,0,1,7,8,12.5,Mid-Distance
13767,May,2023,Ventura,CA,Passenger,2,1,3,190,193,1.55,Nearest
13768,May,2023,Douglas,CO,Passenger,0,1,1,49,50,2.0,Mid-Distance
13769,May,2023,Douglas,WA,Truck,7,0,7,12885,12892,0.05,Washington
13770,May,2023,Essex,NJ,Passenger,2,0,2,4,6,33.33,Furthest
13771,May,2023,Grays Harbor,WA,Passenger,290,181,471,48014,48485,0.97,Washington
13772,May,2023,Benton,OR,Passenger,1,0,1,30,31,3.23,Nearest
13773,May,2023,Napa,CA,Passenger,0,1,1,10,11,9.09,Nearest
13774,May,2023,Norfolk,VA,Passenger,3,2,5,249,254,1.97,Furthest
13775,May,2023,Cowlitz,WA,Passenger,454,206,660,69496,70156,0.94,Washington
13776,May,2023,Santa Clara,CA,Passenger,8,1,9,142,151,5.96,Nearest
13777,May,2023,Goochland,VA,Passenger,0,1,1,36,37,2.7,Furthest
13778,May,2023,Pend Oreille,WA,Passenger,30,11,41,8845,8886,0.46,Washington
13779,May,2023,Placer,CA,Passenger,1,0,1,50,51,1.96,Nearest
13780,May,2023,King,WA,Passenger,55335,14137,69472,1316224,1385696,5.01,Washington
13781,May,2023,Asotin,WA,Truck,0,0,0,6599,6599,0.0,Washington
13782,May,2023,Skagit,WA,Truck,19,0,19,31695,31714,0.06,Washington
13783,May,2023,Hillsborough,FL,Passenger,0,1,1,95,96,1.04,Furthest
13784,May,2023,Clark,WA,Passenger,5619,2279,7898,311557,319455,2.47,Washington
13785,May,2023,Kittitas,WA,Truck,8,0,8,14448,14456,0.06,Washington
13786,May,2023,Fairbanks North Star,AK,Passenger,0,1,1,45,46,2.17,Nearest
13787,May,2023,Williamson,TX,Passenger,0,1,1,46,47,2.13,Mid-Distance
13788,May,2023,Rockdale,GA,Passenger,1,0,1,3,4,25.0,Furthest
13789,May,2023,Richmond,NY,Passenger,1,0,1,6,7,14.29,Furthest
13790,May,2023,Saratoga,NY,Passenger,1,1,2,27,29,6.9,Furthest
13791,May,2023,Pacific,WA,Truck,3,0,3,7785,7788,0.04,Washington
13792,May,2023,Solano,CA,Passenger,5,0,5,132,137,3.65,Nearest
13793,May,2023,Geary,KS,Passenger,1,0,1,67,68,1.47,Mid-Distance
13794,May,2023,Hoke,NC,Passenger,1,0,1,53,54,1.85,Furthest
13795,May,2023,Cumberland,PA,Passenger,1,0,1,30,31,3.23,Furthest
13796,May,2023,Kittitas,WA,Passenger,339,102,441,29165,29606,1.49,Washington
13797,May,2023,Broward,FL,Passenger,1,0,1,53,54,1.85,Furthest
13798,May,2023,Sarasota,FL,Passenger,1,0,1,14,15,6.67,Furthest
13799,May,2023,Kitsap,WA,Passenger,3126,1246,4372,175192,179564,2.43,Washington
13800,May,2023,Wahkiakum,WA,Truck,2,0,2,1753,1755,0.11,Washington
13801,May,2023,Travis,TX,Passenger,1,0,1,75,76,1.32,Mid-Distance
13802,May,2023,Coryell,TX,Passenger,1,0,1,70,71,1.41,Mid-Distance
13803,May,2023,San Diego,CA,Passenger,16,9,25,1823,1848,1.35,Nearest
13804,May,2023,Leavenworth,KS,Passenger,0,1,1,89,90,1.11,Mid-Distance
13805,May,2023,Houston,GA,Passenger,1,0,1,26,27,3.7,Furthest
13806,May,2023,Lincoln,OR,Passenger,0,1,1,12,13,7.69,Nearest
13807,May,2023,Skamania,WA,Passenger,101,58,159,7977,8136,1.95,Washington
13808,May,2023,Hamilton,OH,Passenger,1,0,1,24,25,4.0,Furthest
13809,May,2023,Suffolk,VA,Passenger,1,0,1,101,102,0.98,Furthest
13810,May,2023,Cape May,NJ,Passenger,0,1,1,7,8,12.5,Furthest
13811,May,2023,Orange,CA,Passenger,6,2,8,260,268,2.99,Nearest
13812,May,2023,Lewis,WA,Passenger,309,203,512,58552,59064,0.87,Washington
13813,May,2023,Yakima,WA,Passenger,484,249,733,164633,165366,0.44,Washington
13814,May,2023,Hennepin,MN,Passenger,1,0,1,27,28,3.57,Mid-Distance
13815,May,2023,Harnett,NC,Passenger,4,0,4,116,120,3.33,Furthest
13816,May,2023,Contra Costa,CA,Passenger,0,3,3,183,186,1.61,Nearest
13817,May,2023,Riverside,CA,Passenger,6,1,7,348,355,1.97,Nearest
13818,May,2023,Salt Lake,UT,Passenger,0,1,1,86,87,1.15,Nearest
13819,May,2023,Emmet,MI,Passenger,0,1,1,0,1,100.0,Furthest
13820,May,2023,Grant,WA,Truck,10,0,10,27771,27781,0.04,Washington
13821,May,2023,Rockingham,NH,Passenger,1,0,1,11,12,8.33,Furthest
13822,May,2023,Sacramento,CA,Passenger,4,0,4,129,133,3.01,Nearest
13823,May,2023,Lincoln,WA,Truck,0,0,0,4844,4844,0.0,Washington
13824,May,2023,Klickitat,WA,Passenger,145,63,208,15072,15280,1.36,Washington
13825,May,2023,Adams,CO,Passenger,1,0,1,25,26,3.85,Mid-Distance
13826,May,2023,Vernon,LA,Passenger,1,0,1,68,69,1.45,Mid-Distance
13827,May,2023,Oldham,KY,Passenger,0,1,1,3,4,25.0,Furthest
13828,May,2023,Lane,OR,Passenger,0,1,1,60,61,1.64,Nearest
13829,May,2023,Benton,WA,Truck,22,0,22,42823,42845,0.05,Washington
13830,May,2023,Island,WA,Passenger,1044,430,1474,60998,62472,2.36,Washington
13831,May,2023,Lake,IL,Passenger,2,0,2,104,106,1.89,Mid-Distance
13832,November,2017,New Haven,CT,Passenger,0,1,1,53,54,1.85,Furthest
13833,November,2017,District of Columbia,DC,Passenger,0,3,3,206,209,1.44,Furthest
13834,November,2017,Franklin,OH,Passenger,0,1,1,109,110,0.91,Furthest
13835,November,2017,Pinal,AZ,Passenger,2,0,2,221,223,0.9,Nearest
13836,November,2017,Ferry,WA,Passenger,1,3,4,4408,4412,0.09,Washington
13837,November,2017,Okanogan,WA,Passenger,5,17,22,25731,25753,0.09,Washington
13838,November,2017,Clark,NV,Passenger,1,2,3,760,763,0.39,Nearest
13839,November,2017,Pacific,WA,Truck,0,0,0,7535,7535,0.0,Washington
13840,November,2017,Clallam,WA,Truck,0,0,0,21181,21181,0.0,Washington
13841,November,2017,Skagit,WA,Truck,1,0,1,31687,31688,0.0,Washington
13842,November,2017,Monterey,CA,Passenger,0,2,2,196,198,1.01,Nearest
13843,November,2017,Brevard,FL,Passenger,0,1,1,104,105,0.95,Furthest
13844,November,2017,Lumpkin,GA,Passenger,1,0,1,9,10,10.0,Furthest
13845,November,2017,Klickitat,WA,Truck,0,0,0,8002,8002,0.0,Washington
13846,November,2017,Jefferson,WA,Truck,0,0,0,9461,9461,0.0,Washington
13847,November,2017,Franklin,WA,Passenger,31,48,79,56681,56760,0.14,Washington
13848,November,2017,Prince William,VA,Passenger,0,3,3,271,274,1.09,Furthest
13849,November,2017,Sumter,FL,Passenger,0,1,1,10,11,9.09,Furthest
13850,November,2017,Nantucket,MA,Passenger,1,0,1,3,4,25.0,Furthest
13851,November,2017,San Juan,WA,Passenger,126,41,167,13785,13952,1.2,Washington
13852,November,2017,Spokane,WA,Truck,1,0,1,91421,91422,0.0,Washington
13853,November,2017,Clark,WA,Passenger,840,558,1398,303188,304586,0.46,Washington
13854,November,2017,Pacific,WA,Passenger,15,11,26,15334,15360,0.17,Washington
13855,November,2017,Prince George,VA,Passenger,0,1,1,71,72,1.39,Furthest
13856,November,2017,Clay,FL,Passenger,0,1,1,108,109,0.92,Furthest
13857,November,2017,Ramsey,MN,Passenger,1,0,1,39,40,2.5,Mid-Distance
13858,November,2017,Missoula,MT,Passenger,1,0,1,69,70,1.43,Nearest
13859,November,2017,Adams,WA,Passenger,3,5,8,12358,12366,0.06,Washington
13860,November,2017,Skamania,WA,Passenger,10,7,17,8576,8593,0.2,Washington
13861,November,2017,Whitman,WA,Truck,0,0,0,8437,8437,0.0,Washington
13862,November,2017,Maricopa,AZ,Passenger,2,0,2,1629,1631,0.12,Nearest
13863,November,2017,Pend Oreille,WA,Passenger,3,4,7,9428,9435,0.07,Washington
13864,November,2017,Essex,NJ,Passenger,1,0,1,10,11,9.09,Furthest
13865,November,2017,El Paso,TX,Passenger,1,0,1,524,525,0.19,Mid-Distance
13866,November,2017,Columbia,WA,Truck,0,0,0,1537,1537,0.0,Washington
13867,November,2017,Northampton,PA,Passenger,0,1,1,66,67,1.49,Furthest
13868,November,2017,Thurston,WA,Passenger,457,380,837,189509,190346,0.44,Washington
13869,November,2017,Palm Beach,FL,Passenger,0,1,1,92,93,1.08,Furthest
13870,November,2017,King,WA,Passenger,11131,4614,15745,1371535,1387280,1.13,Washington
13871,November,2017,Carroll,NH,Passenger,0,1,1,1,2,50.0,Furthest
13872,November,2017,Douglas,WA,Passenger,37,33,70,27072,27142,0.26,Washington
13873,November,2017,Island,WA,Truck,0,0,0,20694,20694,0.0,Washington
13874,November,2017,Wahkiakum,WA,Truck,0,0,0,1661,1661,0.0,Washington
13875,November,2017,Maui,HI,Passenger,1,0,1,68,69,1.45,Nearest
13876,November,2017,Fairfax,VA,Passenger,2,2,4,833,837,0.48,Furthest
13877,November,2017,Multnomah,OR,Passenger,3,3,6,901,907,0.66,Nearest
13878,November,2017,Queens,NY,Passenger,1,0,1,61,62,1.61,Furthest
13879,November,2017,Benton,WA,Truck,0,0,0,40497,40497,0.0,Washington
13880,November,2017,Lewis,WA,Truck,0,0,0,25234,25234,0.0,Washington
13881,November,2017,Riverside,CA,Passenger,1,2,3,748,751,0.4,Nearest
13882,November,2017,Thurston,WA,Truck,0,0,0,53689,53689,0.0,Washington
13883,November,2017,Norfolk,MA,Passenger,1,0,1,38,39,2.56,Furthest
13884,November,2017,Klickitat,WA,Passenger,23,26,49,14871,14920,0.33,Washington
13885,November,2017,Gwinnett,GA,Passenger,0,1,1,83,84,1.19,Furthest
13886,November,2017,Whatcom,WA,Truck,1,0,1,41929,41930,0.0,Washington
13887,November,2017,Fulton,GA,Passenger,1,0,1,109,110,0.91,Furthest
13888,November,2017,Yakima,WA,Truck,0,0,0,57917,57917,0.0,Washington
13889,November,2017,Kitsap,WA,Passenger,676,367,1043,175388,176431,0.59,Washington
13890,November,2017,Anne Arundel,MD,Passenger,0,1,1,488,489,0.2,Furthest
13891,November,2017,Pima,AZ,Passenger,1,1,2,412,414,0.48,Nearest
13892,November,2017,Clallam,WA,Passenger,98,86,184,48866,49050,0.38,Washington
13893,November,2017,San Diego,CA,Passenger,5,1,6,2584,2590,0.23,Nearest
13894,November,2017,Mason,WA,Passenger,63,72,135,44603,44738,0.3,Washington
13895,November,2017,Walla Walla,WA,Passenger,29,31,60,35239,35299,0.17,Washington
13896,November,2017,Frederick,MD,Passenger,0,1,1,87,88,1.14,Furthest
13897,November,2017,Wahkiakum,WA,Passenger,0,2,2,2868,2870,0.07,Washington
13898,November,2017,Columbia,WA,Passenger,2,1,3,2391,2394,0.13,Washington
13899,November,2017,Ferry,WA,Truck,0,0,0,3544,3544,0.0,Washington
13900,November,2017,Polk,FL,Passenger,1,0,1,62,63,1.59,Furthest
13901,November,2017,San Mateo,CA,Passenger,0,1,1,147,148,0.68,Nearest
13902,November,2017,Albemarle,VA,Passenger,0,1,1,32,33,3.03,Furthest
13903,November,2017,Orleans,LA,Passenger,0,1,1,46,47,2.13,Mid-Distance
13904,November,2017,Los Angeles,CA,Passenger,5,2,7,1212,1219,0.57,Nearest
13905,November,2017,Cowlitz,WA,Truck,0,0,0,28144,28144,0.0,Washington
13906,November,2017,Virginia Beach,VA,Passenger,2,1,3,661,664,0.45,Furthest
13907,November,2017,Cowlitz,WA,Passenger,54,65,119,70592,70711,0.17,Washington
13908,November,2017,Skagit,WA,Passenger,159,131,290,89317,89607,0.32,Washington
13909,November,2017,Dakota,MN,Passenger,0,2,2,37,39,5.13,Mid-Distance
13910,November,2017,Ventura,CA,Passenger,0,1,1,327,328,0.3,Nearest
13911,November,2017,Dale,AL,Passenger,0,1,1,63,64,1.56,Furthest
13912,November,2017,Snohomish,WA,Passenger,1987,1019,3006,516018,519024,0.58,Washington
13913,November,2017,Pierce,WA,Passenger,1050,942,1992,526013,528005,0.38,Washington
13914,November,2017,Utah,UT,Passenger,0,1,1,136,137,0.73,Nearest
13915,November,2017,Lane,OR,Passenger,0,1,1,207,208,0.48,Nearest
13916,November,2017,Morris,NJ,Passenger,1,0,1,22,23,4.35,Furthest
13917,November,2017,Sedgwick,KS,Passenger,0,1,1,105,106,0.94,Mid-Distance
13918,November,2017,Chelan,WA,Truck,0,0,0,21519,21519,0.0,Washington
13919,November,2017,Dallas,TX,Passenger,0,1,1,181,182,0.55,Mid-Distance
13920,November,2017,Stevens,WA,Passenger,10,21,31,31554,31585,0.1,Washington
13921,November,2017,King,WA,Truck,7,1,8,185511,185519,0.0,Washington
13922,November,2017,Nassau,NY,Passenger,1,1,2,38,40,5.0,Furthest
13923,November,2017,Grays Harbor,WA,Passenger,42,41,83,45582,45665,0.18,Washington
13924,November,2017,San Juan,WA,Truck,0,0,0,5574,5574,0.0,Washington
13925,November,2017,Juneau,AK,Passenger,0,1,1,45,46,2.17,Nearest
13926,November,2017,Latah,ID,Passenger,0,1,1,77,78,1.28,Nearest
13927,November,2017,Island,WA,Passenger,147,156,303,61346,61649,0.49,Washington
13928,November,2017,Manassas,VA,Passenger,0,1,1,9,10,10.0,Furthest
13929,November,2017,Marin,CA,Passenger,1,0,1,57,58,1.72,Nearest
13930,November,2017,Contra Costa,CA,Passenger,0,1,1,470,471,0.21,Nearest
13931,November,2017,Montgomery,MD,Passenger,1,0,1,300,301,0.33,Furthest
13932,November,2017,Duval,FL,Passenger,1,1,2,365,367,0.54,Furthest
13933,November,2017,Garfield,WA,Passenger,1,0,1,1313,1314,0.08,Washington
13935,November,2017,Travis,TX,Passenger,0,1,1,186,187,0.53,Mid-Distance
13936,November,2017,Benton,WA,Passenger,165,160,325,129883,130208,0.25,Washington
13937,November,2017,Lincoln,WA,Passenger,2,5,7,7552,7559,0.09,Washington
13938,November,2017,Allegheny,PA,Passenger,1,0,1,91,92,1.09,Furthest
13939,November,2017,Canyon,ID,Passenger,0,1,1,91,92,1.09,Nearest
13940,November,2017,Tarrant,TX,Passenger,1,0,1,230,231,0.43,Mid-Distance
13941,November,2017,Whitman,WA,Passenger,16,19,35,22387,22422,0.16,Washington
13942,November,2017,Bexar,TX,Passenger,1,1,2,825,827,0.24,Mid-Distance
13943,November,2017,Lewis,WA,Passenger,53,39,92,56418,56510,0.16,Washington
13944,November,2017,Nueces,TX,Passenger,1,1,2,92,94,2.13,Mid-Distance
13945,November,2017,Charles,MD,Passenger,0,1,1,84,85,1.18,Furthest
13946,November,2017,Manatee,FL,Passenger,1,0,1,40,41,2.44,Furthest
13947,November,2017,Madison,ID,Passenger,1,0,1,39,40,2.5,Nearest
13948,November,2017,Lincoln,WA,Truck,0,0,0,4484,4484,0.0,Washington
13949,November,2017,Lee,AL,Passenger,1,0,1,35,36,2.78,Furthest
13950,November,2017,Okanogan,WA,Truck,0,0,0,16273,16273,0.0,Washington
13951,November,2017,Tulare,CA,Passenger,1,0,1,189,190,0.53,Nearest
13952,November,2017,St. Clair,IL,Passenger,0,1,1,162,163,0.61,Mid-Distance
13953,November,2017,Sangamon,IL,Passenger,1,0,1,11,12,8.33,Mid-Distance
13954,November,2017,Montgomery,TX,Passenger,1,0,1,62,63,1.59,Mid-Distance
13955,November,2017,Prince George's,MD,Passenger,0,1,1,180,181,0.55,Furthest
13956,November,2017,Kittitas,WA,Passenger,34,24,58,28271,28329,0.2,Washington
13957,November,2017,Twin Falls,ID,Passenger,0,1,1,24,25,4.0,Nearest
13958,November,2017,Pierce,WA,Truck,0,0,0,137030,137030,0.0,Washington
13959,November,2017,Orange,CA,Passenger,3,1,4,584,588,0.68,Nearest
13960,November,2017,Deschutes,OR,Passenger,1,0,1,180,181,0.55,Nearest
13961,November,2017,Howard,MD,Passenger,0,2,2,91,93,2.15,Furthest
13962,November,2017,Grays Harbor,WA,Truck,0,0,0,20019,20019,0.0,Washington
13963,November,2017,Flathead,MT,Passenger,1,0,1,55,56,1.79,Nearest
13964,November,2017,Asotin,WA,Passenger,7,5,12,12514,12526,0.1,Washington
13965,November,2017,Cape May,NJ,Passenger,0,1,1,21,22,4.55,Furthest
13966,November,2017,Chelan,WA,Passenger,83,36,119,52832,52951,0.22,Washington
13967,November,2017,Volusia,FL,Passenger,0,1,1,38,39,2.56,Furthest
13968,November,2017,Hawaii,HI,Passenger,1,0,1,77,78,1.28,Nearest
13969,November,2017,New London,CT,Passenger,1,1,2,251,253,0.79,Furthest
13970,November,2017,Hardin,KY,Passenger,0,1,1,119,120,0.83,Furthest
13971,November,2017,Adams,WA,Truck,0,0,0,5141,5141,0.0,Washington
13972,November,2017,Kittitas,WA,Truck,0,0,0,13759,13759,0.0,Washington
13973,November,2017,Jefferson,WA,Passenger,116,71,187,24182,24369,0.77,Washington
13974,November,2017,Snohomish,WA,Truck,1,0,1,121380,121381,0.0,Washington
13975,November,2017,Whatcom,WA,Passenger,524,214,738,144659,145397,0.51,Washington
13976,November,2017,Yakima,WA,Passenger,57,73,130,161627,161757,0.08,Washington
13977,November,2017,Kent,MI,Passenger,0,1,1,34,35,2.86,Furthest
13978,November,2017,St. Lucie,FL,Passenger,1,0,1,26,27,3.7,Furthest
13979,November,2017,Norfolk,VA,Passenger,1,1,2,305,307,0.65,Furthest
13980,November,2017,Pend Oreille,WA,Truck,0,0,0,5595,5595,0.0,Washington
13981,November,2017,Jefferson,NY,Passenger,1,0,1,235,236,0.42,Furthest
13982,November,2017,Spokane,WA,Passenger,291,239,530,299642,300172,0.18,Washington
13983,November,2017,Grant,WA,Passenger,24,33,57,61891,61948,0.09,Washington
13984,November,2017,Alameda,CA,Passenger,0,1,1,353,354,0.28,Nearest
13985,November,2017,Shelby,TN,Passenger,0,1,1,104,105,0.95,Furthest
13986,November,2017,Richland,SC,Passenger,0,1,1,178,179,0.56,Furthest
13987,November,2017,Sacramento,CA,Passenger,1,0,1,317,318,0.31,Nearest
13988,November,2017,Hamilton,TN,Passenger,1,0,1,21,22,4.55,Furthest
13989,November,2017,Montgomery,PA,Passenger,1,0,1,39,40,2.5,Furthest
13990,November,2017,Asotin,WA,Truck,0,0,0,6552,6552,0.0,Washington
13991,November,2017,Montgomery,TN,Passenger,1,0,1,271,272,0.37,Furthest
13992,November,2017,Orange,FL,Passenger,1,1,2,144,146,1.37,Furthest
13993,November,2017,Walla Walla,WA,Truck,0,0,0,13312,13312,0.0,Washington
13994,November,2017,Hamilton,IN,Passenger,1,0,1,54,55,1.82,Furthest
13995,November,2017,Garfield,WA,Truck,0,0,0,937,937,0.0,Washington
13996,November,2017,Santa Fe,NM,Passenger,0,1,1,42,43,2.33,Mid-Distance
13997,November,2017,Franklin,MA,Passenger,0,1,1,4,5,20.0,Furthest
13998,November,2017,El Paso,CO,Passenger,2,0,2,764,766,0.26,Mid-Distance
13999,November,2017,Mason,WA,Truck,0,0,0,19540,19540,0.0,Washington
14000,November,2017,Douglas,WA,Truck,0,0,0,11702,11702,0.0,Washington
14001,November,2017,Moore,NC,Passenger,0,1,1,202,203,0.49,Furthest
14002,November,2017,Okaloosa,FL,Passenger,1,0,1,186,187,0.53,Furthest
14003,November,2017,Arlington,VA,Passenger,1,2,3,170,173,1.73,Furthest
14004,November,2017,DeKalb,GA,Passenger,1,0,1,85,86,1.16,Furthest
14005,November,2017,Richmond,GA,Passenger,0,1,1,91,92,1.09,Furthest
14006,November,2017,Saratoga,NY,Passenger,1,1,2,71,73,2.74,Furthest
14007,November,2017,Clark,WA,Truck,0,0,0,78247,78247,0.0,Washington
14008,November,2017,Santa Clara,CA,Passenger,7,1,8,385,393,2.04,Nearest
14009,November,2017,DeKalb,IN,Passenger,1,0,1,1,2,50.0,Furthest
14010,November,2017,Tuolumne,CA,Passenger,0,1,1,16,17,5.88,Nearest
14011,November,2017,Santa Rosa,FL,Passenger,1,0,1,105,106,0.94,Furthest
14012,November,2017,Stevens,WA,Truck,0,0,0,18334,18334,0.0,Washington
14013,November,2017,Kitsap,WA,Truck,1,0,1,52629,52630,0.0,Washington
14014,November,2017,Portsmouth,VA,Passenger,0,1,1,67,68,1.47,Furthest
14015,November,2017,Honolulu,HI,Passenger,2,2,4,557,561,0.71,Nearest
14016,November,2017,Franklin,WA,Truck,0,0,0,18414,18414,0.0,Washington
14017,November,2017,Skamania,WA,Truck,0,0,0,3893,3893,0.0,Washington
14018,November,2017,Grant,WA,Truck,0,0,0,25520,25520,0.0,Washington
14019,November,2018,Moore,NC,Passenger,0,1,1,193,194,0.52,Furthest
14020,November,2018,Lee,AL,Passenger,1,0,1,36,37,2.7,Furthest
14021,November,2018,Richland,SC,Passenger,0,1,1,163,164,0.61,Furthest
14022,November,2018,Kittitas,WA,Passenger,61,34,95,29286,29381,0.32,Washington
14023,November,2018,Polk,FL,Passenger,1,0,1,63,64,1.56,Furthest
14025,November,2018,Carroll,NH,Passenger,0,1,1,1,2,50.0,Furthest
14026,November,2018,Albemarle,VA,Passenger,1,0,1,27,28,3.57,Furthest
14027,November,2018,Williamson,TX,Passenger,0,1,1,148,149,0.67,Mid-Distance
14028,November,2018,Whatcom,WA,Passenger,730,355,1085,149134,150219,0.72,Washington
14029,November,2018,Madison,ID,Passenger,1,0,1,37,38,2.63,Nearest
14030,November,2018,New London,CT,Passenger,0,1,1,253,254,0.39,Furthest
14031,November,2018,El Paso,TX,Passenger,1,0,1,496,497,0.2,Mid-Distance
14032,November,2018,Adams,WA,Truck,0,0,0,5160,5160,0.0,Washington
14033,November,2018,Sangamon,IL,Passenger,1,0,1,9,10,10.0,Mid-Distance
14034,November,2018,Ada,ID,Passenger,0,2,2,314,316,0.63,Nearest
14035,November,2018,Manatee,FL,Passenger,1,0,1,39,40,2.5,Furthest
14036,November,2018,Honolulu,HI,Passenger,1,3,4,517,521,0.77,Nearest
14037,November,2018,Mason,WA,Truck,0,0,0,20190,20190,0.0,Washington
14038,November,2018,San Juan,WA,Truck,0,0,0,5805,5805,0.0,Washington
14039,November,2018,Lane,OR,Passenger,0,1,1,174,175,0.57,Nearest
14040,November,2018,Asotin,WA,Truck,0,0,0,6620,6620,0.0,Washington
14041,November,2018,Whatcom,WA,Truck,2,0,2,42656,42658,0.0,Washington
14042,November,2018,Volusia,FL,Passenger,0,1,1,36,37,2.7,Furthest
14043,November,2018,Juneau,AK,Passenger,0,1,1,43,44,2.27,Nearest
14044,November,2018,Cape May,NJ,Passenger,0,1,1,21,22,4.55,Furthest
14045,November,2018,Garfield,WA,Passenger,1,1,2,1331,1333,0.15,Washington
14046,November,2018,Morris,NJ,Passenger,1,0,1,18,19,5.26,Furthest
14047,November,2018,Rogers,OK,Passenger,1,0,1,6,7,14.29,Mid-Distance
14048,November,2018,Pierce,WA,Truck,0,0,0,139061,139061,0.0,Washington
14049,November,2018,Pend Oreille,WA,Passenger,5,5,10,9557,9567,0.1,Washington
14050,November,2018,Camden,NJ,Passenger,0,1,1,26,27,3.7,Furthest
14051,November,2018,Garfield,OK,Passenger,1,0,1,13,14,7.14,Mid-Distance
14052,November,2018,Wahkiakum,WA,Truck,0,0,0,1704,1704,0.0,Washington
14053,November,2018,Valencia,NM,Passenger,1,0,1,10,11,9.09,Mid-Distance
14054,November,2018,Montgomery,TX,Passenger,2,0,2,62,64,3.12,Mid-Distance
14055,November,2018,Hennepin,MN,Passenger,2,0,2,109,111,1.8,Mid-Distance
14056,November,2018,Whitman,WA,Truck,0,0,0,8531,8531,0.0,Washington
14057,November,2018,Chelan,WA,Passenger,135,60,195,54064,54259,0.36,Washington
14058,November,2018,Spokane,WA,Passenger,408,358,766,306895,307661,0.25,Washington
14059,November,2018,Clallam,WA,Truck,0,0,0,21613,21613,0.0,Washington
14060,November,2018,Travis,TX,Passenger,0,1,1,198,199,0.5,Mid-Distance
14061,November,2018,Skamania,WA,Passenger,18,14,32,8731,8763,0.37,Washington
14062,November,2018,King,WA,Passenger,15784,6398,22182,1377200,1399382,1.59,Washington
14063,November,2018,Broward,FL,Passenger,2,1,3,133,136,2.21,Furthest
14064,November,2018,Adams,WA,Passenger,5,5,10,12749,12759,0.08,Washington
14065,November,2018,Yakima,WA,Truck,0,0,0,58751,58751,0.0,Washington
14066,November,2018,Snohomish,WA,Passenger,2789,1415,4204,526785,530989,0.79,Washington
14067,November,2018,Prince George's,MD,Passenger,1,1,2,182,184,1.09,Furthest
14068,November,2018,Marion,OR,Passenger,1,0,1,119,120,0.83,Nearest
14069,November,2018,Randolph,NC,Passenger,1,0,1,5,6,16.67,Furthest
14070,November,2018,San Juan,PR,Passenger,0,1,1,5,6,16.67,Mid-Distance
14071,November,2018,Clallam,WA,Passenger,147,121,268,50323,50591,0.53,Washington
14072,November,2018,Columbia,WA,Truck,0,0,0,1516,1516,0.0,Washington
14073,November,2018,Dallas,TX,Passenger,0,1,1,198,199,0.5,Mid-Distance
14074,November,2018,Clackamas,OR,Passenger,1,1,2,217,219,0.91,Nearest
14075,November,2018,Anne Arundel,MD,Passenger,0,2,2,451,453,0.44,Furthest
14076,November,2018,Lewis,WA,Passenger,89,71,160,58211,58371,0.27,Washington
14077,November,2018,Charles,MD,Passenger,0,1,1,78,79,1.27,Furthest
14078,November,2018,Hawaii,HI,Passenger,1,0,1,65,66,1.52,Nearest
14079,November,2018,Kitsap,WA,Truck,1,0,1,53652,53653,0.0,Washington
14080,November,2018,Douglas,WA,Passenger,49,33,82,27967,28049,0.29,Washington
14081,November,2018,Spokane,WA,Truck,1,0,1,93666,93667,0.0,Washington
14082,November,2018,Franklin,WA,Truck,0,0,0,18987,18987,0.0,Washington
14083,November,2018,Deschutes,OR,Passenger,2,0,2,163,165,1.21,Nearest
14084,November,2018,Richmond,GA,Passenger,0,1,1,92,93,1.08,Furthest
14085,November,2018,Cook,IL,Passenger,1,0,1,250,251,0.4,Mid-Distance
14086,November,2018,Lincoln,WA,Truck,0,0,0,4630,4630,0.0,Washington
14087,November,2018,Franklin,MA,Passenger,0,1,1,1,2,50.0,Furthest
14088,November,2018,Santa Clara,CA,Passenger,8,1,9,373,382,2.36,Nearest
14089,November,2018,Twin Falls,ID,Passenger,0,1,1,23,24,4.17,Nearest
14090,November,2018,St. Clair,IL,Passenger,0,1,1,164,165,0.61,Mid-Distance
14091,November,2018,Wahkiakum,WA,Passenger,1,1,2,2984,2986,0.07,Washington
14092,November,2018,Charleston,SC,Passenger,1,0,1,125,126,0.79,Furthest
14093,November,2018,San Diego,CA,Passenger,8,2,10,2565,2575,0.39,Nearest
14094,November,2018,Monroe,IL,Passenger,1,0,1,4,5,20.0,Mid-Distance
14095,November,2018,Sedgwick,KS,Passenger,0,1,1,99,100,1.0,Mid-Distance
14096,November,2018,Santa Cruz,CA,Passenger,1,0,1,40,41,2.44,Nearest
14097,November,2018,Chelan,WA,Truck,0,0,0,22082,22082,0.0,Washington
14098,November,2018,Ferry,WA,Passenger,3,2,5,4383,4388,0.11,Washington
14099,November,2018,Montgomery,PA,Passenger,2,0,2,35,37,5.41,Furthest
14100,November,2018,Okanogan,WA,Passenger,15,22,37,26132,26169,0.14,Washington
14101,November,2018,Harnett,NC,Passenger,1,0,1,235,236,0.42,Furthest
14102,November,2018,Grays Harbor,WA,Passenger,61,68,129,47373,47502,0.27,Washington
14103,November,2018,Island,WA,Truck,0,0,0,21178,21178,0.0,Washington
14104,November,2018,Benton,WA,Truck,0,0,0,41442,41442,0.0,Washington
14105,November,2018,Nueces,TX,Passenger,1,1,2,93,95,2.11,Mid-Distance
14106,November,2018,New Haven,CT,Passenger,0,1,1,48,49,2.04,Furthest
14107,November,2018,Portsmouth,VA,Passenger,0,1,1,79,80,1.25,Furthest
14108,November,2018,Kent,MI,Passenger,0,1,1,23,24,4.17,Furthest
14109,November,2018,Whitman,WA,Passenger,20,35,55,22795,22850,0.24,Washington
14110,November,2018,Lincoln,WA,Passenger,2,6,8,7771,7779,0.1,Washington
14111,November,2018,DeKalb,IN,Passenger,1,0,1,1,2,50.0,Furthest
14112,November,2018,Skagit,WA,Passenger,249,184,433,91187,91620,0.47,Washington
14113,November,2018,Carson City,NV,Passenger,1,0,1,15,16,6.25,Nearest
14114,November,2018,DuPage,IL,Passenger,1,0,1,57,58,1.72,Mid-Distance
14115,November,2018,Clark,WA,Truck,0,0,0,79742,79742,0.0,Washington
14116,November,2018,Thurston,WA,Truck,0,0,0,54923,54923,0.0,Washington
14117,November,2018,Dakota,MN,Passenger,0,2,2,34,36,5.56,Mid-Distance
14118,November,2018,San Mateo,CA,Passenger,2,1,3,128,131,2.29,Nearest
14119,November,2018,El Paso,CO,Passenger,3,1,4,764,768,0.52,Mid-Distance
14120,November,2018,King,WA,Truck,6,1,7,182760,182767,0.0,Washington
14121,November,2018,Douglas,WA,Truck,0,0,0,12123,12123,0.0,Washington
14122,November,2018,Ramsey,MN,Passenger,1,0,1,40,41,2.44,Mid-Distance
14123,November,2018,Skamania,WA,Truck,0,0,0,4005,4005,0.0,Washington
14124,November,2018,Kitsap,WA,Passenger,916,522,1438,180341,181779,0.79,Washington
14125,November,2018,Shasta,CA,Passenger,1,0,1,42,43,2.33,Nearest
14126,November,2018,Manassas,VA,Passenger,0,1,1,9,10,10.0,Furthest
14127,November,2018,Goochland,VA,Passenger,0,1,1,244,245,0.41,Furthest
14128,November,2018,Orange,CA,Passenger,5,2,7,544,551,1.27,Nearest
14129,November,2018,Frederick,MD,Passenger,0,1,1,82,83,1.2,Furthest
14130,November,2018,Maricopa,AZ,Passenger,3,2,5,1540,1545,0.32,Nearest
14131,November,2018,Santa Fe,NM,Passenger,0,1,1,43,44,2.27,Mid-Distance
14132,November,2018,Washington,OR,Passenger,0,1,1,470,471,0.21,Nearest
14133,November,2018,Bergen,NJ,Passenger,1,0,1,27,28,3.57,Furthest
14134,November,2018,District of Columbia,DC,Passenger,1,3,4,193,197,2.03,Furthest
14135,November,2018,Lumpkin,GA,Passenger,1,0,1,7,8,12.5,Furthest
14136,November,2018,Santa Rosa,FL,Passenger,1,0,1,88,89,1.12,Furthest
14137,November,2018,Tarrant,TX,Passenger,1,0,1,207,208,0.48,Mid-Distance
14138,November,2018,Nassau,NY,Passenger,3,0,3,36,39,7.69,Furthest
14139,November,2018,Bexar,TX,Passenger,3,4,7,719,726,0.96,Mid-Distance
14140,November,2018,Washtenaw,MI,Passenger,1,0,1,39,40,2.5,Furthest
14141,November,2018,Mecklenburg,NC,Passenger,1,0,1,79,80,1.25,Furthest
14142,November,2018,Denver,CO,Passenger,1,0,1,130,131,0.76,Mid-Distance
14143,November,2018,Stevens,WA,Truck,0,0,0,18731,18731,0.0,Washington
14144,November,2018,Beaufort,SC,Passenger,1,0,1,34,35,2.86,Furthest
14145,November,2018,Pend Oreille,WA,Truck,0,0,0,5742,5742,0.0,Washington
14146,November,2018,Skagit,WA,Truck,1,0,1,32338,32339,0.0,Washington
14147,November,2018,Fairfax,VA,Passenger,1,2,3,806,809,0.37,Furthest
14148,November,2018,St. Lucie,FL,Passenger,1,0,1,29,30,3.33,Furthest
14149,November,2018,Guadalupe,TX,Passenger,1,0,1,80,81,1.23,Mid-Distance
14150,November,2018,Grays Harbor,WA,Truck,0,0,0,20338,20338,0.0,Washington
14151,November,2018,Kootenai,ID,Passenger,1,1,2,220,222,0.9,Nearest
14152,November,2018,Orange,FL,Passenger,2,1,3,163,166,1.81,Furthest
14153,November,2018,Caddo,LA,Passenger,0,1,1,23,24,4.17,Mid-Distance
14154,November,2018,Lee,FL,Passenger,1,0,1,52,53,1.89,Furthest
14155,November,2018,Jefferson,NY,Passenger,0,1,1,230,231,0.43,Furthest
14156,November,2018,Norfolk,VA,Passenger,2,2,4,342,346,1.16,Furthest
14157,November,2018,Yakima,WA,Passenger,78,98,176,164686,164862,0.11,Washington
14158,November,2018,Suffolk,MA,Passenger,0,1,1,43,44,2.27,Furthest
14159,November,2018,Montgomery,MD,Passenger,1,0,1,275,276,0.36,Furthest
14160,November,2018,Jefferson,CO,Passenger,0,2,2,63,65,3.08,Mid-Distance
14161,November,2018,Klickitat,WA,Truck,0,0,0,8183,8183,0.0,Washington
14162,November,2018,Maui,HI,Passenger,1,0,1,52,53,1.89,Nearest
14163,November,2018,Fulton,GA,Passenger,1,2,3,107,110,2.73,Furthest
14164,November,2018,Tuolumne,CA,Passenger,0,1,1,12,13,7.69,Nearest
14165,November,2018,Riverside,CA,Passenger,2,2,4,683,687,0.58,Nearest
14166,November,2018,Douglas,NE,Passenger,0,1,1,66,67,1.49,Mid-Distance
14167,November,2018,Columbia,WA,Passenger,2,2,4,2437,2441,0.16,Washington
14168,November,2018,Walla Walla,WA,Passenger,38,52,90,36092,36182,0.25,Washington
14169,November,2018,Stevens,WA,Passenger,16,27,43,31791,31834,0.14,Washington
14170,November,2018,DeKalb,GA,Passenger,1,0,1,77,78,1.28,Furthest
14171,November,2018,Multnomah,OR,Passenger,3,5,8,755,763,1.05,Nearest
14172,November,2018,Thurston,WA,Passenger,707,567,1274,195458,196732,0.65,Washington
14173,November,2018,San Juan,WA,Passenger,176,68,244,14214,14458,1.69,Washington
14174,November,2018,Monterey,CA,Passenger,0,1,1,190,191,0.52,Nearest
14175,November,2018,Flathead,MT,Passenger,1,0,1,55,56,1.79,Nearest
14176,November,2018,Alameda,CA,Passenger,0,2,2,327,329,0.61,Nearest
14177,November,2018,Howard,MD,Passenger,0,1,1,86,87,1.15,Furthest
14178,November,2018,Clark,NV,Passenger,2,2,4,721,725,0.55,Nearest
14179,November,2018,Island,WA,Passenger,266,224,490,63109,63599,0.77,Washington
14180,November,2018,Ventura,CA,Passenger,0,2,2,318,320,0.62,Nearest
14181,November,2018,Benton,WA,Passenger,210,224,434,132792,133226,0.33,Washington
14182,November,2018,Franklin,WA,Passenger,38,64,102,58943,59045,0.17,Washington
14183,November,2018,Walla Walla,WA,Truck,0,0,0,13518,13518,0.0,Washington
14184,November,2018,Pacific,WA,Passenger,20,23,43,15810,15853,0.27,Washington
14185,November,2018,Clay,FL,Passenger,0,1,1,88,89,1.12,Furthest
14186,November,2018,San Francisco,CA,Passenger,2,1,3,118,121,2.48,Nearest
14187,November,2018,Dale,AL,Passenger,0,1,1,57,58,1.72,Furthest
14188,November,2018,Jefferson,WA,Passenger,169,104,273,24795,25068,1.09,Washington
14189,November,2018,Snohomish,WA,Truck,1,0,1,121952,121953,0.0,Washington
14190,November,2018,Collin,TX,Passenger,1,1,2,146,148,1.35,Mid-Distance
14191,November,2018,Garfield,WA,Truck,0,0,0,964,964,0.0,Washington
14192,November,2018,Okanogan,WA,Truck,0,0,0,16492,16492,0.0,Washington
14193,November,2018,Pima,AZ,Passenger,1,1,2,399,401,0.5,Nearest
14194,November,2018,Grant,WA,Passenger,32,52,84,64032,64116,0.13,Washington
14195,November,2018,Marion,IN,Passenger,1,0,1,120,121,0.83,Furthest
14196,November,2018,Middlesex,MA,Passenger,0,1,1,135,136,0.74,Furthest
14197,November,2018,Brevard,FL,Passenger,0,1,1,95,96,1.04,Furthest
14198,November,2018,Houston,GA,Passenger,1,0,1,52,53,1.89,Furthest
14199,November,2018,Contra Costa,CA,Passenger,0,2,2,416,418,0.48,Nearest
14200,November,2018,Pinal,AZ,Passenger,2,0,2,201,203,0.99,Nearest
14201,November,2018,Klickitat,WA,Passenger,23,32,55,15421,15476,0.36,Washington
14202,November,2018,Bucks,PA,Passenger,1,0,1,16,17,5.88,Furthest
14203,November,2018,Clark,WA,Passenger,1188,830,2018,310997,313015,0.64,Washington
14204,November,2018,Ferry,WA,Truck,0,0,0,3582,3582,0.0,Washington
14205,November,2018,Klamath,OR,Passenger,1,0,1,36,37,2.7,Nearest
14206,November,2018,Oldham,KY,Passenger,0,1,1,5,6,16.67,Furthest
14207,November,2018,Washoe,NV,Passenger,1,0,1,107,108,0.93,Nearest
14208,November,2018,Larimer,CO,Passenger,1,0,1,61,62,1.61,Mid-Distance
14209,November,2018,Cowlitz,WA,Passenger,69,91,160,72372,72532,0.22,Washington
14210,November,2018,Los Angeles,CA,Passenger,7,5,12,1126,1138,1.05,Nearest
14211,November,2018,Norfolk,MA,Passenger,1,0,1,36,37,2.7,Furthest
14212,November,2018,Hamilton,IN,Passenger,1,0,1,46,47,2.13,Furthest
14213,November,2018,Kittitas,WA,Truck,0,0,0,14162,14162,0.0,Washington
14214,November,2018,Sumter,FL,Passenger,0,1,1,10,11,9.09,Furthest
14215,November,2018,Mason,WA,Passenger,103,110,213,46427,46640,0.46,Washington
14216,November,2018,Cumberland,NC,Passenger,0,1,1,520,521,0.19,Furthest
14217,November,2018,Duval,FL,Passenger,1,2,3,381,384,0.78,Furthest
14218,November,2018,Lewis,WA,Truck,0,0,0,25625,25625,0.0,Washington
14219,November,2018,Prince William,VA,Passenger,0,4,4,257,261,1.53,Furthest
14220,November,2018,Grant,WA,Truck,0,0,0,26159,26159,0.0,Washington
14221,November,2018,Hardin,KY,Passenger,0,1,1,111,112,0.89,Furthest
14222,November,2018,Cowlitz,WA,Truck,0,0,0,28723,28723,0.0,Washington
14223,November,2018,Allegheny,PA,Passenger,1,0,1,84,85,1.18,Furthest
14224,November,2018,Shelby,TN,Passenger,0,1,1,102,103,0.97,Furthest
14225,November,2018,Arlington,VA,Passenger,1,1,2,166,168,1.19,Furthest
14226,November,2018,Virginia Beach,VA,Passenger,2,1,3,697,700,0.43,Furthest
14227,November,2018,Gwinnett,GA,Passenger,0,1,1,77,78,1.28,Furthest
14228,November,2018,Cochise,AZ,Passenger,0,1,1,119,120,0.83,Nearest
14229,November,2018,Jefferson,WA,Truck,0,0,0,9615,9615,0.0,Washington
14230,November,2018,Palm Beach,FL,Passenger,0,1,1,93,94,1.06,Furthest
14231,November,2018,Pacific,WA,Truck,0,0,0,7611,7611,0.0,Washington
14232,November,2018,Asotin,WA,Passenger,12,9,21,12726,12747,0.16,Washington
14233,November,2018,Saratoga,NY,Passenger,1,0,1,62,63,1.59,Furthest
14234,November,2018,Pierce,WA,Passenger,1470,1339,2809,538424,541233,0.52,Washington
14235,November,2018,Tulsa,OK,Passenger,1,1,2,47,49,4.08,Mid-Distance
14236,November,2018,St. Mary's,MD,Passenger,1,0,1,218,219,0.46,Furthest
14237,November,2018,Fresno,CA,Passenger,1,0,1,189,190,0.53,Nearest
14238,November,2018,Nantucket,MA,Passenger,1,0,1,4,5,20.0,Furthest
14239,November,2019,Montgomery,OH,Passenger,0,1,1,48,49,2.04,Furthest
14240,November,2019,Hennepin,MN,Passenger,3,1,4,99,103,3.88,Mid-Distance
14241,November,2019,Greene,MO,Passenger,0,1,1,31,32,3.12,Furthest
14242,November,2019,Broward,FL,Passenger,2,1,3,124,127,2.36,Furthest
14243,November,2019,Asotin,WA,Passenger,13,8,21,12655,12676,0.17,Washington
14244,November,2019,Dallas,TX,Passenger,1,0,1,209,210,0.48,Mid-Distance
14245,November,2019,Franklin,MA,Passenger,0,1,1,1,2,50.0,Furthest
14246,November,2019,Kootenai,ID,Passenger,1,1,2,226,228,0.88,Nearest
14247,November,2019,Richmond,GA,Passenger,0,1,1,93,94,1.06,Furthest
14248,November,2019,Wahkiakum,WA,Passenger,4,3,7,3037,3044,0.23,Washington
14249,November,2019,Montgomery,PA,Passenger,2,0,2,36,38,5.26,Furthest
14250,November,2019,Grant,WA,Truck,0,0,0,26953,26953,0.0,Washington
14251,November,2019,Moore,NC,Passenger,0,1,1,173,174,0.57,Furthest
14252,November,2019,Skamania,WA,Truck,0,0,0,4096,4096,0.0,Washington
14253,November,2019,Ada,ID,Passenger,0,1,1,294,295,0.34,Nearest
14254,November,2019,Richland,SC,Passenger,0,1,1,158,159,0.63,Furthest
14255,November,2019,Portsmouth,VA,Passenger,0,1,1,79,80,1.25,Furthest
14256,November,2019,Shasta,CA,Passenger,1,0,1,38,39,2.56,Nearest
14257,November,2019,Wilson,TX,Passenger,0,1,1,8,9,11.11,Mid-Distance
14258,November,2019,Jefferson,WA,Truck,0,0,0,9654,9654,0.0,Washington
14259,November,2019,DuPage,IL,Passenger,3,0,3,63,66,4.55,Mid-Distance
14260,November,2019,Pacific,WA,Passenger,29,30,59,16115,16174,0.36,Washington
14261,November,2019,Whatcom,WA,Truck,2,0,2,43148,43150,0.0,Washington
14262,November,2019,Pima,AZ,Passenger,2,1,3,372,375,0.8,Nearest
14263,November,2019,Kern,CA,Passenger,0,1,1,220,221,0.45,Nearest
14264,November,2019,Pinal,AZ,Passenger,1,0,1,191,192,0.52,Nearest
14265,November,2019,Polk,FL,Passenger,1,0,1,66,67,1.49,Furthest
14266,November,2019,Suffolk,VA,Passenger,1,0,1,124,125,0.8,Furthest
14267,November,2019,Tuolumne,CA,Passenger,0,1,1,11,12,8.33,Nearest
14268,November,2019,Lake,FL,Passenger,1,0,1,21,22,4.55,Furthest
14269,November,2019,Bexar,TX,Passenger,1,5,6,648,654,0.92,Mid-Distance
14270,November,2019,Bucks,PA,Passenger,1,0,1,22,23,4.35,Furthest
14271,November,2019,Lincoln,WA,Truck,0,0,0,4695,4695,0.0,Washington
14272,November,2019,Clallam,WA,Passenger,195,153,348,50908,51256,0.68,Washington
14273,November,2019,Lewis,WA,Passenger,109,103,212,59509,59721,0.35,Washington
14274,November,2019,El Paso,TX,Passenger,3,0,3,459,462,0.65,Mid-Distance
14275,November,2019,Duval,FL,Passenger,1,2,3,367,370,0.81,Furthest
14276,November,2019,Harris,TX,Passenger,1,1,2,240,242,0.83,Mid-Distance
14277,November,2019,Walla Walla,WA,Truck,0,0,0,13674,13674,0.0,Washington
14278,November,2019,Wahkiakum,WA,Truck,0,0,0,1752,1752,0.0,Washington
14279,November,2019,Sumter,FL,Passenger,0,1,1,9,10,10.0,Furthest
14280,November,2019,Boone,MO,Passenger,0,1,1,11,12,8.33,Furthest
14281,November,2019,Fairbanks North Star,AK,Passenger,0,1,1,98,99,1.01,Nearest
14282,November,2019,Multnomah,OR,Passenger,4,6,10,726,736,1.36,Nearest
14283,November,2019,Charleston,SC,Passenger,1,0,1,109,110,0.91,Furthest
14284,November,2019,Jefferson,WA,Passenger,212,132,344,25183,25527,1.35,Washington
14285,November,2019,Hawaii,HI,Passenger,1,0,1,57,58,1.72,Nearest
14286,November,2019,Island,WA,Passenger,363,251,614,63666,64280,0.96,Washington
14287,November,2019,Sedgwick,KS,Passenger,1,1,2,96,98,2.04,Mid-Distance
14288,November,2019,Alexandria,VA,Passenger,1,0,1,147,148,0.68,Furthest
14289,November,2019,Cumberland,NC,Passenger,0,2,2,486,488,0.41,Furthest
14290,November,2019,Honolulu,HI,Passenger,4,2,6,482,488,1.23,Nearest
14291,November,2019,Santa Rosa,FL,Passenger,1,0,1,88,89,1.12,Furthest
14292,November,2019,Charles,MD,Passenger,0,1,1,84,85,1.18,Furthest
14293,November,2019,Nassau,NY,Passenger,4,0,4,39,43,9.3,Furthest
14294,November,2019,Ferry,WA,Passenger,5,2,7,4414,4421,0.16,Washington
14295,November,2019,San Juan,WA,Truck,0,0,0,5929,5929,0.0,Washington
14296,November,2019,Benton,WA,Truck,0,0,0,42413,42413,0.0,Washington
14297,November,2019,Asotin,WA,Truck,0,0,0,6694,6694,0.0,Washington
14298,November,2019,Sangamon,IL,Passenger,1,0,1,5,6,16.67,Mid-Distance
14299,November,2019,Palm Beach,FL,Passenger,0,1,1,83,84,1.19,Furthest
14300,November,2019,RÃ­o Grande,PR,Passenger,1,0,1,1,2,50.0,Mid-Distance
14301,November,2019,Houston,GA,Passenger,1,0,1,59,60,1.67,Furthest
14302,November,2019,Ventura,CA,Passenger,0,3,3,302,305,0.98,Nearest
14303,November,2019,Okanogan,WA,Passenger,27,30,57,26234,26291,0.22,Washington
14304,November,2019,Kitsap,WA,Passenger,1190,649,1839,182242,184081,1.0,Washington
14305,November,2019,Franklin,WA,Passenger,53,75,128,60785,60913,0.21,Washington
14306,November,2019,Chelan,WA,Passenger,196,75,271,54642,54913,0.49,Washington
14307,November,2019,Tarrant,TX,Passenger,2,0,2,195,197,1.02,Mid-Distance
14308,November,2019,Skagit,WA,Passenger,347,210,557,92574,93131,0.6,Washington
14309,November,2019,Ramsey,MN,Passenger,1,0,1,40,41,2.44,Mid-Distance
14310,November,2019,Whitman,WA,Truck,0,0,0,8581,8581,0.0,Washington
14311,November,2019,Spokane,WA,Truck,1,0,1,96217,96218,0.0,Washington
14312,November,2019,Carson City,NV,Passenger,1,0,1,10,11,9.09,Nearest
14313,November,2019,Kitsap,WA,Truck,1,0,1,54405,54406,0.0,Washington
14314,November,2019,Pend Oreille,WA,Truck,0,0,0,5733,5733,0.0,Washington
14315,November,2019,Berkshire,MA,Passenger,0,1,1,5,6,16.67,Furthest
14316,November,2019,Santa Cruz,CA,Passenger,1,0,1,36,37,2.7,Nearest
14317,November,2019,Norfolk,VA,Passenger,1,2,3,347,350,0.86,Furthest
14318,November,2019,Middlesex,MA,Passenger,1,1,2,107,109,1.83,Furthest
14319,November,2019,Cowlitz,WA,Truck,0,0,0,29029,29029,0.0,Washington
14321,November,2019,King,WA,Truck,6,1,7,182343,182350,0.0,Washington
14322,November,2019,Denver,CO,Passenger,1,0,1,128,129,0.78,Mid-Distance
14323,November,2019,Arlington,VA,Passenger,0,2,2,153,155,1.29,Furthest
14324,November,2019,Washtenaw,MI,Passenger,1,0,1,41,42,2.38,Furthest
14325,November,2019,Manassas,VA,Passenger,0,1,1,7,8,12.5,Furthest
14326,November,2019,Douglas,WA,Passenger,65,38,103,28288,28391,0.36,Washington
14327,November,2019,Montgomery,TX,Passenger,1,0,1,56,57,1.75,Mid-Distance
14328,November,2019,San Mateo,CA,Passenger,1,1,2,121,123,1.63,Nearest
14329,November,2019,Goochland,VA,Passenger,3,1,4,264,268,1.49,Furthest
14330,November,2019,Skamania,WA,Passenger,26,20,46,8789,8835,0.52,Washington
14331,November,2019,Stevens,WA,Truck,0,0,0,18795,18795,0.0,Washington
14332,November,2019,DeKalb,IN,Passenger,1,0,1,1,2,50.0,Furthest
14333,November,2019,Stevens,WA,Passenger,31,30,61,31606,31667,0.19,Washington
14334,November,2019,Tulsa,OK,Passenger,1,1,2,48,50,4.0,Mid-Distance
14335,November,2019,Adams,WA,Passenger,6,7,13,12928,12941,0.1,Washington
14336,November,2019,Pierce,WA,Passenger,2083,1635,3718,547543,551261,0.67,Washington
14337,November,2019,Juneau,AK,Passenger,0,2,2,28,30,6.67,Nearest
14338,November,2019,Douglas,NE,Passenger,0,1,1,59,60,1.67,Mid-Distance
14339,November,2019,Frederick,MD,Passenger,1,1,2,83,85,2.35,Furthest
14340,November,2019,Pinellas,FL,Passenger,1,1,2,108,110,1.82,Furthest
14341,November,2019,Placer,CA,Passenger,1,0,1,96,97,1.03,Nearest
14342,November,2019,Osceola,FL,Passenger,1,0,1,43,44,2.27,Furthest
14343,November,2019,Cascade,MT,Passenger,0,1,1,56,57,1.75,Nearest
14344,November,2019,Clark,WA,Truck,0,0,0,81279,81279,0.0,Washington
14345,November,2019,San Juan,WA,Passenger,243,78,321,14405,14726,2.18,Washington
14346,November,2019,San Diego,CA,Passenger,9,3,12,2805,2817,0.43,Nearest
14347,November,2019,New Haven,CT,Passenger,0,2,2,47,49,4.08,Furthest
14348,November,2019,San Francisco,CA,Passenger,2,1,3,100,103,2.91,Nearest
14349,November,2019,Thurston,WA,Truck,0,0,0,55656,55656,0.0,Washington
14350,November,2019,Orange,CA,Passenger,7,2,9,505,514,1.75,Nearest
14351,November,2019,Mason,WA,Passenger,140,130,270,47611,47881,0.56,Washington
14352,November,2019,Benton,WA,Passenger,310,308,618,135108,135726,0.46,Washington
14353,November,2019,Spartanburg,SC,Passenger,0,1,1,43,44,2.27,Furthest
14354,November,2019,Whatcom,WA,Passenger,964,470,1434,151593,153027,0.94,Washington
14355,November,2019,Flathead,MT,Passenger,1,0,1,64,65,1.54,Nearest
14356,November,2019,Grays Harbor,WA,Truck,0,0,0,20750,20750,0.0,Washington
14357,November,2019,Whitman,WA,Passenger,41,46,87,22704,22791,0.38,Washington
14358,November,2019,Travis,TX,Passenger,2,1,3,199,202,1.49,Mid-Distance
14359,November,2019,Brevard,FL,Passenger,0,1,1,88,89,1.12,Furthest
14360,November,2019,Vigo,IN,Passenger,1,0,1,6,7,14.29,Furthest
14361,November,2019,Saginaw,MI,Passenger,1,0,1,11,12,8.33,Furthest
14362,November,2019,Volusia,FL,Passenger,0,1,1,41,42,2.38,Furthest
14363,November,2019,Grant,WA,Passenger,53,65,118,65498,65616,0.18,Washington
14364,November,2019,Solano,CA,Passenger,1,0,1,204,205,0.49,Nearest
14365,November,2019,Montgomery,AL,Passenger,0,1,1,39,40,2.5,Furthest
14366,November,2019,Prince George's,MD,Passenger,1,1,2,174,176,1.14,Furthest
14367,November,2019,Jones,GA,Passenger,1,0,1,1,2,50.0,Furthest
14368,November,2019,Fairfax,VA,Passenger,4,2,6,755,761,0.79,Furthest
14369,November,2019,Garfield,WA,Passenger,0,1,1,1304,1305,0.08,Washington
14370,November,2019,Lewis,WA,Truck,0,0,0,26110,26110,0.0,Washington
14371,November,2019,Thurston,WA,Passenger,1035,700,1735,199127,200862,0.86,Washington
14372,November,2019,King,WA,Passenger,21598,7457,29055,1395552,1424607,2.04,Washington
14373,November,2019,Los Angeles,CA,Passenger,8,9,17,1065,1082,1.57,Nearest
14374,November,2019,Contra Costa,CA,Passenger,3,2,5,349,354,1.41,Nearest
14375,November,2019,Columbia,WA,Passenger,3,2,5,2443,2448,0.2,Washington
14376,November,2019,Wayne,MI,Passenger,0,1,1,61,62,1.61,Furthest
14377,November,2019,Anne Arundel,MD,Passenger,1,2,3,435,438,0.68,Furthest
14378,November,2019,Camden,NJ,Passenger,0,1,1,22,23,4.35,Furthest
14379,November,2019,Clackamas,OR,Passenger,2,1,3,211,214,1.4,Nearest
14380,November,2019,Garfield,WA,Truck,0,0,0,965,965,0.0,Washington
14381,November,2019,Cape May,NJ,Passenger,0,1,1,13,14,7.14,Furthest
14382,November,2019,Maricopa,AZ,Passenger,6,5,11,1507,1518,0.72,Nearest
14383,November,2019,Larimer,CO,Passenger,1,0,1,56,57,1.75,Mid-Distance
14384,November,2019,Clark,WA,Passenger,1806,1025,2831,317525,320356,0.88,Washington
14385,November,2019,Shelby,OH,Passenger,0,1,1,1,2,50.0,Furthest
14386,November,2019,Fresno,CA,Passenger,1,0,1,190,191,0.52,Nearest
14387,November,2019,Clark,NV,Passenger,4,2,6,683,689,0.87,Nearest
14388,November,2019,Lincoln,WA,Passenger,1,11,12,7798,7810,0.15,Washington
14389,November,2019,Hudson,NJ,Passenger,1,0,1,38,39,2.56,Furthest
14390,November,2019,Maui,HI,Passenger,1,0,1,42,43,2.33,Nearest
14391,November,2019,Powhatan,VA,Passenger,1,0,1,0,1,100.0,Furthest
14392,November,2019,Arapahoe,CO,Passenger,1,0,1,145,146,0.68,Mid-Distance
14393,November,2019,Queens,NY,Passenger,1,0,1,54,55,1.82,Furthest
14394,November,2019,Skagit,WA,Truck,1,0,1,32541,32542,0.0,Washington
14395,November,2019,Chesapeake,VA,Passenger,0,2,2,439,441,0.45,Furthest
14396,November,2019,Monroe,IL,Passenger,1,0,1,4,5,20.0,Mid-Distance
14397,November,2019,Cochise,AZ,Passenger,0,1,1,104,105,0.95,Nearest
14398,November,2019,Walla Walla,WA,Passenger,64,61,125,36282,36407,0.34,Washington
14399,November,2019,Washoe,NV,Passenger,1,0,1,108,109,0.92,Nearest
14400,November,2019,Island,WA,Truck,1,0,1,21317,21318,0.0,Washington
14401,November,2019,Owyhee,ID,Passenger,1,0,1,3,4,25.0,Nearest
14402,November,2019,Kittitas,WA,Passenger,89,46,135,30012,30147,0.45,Washington
14403,November,2019,Harrison,MS,Passenger,1,0,1,58,59,1.69,Mid-Distance
14404,November,2019,Snohomish,WA,Truck,0,0,0,123166,123166,0.0,Washington
14405,November,2019,Yakima,WA,Truck,0,0,0,59589,59589,0.0,Washington
14406,November,2019,Jefferson,CO,Passenger,0,2,2,59,61,3.28,Mid-Distance
14407,November,2019,Cook,IL,Passenger,1,0,1,230,231,0.43,Mid-Distance
14408,November,2019,Alameda,CA,Passenger,5,1,6,291,297,2.02,Nearest
14409,November,2019,Pacific,WA,Truck,0,0,0,7740,7740,0.0,Washington
14410,November,2019,Dakota,MN,Passenger,0,1,1,34,35,2.86,Mid-Distance
14411,November,2019,Harnett,NC,Passenger,1,1,2,208,210,0.95,Furthest
14412,November,2019,Fulton,GA,Passenger,0,2,2,105,107,1.87,Furthest
14413,November,2019,Klickitat,WA,Passenger,45,38,83,15673,15756,0.53,Washington
14414,November,2019,Kittitas,WA,Truck,0,0,0,14619,14619,0.0,Washington
14415,November,2019,St. Mary's,MD,Passenger,1,0,1,218,219,0.46,Furthest
14416,November,2019,Oldham,KY,Passenger,0,1,1,5,6,16.67,Furthest
14417,November,2019,Riverside,CA,Passenger,4,1,5,636,641,0.78,Nearest
14418,November,2019,Pend Oreille,WA,Passenger,7,7,14,9516,9530,0.15,Washington
14419,November,2019,Lake,IL,Passenger,1,0,1,166,167,0.6,Mid-Distance
14420,November,2019,District of Columbia,DC,Passenger,1,1,2,212,214,0.93,Furthest
14421,November,2019,Norfolk,MA,Passenger,1,0,1,36,37,2.7,Furthest
14422,November,2019,Sarasota,FL,Passenger,2,0,2,25,27,7.41,Furthest
14423,November,2019,Williamson,TX,Passenger,0,2,2,146,148,1.35,Mid-Distance
14424,November,2019,Cowlitz,WA,Passenger,114,106,220,73591,73811,0.3,Washington
14425,November,2019,Loudoun,VA,Passenger,1,0,1,95,96,1.04,Furthest
14426,November,2019,Spokane,WA,Passenger,631,470,1101,314632,315733,0.35,Washington
14427,November,2019,San Joaquin,CA,Passenger,1,0,1,135,136,0.74,Nearest
14428,November,2019,Douglas,WA,Truck,0,0,0,12301,12301,0.0,Washington
14429,November,2019,Jefferson,NY,Passenger,0,2,2,214,216,0.93,Furthest
14430,November,2019,Deschutes,OR,Passenger,3,0,3,147,150,2.0,Nearest
14431,November,2019,Oklahoma,OK,Passenger,0,1,1,126,127,0.79,Mid-Distance
14432,November,2019,Ferry,WA,Truck,0,0,0,3581,3581,0.0,Washington
14433,November,2019,Grays Harbor,WA,Passenger,99,99,198,48351,48549,0.41,Washington
14434,November,2019,Howard,MD,Passenger,0,1,1,73,74,1.35,Furthest
14435,November,2019,Franklin,WA,Truck,0,0,0,19729,19729,0.0,Washington
14436,November,2019,Penobscot,ME,Passenger,0,1,1,13,14,7.14,Furthest
14437,November,2019,Stafford,VA,Passenger,1,1,2,95,97,2.06,Furthest
14438,November,2019,DeKalb,GA,Passenger,1,0,1,81,82,1.22,Furthest
14439,November,2019,Suffolk,MA,Passenger,0,1,1,36,37,2.7,Furthest
14440,November,2019,Chelan,WA,Truck,0,0,0,22517,22517,0.0,Washington
14441,November,2019,Klamath,OR,Passenger,1,0,1,37,38,2.63,Nearest
14442,November,2019,Allegheny,PA,Passenger,1,0,1,77,78,1.28,Furthest
14443,November,2019,Putnam,TN,Passenger,0,1,1,3,4,25.0,Furthest
14444,November,2019,Calvert,MD,Passenger,0,2,2,92,94,2.13,Furthest
14445,November,2019,Albemarle,VA,Passenger,1,0,1,25,26,3.85,Furthest
14446,November,2019,Columbia,WA,Truck,0,0,0,1535,1535,0.0,Washington
14447,November,2019,Snohomish,WA,Passenger,3943,1706,5649,535420,541069,1.04,Washington
14448,November,2019,Valencia,NM,Passenger,1,0,1,5,6,16.67,Mid-Distance
14449,November,2019,Okanogan,WA,Truck,0,0,0,16557,16557,0.0,Washington
14450,November,2019,New London,CT,Passenger,0,2,2,244,246,0.81,Furthest
14451,November,2019,Adams,WA,Truck,0,0,0,5184,5184,0.0,Washington
14452,November,2019,Guadalupe,TX,Passenger,1,0,1,67,68,1.47,Mid-Distance
14453,November,2019,Collin,TX,Passenger,1,1,2,130,132,1.52,Mid-Distance
14454,November,2019,Clallam,WA,Truck,1,0,1,21847,21848,0.0,Washington
14455,November,2019,Pierce,WA,Truck,0,0,0,140707,140707,0.0,Washington
14456,November,2019,Kent,MI,Passenger,0,1,1,24,25,4.0,Furthest
14457,November,2019,Clay,FL,Passenger,0,1,1,87,88,1.14,Furthest
14458,November,2019,Rogers,OK,Passenger,1,0,1,5,6,16.67,Mid-Distance
14459,November,2019,Twin Falls,ID,Passenger,0,1,1,28,29,3.45,Nearest
14460,November,2019,El Paso,CO,Passenger,2,1,3,740,743,0.4,Mid-Distance
14461,November,2019,Virginia Beach,VA,Passenger,1,0,1,701,702,0.14,Furthest
14462,November,2019,Randolph,NC,Passenger,1,0,1,7,8,12.5,Furthest
14463,November,2019,Nueces,TX,Passenger,1,1,2,88,90,2.22,Mid-Distance
14464,November,2019,Boulder,CO,Passenger,0,1,1,50,51,1.96,Mid-Distance
14465,November,2019,Yakima,WA,Passenger,117,116,233,166000,166233,0.14,Washington
14466,November,2019,Carroll,NH,Passenger,0,1,1,3,4,25.0,Furthest
14467,November,2019,Klickitat,WA,Truck,0,0,0,8306,8306,0.0,Washington
14468,November,2019,Lee,FL,Passenger,1,0,1,53,54,1.85,Furthest
14469,November,2019,Shelby,TN,Passenger,0,1,1,96,97,1.03,Furthest
14470,November,2019,Mason,WA,Truck,0,0,0,20508,20508,0.0,Washington
14471,November,2019,Santa Clara,CA,Passenger,6,2,8,360,368,2.17,Nearest
14472,November,2019,Prince William,VA,Passenger,1,3,4,232,236,1.69,Furthest
14473,November,2020,St. Mary's,MD,Passenger,1,0,1,215,216,0.46,Furthest
14474,November,2020,Palm Beach,FL,Passenger,0,1,1,73,74,1.35,Furthest
14475,November,2020,Prince William,VA,Passenger,2,2,4,220,224,1.79,Furthest
14476,November,2020,Adams,WA,Passenger,10,6,16,12942,12958,0.12,Washington
14477,November,2020,Walla Walla,WA,Passenger,95,66,161,36066,36227,0.44,Washington
14478,November,2020,Riverside,CA,Passenger,4,1,5,598,603,0.83,Nearest
14479,November,2020,Loudoun,VA,Passenger,1,0,1,77,78,1.28,Furthest
14480,November,2020,Pend Oreille,WA,Truck,0,0,0,5718,5718,0.0,Washington
14481,November,2020,Santa Cruz,CA,Passenger,1,0,1,29,30,3.33,Nearest
14482,November,2020,Skamania,WA,Passenger,33,21,54,8305,8359,0.65,Washington
14483,November,2020,San Juan,WA,Truck,0,0,0,5866,5866,0.0,Washington
14484,November,2020,Cascade,MT,Passenger,0,1,1,52,53,1.89,Nearest
14485,November,2020,Clallam,WA,Passenger,262,176,438,49872,50310,0.87,Washington
14486,November,2020,Williamson,TX,Passenger,0,2,2,122,124,1.61,Mid-Distance
14487,November,2020,Cape May,NJ,Passenger,0,1,1,10,11,9.09,Furthest
14488,November,2020,Erie,NY,Passenger,1,0,1,44,45,2.22,Furthest
14489,November,2020,Goochland,VA,Passenger,4,2,6,243,249,2.41,Furthest
14490,November,2020,Fresno,CA,Passenger,1,0,1,169,170,0.59,Nearest
14491,November,2020,Ulster,NY,Passenger,1,0,1,8,9,11.11,Furthest
14492,November,2020,Frederick,MD,Passenger,1,1,2,73,75,2.67,Furthest
14493,November,2020,El Dorado,CA,Passenger,1,0,1,33,34,2.94,Nearest
14494,November,2020,Maricopa,AZ,Passenger,5,6,11,1316,1327,0.83,Nearest
14495,November,2020,Manassas,VA,Passenger,0,1,1,5,6,16.67,Furthest
14496,November,2020,Bradley,TN,Passenger,1,0,1,0,1,100.0,Furthest
14497,November,2020,DuPage,IL,Passenger,3,0,3,53,56,5.36,Mid-Distance
14498,November,2020,Pierce,WA,Passenger,2759,1756,4515,554918,559433,0.81,Washington
14499,November,2020,Whitman,WA,Passenger,51,44,95,21963,22058,0.43,Washington
14500,November,2020,Lewis,WA,Truck,0,0,0,26547,26547,0.0,Washington
14501,November,2020,Hawaii,HI,Passenger,1,0,1,52,53,1.89,Nearest
14502,November,2020,Saginaw,MI,Passenger,1,0,1,9,10,10.0,Furthest
14503,November,2020,Cowlitz,WA,Truck,0,0,0,28871,28871,0.0,Washington
14504,November,2020,Yakima,WA,Passenger,166,122,288,167009,167297,0.17,Washington
14505,November,2020,Adams,WA,Truck,0,0,0,5325,5325,0.0,Washington
14506,November,2020,Mason,WA,Truck,0,0,0,20860,20860,0.0,Washington
14507,November,2020,Missoula,MT,Passenger,1,0,1,63,64,1.56,Nearest
14508,November,2020,Mason,WA,Passenger,169,135,304,47500,47804,0.64,Washington
14509,November,2020,Richland,SC,Passenger,0,1,1,139,140,0.71,Furthest
14510,November,2020,Skagit,WA,Truck,1,0,1,32715,32716,0.0,Washington
14511,November,2020,Camden,NJ,Passenger,0,1,1,22,23,4.35,Furthest
14512,November,2020,Orange,FL,Passenger,1,0,1,115,116,0.86,Furthest
14513,November,2020,King,WA,Truck,6,1,7,184180,184187,0.0,Washington
14514,November,2020,Asotin,WA,Truck,0,0,0,6665,6665,0.0,Washington
14515,November,2020,Harris,TX,Passenger,1,0,1,215,216,0.46,Mid-Distance
14516,November,2020,Pacific,WA,Passenger,36,34,70,15737,15807,0.44,Washington
14517,November,2020,Anne Arundel,MD,Passenger,1,1,2,399,401,0.5,Furthest
14518,November,2020,Montgomery,TX,Passenger,1,0,1,47,48,2.08,Mid-Distance
14519,November,2020,Kings,NY,Passenger,1,0,1,63,64,1.56,Furthest
14520,November,2020,Hudson,NJ,Passenger,1,0,1,38,39,2.56,Furthest
14521,November,2020,Spokane,WA,Passenger,859,542,1401,320275,321676,0.44,Washington
14522,November,2020,Nassau,NY,Passenger,4,0,4,28,32,12.5,Furthest
14523,November,2020,Stevens,WA,Passenger,36,39,75,30275,30350,0.25,Washington
14524,November,2020,Fulton,GA,Passenger,1,2,3,89,92,3.26,Furthest
14525,November,2020,Garfield,WA,Truck,0,0,0,997,997,0.0,Washington
14526,November,2020,Suffolk,VA,Passenger,1,0,1,125,126,0.79,Furthest
14527,November,2020,Okaloosa,FL,Passenger,0,1,1,133,134,0.75,Furthest
14528,November,2020,Jones,GA,Passenger,1,0,1,1,2,50.0,Furthest
14529,November,2020,Thurston,WA,Passenger,1290,763,2053,197232,199285,1.03,Washington
14530,November,2020,Moore,NC,Passenger,0,1,1,152,153,0.65,Furthest
14531,November,2020,Randolph,NC,Passenger,1,0,1,6,7,14.29,Furthest
14532,November,2020,Jefferson,WA,Passenger,276,153,429,24728,25157,1.71,Washington
14533,November,2020,Williams,ND,Passenger,0,1,1,10,11,9.09,Mid-Distance
14534,November,2020,Columbia,WA,Truck,0,0,0,1530,1530,0.0,Washington
14535,November,2020,Kittitas,WA,Truck,0,0,0,14645,14645,0.0,Washington
14536,November,2020,Carroll,MD,Passenger,0,1,1,21,22,4.55,Furthest
14537,November,2020,Suffolk,MA,Passenger,0,2,2,33,35,5.71,Furthest
14538,November,2020,Twin Falls,ID,Passenger,0,1,1,24,25,4.0,Nearest
14539,November,2020,Bexar,TX,Passenger,4,5,9,567,576,1.56,Mid-Distance
14540,November,2020,Okanogan,WA,Passenger,51,37,88,25984,26072,0.34,Washington
14541,November,2020,San Mateo,CA,Passenger,1,1,2,108,110,1.82,Nearest
14542,November,2020,St. Clair,IL,Passenger,1,0,1,138,139,0.72,Mid-Distance
14543,November,2020,Platte,MO,Passenger,1,0,1,17,18,5.56,Furthest
14544,November,2020,Pinellas,FL,Passenger,1,1,2,98,100,2.0,Furthest
14545,November,2020,Asotin,WA,Passenger,17,14,31,12411,12442,0.25,Washington
14546,November,2020,Jefferson,NY,Passenger,0,1,1,209,210,0.48,Furthest
14547,November,2020,Howard,MD,Passenger,0,1,1,62,63,1.59,Furthest
14548,November,2020,Lake,FL,Passenger,1,0,1,22,23,4.35,Furthest
14549,November,2020,Arapahoe,CO,Passenger,1,0,1,121,122,0.82,Mid-Distance
14550,November,2020,Gwinnett,GA,Passenger,1,0,1,69,70,1.43,Furthest
14551,November,2020,Washtenaw,MI,Passenger,1,0,1,31,32,3.12,Furthest
14552,November,2020,Clark,WA,Passenger,2284,1140,3424,318828,322252,1.06,Washington
14553,November,2020,Snohomish,WA,Passenger,4956,1823,6779,538061,544840,1.24,Washington
14554,November,2020,Orange,CA,Passenger,4,3,7,451,458,1.53,Nearest
14555,November,2020,San Juan,WA,Passenger,355,106,461,14017,14478,3.18,Washington
14556,November,2020,Prince George's,MD,Passenger,2,1,3,148,151,1.99,Furthest
14557,November,2020,Kern,CA,Passenger,0,1,1,216,217,0.46,Nearest
14558,November,2020,Spartanburg,SC,Passenger,0,1,1,48,49,2.04,Furthest
14559,November,2020,Benton,WA,Passenger,426,348,774,134791,135565,0.57,Washington
14560,November,2020,El Paso,TX,Passenger,3,0,3,400,403,0.74,Mid-Distance
14561,November,2020,Deschutes,OR,Passenger,1,0,1,122,123,0.81,Nearest
14562,November,2020,Rockingham,NH,Passenger,1,0,1,22,23,4.35,Furthest
14563,November,2020,Anchorage,AK,Passenger,1,0,1,143,144,0.69,Nearest
14564,November,2020,Placer,CA,Passenger,2,0,2,85,87,2.3,Nearest
14565,November,2020,Pima,AZ,Passenger,3,1,4,324,328,1.22,Nearest
14566,November,2020,San Diego,CA,Passenger,14,4,18,2711,2729,0.66,Nearest
14567,November,2020,Klickitat,WA,Truck,0,0,0,8086,8086,0.0,Washington
14568,November,2020,Santa Clara,CA,Passenger,6,2,8,270,278,2.88,Nearest
14569,November,2020,Ventura,CA,Passenger,1,1,2,269,271,0.74,Nearest
14570,November,2020,San Joaquin,CA,Passenger,1,0,1,110,111,0.9,Nearest
14571,November,2020,Wichita,TX,Passenger,1,0,1,41,42,2.38,Mid-Distance
14572,November,2020,Arlington,VA,Passenger,0,2,2,143,145,1.38,Furthest
14573,November,2020,Island,WA,Passenger,480,287,767,62942,63709,1.2,Washington
14574,November,2020,Larimer,CO,Passenger,1,0,1,53,54,1.85,Mid-Distance
14575,November,2020,Stevens,WA,Truck,0,0,0,18671,18671,0.0,Washington
14576,November,2020,Albemarle,VA,Passenger,1,0,1,21,22,4.55,Furthest
14577,November,2020,Ada,ID,Passenger,0,1,1,245,246,0.41,Nearest
14578,November,2020,Oldham,KY,Passenger,0,1,1,4,5,20.0,Furthest
14579,November,2020,Harrison,MS,Passenger,1,0,1,53,54,1.85,Mid-Distance
14580,November,2020,Norfolk,VA,Passenger,2,3,5,341,346,1.45,Furthest
14581,November,2020,Douglas,WA,Passenger,82,43,125,28127,28252,0.44,Washington
14582,November,2020,Whatcom,WA,Truck,3,0,3,43487,43490,0.01,Washington
14583,November,2020,Houston,GA,Passenger,1,0,1,52,53,1.89,Furthest
14584,November,2020,New Haven,CT,Passenger,0,2,2,35,37,5.41,Furthest
14585,November,2020,Plaquemines,LA,Passenger,0,1,1,13,14,7.14,Mid-Distance
14586,November,2020,Bartow,GA,Passenger,0,1,1,4,5,20.0,Furthest
14587,November,2020,Klickitat,WA,Passenger,62,42,104,14976,15080,0.69,Washington
14588,November,2020,Monroe,IL,Passenger,1,0,1,3,4,25.0,Mid-Distance
14589,November,2020,Dakota,MN,Passenger,0,1,1,28,29,3.45,Mid-Distance
14590,November,2020,Shelby,OH,Passenger,0,1,1,1,2,50.0,Furthest
14591,November,2020,Wahkiakum,WA,Truck,0,0,0,1766,1766,0.0,Washington
14592,November,2020,Lee,FL,Passenger,1,0,1,45,46,2.17,Furthest
14593,November,2020,Skagit,WA,Passenger,481,235,716,91415,92131,0.78,Washington
14594,November,2020,Queens,NY,Passenger,1,0,1,52,53,1.89,Furthest
14595,November,2020,San Francisco,CA,Passenger,1,1,2,89,91,2.2,Nearest
14596,November,2020,St. Louis,MO,Passenger,1,0,1,95,96,1.04,Furthest
14597,November,2020,Douglas,NE,Passenger,0,1,1,48,49,2.04,Mid-Distance
14598,November,2020,DeKalb,IN,Passenger,1,0,1,0,1,100.0,Furthest
14599,November,2020,Snohomish,WA,Truck,0,0,0,125469,125469,0.0,Washington
14600,November,2020,Grant,WA,Passenger,78,79,157,65766,65923,0.24,Washington
14601,November,2020,New London,CT,Passenger,1,2,3,237,240,1.25,Furthest
14602,November,2020,Chelan,WA,Truck,0,0,0,22778,22778,0.0,Washington
14603,November,2020,Clark,WA,Truck,0,0,0,83228,83228,0.0,Washington
14604,November,2020,Hamilton,IN,Passenger,2,0,2,34,36,5.56,Furthest
14605,November,2020,Nassau,FL,Passenger,1,0,1,36,37,2.7,Furthest
14606,November,2020,Solano,CA,Passenger,1,0,1,206,207,0.48,Nearest
14607,November,2020,Owyhee,ID,Passenger,1,0,1,3,4,25.0,Nearest
14608,November,2020,Clallam,WA,Truck,1,0,1,21782,21783,0.0,Washington
14609,November,2020,Harnett,NC,Passenger,1,0,1,187,188,0.53,Furthest
14610,November,2020,Whitman,WA,Truck,0,0,0,8487,8487,0.0,Washington
14611,November,2020,Powhatan,VA,Passenger,1,0,1,0,1,100.0,Furthest
14612,November,2020,Kent,MI,Passenger,0,1,1,24,25,4.0,Furthest
14613,November,2020,Lewis,WA,Passenger,117,117,234,58633,58867,0.4,Washington
14614,November,2020,Cowlitz,WA,Passenger,170,124,294,72016,72310,0.41,Washington
14615,November,2020,Jefferson,WA,Truck,0,0,0,9582,9582,0.0,Washington
14616,November,2020,District of Columbia,DC,Passenger,3,1,4,199,203,1.97,Furthest
14617,November,2020,Charleston,SC,Passenger,2,0,2,91,93,2.15,Furthest
14618,November,2020,Vigo,IN,Passenger,1,0,1,6,7,14.29,Furthest
14619,November,2020,Polk,FL,Passenger,1,0,1,58,59,1.69,Furthest
14620,November,2020,Maui,HI,Passenger,1,0,1,28,29,3.45,Nearest
14621,November,2020,Bucks,PA,Passenger,1,0,1,18,19,5.26,Furthest
14622,November,2020,Grays Harbor,WA,Passenger,122,117,239,48546,48785,0.49,Washington
14623,November,2020,Boulder,CO,Passenger,0,1,1,44,45,2.22,Mid-Distance
14624,November,2020,Franklin,WA,Truck,0,0,0,20378,20378,0.0,Washington
14625,November,2020,Alexandria,VA,Passenger,2,0,2,134,136,1.47,Furthest
14626,November,2020,Broward,FL,Passenger,2,1,3,109,112,2.68,Furthest
14627,November,2020,Stafford,VA,Passenger,1,1,2,93,95,2.11,Furthest
14628,November,2020,Nueces,TX,Passenger,1,0,1,83,84,1.19,Mid-Distance
14629,November,2020,Walla Walla,WA,Truck,0,0,0,13819,13819,0.0,Washington
14630,November,2020,Kauai,HI,Passenger,1,0,1,15,16,6.25,Nearest
14631,November,2020,Dallas,TX,Passenger,1,0,1,174,175,0.57,Mid-Distance
14632,November,2020,Collin,TX,Passenger,1,1,2,117,119,1.68,Mid-Distance
14633,November,2020,Washington,OR,Passenger,1,0,1,416,417,0.24,Nearest
14634,November,2020,Ferry,WA,Passenger,8,3,11,4347,4358,0.25,Washington
14635,November,2020,Calvert,MD,Passenger,0,2,2,85,87,2.3,Furthest
14636,November,2020,Tulsa,OK,Passenger,1,1,2,39,41,4.88,Mid-Distance
14637,November,2020,Pierce,WA,Truck,0,0,0,144543,144543,0.0,Washington
14638,November,2020,Richmond,GA,Passenger,0,1,1,79,80,1.25,Furthest
14639,November,2020,Alameda,CA,Passenger,3,0,3,259,262,1.15,Nearest
14640,November,2020,Montgomery,OH,Passenger,0,1,1,52,53,1.89,Furthest
14641,November,2020,Penobscot,ME,Passenger,0,1,1,10,11,9.09,Furthest
14642,November,2020,Leavenworth,KS,Passenger,0,1,1,125,126,0.79,Mid-Distance
14643,November,2020,Pacific,WA,Truck,0,0,0,7762,7762,0.0,Washington
14644,November,2020,Okanogan,WA,Truck,0,0,0,16579,16579,0.0,Washington
14645,November,2020,Charles,MD,Passenger,1,1,2,73,75,2.67,Furthest
14646,November,2020,Whatcom,WA,Passenger,1203,534,1737,149736,151473,1.15,Washington
14647,November,2020,Klamath,OR,Passenger,1,0,1,31,32,3.12,Nearest
14648,November,2020,Sumter,FL,Passenger,0,1,1,10,11,9.09,Furthest
14649,November,2020,Douglas,CO,Passenger,0,1,1,78,79,1.27,Mid-Distance
14650,November,2020,Kittitas,WA,Passenger,125,52,177,29743,29920,0.59,Washington
14651,November,2020,Benton,WA,Truck,0,0,0,43111,43111,0.0,Washington
14652,November,2020,Honolulu,HI,Passenger,5,2,7,429,436,1.61,Nearest
14653,November,2020,Kitsap,WA,Passenger,1521,737,2258,179773,182031,1.24,Washington
14654,November,2020,Denton,TX,Passenger,1,0,1,85,86,1.16,Mid-Distance
14655,November,2020,Flathead,MT,Passenger,1,0,1,53,54,1.85,Nearest
14656,November,2020,Yakima,WA,Truck,0,0,0,60772,60772,0.0,Washington
14657,November,2020,DeKalb,GA,Passenger,1,0,1,71,72,1.39,Furthest
14658,November,2020,Carson City,NV,Passenger,1,0,1,12,13,7.69,Nearest
14659,November,2020,Ramsey,MN,Passenger,1,0,1,34,35,2.86,Mid-Distance
14660,November,2020,Middlesex,MA,Passenger,1,1,2,91,93,2.15,Furthest
14661,November,2020,Island,WA,Truck,0,0,0,21304,21304,0.0,Washington
14662,November,2020,Putnam,TN,Passenger,0,1,1,2,3,33.33,Furthest
14663,November,2020,Sacramento,CA,Passenger,2,0,2,242,244,0.82,Nearest
14664,November,2020,Garfield,WA,Passenger,0,1,1,1363,1364,0.07,Washington
14665,November,2020,Hampshire,MA,Passenger,1,0,1,6,7,14.29,Furthest
14666,November,2020,Chesapeake,VA,Passenger,0,3,3,405,408,0.74,Furthest
14667,November,2020,Lincoln,WA,Truck,0,0,0,4660,4660,0.0,Washington
14668,November,2020,Spokane,WA,Truck,0,0,0,100377,100377,0.0,Washington
14669,November,2020,Clark,NV,Passenger,3,2,5,653,658,0.76,Nearest
14670,November,2020,Skamania,WA,Truck,0,0,0,4008,4008,0.0,Washington
14671,November,2020,Sarasota,FL,Passenger,2,0,2,26,28,7.14,Furthest
14672,November,2020,Pend Oreille,WA,Passenger,9,4,13,9146,9159,0.14,Washington
14673,November,2020,Wilson,TX,Passenger,0,1,1,5,6,16.67,Mid-Distance
14674,November,2020,Morris,NJ,Passenger,1,0,1,17,18,5.56,Furthest
14675,November,2020,Juneau,AK,Passenger,0,1,1,26,27,3.7,Nearest
14676,November,2020,Contra Costa,CA,Passenger,4,3,7,284,291,2.41,Nearest
14677,November,2020,Portsmouth,VA,Passenger,0,1,1,76,77,1.3,Furthest
14678,November,2020,Washoe,NV,Passenger,1,0,1,103,104,0.96,Nearest
14679,November,2020,Fairfax,VA,Passenger,4,3,7,710,717,0.98,Furthest
14680,November,2020,RÃ­o Grande,PR,Passenger,1,0,1,1,2,50.0,Mid-Distance
14681,November,2020,Rogers,OK,Passenger,1,0,1,4,5,20.0,Mid-Distance
14682,November,2020,Los Angeles,CA,Passenger,9,10,19,957,976,1.95,Nearest
14683,November,2020,Virginia Beach,VA,Passenger,1,0,1,643,644,0.16,Furthest
14684,November,2020,Lincoln,WA,Passenger,5,11,16,7617,7633,0.21,Washington
14685,November,2020,Greene,MO,Passenger,0,1,1,32,33,3.03,Furthest
14686,November,2020,Grays Harbor,WA,Truck,0,0,0,21133,21133,0.0,Washington
14687,November,2020,Columbia,WA,Passenger,4,3,7,2439,2446,0.29,Washington
14689,November,2020,Sedgwick,KS,Passenger,1,1,2,89,91,2.2,Mid-Distance
14690,November,2020,Cumberland,NC,Passenger,0,3,3,447,450,0.67,Furthest
14691,November,2020,Carroll,NH,Passenger,0,1,1,5,6,16.67,Furthest
14692,November,2020,Franklin,WA,Passenger,78,80,158,61166,61324,0.26,Washington
14693,November,2020,Kitsap,WA,Truck,0,0,0,54292,54292,0.0,Washington
14694,November,2020,Allegheny,PA,Passenger,1,1,2,66,68,2.94,Furthest
14695,November,2020,Miami-Dade,FL,Passenger,1,0,1,101,102,0.98,Furthest
14696,November,2020,Utah,UT,Passenger,0,1,1,128,129,0.78,Nearest
14697,November,2020,Grant,WA,Truck,0,0,0,27418,27418,0.0,Washington
14698,November,2020,Travis,TX,Passenger,2,0,2,170,172,1.16,Mid-Distance
14699,November,2020,Montgomery,AL,Passenger,0,1,1,40,41,2.44,Furthest
14700,November,2020,Monterey,CA,Passenger,0,1,1,155,156,0.64,Nearest
14701,November,2020,Fairbanks North Star,AK,Passenger,0,1,1,92,93,1.08,Nearest
14702,November,2020,Thurston,WA,Truck,0,0,0,56280,56280,0.0,Washington
14703,November,2020,Montgomery,PA,Passenger,1,0,1,24,25,4.0,Furthest
14704,November,2020,Clackamas,OR,Passenger,2,0,2,179,181,1.1,Nearest
14705,November,2020,Salt Lake,UT,Passenger,0,1,1,172,173,0.58,Nearest
14706,November,2020,Fort Bend,TX,Passenger,1,0,1,42,43,2.33,Mid-Distance
14707,November,2020,Ferry,WA,Truck,0,0,0,3598,3598,0.0,Washington
14708,November,2020,El Paso,CO,Passenger,2,0,2,699,701,0.29,Mid-Distance
14709,November,2020,Wahkiakum,WA,Passenger,6,6,12,3039,3051,0.39,Washington
14710,November,2020,Multnomah,OR,Passenger,3,6,9,690,699,1.29,Nearest
14711,November,2020,New York,NY,Passenger,1,0,1,54,55,1.82,Furthest
14712,November,2020,Hennepin,MN,Passenger,2,0,2,83,85,2.35,Mid-Distance
14713,November,2020,King,WA,Passenger,26599,8083,34682,1371168,1405850,2.47,Washington
14714,November,2020,Howard,IN,Passenger,0,1,1,3,4,25.0,Furthest
14715,November,2020,Chelan,WA,Passenger,271,84,355,54377,54732,0.65,Washington
14716,November,2020,Denver,CO,Passenger,1,0,1,114,115,0.87,Mid-Distance
14717,November,2020,Douglas,WA,Truck,0,0,0,12451,12451,0.0,Washington
14718,November,2020,Lake,IL,Passenger,2,0,2,158,160,1.25,Mid-Distance
14719,November,2020,Boone,MO,Passenger,0,1,1,10,11,9.09,Furthest
14720,November,2020,Duval,FL,Passenger,0,2,2,354,356,0.56,Furthest
14721,November,2021,Whitman,WA,Passenger,66,58,124,21959,22083,0.56,Washington
14722,November,2021,Klamath,OR,Passenger,1,0,1,28,29,3.45,Nearest
14723,November,2021,Nassau,NY,Passenger,2,0,2,24,26,7.69,Furthest
14724,November,2021,Penobscot,ME,Passenger,0,1,1,8,9,11.11,Furthest
14725,November,2021,Douglas,CO,Passenger,0,1,1,76,77,1.3,Mid-Distance
14726,November,2021,Orange,CA,Passenger,5,2,7,384,391,1.79,Nearest
14727,November,2021,Platte,MO,Passenger,1,0,1,17,18,5.56,Furthest
14728,November,2021,Kauai,HI,Passenger,1,0,1,17,18,5.56,Nearest
14729,November,2021,Spokane,WA,Passenger,1262,748,2010,327064,329074,0.61,Washington
14730,November,2021,Middlesex,MA,Passenger,1,1,2,84,86,2.33,Furthest
14731,November,2021,Suffolk,MA,Passenger,0,2,2,26,28,7.14,Furthest
14732,November,2021,Sevier,AR,Passenger,0,1,1,0,1,100.0,Mid-Distance
14733,November,2021,Douglas,WA,Passenger,106,53,159,28610,28769,0.55,Washington
14734,November,2021,Harrison,MS,Passenger,2,0,2,46,48,4.17,Mid-Distance
14735,November,2021,Geary,KS,Passenger,1,0,1,96,97,1.03,Mid-Distance
14736,November,2021,Orange,FL,Passenger,1,0,1,104,105,0.95,Furthest
14737,November,2021,Lake,IL,Passenger,3,0,3,152,155,1.94,Mid-Distance
14738,November,2021,Benton,WA,Truck,0,0,0,43650,43650,0.0,Washington
14739,November,2021,Riverside,CA,Passenger,5,1,6,502,508,1.18,Nearest
14740,November,2021,Hudson,NJ,Passenger,1,0,1,40,41,2.44,Furthest
14741,November,2021,Stafford,VA,Passenger,2,1,3,95,98,3.06,Furthest
14742,November,2021,Mason,WA,Passenger,255,158,413,47799,48212,0.86,Washington
14743,November,2021,Lane,OR,Passenger,0,1,1,109,110,0.91,Nearest
14744,November,2021,Wilson,NC,Passenger,1,0,1,0,1,100.0,Furthest
14745,November,2021,Benton,WA,Passenger,625,435,1060,136011,137071,0.77,Washington
14746,November,2021,Honolulu,HI,Passenger,4,3,7,356,363,1.93,Nearest
14747,November,2021,Salt Lake,UT,Passenger,0,1,1,155,156,0.64,Nearest
14748,November,2021,Vigo,IN,Passenger,1,0,1,5,6,16.67,Furthest
14749,November,2021,Santa Cruz,CA,Passenger,1,0,1,22,23,4.35,Nearest
14750,November,2021,Baltimore,MD,Passenger,1,0,1,83,84,1.19,Furthest
14751,November,2021,Travis,TX,Passenger,3,3,6,129,135,4.44,Mid-Distance
14752,November,2021,Powhatan,VA,Passenger,1,0,1,1,2,50.0,Furthest
14753,November,2021,El Paso,CO,Passenger,3,0,3,653,656,0.46,Mid-Distance
14754,November,2021,Sonoma,CA,Passenger,0,1,1,82,83,1.2,Nearest
14755,November,2021,Pennington,SD,Passenger,1,0,1,31,32,3.12,Mid-Distance
14756,November,2021,Champaign,IL,Passenger,1,0,1,9,10,10.0,Mid-Distance
14757,November,2021,Snohomish,WA,Truck,2,0,2,125685,125687,0.0,Washington
14758,November,2021,Fort Bend,TX,Passenger,1,0,1,35,36,2.78,Mid-Distance
14759,November,2021,Cook,IL,Passenger,2,0,2,192,194,1.03,Mid-Distance
14760,November,2021,Pend Oreille,WA,Truck,0,0,0,5696,5696,0.0,Washington
14761,November,2021,Sarpy,NE,Passenger,1,0,1,58,59,1.69,Mid-Distance
14762,November,2021,Coryell,TX,Passenger,1,0,1,106,107,0.93,Mid-Distance
14763,November,2021,Wahkiakum,WA,Truck,0,0,0,1817,1817,0.0,Washington
14764,November,2021,Alexandria,VA,Passenger,2,0,2,118,120,1.67,Furthest
14765,November,2021,Stevens,WA,Passenger,54,43,97,30313,30410,0.32,Washington
14766,November,2021,New Haven,CT,Passenger,0,2,2,27,29,6.9,Furthest
14767,November,2021,Suffolk,VA,Passenger,1,0,1,122,123,0.81,Furthest
14768,November,2021,Skamania,WA,Passenger,57,40,97,8344,8441,1.15,Washington
14769,November,2021,San Juan,WA,Passenger,473,147,620,14195,14815,4.18,Washington
14770,November,2021,Klickitat,WA,Truck,0,0,0,8335,8335,0.0,Washington
14771,November,2021,Larimer,CO,Passenger,1,0,1,50,51,1.96,Mid-Distance
14772,November,2021,Yakima,WA,Truck,0,0,0,61715,61715,0.0,Washington
14773,November,2021,Yakima,WA,Passenger,272,167,439,168647,169086,0.26,Washington
14774,November,2021,Island,WA,Passenger,701,342,1043,62971,64014,1.63,Washington
14775,November,2021,Virginia Beach,VA,Passenger,2,0,2,569,571,0.35,Furthest
14776,November,2021,Harris,TX,Passenger,1,1,2,168,170,1.18,Mid-Distance
14777,November,2021,San Mateo,CA,Passenger,2,0,2,79,81,2.47,Nearest
14778,November,2021,Kings,NY,Passenger,1,0,1,66,67,1.49,Furthest
14779,November,2021,Grant,WA,Passenger,131,97,228,66942,67170,0.34,Washington
14780,November,2021,Miami-Dade,FL,Passenger,1,0,1,89,90,1.11,Furthest
14781,November,2021,Harnett,NC,Passenger,1,1,2,151,153,1.31,Furthest
14782,November,2021,Washington,MD,Passenger,2,0,2,14,16,12.5,Furthest
14783,November,2021,Columbia,WA,Passenger,6,2,8,2459,2467,0.32,Washington
14784,November,2021,Collin,TX,Passenger,1,0,1,101,102,0.98,Mid-Distance
14785,November,2021,Skagit,WA,Truck,1,0,1,32804,32805,0.0,Washington
14786,November,2021,Kitsap,WA,Passenger,2083,941,3024,180487,183511,1.65,Washington
14787,November,2021,Philadelphia,PA,Passenger,1,0,1,38,39,2.56,Furthest
14788,November,2021,Columbia,WA,Truck,0,0,0,1552,1552,0.0,Washington
14789,November,2021,Kings,CA,Passenger,2,0,2,322,324,0.62,Nearest
14790,November,2021,St. Clair,IL,Passenger,2,0,2,120,122,1.64,Mid-Distance
14791,November,2021,Jefferson,WA,Passenger,372,195,567,24790,25357,2.24,Washington
14792,November,2021,Louisa,VA,Passenger,0,1,1,1,2,50.0,Furthest
14793,November,2021,Ferry,WA,Truck,0,0,0,3600,3600,0.0,Washington
14794,November,2021,San Joaquin,CA,Passenger,1,1,2,95,97,2.06,Nearest
14795,November,2021,Flathead,MT,Passenger,1,0,1,40,41,2.44,Nearest
14796,November,2021,Rogers,OK,Passenger,1,0,1,3,4,25.0,Mid-Distance
14797,November,2021,Jefferson,NY,Passenger,0,1,1,202,203,0.49,Furthest
14798,November,2021,San Francisco,CA,Passenger,0,1,1,80,81,1.23,Nearest
14799,November,2021,Lee,FL,Passenger,1,0,1,29,30,3.33,Furthest
14800,November,2021,DuPage,IL,Passenger,1,0,1,49,50,2.0,Mid-Distance
14801,November,2021,Portsmouth,VA,Passenger,0,1,1,77,78,1.28,Furthest
14802,November,2021,Skamania,WA,Truck,0,0,0,4003,4003,0.0,Washington
14803,November,2021,Dallas,TX,Passenger,1,0,1,143,144,0.69,Mid-Distance
14804,November,2021,King,WA,Passenger,34716,10089,44805,1362899,1407704,3.18,Washington
14805,November,2021,New London,CT,Passenger,1,4,5,212,217,2.3,Furthest
14806,November,2021,Goochland,VA,Passenger,3,2,5,187,192,2.6,Furthest
14807,November,2021,Fairbanks North Star,AK,Passenger,0,1,1,76,77,1.3,Nearest
14808,November,2021,Thurston,WA,Passenger,1845,949,2794,197125,199919,1.4,Washington
14809,November,2021,Douglas,NE,Passenger,1,1,2,46,48,4.17,Mid-Distance
14810,November,2021,Okanogan,WA,Truck,0,0,0,16689,16689,0.0,Washington
14811,November,2021,San Diego,CA,Passenger,16,8,24,2436,2460,0.98,Nearest
14812,November,2021,Contra Costa,CA,Passenger,1,4,5,262,267,1.87,Nearest
14813,November,2021,Las Animas,CO,Passenger,1,0,1,0,1,100.0,Mid-Distance
14814,November,2021,Whatcom,WA,Passenger,1611,660,2271,150227,152498,1.49,Washington
14815,November,2021,Cumberland,NC,Passenger,1,2,3,395,398,0.75,Furthest
14816,November,2021,Boone,MO,Passenger,0,1,1,9,10,10.0,Furthest
14817,November,2021,San Juan,WA,Truck,0,0,0,5996,5996,0.0,Washington
14819,November,2021,Milwaukee,WI,Passenger,1,0,1,36,37,2.7,Mid-Distance
14820,November,2021,Pacific,WA,Truck,0,0,0,8004,8004,0.0,Washington
14821,November,2021,Hillsborough,FL,Passenger,0,1,1,138,139,0.72,Furthest
14822,November,2021,Plaquemines,LA,Passenger,0,1,1,17,18,5.56,Mid-Distance
14823,November,2021,Bexar,TX,Passenger,3,4,7,484,491,1.43,Mid-Distance
14824,November,2021,Loudoun,VA,Passenger,1,0,1,66,67,1.49,Furthest
14825,November,2021,Erie,NY,Passenger,1,0,1,31,32,3.12,Furthest
14826,November,2021,Pinellas,FL,Passenger,0,1,1,87,88,1.14,Furthest
14827,November,2021,Kern,CA,Passenger,0,1,1,199,200,0.5,Nearest
14828,November,2021,Pierce,WA,Passenger,4130,2111,6241,557334,563575,1.11,Washington
14829,November,2021,Williams,ND,Passenger,0,1,1,8,9,11.11,Mid-Distance
14830,November,2021,Sedgwick,KS,Passenger,1,1,2,81,83,2.41,Mid-Distance
14831,November,2021,Walla Walla,WA,Passenger,137,85,222,36395,36617,0.61,Washington
14832,November,2021,St. Mary's,MD,Passenger,1,0,1,202,203,0.49,Furthest
14833,November,2021,Kittitas,WA,Truck,0,0,0,14805,14805,0.0,Washington
14834,November,2021,Charleston,SC,Passenger,2,1,3,77,80,3.75,Furthest
14835,November,2021,Klickitat,WA,Passenger,88,52,140,15349,15489,0.9,Washington
14836,November,2021,Cowlitz,WA,Truck,0,1,1,29027,29028,0.0,Washington
14837,November,2021,El Paso,TX,Passenger,3,0,3,348,351,0.85,Mid-Distance
14838,November,2021,Oldham,KY,Passenger,0,1,1,4,5,20.0,Furthest
14839,November,2021,Carroll,MD,Passenger,0,1,1,16,17,5.88,Furthest
14840,November,2021,Denton,TX,Passenger,1,0,1,75,76,1.32,Mid-Distance
14841,November,2021,Broward,FL,Passenger,2,0,2,96,98,2.04,Furthest
14842,November,2021,Asotin,WA,Truck,0,0,0,6760,6760,0.0,Washington
14843,November,2021,Houston,GA,Passenger,1,0,1,43,44,2.27,Furthest
14844,November,2021,Jefferson,WA,Truck,0,0,0,9601,9601,0.0,Washington
14845,November,2021,Anne Arundel,MD,Passenger,4,3,7,357,364,1.92,Furthest
14846,November,2021,Hawaii,HI,Passenger,1,0,1,41,42,2.38,Nearest
14847,November,2021,Richmond,NY,Passenger,1,0,1,6,7,14.29,Furthest
14848,November,2021,Spartanburg,SC,Passenger,0,1,1,48,49,2.04,Furthest
14849,November,2021,Owyhee,ID,Passenger,1,0,1,2,3,33.33,Nearest
14850,November,2021,Lincoln,WA,Passenger,7,16,23,7693,7716,0.3,Washington
14851,November,2021,Asotin,WA,Passenger,21,17,38,12753,12791,0.3,Washington
14852,November,2021,Ulster,NY,Passenger,1,0,1,9,10,10.0,Furthest
14853,November,2021,Duval,FL,Passenger,0,2,2,322,324,0.62,Furthest
14854,November,2021,Fresno,CA,Passenger,1,0,1,156,157,0.64,Nearest
14855,November,2021,Sarasota,FL,Passenger,2,0,2,29,31,6.45,Furthest
14856,November,2021,Pima,AZ,Passenger,1,1,2,249,251,0.8,Nearest
14857,November,2021,Prince William,VA,Passenger,1,1,2,200,202,0.99,Furthest
14858,November,2021,Clackamas,OR,Passenger,2,0,2,162,164,1.22,Nearest
14859,November,2021,Maricopa,AZ,Passenger,8,2,10,1060,1070,0.93,Nearest
14860,November,2021,Saratoga,NY,Passenger,1,0,1,39,40,2.5,Furthest
14861,November,2021,RÃ­o Grande,PR,Passenger,1,0,1,0,1,100.0,Mid-Distance
14862,November,2021,Montgomery,TX,Passenger,1,1,2,36,38,5.26,Mid-Distance
14863,November,2021,Douglas,WA,Truck,0,0,0,12693,12693,0.0,Washington
14864,November,2021,Monterey,CA,Passenger,0,1,1,137,138,0.72,Nearest
14865,November,2021,Nueces,TX,Passenger,1,0,1,64,65,1.54,Mid-Distance
14866,November,2021,Franklin,WA,Truck,0,0,0,20782,20782,0.0,Washington
14867,November,2021,Solano,CA,Passenger,1,0,1,175,176,0.57,Nearest
14868,November,2021,Norfolk,VA,Passenger,3,3,6,307,313,1.92,Furthest
14869,November,2021,Lake,FL,Passenger,1,0,1,22,23,4.35,Furthest
14870,November,2021,Wilson,TX,Passenger,0,1,1,2,3,33.33,Mid-Distance
14871,November,2021,Sumter,SC,Passenger,0,1,1,34,35,2.86,Furthest
14872,November,2021,Garfield,WA,Truck,0,0,0,995,995,0.0,Washington
14873,November,2021,Dorchester,SC,Passenger,1,0,1,63,64,1.56,Furthest
14874,November,2021,Ventura,CA,Passenger,2,1,3,246,249,1.2,Nearest
14875,November,2021,Pend Oreille,WA,Passenger,18,7,25,9167,9192,0.27,Washington
14876,November,2021,Lewis,WA,Passenger,199,163,362,59631,59993,0.6,Washington
14877,November,2021,Multnomah,OR,Passenger,2,6,8,612,620,1.29,Nearest
14878,November,2021,St. Louis,MO,Passenger,1,0,1,71,72,1.39,Furthest
14879,November,2021,Lewis,WA,Truck,0,0,0,26719,26719,0.0,Washington
14880,November,2021,Carson City,NV,Passenger,1,0,1,8,9,11.11,Nearest
14881,November,2021,Placer,CA,Passenger,2,0,2,70,72,2.78,Nearest
14882,November,2021,Burlington,NJ,Passenger,0,1,1,120,121,0.83,Furthest
14883,November,2021,Clark,WA,Truck,0,0,0,84070,84070,0.0,Washington
14884,November,2021,Leavenworth,KS,Passenger,0,1,1,107,108,0.93,Mid-Distance
14885,November,2021,Hidalgo,TX,Passenger,0,1,1,53,54,1.85,Mid-Distance
14886,November,2021,Hamilton,IN,Passenger,2,0,2,28,30,6.67,Furthest
14887,November,2021,Albemarle,VA,Passenger,1,0,1,19,20,5.0,Furthest
14888,November,2021,Wahkiakum,WA,Passenger,17,10,27,3091,3118,0.87,Washington
14889,November,2021,Stevens,WA,Truck,0,0,0,18924,18924,0.0,Washington
14890,November,2021,Juneau,AK,Passenger,0,1,1,27,28,3.57,Nearest
14891,November,2021,Alameda,CA,Passenger,4,0,4,211,215,1.86,Nearest
14892,November,2021,Randolph,NC,Passenger,1,0,1,5,6,16.67,Furthest
14893,November,2021,Snohomish,WA,Passenger,6837,2229,9066,538413,547479,1.66,Washington
14894,November,2021,Cowlitz,WA,Passenger,265,159,424,71773,72197,0.59,Washington
14895,November,2021,Kitsap,WA,Truck,0,0,0,54275,54275,0.0,Washington
14896,November,2021,Calvert,MD,Passenger,0,2,2,82,84,2.38,Furthest
14897,November,2021,Walla Walla,WA,Truck,0,0,0,14078,14078,0.0,Washington
14898,November,2021,Rockdale,GA,Passenger,1,0,1,7,8,12.5,Furthest
14899,November,2021,San Luis Obispo,CA,Passenger,1,0,1,57,58,1.72,Nearest
14900,November,2021,Grays Harbor,WA,Truck,0,0,0,21428,21428,0.0,Washington
14901,November,2021,Montgomery,PA,Passenger,2,0,2,21,23,8.7,Furthest
14902,November,2021,Adams,WA,Truck,0,0,0,5421,5421,0.0,Washington
14903,November,2021,Hamilton,OH,Passenger,1,0,1,32,33,3.03,Furthest
14904,November,2021,Santa Clara,CA,Passenger,7,1,8,230,238,3.36,Nearest
14905,November,2021,Escambia,FL,Passenger,0,1,1,138,139,0.72,Furthest
14906,November,2021,Manassas,VA,Passenger,0,1,1,7,8,12.5,Furthest
14907,November,2021,Anchorage,AK,Passenger,1,0,1,124,125,0.8,Nearest
14908,November,2021,Whatcom,WA,Truck,4,0,4,43702,43706,0.01,Washington
14909,November,2021,Shelby,OH,Passenger,0,1,1,2,3,33.33,Furthest
14910,November,2021,District of Columbia,DC,Passenger,5,0,5,191,196,2.55,Furthest
14911,November,2021,Gwinnett,GA,Passenger,1,0,1,58,59,1.69,Furthest
14912,November,2021,Marin,CA,Passenger,0,1,1,33,34,2.94,Nearest
14913,November,2021,Thurston,WA,Truck,0,0,0,56178,56178,0.0,Washington
14914,November,2021,Clark,WA,Passenger,3363,1536,4899,320835,325734,1.5,Washington
14915,November,2021,Los Angeles,CA,Passenger,10,7,17,832,849,2.0,Nearest
14916,November,2021,Lincoln,WA,Truck,0,0,0,4811,4811,0.0,Washington
14917,November,2021,Clark,NV,Passenger,4,2,6,558,564,1.06,Nearest
14918,November,2021,Carroll,NH,Passenger,0,1,1,5,6,16.67,Furthest
14919,November,2021,DeKalb,GA,Passenger,1,0,1,56,57,1.75,Furthest
14920,November,2021,Camden,NJ,Passenger,0,1,1,14,15,6.67,Furthest
14921,November,2021,Okanogan,WA,Passenger,67,43,110,26601,26711,0.41,Washington
14922,November,2021,Clallam,WA,Passenger,372,238,610,50508,51118,1.19,Washington
14923,November,2021,Sacramento,CA,Passenger,2,0,2,216,218,0.92,Nearest
14924,November,2021,Spokane,WA,Truck,0,0,0,102699,102699,0.0,Washington
14925,November,2021,Washington,OR,Passenger,1,0,1,348,349,0.29,Nearest
14926,November,2021,Whitman,WA,Truck,0,0,0,8556,8556,0.0,Washington
14927,November,2021,Chelan,WA,Passenger,400,113,513,54703,55216,0.93,Washington
14928,November,2021,Saginaw,MI,Passenger,1,0,1,5,6,16.67,Furthest
14929,November,2021,King,WA,Truck,6,1,7,183330,183337,0.0,Washington
14930,November,2021,Polk,FL,Passenger,1,0,1,55,56,1.79,Furthest
14931,November,2021,Essex,NJ,Passenger,2,0,2,10,12,16.67,Furthest
14932,November,2021,Wood,OH,Passenger,0,1,1,5,6,16.67,Furthest
14933,November,2021,Onslow,NC,Passenger,0,1,1,169,170,0.59,Furthest
14934,November,2021,Frederick,MD,Passenger,1,1,2,69,71,2.82,Furthest
14935,November,2021,Rockingham,NH,Passenger,1,0,1,19,20,5.0,Furthest
14936,November,2021,Ray,MO,Passenger,0,1,1,1,2,50.0,Furthest
14937,November,2021,Island,WA,Truck,0,0,0,21547,21547,0.0,Washington
14938,November,2021,Richmond,GA,Passenger,0,1,1,71,72,1.39,Furthest
14939,November,2021,Adams,WA,Passenger,16,14,30,13044,13074,0.23,Washington
14940,November,2021,Franklin,WA,Passenger,154,103,257,62279,62536,0.41,Washington
14941,November,2021,Skagit,WA,Passenger,667,299,966,91301,92267,1.05,Washington
14942,November,2021,Ferry,WA,Passenger,13,3,16,4457,4473,0.36,Washington
14943,November,2021,Yamhill,OR,Passenger,1,0,1,32,33,3.03,Nearest
14944,November,2021,Bartow,GA,Passenger,0,1,1,3,4,25.0,Furthest
14945,November,2021,Grays Harbor,WA,Passenger,191,155,346,49503,49849,0.69,Washington
14946,November,2021,San Bernardino,CA,Passenger,0,1,1,363,364,0.27,Nearest
14947,November,2021,Moore,NC,Passenger,0,1,1,121,122,0.82,Furthest
14948,November,2021,Williamson,TX,Passenger,1,2,3,93,96,3.12,Mid-Distance
14949,November,2021,Howard,IN,Passenger,0,1,1,6,7,14.29,Furthest
14950,November,2021,Fairfax,VA,Passenger,3,4,7,656,663,1.06,Furthest
14951,November,2021,Allegheny,PA,Passenger,1,1,2,59,61,3.28,Furthest
14952,November,2021,Allen,IN,Passenger,1,0,1,14,15,6.67,Furthest
14953,November,2021,Tarrant,TX,Passenger,1,0,1,129,130,0.77,Mid-Distance
14954,November,2021,Danville,VA,Passenger,1,0,1,0,1,100.0,Furthest
14955,November,2021,Pierce,WA,Truck,0,0,0,145138,145138,0.0,Washington
14956,November,2021,Hennepin,MN,Passenger,3,0,3,65,68,4.41,Mid-Distance
14957,November,2021,Kittitas,WA,Passenger,196,75,271,29843,30114,0.9,Washington
14958,November,2021,Pacific,WA,Passenger,51,64,115,16071,16186,0.71,Washington
14959,November,2021,Bernalillo,NM,Passenger,1,0,1,109,110,0.91,Mid-Distance
14960,November,2021,Prince George's,MD,Passenger,2,1,3,141,144,2.08,Furthest
14961,November,2021,Clallam,WA,Truck,1,0,1,22115,22116,0.0,Washington
14962,November,2021,Mason,WA,Truck,0,0,0,21254,21254,0.0,Washington
14963,November,2021,Grant,WA,Truck,0,0,0,28045,28045,0.0,Washington
14964,November,2021,Chesapeake,VA,Passenger,2,3,5,373,378,1.32,Furthest
14965,November,2021,Arlington,VA,Passenger,1,1,2,127,129,1.55,Furthest
14966,November,2021,Charles,MD,Passenger,1,1,2,67,69,2.9,Furthest
14967,November,2021,Okaloosa,FL,Passenger,0,1,1,109,110,0.91,Furthest
14968,November,2021,New York,NY,Passenger,1,0,1,37,38,2.63,Furthest
14969,November,2021,Chelan,WA,Truck,0,0,0,23094,23094,0.0,Washington
14970,November,2021,Garfield,WA,Passenger,0,3,3,1350,1353,0.22,Washington
14971,November,2021,Montgomery,MD,Passenger,3,2,5,203,208,2.4,Furthest
14972,November,2021,Queens,NY,Passenger,1,0,1,46,47,2.13,Furthest
14973,November,2021,Howard,MD,Passenger,0,1,1,54,55,1.82,Furthest
14974,November,2021,Cape May,NJ,Passenger,0,1,1,8,9,11.11,Furthest
14975,November,2021,Wichita,TX,Passenger,1,0,1,42,43,2.33,Mid-Distance
14976,November,2021,Greene,MO,Passenger,0,1,1,25,26,3.85,Furthest
14977,November,2021,Richland,SC,Passenger,0,1,1,130,131,0.76,Furthest
14978,November,2021,Boulder,CO,Passenger,1,1,2,37,39,5.13,Mid-Distance
14979,November,2021,Wake,NC,Passenger,1,0,1,108,109,0.92,Furthest
14980,November,2022,Solano,CA,Passenger,2,0,2,146,148,1.35,Nearest
14981,November,2022,Wichita,TX,Passenger,2,0,2,36,38,5.26,Mid-Distance
14982,November,2022,Saratoga,NY,Passenger,1,0,1,36,37,2.7,Furthest
14983,November,2022,Goochland,VA,Passenger,0,1,1,71,72,1.39,Furthest
14984,November,2022,Whitman,WA,Passenger,109,65,174,21989,22163,0.79,Washington
14985,November,2022,Montgomery,PA,Passenger,1,0,1,18,19,5.26,Furthest
14986,November,2022,Grays Harbor,WA,Passenger,242,161,403,48681,49084,0.82,Washington
14987,November,2022,Essex,NJ,Passenger,2,0,2,8,10,20.0,Furthest
14988,November,2022,Hidalgo,TX,Passenger,0,1,1,48,49,2.04,Mid-Distance
14989,November,2022,Prince George's,MD,Passenger,3,1,4,111,115,3.48,Furthest
14990,November,2022,Whatcom,WA,Passenger,2054,800,2854,148864,151718,1.88,Washington
14991,November,2022,St. Tammany,LA,Passenger,1,0,1,32,33,3.03,Mid-Distance
14992,November,2022,Honolulu,HI,Passenger,3,3,6,287,293,2.05,Nearest
14993,November,2022,King,WA,Truck,337,2,339,179007,179346,0.19,Washington
14994,November,2022,Clark,NV,Passenger,5,2,7,427,434,1.61,Nearest
14995,November,2022,Bartow,GA,Passenger,0,1,1,3,4,25.0,Furthest
14996,November,2022,Orange,CA,Passenger,6,2,8,304,312,2.56,Nearest
14997,November,2022,Wahkiakum,WA,Passenger,25,13,38,3045,3083,1.23,Washington
14998,November,2022,Franklin,WA,Passenger,246,117,363,61801,62164,0.58,Washington
14999,November,2022,Douglas,WA,Passenger,162,59,221,28510,28731,0.77,Washington
15000,November,2022,Charles,MD,Passenger,1,1,2,49,51,3.92,Furthest
15001,November,2022,Island,WA,Passenger,922,394,1316,61562,62878,2.09,Washington
15002,November,2022,Multnomah,OR,Passenger,0,2,2,454,456,0.44,Nearest
15003,November,2022,Douglas,WA,Truck,2,0,2,12811,12813,0.02,Washington
15004,November,2022,Kootenai,ID,Truck,1,0,1,29,30,3.33,Nearest
15005,November,2022,San Diego,CA,Passenger,17,10,27,2066,2093,1.29,Nearest
15006,November,2022,Hawaii,HI,Passenger,1,0,1,26,27,3.7,Nearest
15007,November,2022,Anne Arundel,MD,Passenger,4,4,8,301,309,2.59,Furthest
15008,November,2022,Bexar,TX,Passenger,4,3,7,379,386,1.81,Mid-Distance
15009,November,2022,Chelan,WA,Truck,11,0,11,23139,23150,0.05,Washington
15010,November,2022,San Joaquin,CA,Passenger,1,0,1,75,76,1.32,Nearest
15011,November,2022,Boulder,CO,Passenger,1,0,1,30,31,3.23,Mid-Distance
15012,November,2022,Allen,IN,Passenger,1,0,1,11,12,8.33,Furthest
15013,November,2022,Travis,TX,Passenger,1,0,1,83,84,1.19,Mid-Distance
15014,November,2022,El Paso,CO,Passenger,3,1,4,525,529,0.76,Mid-Distance
15015,November,2022,Galveston,TX,Passenger,0,1,1,16,17,5.88,Mid-Distance
15016,November,2022,San Bernardino,CA,Passenger,1,1,2,290,292,0.68,Nearest
15017,November,2022,Frederick,MD,Passenger,1,0,1,57,58,1.72,Furthest
15018,November,2022,Newport News,VA,Passenger,1,0,1,95,96,1.04,Furthest
15019,November,2022,Fairfax,VA,Truck,1,0,1,101,102,0.98,Furthest
15020,November,2022,San Juan,WA,Truck,7,0,7,5939,5946,0.12,Washington
15021,November,2022,Pierce,WA,Truck,71,0,71,139968,140039,0.05,Washington
15022,November,2022,Champaign,IL,Passenger,1,0,1,7,8,12.5,Mid-Distance
15023,November,2022,Plaquemines,LA,Passenger,1,1,2,16,18,11.11,Mid-Distance
15024,November,2022,Santa Cruz,CA,Passenger,1,0,1,18,19,5.26,Nearest
15025,November,2022,Ferry,WA,Passenger,24,4,28,4370,4398,0.64,Washington
15026,November,2022,Benton,WA,Truck,7,0,7,43416,43423,0.02,Washington
15027,November,2022,Montgomery,MD,Passenger,3,2,5,175,180,2.78,Furthest
15028,November,2022,Yellowstone,MT,Passenger,0,1,1,17,18,5.56,Nearest
15029,November,2022,Richmond,NY,Passenger,1,0,1,6,7,14.29,Furthest
15030,November,2022,Penobscot,ME,Passenger,0,1,1,8,9,11.11,Furthest
15031,November,2022,Sonoma,CA,Passenger,1,1,2,64,66,3.03,Nearest
15032,November,2022,Alexandria,VA,Passenger,4,1,5,95,100,5.0,Furthest
15033,November,2022,Arlington,VA,Passenger,1,0,1,107,108,0.93,Furthest
15034,November,2022,Adams,CO,Passenger,1,0,1,33,34,2.94,Mid-Distance
15035,November,2022,Elmore,ID,Passenger,1,0,1,11,12,8.33,Nearest
15036,November,2022,Pierce,WA,Passenger,5996,2477,8473,540119,548592,1.54,Washington
15037,November,2022,Salt Lake,UT,Passenger,1,1,2,106,108,1.85,Nearest
15038,November,2022,Middlesex,MA,Passenger,2,1,3,61,64,4.69,Furthest
15039,November,2022,Garfield,WA,Truck,0,0,0,981,981,0.0,Washington
15040,November,2022,St. Louis,MO,Passenger,1,0,1,54,55,1.82,Furthest
15041,November,2022,Arapahoe,CO,Passenger,0,1,1,70,71,1.41,Mid-Distance
15042,November,2022,Stevens,WA,Passenger,88,56,144,30077,30221,0.48,Washington
15043,November,2022,Montgomery,AL,Passenger,0,1,1,29,30,3.33,Furthest
15044,November,2022,Howard,MD,Passenger,0,1,1,46,47,2.13,Furthest
15045,November,2022,Louisa,VA,Passenger,0,1,1,1,2,50.0,Furthest
15046,November,2022,Cook,IL,Passenger,2,0,2,158,160,1.25,Mid-Distance
15047,November,2022,Houston,GA,Passenger,1,0,1,25,26,3.85,Furthest
15048,November,2022,Danville,VA,Passenger,1,0,1,0,1,100.0,Furthest
15049,November,2022,Bryan,GA,Passenger,0,1,1,38,39,2.56,Furthest
15050,November,2022,Adams,WA,Passenger,22,11,33,13032,13065,0.25,Washington
15051,November,2022,Duval,FL,Passenger,1,1,2,242,244,0.82,Furthest
15052,November,2022,Ferry,WA,Truck,0,0,0,3579,3579,0.0,Washington
15053,November,2022,Harnett,NC,Passenger,2,0,2,133,135,1.48,Furthest
15054,November,2022,Calvert,MD,Passenger,0,2,2,74,76,2.63,Furthest
15055,November,2022,Asotin,WA,Passenger,29,20,49,12522,12571,0.39,Washington
15056,November,2022,Berkeley,SC,Passenger,0,1,1,109,110,0.91,Furthest
15057,November,2022,Contra Costa,CA,Passenger,0,3,3,209,212,1.42,Nearest
15058,November,2022,Cowlitz,WA,Passenger,389,188,577,70283,70860,0.81,Washington
15059,November,2022,Jefferson,WA,Truck,6,0,6,9386,9392,0.06,Washington
15060,November,2022,Benton,WA,Passenger,914,491,1405,135879,137284,1.02,Washington
15061,November,2022,Alameda,CA,Passenger,3,0,3,163,166,1.81,Nearest
15062,November,2022,Norfolk,VA,Passenger,3,3,6,272,278,2.16,Furthest
15063,November,2022,Richmond,GA,Passenger,0,1,1,58,59,1.69,Furthest
15064,November,2022,Wilson,TX,Passenger,0,1,1,2,3,33.33,Mid-Distance
15065,November,2022,Hennepin,MN,Passenger,1,0,1,39,40,2.5,Mid-Distance
15066,November,2022,Lewis,WA,Passenger,260,178,438,59990,60428,0.72,Washington
15067,November,2022,Ray,MO,Passenger,0,1,1,1,2,50.0,Furthest
15068,November,2022,Island,WA,Truck,15,0,15,21264,21279,0.07,Washington
15069,November,2022,Harrison,MS,Passenger,1,0,1,32,33,3.03,Mid-Distance
15070,November,2022,Sarasota,FL,Passenger,1,0,1,18,19,5.26,Furthest
15071,November,2022,Clallam,WA,Passenger,470,261,731,49431,50162,1.46,Washington
15072,November,2022,Williamson,TX,Passenger,0,2,2,64,66,3.03,Mid-Distance
15073,November,2022,El Paso,TX,Passenger,2,0,2,292,294,0.68,Mid-Distance
15074,November,2022,Clark,WA,Passenger,4776,1979,6755,315151,321906,2.1,Washington
15075,November,2022,Escambia,FL,Passenger,0,1,1,117,118,0.85,Furthest
15076,November,2022,Clackamas,OR,Passenger,1,0,1,117,118,0.85,Nearest
15077,November,2022,DeKalb,GA,Passenger,1,0,1,40,41,2.44,Furthest
15078,November,2022,Kings,CA,Passenger,2,1,3,282,285,1.05,Nearest
15079,November,2022,Grant,WA,Passenger,220,110,330,66830,67160,0.49,Washington
15080,November,2022,Kitsap,WA,Passenger,2699,1134,3833,177551,181384,2.11,Washington
15081,November,2022,Napa,CA,Passenger,0,1,1,9,10,10.0,Nearest
15082,November,2022,Los Angeles,CA,Passenger,5,6,11,672,683,1.61,Nearest
15083,November,2022,Lincoln,WA,Passenger,12,19,31,7772,7803,0.4,Washington
15084,November,2022,Pennington,SD,Passenger,2,0,2,24,26,7.69,Mid-Distance
15085,November,2022,Hoke,NC,Passenger,1,0,1,57,58,1.72,Furthest
15086,November,2022,Grant,WA,Truck,4,0,4,27996,28000,0.01,Washington
15087,November,2022,Queens,NY,Passenger,1,0,1,32,33,3.03,Furthest
15088,November,2022,New London,CT,Passenger,2,4,6,182,188,3.19,Furthest
15089,November,2022,Lee,FL,Passenger,1,0,1,25,26,3.85,Furthest
15090,November,2022,Whatcom,WA,Truck,21,0,21,43111,43132,0.05,Washington
15091,November,2022,Hamilton,OH,Passenger,1,0,1,27,28,3.57,Furthest
15092,November,2022,Spokane,WA,Truck,19,0,19,101973,101992,0.02,Washington
15093,November,2022,Las Animas,CO,Passenger,1,0,1,1,2,50.0,Mid-Distance
15094,November,2022,Stafford,VA,Passenger,3,1,4,80,84,4.76,Furthest
15095,November,2022,Allegheny,PA,Passenger,1,0,1,48,49,2.04,Furthest
15096,November,2022,Whitman,WA,Truck,3,0,3,8630,8633,0.03,Washington
15097,November,2022,Fairbanks North Star,AK,Passenger,0,1,1,60,61,1.64,Nearest
15098,November,2022,Larimer,CO,Passenger,1,0,1,41,42,2.38,Mid-Distance
15099,November,2022,Lewis,WA,Truck,2,0,2,26343,26345,0.01,Washington
15100,November,2022,Geary,KS,Passenger,1,0,1,77,78,1.28,Mid-Distance
15101,November,2022,Bell,TX,Passenger,1,0,1,281,282,0.35,Mid-Distance
15102,November,2022,New Haven,CT,Passenger,0,2,2,23,25,8.0,Furthest
15103,November,2022,Chesapeake,VA,Passenger,2,3,5,293,298,1.68,Furthest
15104,November,2022,Grays Harbor,WA,Truck,3,0,3,21117,21120,0.01,Washington
15105,November,2022,Lincoln,OR,Passenger,0,1,1,17,18,5.56,Nearest
15106,November,2022,Columbia,WA,Truck,0,0,0,1591,1591,0.0,Washington
15107,November,2022,Hillsborough,FL,Passenger,0,1,1,110,111,0.9,Furthest
15108,November,2022,Loudoun,VA,Passenger,3,1,4,60,64,6.25,Furthest
15109,November,2022,Lincoln,WA,Truck,0,0,0,4862,4862,0.0,Washington
15110,November,2022,Yakima,WA,Passenger,410,218,628,166511,167139,0.38,Washington
15111,November,2022,St. Mary's,MD,Passenger,1,0,1,170,171,0.58,Furthest
15112,November,2022,San Juan,WA,Passenger,554,168,722,13981,14703,4.91,Washington
15113,November,2022,Clark,WA,Truck,39,0,39,82070,82109,0.05,Washington
15114,November,2022,Kittitas,WA,Passenger,297,93,390,29569,29959,1.3,Washington
15115,November,2022,Douglas,CO,Passenger,0,1,1,58,59,1.69,Mid-Distance
15116,November,2022,Cumberland,NC,Passenger,1,2,3,320,323,0.93,Furthest
15117,November,2022,Carroll,NH,Passenger,0,1,1,5,6,16.67,Furthest
15118,November,2022,Cowlitz,WA,Truck,4,0,4,28412,28416,0.01,Washington
15119,November,2022,Collin,TX,Passenger,2,0,2,54,56,3.57,Mid-Distance
15120,November,2022,Skagit,WA,Passenger,908,352,1260,89513,90773,1.39,Washington
15121,November,2022,Polk,OR,Passenger,0,1,1,20,21,4.76,Nearest
15122,November,2022,Lake,IL,Passenger,1,0,1,117,118,0.85,Mid-Distance
15123,November,2022,Onslow,NC,Passenger,0,1,1,150,151,0.66,Furthest
15124,November,2022,Pend Oreille,WA,Truck,0,0,0,5602,5602,0.0,Washington
15125,November,2022,Monterey,CA,Passenger,1,1,2,119,121,1.65,Nearest
15126,November,2022,Adams,WA,Truck,1,0,1,5396,5397,0.02,Washington
15127,November,2022,Kern,CA,Passenger,1,1,2,188,190,1.05,Nearest
15128,November,2022,Walla Walla,WA,Passenger,201,108,309,35703,36012,0.86,Washington
15129,November,2022,Thurston,WA,Passenger,2552,1116,3668,192629,196297,1.87,Washington
15130,November,2022,District of Columbia,DC,Passenger,4,0,4,155,159,2.52,Furthest
15131,November,2022,Leavenworth,KS,Passenger,0,1,1,92,93,1.08,Mid-Distance
15132,November,2022,Charleston,SC,Passenger,2,2,4,53,57,7.02,Furthest
15133,November,2022,Denton,TX,Passenger,1,0,1,53,54,1.85,Mid-Distance
15134,November,2022,Kitsap,WA,Truck,28,0,28,53049,53077,0.05,Washington
15135,November,2022,Owyhee,ID,Passenger,1,0,1,3,4,25.0,Nearest
15136,November,2022,Suffolk,VA,Passenger,1,0,1,113,114,0.88,Furthest
15137,November,2022,Sacramento,CA,Passenger,3,0,3,171,174,1.72,Nearest
15138,November,2022,King,WA,Passenger,46991,12053,59044,1341209,1400253,4.22,Washington
15139,November,2022,Jefferson,NY,Passenger,0,1,1,191,192,0.52,Furthest
15140,November,2022,Rockingham,NH,Passenger,1,0,1,12,13,7.69,Furthest
15141,November,2022,Asotin,WA,Truck,0,0,0,6694,6694,0.0,Washington
15142,November,2022,Cumberland,PA,Passenger,1,0,1,35,36,2.78,Furthest
15143,November,2022,Moore,NC,Passenger,0,1,1,106,107,0.93,Furthest
15144,November,2022,Harris,TX,Passenger,1,0,1,124,125,0.8,Mid-Distance
15145,November,2022,Skamania,WA,Passenger,89,51,140,8127,8267,1.69,Washington
15146,November,2022,Beaufort,SC,Passenger,1,0,1,21,22,4.55,Furthest
15147,November,2022,Gwinnett,GA,Passenger,1,0,1,46,47,2.13,Furthest
15148,November,2022,Kauai,HI,Passenger,1,1,2,13,15,13.33,Nearest
15149,November,2022,Burlington,NJ,Passenger,0,2,2,97,99,2.02,Furthest
15150,November,2022,Dallas,TX,Passenger,1,0,1,87,88,1.14,Mid-Distance
15151,November,2022,Fairfax,VA,Passenger,5,3,8,572,580,1.38,Furthest
15152,November,2022,Santa Clara,CA,Passenger,9,2,11,177,188,5.85,Nearest
15154,November,2022,Randolph,NC,Passenger,1,0,1,4,5,20.0,Furthest
15155,November,2022,Santa Barbara,CA,Passenger,1,0,1,66,67,1.49,Nearest
15156,November,2022,Stevens,WA,Truck,2,0,2,18874,18876,0.01,Washington
15157,November,2022,Hamilton,OH,Truck,1,0,1,2,3,33.33,Furthest
15158,November,2022,Riverside,CA,Passenger,7,0,7,406,413,1.69,Nearest
15159,November,2022,Yakima,WA,Truck,6,0,6,61264,61270,0.01,Washington
15160,November,2022,Douglas,NE,Passenger,2,2,4,29,33,12.12,Mid-Distance
15161,November,2022,Lake,FL,Passenger,1,0,1,16,17,5.88,Furthest
15162,November,2022,Maricopa,AZ,Passenger,6,2,8,721,729,1.1,Nearest
15163,November,2022,Pacific,WA,Passenger,70,79,149,15759,15908,0.94,Washington
15164,November,2022,Snohomish,WA,Truck,79,0,79,122767,122846,0.06,Washington
15165,November,2022,Kittitas,WA,Truck,5,0,5,14582,14587,0.03,Washington
15166,November,2022,Spokane,WA,Passenger,1896,915,2811,324763,327574,0.86,Washington
15167,November,2022,Virginia Beach,VA,Passenger,2,0,2,460,462,0.43,Furthest
15168,November,2022,Jefferson,WA,Passenger,474,229,703,24392,25095,2.8,Washington
15169,November,2022,Wahkiakum,WA,Truck,1,0,1,1804,1805,0.06,Washington
15170,November,2022,Ulster,NY,Passenger,1,0,1,5,6,16.67,Furthest
15171,November,2022,Skamania,WA,Truck,0,0,0,3892,3892,0.0,Washington
15172,November,2022,Sheridan,WY,Passenger,1,0,1,5,6,16.67,Nearest
15173,November,2022,Oldham,KY,Passenger,0,1,1,4,5,20.0,Furthest
15174,November,2022,Pend Oreille,WA,Passenger,19,13,32,8989,9021,0.35,Washington
15175,November,2022,Columbia,WA,Passenger,8,1,9,2431,2440,0.37,Washington
15176,November,2022,Camden,NJ,Passenger,0,1,1,12,13,7.69,Furthest
15177,November,2022,Washington,MD,Passenger,2,0,2,14,16,12.5,Furthest
15178,November,2022,Snohomish,WA,Passenger,9877,2716,12593,530771,543364,2.32,Washington
15179,November,2022,Klickitat,WA,Truck,3,0,3,8251,8254,0.04,Washington
15180,November,2022,Pulaski,AR,Passenger,3,0,3,26,29,10.34,Mid-Distance
15181,November,2022,Franklin,WA,Truck,3,0,3,20955,20958,0.01,Washington
15182,November,2022,Clallam,WA,Truck,8,0,8,21885,21893,0.04,Washington
15183,November,2022,Marin,CA,Passenger,0,1,1,29,30,3.33,Nearest
15184,November,2022,Broward,FL,Passenger,1,0,1,64,65,1.54,Furthest
15185,November,2022,Kent,DE,Passenger,1,0,1,49,50,2.0,Furthest
15186,November,2022,Okanogan,WA,Truck,2,0,2,16474,16476,0.01,Washington
15187,November,2022,Carroll,MD,Passenger,0,1,1,17,18,5.56,Furthest
15188,November,2022,Sedgwick,KS,Passenger,1,1,2,65,67,2.99,Mid-Distance
15189,November,2022,Rockdale,GA,Passenger,1,0,1,6,7,14.29,Furthest
15190,November,2022,Okanogan,WA,Passenger,98,51,149,26251,26400,0.56,Washington
15191,November,2022,Sevier,AR,Passenger,0,1,1,0,1,100.0,Mid-Distance
15192,November,2022,Sarpy,NE,Passenger,1,0,1,49,50,2.0,Mid-Distance
15193,November,2022,St. Clair,IL,Passenger,2,0,2,112,114,1.75,Mid-Distance
15194,November,2022,Walla Walla,WA,Truck,3,0,3,13912,13915,0.02,Washington
15195,November,2022,Dorchester,SC,Passenger,1,0,1,44,45,2.22,Furthest
15196,November,2022,Lane,OR,Passenger,0,1,1,74,75,1.33,Nearest
15197,November,2022,Yavapai,AZ,Passenger,1,0,1,22,23,4.35,Nearest
15198,November,2022,Pacific,WA,Truck,1,0,1,7853,7854,0.01,Washington
15199,November,2022,Placer,CA,Passenger,2,0,2,59,61,3.28,Nearest
15200,November,2022,Jackson,OK,Passenger,0,1,1,32,33,3.03,Mid-Distance
15201,November,2022,Mason,WA,Truck,7,0,7,20895,20902,0.03,Washington
15202,November,2022,Okaloosa,FL,Passenger,0,1,1,92,93,1.08,Furthest
15203,November,2022,Ventura,CA,Passenger,2,1,3,212,215,1.4,Nearest
15204,November,2022,Portsmouth,VA,Passenger,0,1,1,70,71,1.41,Furthest
15205,November,2022,Garfield,WA,Passenger,1,3,4,1307,1311,0.31,Washington
15206,November,2022,Hudson,NJ,Passenger,1,0,1,30,31,3.23,Furthest
15207,November,2022,Thurston,WA,Truck,34,0,34,54782,54816,0.06,Washington
15208,November,2022,Cape May,NJ,Passenger,0,1,1,7,8,12.5,Furthest
15209,November,2022,Platte,MO,Passenger,1,0,1,19,20,5.0,Furthest
15210,November,2022,Rock Island,IL,Passenger,0,1,1,15,16,6.25,Mid-Distance
15211,November,2022,Williams,ND,Passenger,0,1,1,5,6,16.67,Mid-Distance
15212,November,2022,Sumter,SC,Passenger,0,1,1,33,34,2.94,Furthest
15213,November,2022,Klickitat,WA,Passenger,120,53,173,15133,15306,1.13,Washington
15214,November,2022,Skagit,WA,Truck,8,0,8,32208,32216,0.02,Washington
15215,November,2022,Mason,WA,Passenger,360,190,550,46961,47511,1.16,Washington
15216,November,2022,Nueces,TX,Passenger,0,1,1,50,51,1.96,Mid-Distance
15217,November,2022,Chelan,WA,Passenger,525,142,667,54281,54948,1.21,Washington
15218,November,2022,Nassau,NY,Passenger,1,0,1,21,22,4.55,Furthest
15219,November,2022,Miami-Dade,FL,Passenger,1,0,1,64,65,1.54,Furthest
15220,October,2017,Adams,WA,Passenger,3,3,6,12283,12289,0.05,Washington
15221,October,2017,Mason,WA,Truck,0,0,0,19470,19470,0.0,Washington
15222,October,2017,Pend Oreille,WA,Passenger,3,4,7,9370,9377,0.07,Washington
15223,October,2017,Albemarle,VA,Passenger,0,1,1,32,33,3.03,Furthest
15224,October,2017,Twin Falls,ID,Passenger,0,1,1,24,25,4.0,Nearest
15225,October,2017,DeKalb,GA,Passenger,1,0,1,85,86,1.16,Furthest
15226,October,2017,Monterey,CA,Passenger,0,2,2,193,195,1.03,Nearest
15227,October,2017,Grant,WA,Passenger,20,33,53,61666,61719,0.09,Washington
15228,October,2017,Garfield,WA,Truck,0,0,0,943,943,0.0,Washington
15229,October,2017,Thurston,WA,Truck,0,0,0,53577,53577,0.0,Washington
15230,October,2017,Pima,AZ,Passenger,1,1,2,414,416,0.48,Nearest
15231,October,2017,Franklin,OH,Passenger,0,1,1,112,113,0.88,Furthest
15232,October,2017,Richmond,GA,Passenger,0,1,1,90,91,1.1,Furthest
15233,October,2017,Contra Costa,CA,Passenger,0,1,1,489,490,0.2,Nearest
15234,October,2017,Kent,MI,Passenger,0,1,1,34,35,2.86,Furthest
15235,October,2017,Wahkiakum,WA,Truck,0,0,0,1672,1672,0.0,Washington
15236,October,2017,Hamilton,TN,Passenger,1,0,1,21,22,4.55,Furthest
15237,October,2017,Bexar,TX,Passenger,1,1,2,822,824,0.24,Mid-Distance
15238,October,2017,Franklin,WA,Passenger,31,49,80,56508,56588,0.14,Washington
15239,October,2017,Honolulu,HI,Passenger,2,2,4,557,561,0.71,Nearest
15240,October,2017,Adams,WA,Truck,0,0,0,5135,5135,0.0,Washington
15241,October,2017,Lane,OR,Passenger,0,1,1,214,215,0.47,Nearest
15242,October,2017,Whatcom,WA,Truck,2,0,2,41876,41878,0.0,Washington
15243,October,2017,Lewis,WA,Truck,0,0,0,25209,25209,0.0,Washington
15244,October,2017,Orange,FL,Passenger,1,1,2,145,147,1.36,Furthest
15245,October,2017,Skamania,WA,Passenger,10,7,17,8571,8588,0.2,Washington
15246,October,2017,Morris,NJ,Passenger,1,0,1,22,23,4.35,Furthest
15247,October,2017,Grays Harbor,WA,Passenger,38,41,79,45374,45453,0.17,Washington
15248,October,2017,Maricopa,AZ,Passenger,2,0,2,1627,1629,0.12,Nearest
15249,October,2017,Ferry,WA,Truck,0,0,0,3549,3549,0.0,Washington
15250,October,2017,San Juan,WA,Truck,0,0,0,5569,5569,0.0,Washington
15251,October,2017,Douglas,WA,Truck,0,0,0,11656,11656,0.0,Washington
15252,October,2017,Yakima,WA,Truck,0,0,0,57813,57813,0.0,Washington
15253,October,2017,Santa Rosa,FL,Passenger,1,0,1,108,109,0.92,Furthest
15254,October,2017,Grays Harbor,WA,Truck,0,0,0,20007,20007,0.0,Washington
15255,October,2017,Cowlitz,WA,Passenger,54,65,119,70430,70549,0.17,Washington
15256,October,2017,Fairfax,VA,Passenger,2,2,4,839,843,0.47,Furthest
15257,October,2017,Manatee,FL,Passenger,1,0,1,42,43,2.33,Furthest
15258,October,2017,Whitman,WA,Passenger,12,20,32,22299,22331,0.14,Washington
15259,October,2017,El Paso,TX,Passenger,1,0,1,527,528,0.19,Mid-Distance
15260,October,2017,Shelby,TN,Passenger,0,1,1,104,105,0.95,Furthest
15261,October,2017,New London,CT,Passenger,1,1,2,249,251,0.8,Furthest
15262,October,2017,Nueces,TX,Passenger,0,1,1,93,94,1.06,Mid-Distance
15263,October,2017,Riverside,CA,Passenger,1,2,3,744,747,0.4,Nearest
15264,October,2017,Pierce,WA,Passenger,1040,916,1956,525482,527438,0.37,Washington
15265,October,2017,Deschutes,OR,Passenger,1,0,1,185,186,0.54,Nearest
15266,October,2017,Volusia,FL,Passenger,0,1,1,40,41,2.44,Furthest
15267,October,2017,Clallam,WA,Truck,0,0,0,21147,21147,0.0,Washington
15268,October,2017,Clark,WA,Passenger,829,559,1388,302262,303650,0.46,Washington
15269,October,2017,Los Angeles,CA,Passenger,5,2,7,1219,1226,0.57,Nearest
15270,October,2017,Missoula,MT,Passenger,1,0,1,70,71,1.41,Nearest
15271,October,2017,Virginia Beach,VA,Passenger,2,1,3,654,657,0.46,Furthest
15272,October,2017,Asotin,WA,Passenger,7,5,12,12479,12491,0.1,Washington
15273,October,2017,Prince William,VA,Passenger,0,3,3,268,271,1.11,Furthest
15274,October,2017,Sacramento,CA,Passenger,1,0,1,323,324,0.31,Nearest
15275,October,2017,Benton,WA,Truck,0,0,0,40386,40386,0.0,Washington
15276,October,2017,Flathead,MT,Passenger,1,0,1,54,55,1.82,Nearest
15277,October,2017,Mason,WA,Passenger,61,74,135,44453,44588,0.3,Washington
15278,October,2017,Santa Fe,NM,Passenger,0,1,1,41,42,2.38,Mid-Distance
15279,October,2017,Okaloosa,FL,Passenger,1,0,1,186,187,0.53,Furthest
15280,October,2017,Benton,WA,Passenger,164,155,319,129410,129729,0.25,Washington
15281,October,2017,Kitsap,WA,Truck,1,0,1,52588,52589,0.0,Washington
15282,October,2017,Snohomish,WA,Passenger,1947,999,2946,515244,518190,0.57,Washington
15283,October,2017,Klickitat,WA,Truck,0,0,0,8005,8005,0.0,Washington
15284,October,2017,Anne Arundel,MD,Passenger,0,1,1,486,487,0.21,Furthest
15285,October,2017,Moore,NC,Passenger,0,1,1,202,203,0.49,Furthest
15286,October,2017,Palm Beach,FL,Passenger,0,1,1,95,96,1.04,Furthest
15287,October,2017,Nantucket,MA,Passenger,1,0,1,3,4,25.0,Furthest
15288,October,2017,Saratoga,NY,Passenger,1,1,2,73,75,2.67,Furthest
15289,October,2017,Skagit,WA,Truck,1,0,1,31629,31630,0.0,Washington
15290,October,2017,Santa Clara,CA,Passenger,6,1,7,386,393,1.78,Nearest
15291,October,2017,Thurston,WA,Passenger,442,371,813,188869,189682,0.43,Washington
15292,October,2017,Clark,WA,Truck,0,0,0,78122,78122,0.0,Washington
15293,October,2017,Pacific,WA,Passenger,14,10,24,15322,15346,0.16,Washington
15294,October,2017,Ventura,CA,Passenger,0,1,1,335,336,0.3,Nearest
15295,October,2017,Lee,AL,Passenger,1,0,1,35,36,2.78,Furthest
15296,October,2017,Chelan,WA,Passenger,77,36,113,52717,52830,0.21,Washington
15297,October,2017,Tuolumne,CA,Passenger,0,1,1,15,16,6.25,Nearest
15298,October,2017,Okanogan,WA,Passenger,5,17,22,25713,25735,0.09,Washington
15299,October,2017,Franklin,WA,Truck,0,0,0,18324,18324,0.0,Washington
15300,October,2017,Snohomish,WA,Truck,1,0,1,121462,121463,0.0,Washington
15301,October,2017,Sedgwick,KS,Passenger,0,1,1,103,104,0.96,Mid-Distance
15302,October,2017,Queens,NY,Passenger,1,0,1,62,63,1.59,Furthest
15303,October,2017,Carroll,NH,Passenger,0,1,1,1,2,50.0,Furthest
15304,October,2017,Dakota,MN,Passenger,0,2,2,38,40,5.0,Mid-Distance
15305,October,2017,Alameda,CA,Passenger,0,1,1,352,353,0.28,Nearest
15306,October,2017,Jefferson,WA,Passenger,116,68,184,24072,24256,0.76,Washington
15307,October,2017,Columbia,WA,Truck,0,0,0,1542,1542,0.0,Washington
15308,October,2017,Lincoln,WA,Truck,0,0,0,4491,4491,0.0,Washington
15309,October,2017,Stevens,WA,Truck,0,0,0,18305,18305,0.0,Washington
15310,October,2017,Wayne,MI,Passenger,0,1,1,68,69,1.45,Furthest
15311,October,2017,Travis,TX,Passenger,0,1,1,193,194,0.52,Mid-Distance
15312,October,2017,Sangamon,IL,Passenger,1,0,1,11,12,8.33,Mid-Distance
15313,October,2017,Latah,ID,Passenger,0,1,1,84,85,1.18,Nearest
15314,October,2017,Utah,UT,Passenger,0,1,1,142,143,0.7,Nearest
15315,October,2017,Clay,FL,Passenger,0,1,1,112,113,0.88,Furthest
15316,October,2017,Tarrant,TX,Passenger,1,0,1,228,229,0.44,Mid-Distance
15317,October,2017,Jefferson,NY,Passenger,1,0,1,241,242,0.41,Furthest
15318,October,2017,Garfield,WA,Passenger,1,0,1,1315,1316,0.08,Washington
15319,October,2017,Ramsey,MN,Passenger,1,0,1,40,41,2.44,Mid-Distance
15320,October,2017,Lumpkin,GA,Passenger,1,0,1,9,10,10.0,Furthest
15321,October,2017,Essex,NJ,Passenger,1,0,1,13,14,7.14,Furthest
15322,October,2017,Chelan,WA,Truck,0,0,0,21490,21490,0.0,Washington
15324,October,2017,Kittitas,WA,Passenger,33,23,56,28118,28174,0.2,Washington
15325,October,2017,King,WA,Passenger,10942,4483,15425,1372199,1387624,1.11,Washington
15326,October,2017,Franklin,MA,Passenger,0,1,1,4,5,20.0,Furthest
15327,October,2017,Tulare,CA,Passenger,1,0,1,193,194,0.52,Nearest
15328,October,2017,San Diego,CA,Passenger,5,1,6,2612,2618,0.23,Nearest
15329,October,2017,King,WA,Truck,7,1,8,185856,185864,0.0,Washington
15330,October,2017,Pend Oreille,WA,Truck,0,0,0,5562,5562,0.0,Washington
15331,October,2017,Prince George's,MD,Passenger,0,1,1,180,181,0.55,Furthest
15332,October,2017,San Juan,WA,Passenger,127,40,167,13759,13926,1.2,Washington
15333,October,2017,Fulton,GA,Passenger,1,0,1,109,110,0.91,Furthest
15334,October,2017,Skamania,WA,Truck,0,0,0,3892,3892,0.0,Washington
15335,October,2017,Whitman,WA,Truck,0,0,0,8440,8440,0.0,Washington
15336,October,2017,Kittitas,WA,Truck,0,0,0,13695,13695,0.0,Washington
15337,October,2017,Orleans,LA,Passenger,0,1,1,46,47,2.13,Mid-Distance
15338,October,2017,Walla Walla,WA,Truck,0,0,0,13256,13256,0.0,Washington
15339,October,2017,Orange,CA,Passenger,3,1,4,600,604,0.66,Nearest
15340,October,2017,Montgomery,TN,Passenger,1,0,1,272,273,0.37,Furthest
15341,October,2017,Madison,ID,Passenger,1,0,1,37,38,2.63,Nearest
15342,October,2017,Frederick,MD,Passenger,0,1,1,84,85,1.18,Furthest
15343,October,2017,Multnomah,OR,Passenger,1,3,4,911,915,0.44,Nearest
15344,October,2017,Hamilton,IN,Passenger,1,0,1,58,59,1.69,Furthest
15345,October,2017,Yakima,WA,Passenger,57,72,129,161008,161137,0.08,Washington
15346,October,2017,Nassau,NY,Passenger,1,1,2,38,40,5.0,Furthest
15347,October,2017,Dale,AL,Passenger,0,1,1,61,62,1.61,Furthest
15348,October,2017,Cape May,NJ,Passenger,0,1,1,19,20,5.0,Furthest
15349,October,2017,Spokane,WA,Truck,1,0,1,91331,91332,0.0,Washington
15350,October,2017,District of Columbia,DC,Passenger,0,3,3,204,207,1.45,Furthest
15351,October,2017,Stevens,WA,Passenger,9,22,31,31532,31563,0.1,Washington
15352,October,2017,Island,WA,Passenger,138,153,291,61081,61372,0.47,Washington
15353,October,2017,Hardin,KY,Passenger,0,1,1,117,118,0.85,Furthest
15354,October,2017,Spokane,WA,Passenger,286,238,524,298905,299429,0.17,Washington
15355,October,2017,Okanogan,WA,Truck,0,0,0,16246,16246,0.0,Washington
15356,October,2017,Manassas,VA,Passenger,0,1,1,9,10,10.0,Furthest
15357,October,2017,DeKalb,IN,Passenger,1,0,1,1,2,50.0,Furthest
15358,October,2017,Howard,MD,Passenger,0,2,2,88,90,2.22,Furthest
15359,October,2017,Maui,HI,Passenger,1,0,1,69,70,1.43,Nearest
15360,October,2017,Lincoln,WA,Passenger,2,5,7,7575,7582,0.09,Washington
15361,October,2017,Montgomery,MD,Passenger,1,0,1,302,303,0.33,Furthest
15362,October,2017,St. Clair,IL,Passenger,0,1,1,160,161,0.62,Mid-Distance
15363,October,2017,Columbia,WA,Passenger,1,1,2,2393,2395,0.08,Washington
15364,October,2017,Lewis,WA,Passenger,53,39,92,56275,56367,0.16,Washington
15365,October,2017,Dallas,TX,Passenger,0,1,1,180,181,0.55,Mid-Distance
15366,October,2017,San Mateo,CA,Passenger,0,1,1,149,150,0.67,Nearest
15367,October,2017,Jefferson,WA,Truck,0,0,0,9438,9438,0.0,Washington
15368,October,2017,Walla Walla,WA,Passenger,28,28,56,35147,35203,0.16,Washington
15369,October,2017,New Haven,CT,Passenger,0,1,1,52,53,1.89,Furthest
15370,October,2017,Arlington,VA,Passenger,1,2,3,168,171,1.75,Furthest
15371,October,2017,Ferry,WA,Passenger,1,1,2,4396,4398,0.05,Washington
15372,October,2017,Charles,MD,Passenger,0,1,1,83,84,1.19,Furthest
15373,October,2017,Canyon,ID,Passenger,0,1,1,92,93,1.08,Nearest
15374,October,2017,Sumter,FL,Passenger,0,1,1,10,11,9.09,Furthest
15375,October,2017,Pacific,WA,Truck,0,0,0,7521,7521,0.0,Washington
15376,October,2017,Norfolk,MA,Passenger,1,0,1,37,38,2.63,Furthest
15377,October,2017,Hawaii,HI,Passenger,1,0,1,74,75,1.33,Nearest
15378,October,2017,Whatcom,WA,Passenger,510,202,712,144316,145028,0.49,Washington
15379,October,2017,St. Lucie,FL,Passenger,1,0,1,27,28,3.57,Furthest
15380,October,2017,Douglas,WA,Passenger,36,32,68,26967,27035,0.25,Washington
15381,October,2017,Clallam,WA,Passenger,96,85,181,48722,48903,0.37,Washington
15382,October,2017,Montgomery,PA,Passenger,1,0,1,38,39,2.56,Furthest
15383,October,2017,Juneau,AK,Passenger,0,1,1,45,46,2.17,Nearest
15384,October,2017,Norfolk,VA,Passenger,1,1,2,307,309,0.65,Furthest
15385,October,2017,Kitsap,WA,Passenger,661,355,1016,174891,175907,0.58,Washington
15386,October,2017,Skagit,WA,Passenger,151,126,277,88959,89236,0.31,Washington
15387,October,2017,Montgomery,TX,Passenger,1,0,1,61,62,1.61,Mid-Distance
15388,October,2017,El Paso,CO,Passenger,2,0,2,769,771,0.26,Mid-Distance
15389,October,2017,Northampton,PA,Passenger,0,1,1,69,70,1.43,Furthest
15390,October,2017,Pierce,WA,Truck,0,0,0,137020,137020,0.0,Washington
15391,October,2017,Clark,NV,Passenger,1,2,3,767,770,0.39,Nearest
15392,October,2017,Asotin,WA,Truck,0,0,0,6524,6524,0.0,Washington
15393,October,2017,Allegheny,PA,Passenger,1,0,1,91,92,1.09,Furthest
15394,October,2017,Wahkiakum,WA,Passenger,0,2,2,2849,2851,0.07,Washington
15395,October,2017,Gwinnett,GA,Passenger,0,1,1,85,86,1.16,Furthest
15396,October,2017,Portsmouth,VA,Passenger,0,1,1,65,66,1.52,Furthest
15397,October,2017,Richland,SC,Passenger,0,1,1,183,184,0.54,Furthest
15398,October,2017,Marin,CA,Passenger,1,0,1,58,59,1.69,Nearest
15399,October,2017,Pinal,AZ,Passenger,2,0,2,222,224,0.89,Nearest
15400,October,2017,Island,WA,Truck,0,0,0,20596,20596,0.0,Washington
15401,October,2017,Klickitat,WA,Passenger,22,27,49,14805,14854,0.33,Washington
15402,October,2017,Grant,WA,Truck,0,0,0,25459,25459,0.0,Washington
15403,October,2017,Duval,FL,Passenger,1,1,2,368,370,0.54,Furthest
15404,October,2017,Polk,FL,Passenger,1,0,1,63,64,1.56,Furthest
15405,October,2017,Cowlitz,WA,Truck,0,0,0,28114,28114,0.0,Washington
15406,October,2018,Brevard,FL,Passenger,0,1,1,92,93,1.08,Furthest
15407,October,2018,Palm Beach,FL,Passenger,0,1,1,90,91,1.1,Furthest
15408,October,2018,Collin,TX,Passenger,1,1,2,151,153,1.31,Mid-Distance
15409,October,2018,Island,WA,Truck,0,0,0,21130,21130,0.0,Washington
15410,October,2018,Kent,MI,Passenger,0,1,1,25,26,3.85,Furthest
15411,October,2018,San Mateo,CA,Passenger,1,1,2,128,130,1.54,Nearest
15412,October,2018,Virginia Beach,VA,Passenger,2,1,3,696,699,0.43,Furthest
15413,October,2018,Carson City,NV,Passenger,1,0,1,14,15,6.67,Nearest
15414,October,2018,Columbia,WA,Passenger,2,2,4,2432,2436,0.16,Washington
15415,October,2018,Polk,FL,Passenger,1,0,1,62,63,1.59,Furthest
15416,October,2018,Manatee,FL,Passenger,1,0,1,39,40,2.5,Furthest
15417,October,2018,Franklin,WA,Passenger,35,66,101,58751,58852,0.17,Washington
15418,October,2018,Lewis,WA,Truck,0,0,0,25611,25611,0.0,Washington
15419,October,2018,Dale,AL,Passenger,0,1,1,58,59,1.69,Furthest
15420,October,2018,St. Clair,IL,Passenger,0,1,1,162,163,0.61,Mid-Distance
15421,October,2018,Snohomish,WA,Passenger,2637,1378,4015,525955,529970,0.76,Washington
15422,October,2018,Nantucket,MA,Passenger,1,0,1,4,5,20.0,Furthest
15423,October,2018,Whitman,WA,Truck,0,0,0,8531,8531,0.0,Washington
15424,October,2018,Honolulu,HI,Passenger,1,2,3,517,520,0.58,Nearest
15425,October,2018,Sumter,FL,Passenger,0,1,1,10,11,9.09,Furthest
15426,October,2018,Adams,WA,Truck,0,0,0,5151,5151,0.0,Washington
15427,October,2018,Hennepin,MN,Passenger,2,0,2,112,114,1.75,Mid-Distance
15428,October,2018,District of Columbia,DC,Passenger,0,3,3,192,195,1.54,Furthest
15429,October,2018,Riverside,CA,Passenger,2,2,4,678,682,0.59,Nearest
15430,October,2018,Columbia,WA,Truck,0,0,0,1518,1518,0.0,Washington
15431,October,2018,Yakima,WA,Truck,0,0,0,58757,58757,0.0,Washington
15432,October,2018,Richland,SC,Passenger,0,1,1,165,166,0.6,Furthest
15433,October,2018,Nassau,NY,Passenger,3,0,3,36,39,7.69,Furthest
15434,October,2018,Utah,UT,Passenger,0,1,1,137,138,0.72,Nearest
15435,October,2018,Manassas,VA,Passenger,0,1,1,9,10,10.0,Furthest
15436,October,2018,Orange,CA,Passenger,5,1,6,547,553,1.08,Nearest
15437,October,2018,Prince William,VA,Passenger,0,4,4,258,262,1.53,Furthest
15438,October,2018,Marion,IN,Passenger,1,0,1,119,120,0.83,Furthest
15439,October,2018,Cowlitz,WA,Passenger,69,86,155,72155,72310,0.21,Washington
15440,October,2018,Oldham,KY,Passenger,0,1,1,5,6,16.67,Furthest
15441,October,2018,Walla Walla,WA,Passenger,36,50,86,35994,36080,0.24,Washington
15442,October,2018,Cape May,NJ,Passenger,0,1,1,21,22,4.55,Furthest
15443,October,2018,Sangamon,IL,Passenger,1,0,1,11,12,8.33,Mid-Distance
15444,October,2018,Broward,FL,Passenger,2,1,3,136,139,2.16,Furthest
15445,October,2018,Lee,AL,Passenger,1,0,1,36,37,2.7,Furthest
15446,October,2018,Maricopa,AZ,Passenger,3,1,4,1564,1568,0.26,Nearest
15447,October,2018,Dallas,TX,Passenger,0,1,1,197,198,0.51,Mid-Distance
15448,October,2018,New Haven,CT,Passenger,0,1,1,46,47,2.13,Furthest
15449,October,2018,Los Angeles,CA,Passenger,6,5,11,1134,1145,0.96,Nearest
15450,October,2018,Santa Cruz,CA,Passenger,1,0,1,40,41,2.44,Nearest
15451,October,2018,Washington,OR,Passenger,0,1,1,475,476,0.21,Nearest
15452,October,2018,Mason,WA,Truck,0,0,0,20174,20174,0.0,Washington
15453,October,2018,Shasta,CA,Passenger,1,0,1,43,44,2.27,Nearest
15454,October,2018,Jefferson,WA,Truck,0,0,0,9612,9612,0.0,Washington
15455,October,2018,Charles,MD,Passenger,0,1,1,81,82,1.22,Furthest
15456,October,2018,Guadalupe,TX,Passenger,1,0,1,80,81,1.23,Mid-Distance
15457,October,2018,Grays Harbor,WA,Truck,0,0,0,20286,20286,0.0,Washington
15458,October,2018,Orange,FL,Passenger,2,1,3,164,167,1.8,Furthest
15459,October,2018,Marion,OR,Passenger,1,0,1,121,122,0.82,Nearest
15460,October,2018,Skagit,WA,Passenger,240,180,420,91010,91430,0.46,Washington
15461,October,2018,Pinal,AZ,Passenger,2,0,2,204,206,0.97,Nearest
15462,October,2018,Yakima,WA,Passenger,71,96,167,164423,164590,0.1,Washington
15463,October,2018,Asotin,WA,Truck,0,0,0,6636,6636,0.0,Washington
15464,October,2018,Jefferson,WA,Passenger,163,101,264,24781,25045,1.05,Washington
15465,October,2018,Rogers,OK,Passenger,1,0,1,6,7,14.29,Mid-Distance
15466,October,2018,Volusia,FL,Passenger,0,1,1,37,38,2.63,Furthest
15467,October,2018,Thurston,WA,Truck,0,0,0,54803,54803,0.0,Washington
15468,October,2018,Skamania,WA,Truck,0,0,0,3983,3983,0.0,Washington
15469,October,2018,Nueces,TX,Passenger,1,1,2,90,92,2.17,Mid-Distance
15470,October,2018,Cochise,AZ,Passenger,0,1,1,121,122,0.82,Nearest
15471,October,2018,Juneau,AK,Passenger,0,1,1,43,44,2.27,Nearest
15472,October,2018,Douglas,WA,Passenger,47,33,80,27894,27974,0.29,Washington
15473,October,2018,Cowlitz,WA,Truck,0,0,0,28666,28666,0.0,Washington
15474,October,2018,Hardin,KY,Passenger,0,1,1,116,117,0.85,Furthest
15475,October,2018,Snohomish,WA,Truck,1,0,1,121864,121865,0.0,Washington
15476,October,2018,Suffolk,MA,Passenger,0,1,1,43,44,2.27,Furthest
15477,October,2018,Grant,WA,Passenger,32,50,82,63918,64000,0.13,Washington
15478,October,2018,Caddo,LA,Passenger,0,1,1,24,25,4.0,Mid-Distance
15479,October,2018,Lane,OR,Passenger,0,1,1,174,175,0.57,Nearest
15480,October,2018,Carroll,NH,Passenger,0,1,1,1,2,50.0,Furthest
15481,October,2018,Cook,IL,Passenger,1,0,1,252,253,0.4,Mid-Distance
15482,October,2018,St. Lucie,FL,Passenger,1,0,1,29,30,3.33,Furthest
15483,October,2018,Monroe,IL,Passenger,1,0,1,4,5,20.0,Mid-Distance
15484,October,2018,Williamson,TX,Passenger,0,1,1,158,159,0.63,Mid-Distance
15485,October,2018,Benton,WA,Passenger,192,217,409,132576,132985,0.31,Washington
15486,October,2018,Larimer,CO,Passenger,1,0,1,60,61,1.64,Mid-Distance
15487,October,2018,Pacific,WA,Passenger,19,23,42,15765,15807,0.27,Washington
15488,October,2018,Chelan,WA,Passenger,126,59,185,53932,54117,0.34,Washington
15489,October,2018,Chelan,WA,Truck,0,0,0,22058,22058,0.0,Washington
15490,October,2018,Montgomery,PA,Passenger,2,0,2,36,38,5.26,Furthest
15491,October,2018,Maui,HI,Passenger,1,0,1,54,55,1.82,Nearest
15492,October,2018,Saratoga,NY,Passenger,1,0,1,60,61,1.64,Furthest
15493,October,2018,San Juan,WA,Passenger,169,69,238,14212,14450,1.65,Washington
15494,October,2018,Montgomery,MD,Passenger,1,0,1,279,280,0.36,Furthest
15495,October,2018,Whatcom,WA,Passenger,700,341,1041,148806,149847,0.69,Washington
15496,October,2018,Spokane,WA,Passenger,383,352,735,306205,306940,0.24,Washington
15497,October,2018,Clallam,WA,Truck,0,0,0,21569,21569,0.0,Washington
15498,October,2018,El Paso,CO,Passenger,3,1,4,758,762,0.52,Mid-Distance
15499,October,2018,Klamath,OR,Passenger,1,0,1,34,35,2.86,Nearest
15500,October,2018,Garfield,OK,Passenger,1,0,1,14,15,6.67,Mid-Distance
15501,October,2018,Norfolk,VA,Passenger,2,2,4,336,340,1.18,Furthest
15502,October,2018,San Diego,CA,Passenger,8,2,10,2561,2571,0.39,Nearest
15503,October,2018,Santa Clara,CA,Passenger,8,0,8,373,381,2.1,Nearest
15504,October,2018,Okanogan,WA,Truck,0,0,0,16501,16501,0.0,Washington
15505,October,2018,Ventura,CA,Passenger,0,2,2,314,316,0.63,Nearest
15506,October,2018,Prince George,VA,Passenger,0,1,1,78,79,1.27,Furthest
15507,October,2018,Clallam,WA,Passenger,136,119,255,50301,50556,0.5,Washington
15508,October,2018,Fulton,GA,Passenger,1,2,3,107,110,2.73,Furthest
15509,October,2018,Multnomah,OR,Passenger,3,4,7,758,765,0.92,Nearest
15510,October,2018,Thurston,WA,Passenger,663,552,1215,195071,196286,0.62,Washington
15511,October,2018,Skamania,WA,Passenger,18,12,30,8728,8758,0.34,Washington
15512,October,2018,Walla Walla,WA,Truck,0,0,0,13507,13507,0.0,Washington
15513,October,2018,Pierce,WA,Truck,0,0,0,138782,138782,0.0,Washington
15514,October,2018,Monterey,CA,Passenger,0,1,1,190,191,0.52,Nearest
15515,October,2018,New London,CT,Passenger,0,1,1,254,255,0.39,Furthest
15516,October,2018,Garfield,WA,Truck,0,0,0,960,960,0.0,Washington
15517,October,2018,Middlesex,MA,Passenger,0,1,1,138,139,0.72,Furthest
15518,October,2018,Washtenaw,MI,Passenger,1,0,1,38,39,2.56,Furthest
15519,October,2018,Jefferson,CO,Passenger,0,1,1,63,64,1.56,Mid-Distance
15520,October,2018,Pend Oreille,WA,Passenger,6,5,11,9588,9599,0.11,Washington
15521,October,2018,Arlington,VA,Passenger,1,1,2,166,168,1.19,Furthest
15522,October,2018,Whatcom,WA,Truck,2,0,2,42555,42557,0.0,Washington
15523,October,2018,Prince George's,MD,Passenger,1,1,2,180,182,1.1,Furthest
15524,October,2018,Douglas,WA,Truck,0,0,0,12077,12077,0.0,Washington
15525,October,2018,Gwinnett,GA,Passenger,0,1,1,79,80,1.25,Furthest
15526,October,2018,Adams,WA,Passenger,5,5,10,12720,12730,0.08,Washington
15527,October,2018,Richmond,GA,Passenger,0,1,1,92,93,1.08,Furthest
15528,October,2018,Sedgwick,KS,Passenger,0,1,1,99,100,1.0,Mid-Distance
15529,October,2018,Denver,CO,Passenger,1,0,1,128,129,0.78,Mid-Distance
15530,October,2018,Contra Costa,CA,Passenger,0,2,2,419,421,0.48,Nearest
15531,October,2018,Grays Harbor,WA,Passenger,60,66,126,47272,47398,0.27,Washington
15532,October,2018,Albemarle,VA,Passenger,1,0,1,27,28,3.57,Furthest
15533,October,2018,Mason,WA,Passenger,101,108,209,46356,46565,0.45,Washington
15534,October,2018,Stevens,WA,Truck,0,0,0,18721,18721,0.0,Washington
15535,October,2018,Lincoln,WA,Passenger,2,6,8,7740,7748,0.1,Washington
15536,October,2018,Santa Fe,NM,Passenger,0,1,1,43,44,2.27,Mid-Distance
15537,October,2018,Jefferson,NY,Passenger,0,1,1,224,225,0.44,Furthest
15538,October,2018,Island,WA,Passenger,244,216,460,63045,63505,0.72,Washington
15539,October,2018,Benton,WA,Truck,0,0,0,41429,41429,0.0,Washington
15540,October,2018,Cumberland,NC,Passenger,0,1,1,523,524,0.19,Furthest
15541,October,2018,Tuolumne,CA,Passenger,0,1,1,12,13,7.69,Nearest
15542,October,2018,Bexar,TX,Passenger,3,4,7,731,738,0.95,Mid-Distance
15543,October,2018,Twin Falls,ID,Passenger,0,1,1,22,23,4.35,Nearest
15544,October,2018,Ramsey,MN,Passenger,1,0,1,40,41,2.44,Mid-Distance
15545,October,2018,Alameda,CA,Passenger,0,2,2,333,335,0.6,Nearest
15546,October,2018,Clark,NV,Passenger,2,2,4,729,733,0.55,Nearest
15547,October,2018,Fresno,CA,Passenger,1,0,1,185,186,0.54,Nearest
15548,October,2018,Lumpkin,GA,Passenger,1,0,1,7,8,12.5,Furthest
15549,October,2018,Whitman,WA,Passenger,19,33,52,22745,22797,0.23,Washington
15550,October,2018,Skagit,WA,Truck,1,0,1,32334,32335,0.0,Washington
15551,October,2018,Okanogan,WA,Passenger,15,21,36,26108,26144,0.14,Washington
15552,October,2018,DeKalb,IN,Passenger,1,0,1,1,2,50.0,Furthest
15553,October,2018,Wahkiakum,WA,Passenger,1,1,2,2984,2986,0.07,Washington
15554,October,2018,Frederick,MD,Passenger,0,1,1,83,84,1.19,Furthest
15555,October,2018,DeKalb,GA,Passenger,1,0,1,78,79,1.27,Furthest
15556,October,2018,Shelby,TN,Passenger,0,1,1,103,104,0.96,Furthest
15557,October,2018,Duval,FL,Passenger,1,2,3,383,386,0.78,Furthest
15558,October,2018,Pima,AZ,Passenger,1,1,2,405,407,0.49,Nearest
15559,October,2018,Pend Oreille,WA,Truck,0,0,0,5752,5752,0.0,Washington
15560,October,2018,Kittitas,WA,Passenger,57,35,92,29279,29371,0.31,Washington
15561,October,2018,Ferry,WA,Truck,0,0,0,3566,3566,0.0,Washington
15562,October,2018,Charleston,SC,Passenger,1,0,1,128,129,0.78,Furthest
15563,October,2018,Clark,WA,Passenger,1149,814,1963,310425,312388,0.63,Washington
15564,October,2018,Norfolk,MA,Passenger,1,0,1,37,38,2.63,Furthest
15565,October,2018,Deschutes,OR,Passenger,2,0,2,161,163,1.23,Nearest
15566,October,2018,Santa Rosa,FL,Passenger,1,0,1,89,90,1.11,Furthest
15567,October,2018,Lewis,WA,Passenger,88,70,158,58040,58198,0.27,Washington
15568,October,2018,Clark,WA,Truck,0,0,0,79579,79579,0.0,Washington
15569,October,2018,King,WA,Passenger,15034,6221,21255,1376342,1397597,1.52,Washington
15570,October,2018,Mecklenburg,NC,Passenger,1,0,1,81,82,1.22,Furthest
15571,October,2018,Portsmouth,VA,Passenger,0,1,1,77,78,1.28,Furthest
15572,October,2018,Dakota,MN,Passenger,0,2,2,33,35,5.71,Mid-Distance
15573,October,2018,Lee,FL,Passenger,1,0,1,56,57,1.75,Furthest
15574,October,2018,Fairfax,VA,Passenger,1,2,3,809,812,0.37,Furthest
15575,October,2018,Kootenai,ID,Passenger,1,1,2,218,220,0.91,Nearest
15576,October,2018,Garfield,WA,Passenger,1,1,2,1330,1332,0.15,Washington
15577,October,2018,Asotin,WA,Passenger,12,9,21,12713,12734,0.16,Washington
15578,October,2018,Kitsap,WA,Passenger,880,507,1387,179926,181313,0.76,Washington
15579,October,2018,Flathead,MT,Passenger,1,0,1,53,54,1.85,Nearest
15580,October,2018,Morris,NJ,Passenger,1,0,1,17,18,5.56,Furthest
15581,October,2018,Hamilton,IN,Passenger,1,0,1,47,48,2.08,Furthest
15582,October,2018,Valencia,NM,Passenger,1,0,1,10,11,9.09,Mid-Distance
15583,October,2018,Klickitat,WA,Truck,0,0,0,8154,8154,0.0,Washington
15584,October,2018,San Francisco,CA,Passenger,1,1,2,115,117,1.71,Nearest
15585,October,2018,El Paso,TX,Passenger,1,0,1,501,502,0.2,Mid-Distance
15586,October,2018,Grant,WA,Truck,0,0,0,26085,26085,0.0,Washington
15587,October,2018,Pacific,WA,Truck,0,0,0,7630,7630,0.0,Washington
15588,October,2018,Camden,NJ,Passenger,0,1,1,27,28,3.57,Furthest
15589,October,2018,St. Mary's,MD,Passenger,1,0,1,219,220,0.45,Furthest
15590,October,2018,Wahkiakum,WA,Truck,0,0,0,1701,1701,0.0,Washington
15591,October,2018,Lincoln,WA,Truck,0,0,0,4608,4608,0.0,Washington
15592,October,2018,Montgomery,TX,Passenger,2,0,2,61,63,3.17,Mid-Distance
15593,October,2018,Klickitat,WA,Passenger,24,32,56,15389,15445,0.36,Washington
15594,October,2018,Anne Arundel,MD,Passenger,0,1,1,451,452,0.22,Furthest
15595,October,2018,DuPage,IL,Passenger,1,0,1,56,57,1.75,Mid-Distance
15596,October,2018,Beaufort,SC,Passenger,1,0,1,35,36,2.78,Furthest
15597,October,2018,Spokane,WA,Truck,1,0,1,93433,93434,0.0,Washington
15598,October,2018,Ada,ID,Passenger,0,2,2,313,315,0.63,Nearest
15600,October,2018,Kitsap,WA,Truck,1,0,1,53622,53623,0.0,Washington
15601,October,2018,Stevens,WA,Passenger,14,28,42,31809,31851,0.13,Washington
15602,October,2018,Allegheny,PA,Passenger,1,0,1,83,84,1.19,Furthest
15603,October,2018,Clackamas,OR,Passenger,0,1,1,214,215,0.47,Nearest
15604,October,2018,Pierce,WA,Passenger,1405,1305,2710,537166,539876,0.5,Washington
15605,October,2018,Madison,ID,Passenger,1,0,1,37,38,2.63,Nearest
15606,October,2018,Randolph,NC,Passenger,1,0,1,5,6,16.67,Furthest
15607,October,2018,Hawaii,HI,Passenger,1,0,1,67,68,1.47,Nearest
15608,October,2018,Franklin,WA,Truck,0,0,0,18952,18952,0.0,Washington
15609,October,2018,Kittitas,WA,Truck,0,0,0,14126,14126,0.0,Washington
15610,October,2018,Clay,FL,Passenger,0,1,1,91,92,1.09,Furthest
15611,October,2018,Douglas,NE,Passenger,0,1,1,68,69,1.45,Mid-Distance
15612,October,2018,Houston,GA,Passenger,1,0,1,53,54,1.85,Furthest
15613,October,2018,San Juan,WA,Truck,0,0,0,5787,5787,0.0,Washington
15614,October,2018,Tarrant,TX,Passenger,1,0,1,206,207,0.48,Mid-Distance
15615,October,2018,Franklin,MA,Passenger,0,1,1,1,2,50.0,Furthest
15616,October,2018,Howard,MD,Passenger,0,1,1,87,88,1.14,Furthest
15617,October,2018,Moore,NC,Passenger,0,1,1,195,196,0.51,Furthest
15618,October,2018,Washoe,NV,Passenger,1,0,1,108,109,0.92,Nearest
15619,October,2018,Tulsa,OK,Passenger,1,1,2,47,49,4.08,Mid-Distance
15620,October,2018,San Juan,PR,Passenger,0,1,1,4,5,20.0,Mid-Distance
15621,October,2018,King,WA,Truck,7,1,8,182837,182845,0.0,Washington
15622,October,2018,Ferry,WA,Passenger,3,2,5,4406,4411,0.11,Washington
15623,October,2019,Cowlitz,WA,Truck,0,0,0,29023,29023,0.0,Washington
15624,October,2019,Sarasota,FL,Passenger,2,0,2,26,28,7.14,Furthest
15625,October,2019,Douglas,WA,Passenger,63,38,101,28272,28373,0.36,Washington
15626,October,2019,Richland,SC,Passenger,0,1,1,159,160,0.62,Furthest
15627,October,2019,Calvert,MD,Passenger,0,2,2,92,94,2.13,Furthest
15628,October,2019,RÃ­o Grande,PR,Passenger,1,0,1,1,2,50.0,Mid-Distance
15629,October,2019,Whatcom,WA,Passenger,949,470,1419,151478,152897,0.93,Washington
15630,October,2019,New London,CT,Passenger,0,2,2,244,246,0.81,Furthest
15631,October,2019,Spartanburg,SC,Passenger,0,1,1,41,42,2.38,Furthest
15632,October,2019,Asotin,WA,Passenger,12,8,20,12644,12664,0.16,Washington
15633,October,2019,DeKalb,GA,Passenger,1,0,1,80,81,1.23,Furthest
15634,October,2019,Fulton,GA,Passenger,0,2,2,102,104,1.92,Furthest
15635,October,2019,Clark,WA,Passenger,1782,1016,2798,316964,319762,0.88,Washington
15636,October,2019,Shasta,CA,Passenger,1,0,1,40,41,2.44,Nearest
15637,October,2019,Douglas,NE,Passenger,0,1,1,58,59,1.69,Mid-Distance
15638,October,2019,Ferry,WA,Passenger,5,2,7,4425,4432,0.16,Washington
15639,October,2019,Virginia Beach,VA,Passenger,1,0,1,696,697,0.14,Furthest
15640,October,2019,Santa Cruz,CA,Passenger,1,0,1,36,37,2.7,Nearest
15641,October,2019,Harnett,NC,Passenger,1,1,2,211,213,0.94,Furthest
15642,October,2019,Chesapeake,VA,Passenger,0,1,1,444,445,0.22,Furthest
15643,October,2019,Cape May,NJ,Passenger,0,1,1,13,14,7.14,Furthest
15644,October,2019,Denver,CO,Passenger,1,0,1,131,132,0.76,Mid-Distance
15645,October,2019,Washoe,NV,Passenger,2,0,2,107,109,1.83,Nearest
15646,October,2019,Lee,FL,Passenger,1,0,1,53,54,1.85,Furthest
15647,October,2019,Kitsap,WA,Truck,1,0,1,54352,54353,0.0,Washington
15648,October,2019,Cowlitz,WA,Passenger,112,106,218,73568,73786,0.3,Washington
15649,October,2019,Lake,FL,Passenger,1,0,1,21,22,4.55,Furthest
15650,October,2019,Clay,FL,Passenger,0,1,1,86,87,1.15,Furthest
15651,October,2019,Monroe,IL,Passenger,1,0,1,5,6,16.67,Mid-Distance
15652,October,2019,Bexar,TX,Passenger,1,5,6,649,655,0.92,Mid-Distance
15653,October,2019,Richmond,GA,Passenger,0,1,1,91,92,1.09,Furthest
15654,October,2019,Cochise,AZ,Passenger,0,1,1,106,107,0.93,Nearest
15655,October,2019,Tulsa,OK,Passenger,1,1,2,48,50,4.0,Mid-Distance
15656,October,2019,Boulder,CO,Passenger,0,1,1,51,52,1.92,Mid-Distance
15657,October,2019,Franklin,WA,Passenger,53,76,129,60628,60757,0.21,Washington
15658,October,2019,Spokane,WA,Passenger,616,464,1080,314332,315412,0.34,Washington
15659,October,2019,Clackamas,OR,Passenger,2,1,3,212,215,1.4,Nearest
15660,October,2019,San Mateo,CA,Passenger,1,1,2,120,122,1.64,Nearest
15661,October,2019,Prince William,VA,Passenger,1,3,4,234,238,1.68,Furthest
15662,October,2019,Valencia,NM,Passenger,1,0,1,6,7,14.29,Mid-Distance
15663,October,2019,Hudson,NJ,Passenger,1,0,1,39,40,2.5,Furthest
15664,October,2019,Stevens,WA,Passenger,29,28,57,31624,31681,0.18,Washington
15665,October,2019,Fairfax,VA,Passenger,4,2,6,760,766,0.78,Furthest
15666,October,2019,Okanogan,WA,Passenger,24,28,52,26251,26303,0.2,Washington
15667,October,2019,Adams,WA,Passenger,6,6,12,12912,12924,0.09,Washington
15668,October,2019,Travis,TX,Passenger,2,1,3,202,205,1.46,Mid-Distance
15669,October,2019,Montgomery,PA,Passenger,2,0,2,36,38,5.26,Furthest
15670,October,2019,Ramsey,MN,Passenger,1,0,1,40,41,2.44,Mid-Distance
15671,October,2019,Hawaii,HI,Passenger,1,0,1,58,59,1.69,Nearest
15672,October,2019,Dakota,MN,Passenger,0,1,1,36,37,2.7,Mid-Distance
15673,October,2019,Cumberland,NC,Passenger,0,2,2,491,493,0.41,Furthest
15674,October,2019,Grant,WA,Truck,0,0,0,26891,26891,0.0,Washington
15675,October,2019,Stafford,VA,Passenger,1,1,2,95,97,2.06,Furthest
15676,October,2019,Pierce,WA,Passenger,2058,1629,3687,546972,550659,0.67,Washington
15677,October,2019,Albemarle,VA,Passenger,1,0,1,25,26,3.85,Furthest
15678,October,2019,Pinal,AZ,Passenger,1,0,1,189,190,0.53,Nearest
15679,October,2019,Santa Rosa,FL,Passenger,1,0,1,87,88,1.14,Furthest
15680,October,2019,Clark,NV,Passenger,4,2,6,686,692,0.87,Nearest
15681,October,2019,Grays Harbor,WA,Truck,0,0,0,20730,20730,0.0,Washington
15682,October,2019,St. Mary's,MD,Passenger,1,0,1,218,219,0.46,Furthest
15683,October,2019,Flathead,MT,Passenger,1,0,1,63,64,1.56,Nearest
15684,October,2019,Solano,CA,Passenger,1,0,1,205,206,0.49,Nearest
15685,October,2019,Osceola,FL,Passenger,1,0,1,39,40,2.5,Furthest
15686,October,2019,Clallam,WA,Truck,1,0,1,21846,21847,0.0,Washington
15687,October,2019,Portsmouth,VA,Passenger,0,1,1,79,80,1.25,Furthest
15688,October,2019,Anne Arundel,MD,Passenger,1,2,3,438,441,0.68,Furthest
15689,October,2019,Clallam,WA,Passenger,194,150,344,50936,51280,0.67,Washington
15690,October,2019,Sangamon,IL,Passenger,1,0,1,5,6,16.67,Mid-Distance
15691,October,2019,Lincoln,WA,Passenger,2,11,13,7831,7844,0.17,Washington
15692,October,2019,Thurston,WA,Passenger,1005,686,1691,199109,200800,0.84,Washington
15693,October,2019,Berkshire,MA,Passenger,0,1,1,4,5,20.0,Furthest
15694,October,2019,Pima,AZ,Passenger,2,1,3,378,381,0.79,Nearest
15695,October,2019,Santa Fe,NM,Passenger,0,1,1,41,42,2.38,Mid-Distance
15696,October,2019,Pacific,WA,Passenger,30,29,59,16110,16169,0.36,Washington
15697,October,2019,Putnam,TN,Passenger,0,1,1,3,4,25.0,Furthest
15698,October,2019,Snohomish,WA,Truck,0,0,0,123012,123012,0.0,Washington
15699,October,2019,Houston,GA,Passenger,1,0,1,57,58,1.72,Furthest
15700,October,2019,Jefferson,NY,Passenger,0,2,2,213,215,0.93,Furthest
15701,October,2019,New Haven,CT,Passenger,0,2,2,48,50,4.0,Furthest
15702,October,2019,Island,WA,Passenger,362,250,612,63634,64246,0.95,Washington
15703,October,2019,Vigo,IN,Passenger,1,0,1,6,7,14.29,Furthest
15704,October,2019,Sedgwick,KS,Passenger,1,1,2,96,98,2.04,Mid-Distance
15705,October,2019,Ventura,CA,Passenger,0,3,3,304,307,0.98,Nearest
15706,October,2019,Penobscot,ME,Passenger,0,1,1,13,14,7.14,Furthest
15707,October,2019,Asotin,WA,Truck,0,0,0,6694,6694,0.0,Washington
15708,October,2019,Santa Clara,CA,Passenger,6,2,8,364,372,2.15,Nearest
15709,October,2019,King,WA,Truck,6,1,7,182394,182401,0.0,Washington
15710,October,2019,DuPage,IL,Passenger,3,0,3,60,63,4.76,Mid-Distance
15711,October,2019,Pend Oreille,WA,Passenger,7,6,13,9493,9506,0.14,Washington
15712,October,2019,Okanogan,WA,Truck,0,0,0,16523,16523,0.0,Washington
15713,October,2019,Harrison,MS,Passenger,1,0,1,58,59,1.69,Mid-Distance
15714,October,2019,Skagit,WA,Passenger,336,210,546,92600,93146,0.59,Washington
15715,October,2019,Kootenai,ID,Passenger,1,1,2,224,226,0.88,Nearest
15716,October,2019,Whitman,WA,Truck,0,0,0,8596,8596,0.0,Washington
15717,October,2019,Cascade,MT,Passenger,0,1,1,57,58,1.72,Nearest
15718,October,2019,Grant,WA,Passenger,55,64,119,65376,65495,0.18,Washington
15719,October,2019,Riverside,CA,Passenger,4,1,5,646,651,0.77,Nearest
15720,October,2019,Stevens,WA,Truck,0,0,0,18773,18773,0.0,Washington
15721,October,2019,DeKalb,IN,Passenger,1,0,1,1,2,50.0,Furthest
15722,October,2019,Allegheny,PA,Passenger,1,0,1,77,78,1.28,Furthest
15723,October,2019,Clark,WA,Truck,0,0,0,81150,81150,0.0,Washington
15724,October,2019,Benton,WA,Truck,0,0,0,42370,42370,0.0,Washington
15725,October,2019,Loudoun,VA,Passenger,1,0,1,94,95,1.05,Furthest
15726,October,2019,Wahkiakum,WA,Truck,0,0,0,1752,1752,0.0,Washington
15727,October,2019,Douglas,WA,Truck,0,0,0,12295,12295,0.0,Washington
15728,October,2019,Alameda,CA,Passenger,5,1,6,296,302,1.99,Nearest
15729,October,2019,Yakima,WA,Truck,0,0,0,59494,59494,0.0,Washington
15730,October,2019,Garfield,WA,Truck,0,0,0,963,963,0.0,Washington
15731,October,2019,Thurston,WA,Truck,0,0,0,55645,55645,0.0,Washington
15732,October,2019,Placer,CA,Passenger,1,0,1,95,96,1.04,Nearest
15733,October,2019,Kitsap,WA,Passenger,1177,645,1822,182157,183979,0.99,Washington
15734,October,2019,Walla Walla,WA,Passenger,62,62,124,36327,36451,0.34,Washington
15735,October,2019,Klamath,OR,Passenger,1,0,1,39,40,2.5,Nearest
15736,October,2019,Norfolk,MA,Passenger,1,0,1,36,37,2.7,Furthest
15737,October,2019,San Juan,WA,Truck,0,0,0,5924,5924,0.0,Washington
15738,October,2019,Pend Oreille,WA,Truck,0,0,0,5739,5739,0.0,Washington
15739,October,2019,Volusia,FL,Passenger,0,1,1,41,42,2.38,Furthest
15740,October,2019,Jefferson,WA,Truck,0,0,0,9672,9672,0.0,Washington
15741,October,2019,Skamania,WA,Truck,0,0,0,4101,4101,0.0,Washington
15742,October,2019,Tuolumne,CA,Passenger,0,1,1,12,13,7.69,Nearest
15743,October,2019,Multnomah,OR,Passenger,4,6,10,726,736,1.36,Nearest
15744,October,2019,Suffolk,MA,Passenger,0,1,1,38,39,2.56,Furthest
15745,October,2019,Charleston,SC,Passenger,1,0,1,113,114,0.88,Furthest
15746,October,2019,Boone,MO,Passenger,0,1,1,11,12,8.33,Furthest
15747,October,2019,Collin,TX,Passenger,1,1,2,130,132,1.52,Mid-Distance
15748,October,2019,Carroll,NH,Passenger,0,1,1,3,4,25.0,Furthest
15749,October,2019,Jefferson,CO,Passenger,0,2,2,59,61,3.28,Mid-Distance
15750,October,2019,Dallas,TX,Passenger,1,0,1,211,212,0.47,Mid-Distance
15751,October,2019,Benton,WA,Passenger,307,302,609,134942,135551,0.45,Washington
15752,October,2019,Orange,CA,Passenger,7,3,10,510,520,1.92,Nearest
15753,October,2019,Williamson,TX,Passenger,0,2,2,143,145,1.38,Mid-Distance
15754,October,2019,Shelby,OH,Passenger,0,1,1,1,2,50.0,Furthest
15755,October,2019,Oldham,KY,Passenger,0,1,1,5,6,16.67,Furthest
15756,October,2019,Mason,WA,Passenger,140,129,269,47564,47833,0.56,Washington
15757,October,2019,Franklin,MA,Passenger,0,1,1,1,2,50.0,Furthest
15758,October,2019,Camden,NJ,Passenger,0,1,1,23,24,4.17,Furthest
15759,October,2019,Queens,NY,Passenger,1,0,1,52,53,1.89,Furthest
15760,October,2019,Twin Falls,ID,Passenger,0,1,1,26,27,3.7,Nearest
15761,October,2019,Adams,WA,Truck,0,0,0,5154,5154,0.0,Washington
15762,October,2019,Yakima,WA,Passenger,115,114,229,165908,166137,0.14,Washington
15763,October,2019,Palm Beach,FL,Passenger,0,1,1,84,85,1.18,Furthest
15764,October,2019,Larimer,CO,Passenger,1,0,1,59,60,1.67,Mid-Distance
15765,October,2019,Nueces,TX,Passenger,1,1,2,92,94,2.13,Mid-Distance
15766,October,2019,Montgomery,TX,Passenger,1,0,1,58,59,1.69,Mid-Distance
15767,October,2019,Wahkiakum,WA,Passenger,4,3,7,3049,3056,0.23,Washington
15768,October,2019,Manassas,VA,Passenger,0,1,1,7,8,12.5,Furthest
15769,October,2019,Maricopa,AZ,Passenger,6,5,11,1515,1526,0.72,Nearest
15770,October,2019,Jefferson,WA,Passenger,210,126,336,25159,25495,1.32,Washington
15771,October,2019,San Francisco,CA,Passenger,2,1,3,100,103,2.91,Nearest
15772,October,2019,King,WA,Passenger,21367,7391,28758,1396136,1424894,2.02,Washington
15773,October,2019,Bucks,PA,Passenger,1,0,1,24,25,4.0,Furthest
15774,October,2019,Arlington,VA,Passenger,0,2,2,151,153,1.31,Furthest
15775,October,2019,Montgomery,AL,Passenger,0,1,1,40,41,2.44,Furthest
15776,October,2019,Ada,ID,Passenger,0,2,2,300,302,0.66,Nearest
15777,October,2019,Cook,IL,Passenger,1,0,1,232,233,0.43,Mid-Distance
15778,October,2019,District of Columbia,DC,Passenger,1,1,2,210,212,0.94,Furthest
15779,October,2019,San Juan,WA,Passenger,236,76,312,14410,14722,2.12,Washington
15780,October,2019,Pacific,WA,Truck,0,0,0,7726,7726,0.0,Washington
15781,October,2019,Kittitas,WA,Truck,0,0,0,14618,14618,0.0,Washington
15782,October,2019,Arapahoe,CO,Passenger,1,0,1,146,147,0.68,Mid-Distance
15783,October,2019,Contra Costa,CA,Passenger,2,2,4,356,360,1.11,Nearest
15784,October,2019,Juneau,AK,Passenger,0,2,2,28,30,6.67,Nearest
15785,October,2019,Garfield,WA,Passenger,0,1,1,1301,1302,0.08,Washington
15786,October,2019,Franklin,WA,Truck,0,0,0,19656,19656,0.0,Washington
15787,October,2019,Maui,HI,Passenger,1,0,1,43,44,2.27,Nearest
15788,October,2019,Mason,WA,Truck,0,0,0,20466,20466,0.0,Washington
15789,October,2019,Polk,FL,Passenger,1,0,1,66,67,1.49,Furthest
15790,October,2019,Columbia,WA,Passenger,3,2,5,2435,2440,0.2,Washington
15791,October,2019,Pierce,WA,Truck,0,0,0,140688,140688,0.0,Washington
15792,October,2019,Howard,MD,Passenger,0,1,1,75,76,1.32,Furthest
15793,October,2019,Snohomish,WA,Passenger,3897,1683,5580,535121,540701,1.03,Washington
15794,October,2019,Hennepin,MN,Passenger,3,1,4,99,103,3.88,Mid-Distance
15795,October,2019,Ferry,WA,Truck,0,0,0,3575,3575,0.0,Washington
15796,October,2019,Fairbanks North Star,AK,Passenger,0,1,1,101,102,0.98,Nearest
15797,October,2019,Prince George's,MD,Passenger,1,1,2,178,180,1.11,Furthest
15798,October,2019,Charles,MD,Passenger,0,1,1,82,83,1.2,Furthest
15799,October,2019,Norfolk,VA,Passenger,2,2,4,346,350,1.14,Furthest
15800,October,2019,El Paso,TX,Passenger,3,0,3,462,465,0.65,Mid-Distance
15801,October,2019,Klickitat,WA,Passenger,43,37,80,15665,15745,0.51,Washington
15802,October,2019,Saginaw,MI,Passenger,1,0,1,11,12,8.33,Furthest
15803,October,2019,San Diego,CA,Passenger,10,3,13,2804,2817,0.46,Nearest
15804,October,2019,Jones,GA,Passenger,1,0,1,1,2,50.0,Furthest
15805,October,2019,Wilson,TX,Passenger,0,1,1,7,8,12.5,Mid-Distance
15806,October,2019,Island,WA,Truck,0,0,0,21320,21320,0.0,Washington
15807,October,2019,Lewis,WA,Passenger,108,102,210,59447,59657,0.35,Washington
15808,October,2019,Tarrant,TX,Passenger,2,0,2,198,200,1.0,Mid-Distance
15809,October,2019,Kent,MI,Passenger,0,1,1,23,24,4.17,Furthest
15810,October,2019,Alexandria,VA,Passenger,1,0,1,147,148,0.68,Furthest
15811,October,2019,Powhatan,VA,Passenger,1,0,1,0,1,100.0,Furthest
15812,October,2019,Fresno,CA,Passenger,1,0,1,191,192,0.52,Nearest
15813,October,2019,Brevard,FL,Passenger,0,1,1,90,91,1.1,Furthest
15814,October,2019,Nassau,NY,Passenger,4,0,4,38,42,9.52,Furthest
15815,October,2019,Chelan,WA,Passenger,191,75,266,54655,54921,0.48,Washington
15816,October,2019,Skamania,WA,Passenger,25,20,45,8803,8848,0.51,Washington
15817,October,2019,Guadalupe,TX,Passenger,1,0,1,68,69,1.45,Mid-Distance
15818,October,2019,Whatcom,WA,Truck,2,0,2,43096,43098,0.0,Washington
15819,October,2019,Rogers,OK,Passenger,1,0,1,5,6,16.67,Mid-Distance
15820,October,2019,Kittitas,WA,Passenger,87,45,132,29964,30096,0.44,Washington
15822,October,2019,Columbia,WA,Truck,0,0,0,1533,1533,0.0,Washington
15823,October,2019,Klickitat,WA,Truck,0,0,0,8311,8311,0.0,Washington
15824,October,2019,Lewis,WA,Truck,0,0,0,26045,26045,0.0,Washington
15825,October,2019,Walla Walla,WA,Truck,0,0,0,13670,13670,0.0,Washington
15826,October,2019,Honolulu,HI,Passenger,4,2,6,487,493,1.22,Nearest
15827,October,2019,Deschutes,OR,Passenger,3,0,3,151,154,1.95,Nearest
15828,October,2019,Owyhee,ID,Passenger,1,0,1,3,4,25.0,Nearest
15829,October,2019,Middlesex,MA,Passenger,1,1,2,108,110,1.82,Furthest
15830,October,2019,Whitman,WA,Passenger,38,45,83,22717,22800,0.36,Washington
15831,October,2019,Washtenaw,MI,Passenger,1,0,1,40,41,2.44,Furthest
15832,October,2019,Carson City,NV,Passenger,1,0,1,11,12,8.33,Nearest
15833,October,2019,Kern,CA,Passenger,0,1,1,222,223,0.45,Nearest
15834,October,2019,Grays Harbor,WA,Passenger,95,95,190,48305,48495,0.39,Washington
15835,October,2019,Sumter,FL,Passenger,0,1,1,9,10,10.0,Furthest
15836,October,2019,Broward,FL,Passenger,2,1,3,124,127,2.36,Furthest
15837,October,2019,Spokane,WA,Truck,1,0,1,96090,96091,0.0,Washington
15838,October,2019,Wayne,MI,Passenger,0,1,1,62,63,1.59,Furthest
15839,October,2019,El Paso,CO,Passenger,2,1,3,733,736,0.41,Mid-Distance
15840,October,2019,Skagit,WA,Truck,1,0,1,32558,32559,0.0,Washington
15841,October,2019,Greene,MO,Passenger,0,1,1,31,32,3.12,Furthest
15842,October,2019,Pinellas,FL,Passenger,1,1,2,109,111,1.8,Furthest
15843,October,2019,Oklahoma,OK,Passenger,0,1,1,130,131,0.76,Mid-Distance
15844,October,2019,Duval,FL,Passenger,1,2,3,369,372,0.81,Furthest
15845,October,2019,Randolph,NC,Passenger,1,0,1,6,7,14.29,Furthest
15846,October,2019,Shelby,TN,Passenger,0,1,1,96,97,1.03,Furthest
15847,October,2019,Lake,IL,Passenger,1,0,1,166,167,0.6,Mid-Distance
15848,October,2019,Frederick,MD,Passenger,1,1,2,85,87,2.3,Furthest
15849,October,2019,Los Angeles,CA,Passenger,9,8,17,1071,1088,1.56,Nearest
15850,October,2019,Chelan,WA,Truck,0,0,0,22495,22495,0.0,Washington
15851,October,2019,San Joaquin,CA,Passenger,1,0,1,137,138,0.72,Nearest
15852,October,2019,Harris,TX,Passenger,1,1,2,244,246,0.81,Mid-Distance
15853,October,2019,Goochland,VA,Passenger,3,1,4,267,271,1.48,Furthest
15854,October,2019,Moore,NC,Passenger,0,1,1,177,178,0.56,Furthest
15855,October,2019,Lincoln,WA,Truck,0,0,0,4691,4691,0.0,Washington
15856,October,2020,District of Columbia,DC,Passenger,2,1,3,199,202,1.49,Furthest
15857,October,2020,RÃ­o Grande,PR,Passenger,1,0,1,1,2,50.0,Mid-Distance
15859,October,2020,Montgomery,PA,Passenger,1,0,1,25,26,3.85,Furthest
15860,October,2020,Randolph,NC,Passenger,1,0,1,7,8,12.5,Furthest
15861,October,2020,Whitman,WA,Passenger,50,46,96,21981,22077,0.43,Washington
15862,October,2020,Collin,TX,Passenger,1,1,2,116,118,1.69,Mid-Distance
15863,October,2020,Plaquemines,LA,Passenger,0,1,1,13,14,7.14,Mid-Distance
15864,October,2020,Santa Clara,CA,Passenger,5,2,7,270,277,2.53,Nearest
15865,October,2020,Clark,NV,Passenger,3,2,5,660,665,0.75,Nearest
15866,October,2020,Orange,CA,Passenger,5,3,8,461,469,1.71,Nearest
15867,October,2020,Placer,CA,Passenger,2,0,2,85,87,2.3,Nearest
15868,October,2020,Clark,WA,Passenger,2212,1121,3333,318837,322170,1.03,Washington
15869,October,2020,New Haven,CT,Passenger,0,2,2,33,35,5.71,Furthest
15870,October,2020,Stevens,WA,Truck,0,0,0,18696,18696,0.0,Washington
15871,October,2020,Thurston,WA,Truck,0,0,0,56300,56300,0.0,Washington
15872,October,2020,Whatcom,WA,Passenger,1169,531,1700,149671,151371,1.12,Washington
15873,October,2020,Harnett,NC,Passenger,1,0,1,188,189,0.53,Furthest
15874,October,2020,Skagit,WA,Truck,1,0,1,32682,32683,0.0,Washington
15875,October,2020,Moore,NC,Passenger,0,1,1,152,153,0.65,Furthest
15876,October,2020,Bexar,TX,Passenger,4,5,9,576,585,1.54,Mid-Distance
15877,October,2020,Klickitat,WA,Truck,0,0,0,8088,8088,0.0,Washington
15878,October,2020,Arapahoe,CO,Passenger,1,0,1,122,123,0.81,Mid-Distance
15879,October,2020,Columbia,WA,Truck,0,0,0,1532,1532,0.0,Washington
15880,October,2020,Duval,FL,Passenger,0,2,2,357,359,0.56,Furthest
15881,October,2020,Kent,MI,Passenger,0,1,1,23,24,4.17,Furthest
15882,October,2020,Cascade,MT,Passenger,0,1,1,51,52,1.92,Nearest
15883,October,2020,Ferry,WA,Truck,0,0,0,3596,3596,0.0,Washington
15884,October,2020,Palm Beach,FL,Passenger,0,1,1,75,76,1.32,Furthest
15885,October,2020,Fresno,CA,Passenger,1,0,1,174,175,0.57,Nearest
15886,October,2020,Walla Walla,WA,Passenger,86,65,151,36014,36165,0.42,Washington
15887,October,2020,San Juan,WA,Truck,0,0,0,5864,5864,0.0,Washington
15888,October,2020,Clackamas,OR,Passenger,2,0,2,184,186,1.08,Nearest
15889,October,2020,Pierce,WA,Truck,0,0,0,144394,144394,0.0,Washington
15890,October,2020,Lake,FL,Passenger,1,0,1,22,23,4.35,Furthest
15891,October,2020,Monterey,CA,Passenger,0,1,1,155,156,0.64,Nearest
15892,October,2020,Clark,WA,Truck,0,0,0,83170,83170,0.0,Washington
15893,October,2020,Island,WA,Passenger,463,284,747,62908,63655,1.17,Washington
15894,October,2020,Monroe,IL,Passenger,1,0,1,3,4,25.0,Mid-Distance
15895,October,2020,Howard,MD,Passenger,0,1,1,62,63,1.59,Furthest
15896,October,2020,Williamson,TX,Passenger,0,2,2,127,129,1.55,Mid-Distance
15897,October,2020,Whatcom,WA,Truck,3,0,3,43462,43465,0.01,Washington
15898,October,2020,Kitsap,WA,Truck,0,0,0,54236,54236,0.0,Washington
15899,October,2020,Cape May,NJ,Passenger,0,1,1,12,13,7.69,Furthest
15900,October,2020,Larimer,CO,Passenger,1,0,1,51,52,1.92,Mid-Distance
15901,October,2020,San Juan,WA,Passenger,340,103,443,13969,14412,3.07,Washington
15902,October,2020,Deschutes,OR,Passenger,1,0,1,123,124,0.81,Nearest
15903,October,2020,Bartow,GA,Passenger,0,1,1,4,5,20.0,Furthest
15904,October,2020,Contra Costa,CA,Passenger,4,3,7,286,293,2.39,Nearest
15905,October,2020,King,WA,Passenger,25876,8012,33888,1372970,1406858,2.41,Washington
15906,October,2020,Fairfax,VA,Passenger,4,3,7,717,724,0.97,Furthest
15907,October,2020,Harris,TX,Passenger,1,0,1,220,221,0.45,Mid-Distance
15908,October,2020,Ventura,CA,Passenger,1,1,2,271,273,0.73,Nearest
15909,October,2020,Richmond,GA,Passenger,0,1,1,79,80,1.25,Furthest
15910,October,2020,New London,CT,Passenger,1,2,3,237,240,1.25,Furthest
15911,October,2020,Frederick,MD,Passenger,1,1,2,72,74,2.7,Furthest
15912,October,2020,Rogers,OK,Passenger,1,0,1,4,5,20.0,Mid-Distance
15913,October,2020,Platte,MO,Passenger,1,0,1,17,18,5.56,Furthest
15914,October,2020,Tulsa,OK,Passenger,1,1,2,40,42,4.76,Mid-Distance
15915,October,2020,San Francisco,CA,Passenger,1,1,2,90,92,2.17,Nearest
15916,October,2020,Los Angeles,CA,Passenger,9,10,19,969,988,1.92,Nearest
15917,October,2020,Walla Walla,WA,Truck,0,0,0,13797,13797,0.0,Washington
15918,October,2020,Garfield,WA,Passenger,0,1,1,1352,1353,0.07,Washington
15919,October,2020,Spokane,WA,Passenger,828,525,1353,319743,321096,0.42,Washington
15920,October,2020,Twin Falls,ID,Passenger,0,1,1,23,24,4.17,Nearest
15921,October,2020,Denton,TX,Passenger,1,0,1,85,86,1.16,Mid-Distance
15922,October,2020,Douglas,WA,Truck,0,0,0,12416,12416,0.0,Washington
15923,October,2020,Morris,NJ,Passenger,1,0,1,18,19,5.26,Furthest
15924,October,2020,DeKalb,IN,Passenger,1,0,1,1,2,50.0,Furthest
15925,October,2020,Douglas,WA,Passenger,80,43,123,28068,28191,0.44,Washington
15926,October,2020,Allegheny,PA,Passenger,1,0,1,68,69,1.45,Furthest
15927,October,2020,Douglas,NE,Passenger,0,1,1,48,49,2.04,Mid-Distance
15928,October,2020,Boone,MO,Passenger,0,1,1,10,11,9.09,Furthest
15929,October,2020,Charles,MD,Passenger,1,1,2,75,77,2.6,Furthest
15930,October,2020,Grant,WA,Truck,0,0,0,27386,27386,0.0,Washington
15931,October,2020,Oldham,KY,Passenger,0,1,1,4,5,20.0,Furthest
15932,October,2020,Benton,WA,Truck,0,0,0,43068,43068,0.0,Washington
15933,October,2020,Okanogan,WA,Passenger,47,36,83,25991,26074,0.32,Washington
15934,October,2020,Clallam,WA,Truck,1,0,1,21767,21768,0.0,Washington
15935,October,2020,Washtenaw,MI,Passenger,1,0,1,31,32,3.12,Furthest
15936,October,2020,Greene,MO,Passenger,0,1,1,33,34,2.94,Furthest
15937,October,2020,Klamath,OR,Passenger,1,0,1,31,32,3.12,Nearest
15938,October,2020,Skamania,WA,Passenger,32,20,52,8331,8383,0.62,Washington
15939,October,2020,Howard,IN,Passenger,0,1,1,3,4,25.0,Furthest
15940,October,2020,Sumter,FL,Passenger,0,1,1,10,11,9.09,Furthest
15941,October,2020,Vigo,IN,Passenger,1,0,1,6,7,14.29,Furthest
15942,October,2020,Wilson,TX,Passenger,0,1,1,5,6,16.67,Mid-Distance
15943,October,2020,Franklin,WA,Truck,0,0,0,20373,20373,0.0,Washington
15944,October,2020,Spartanburg,SC,Passenger,0,1,1,49,50,2.0,Furthest
15945,October,2020,Montgomery,AL,Passenger,0,1,1,40,41,2.44,Furthest
15946,October,2020,Clallam,WA,Passenger,252,173,425,49893,50318,0.84,Washington
15947,October,2020,Alexandria,VA,Passenger,2,0,2,135,137,1.46,Furthest
15948,October,2020,Calvert,MD,Passenger,0,2,2,84,86,2.33,Furthest
15949,October,2020,Santa Cruz,CA,Passenger,1,0,1,30,31,3.23,Nearest
15950,October,2020,Prince George's,MD,Passenger,2,1,3,150,153,1.96,Furthest
15951,October,2020,Douglas,CO,Passenger,0,1,1,77,78,1.28,Mid-Distance
15952,October,2020,Salt Lake,UT,Passenger,0,1,1,176,177,0.56,Nearest
15953,October,2020,Juneau,AK,Passenger,0,1,1,27,28,3.57,Nearest
15954,October,2020,Owyhee,ID,Passenger,1,0,1,3,4,25.0,Nearest
15955,October,2020,Dallas,TX,Passenger,1,0,1,179,180,0.56,Mid-Distance
15956,October,2020,Chelan,WA,Passenger,265,82,347,54374,54721,0.63,Washington
15957,October,2020,Okaloosa,FL,Passenger,0,1,1,137,138,0.72,Furthest
15958,October,2020,Prince William,VA,Passenger,2,2,4,220,224,1.79,Furthest
15959,October,2020,Miami-Dade,FL,Passenger,1,0,1,103,104,0.96,Furthest
15960,October,2020,Suffolk,MA,Passenger,0,2,2,34,36,5.56,Furthest
15961,October,2020,Shelby,OH,Passenger,0,1,1,1,2,50.0,Furthest
15962,October,2020,Cowlitz,WA,Truck,0,0,0,28894,28894,0.0,Washington
15963,October,2020,Kittitas,WA,Truck,0,0,0,14630,14630,0.0,Washington
15964,October,2020,St. Louis,MO,Passenger,1,0,1,97,98,1.02,Furthest
15965,October,2020,Middlesex,MA,Passenger,1,1,2,94,96,2.08,Furthest
15966,October,2020,Adams,WA,Passenger,8,7,15,12936,12951,0.12,Washington
15967,October,2020,Ferry,WA,Passenger,8,3,11,4351,4362,0.25,Washington
15968,October,2020,Kittitas,WA,Passenger,121,49,170,29701,29871,0.57,Washington
15969,October,2020,Washington,OR,Passenger,1,0,1,421,422,0.24,Nearest
15970,October,2020,Pacific,WA,Passenger,34,34,68,15725,15793,0.43,Washington
15971,October,2020,Mason,WA,Passenger,165,134,299,47497,47796,0.63,Washington
15972,October,2020,Wahkiakum,WA,Passenger,6,6,12,3035,3047,0.39,Washington
15973,October,2020,Hawaii,HI,Passenger,1,0,1,52,53,1.89,Nearest
15974,October,2020,Skamania,WA,Truck,0,0,0,3995,3995,0.0,Washington
15975,October,2020,Manassas,VA,Passenger,0,1,1,5,6,16.67,Furthest
15976,October,2020,Asotin,WA,Truck,0,0,0,6685,6685,0.0,Washington
15977,October,2020,Lee,FL,Passenger,1,0,1,47,48,2.08,Furthest
15978,October,2020,Stafford,VA,Passenger,1,1,2,94,96,2.08,Furthest
15979,October,2020,Lewis,WA,Truck,0,0,0,26496,26496,0.0,Washington
15980,October,2020,Kern,CA,Passenger,0,1,1,219,220,0.45,Nearest
15981,October,2020,Pima,AZ,Passenger,3,1,4,325,329,1.22,Nearest
15982,October,2020,Anne Arundel,MD,Passenger,1,1,2,404,406,0.49,Furthest
15983,October,2020,Polk,FL,Passenger,1,0,1,59,60,1.67,Furthest
15984,October,2020,Williams,ND,Passenger,0,1,1,11,12,8.33,Mid-Distance
15985,October,2020,Pacific,WA,Truck,0,0,0,7752,7752,0.0,Washington
15986,October,2020,Putnam,TN,Passenger,0,1,1,2,3,33.33,Furthest
15987,October,2020,Thurston,WA,Passenger,1254,761,2015,197304,199319,1.01,Washington
15988,October,2020,Portsmouth,VA,Passenger,0,1,1,74,75,1.33,Furthest
15989,October,2020,Nassau,FL,Passenger,1,0,1,36,37,2.7,Furthest
15990,October,2020,Fort Bend,TX,Passenger,1,0,1,43,44,2.27,Mid-Distance
15991,October,2020,Yakima,WA,Truck,0,0,0,60694,60694,0.0,Washington
15992,October,2020,Broward,FL,Passenger,1,1,2,110,112,1.79,Furthest
15993,October,2020,Leavenworth,KS,Passenger,0,1,1,124,125,0.8,Mid-Distance
15994,October,2020,Sacramento,CA,Passenger,1,0,1,243,244,0.41,Nearest
15995,October,2020,Solano,CA,Passenger,1,0,1,205,206,0.49,Nearest
15996,October,2020,Hudson,NJ,Passenger,1,0,1,39,40,2.5,Furthest
15997,October,2020,Cumberland,NC,Passenger,0,3,3,450,453,0.66,Furthest
15998,October,2020,Goochland,VA,Passenger,3,2,5,246,251,1.99,Furthest
15999,October,2020,Penobscot,ME,Passenger,0,1,1,12,13,7.69,Furthest
16000,October,2020,Nueces,TX,Passenger,1,0,1,85,86,1.16,Mid-Distance
16001,October,2020,Chelan,WA,Truck,0,0,0,22770,22770,0.0,Washington
16002,October,2020,Lincoln,WA,Truck,0,0,0,4661,4661,0.0,Washington
16003,October,2020,Ramsey,MN,Passenger,1,0,1,34,35,2.86,Mid-Distance
16004,October,2020,Jefferson,NY,Passenger,0,1,1,209,210,0.48,Furthest
16005,October,2020,Kitsap,WA,Passenger,1465,730,2195,179705,181900,1.21,Washington
16006,October,2020,Kings,NY,Passenger,1,0,1,63,64,1.56,Furthest
16007,October,2020,Loudoun,VA,Passenger,1,0,1,80,81,1.23,Furthest
16008,October,2020,DeKalb,GA,Passenger,1,0,1,74,75,1.33,Furthest
16009,October,2020,Chesapeake,VA,Passenger,0,3,3,405,408,0.74,Furthest
16010,October,2020,San Joaquin,CA,Passenger,1,0,1,113,114,0.88,Nearest
16011,October,2020,Sarasota,FL,Passenger,2,0,2,24,26,7.69,Furthest
16012,October,2020,Montgomery,OH,Passenger,0,1,1,48,49,2.04,Furthest
16013,October,2020,Honolulu,HI,Passenger,5,2,7,428,435,1.61,Nearest
16014,October,2020,Klickitat,WA,Passenger,59,44,103,15003,15106,0.68,Washington
16015,October,2020,Spokane,WA,Truck,0,0,0,100211,100211,0.0,Washington
16016,October,2020,Wahkiakum,WA,Truck,0,0,0,1764,1764,0.0,Washington
16017,October,2020,Gwinnett,GA,Passenger,1,0,1,68,69,1.45,Furthest
16018,October,2020,El Paso,TX,Passenger,3,0,3,411,414,0.72,Mid-Distance
16019,October,2020,Multnomah,OR,Passenger,3,6,9,700,709,1.27,Nearest
16020,October,2020,Fulton,GA,Passenger,1,2,3,89,92,3.26,Furthest
16021,October,2020,Queens,NY,Passenger,1,0,1,52,53,1.89,Furthest
16022,October,2020,El Dorado,CA,Passenger,1,0,1,32,33,3.03,Nearest
16023,October,2020,Dakota,MN,Passenger,0,1,1,28,29,3.45,Mid-Distance
16024,October,2020,Kauai,HI,Passenger,1,0,1,14,15,6.67,Nearest
16025,October,2020,Boulder,CO,Passenger,0,1,1,42,43,2.33,Mid-Distance
16026,October,2020,Lincoln,WA,Passenger,5,10,15,7609,7624,0.2,Washington
16027,October,2020,Washoe,NV,Passenger,1,0,1,100,101,0.99,Nearest
16028,October,2020,Franklin,WA,Passenger,73,78,151,61101,61252,0.25,Washington
16029,October,2020,Yakima,WA,Passenger,157,122,279,166886,167165,0.17,Washington
16030,October,2020,Montgomery,TX,Passenger,1,0,1,47,48,2.08,Mid-Distance
16031,October,2020,Erie,NY,Passenger,1,0,1,45,46,2.17,Furthest
16032,October,2020,Arlington,VA,Passenger,0,2,2,144,146,1.37,Furthest
16033,October,2020,Pinellas,FL,Passenger,1,1,2,99,101,1.98,Furthest
16034,October,2020,Cowlitz,WA,Passenger,160,122,282,72100,72382,0.39,Washington
16035,October,2020,Harrison,MS,Passenger,1,0,1,51,52,1.92,Mid-Distance
16036,October,2020,Stevens,WA,Passenger,36,39,75,30368,30443,0.25,Washington
16037,October,2020,Skagit,WA,Passenger,466,231,697,91532,92229,0.76,Washington
16038,October,2020,Okanogan,WA,Truck,0,0,0,16573,16573,0.0,Washington
16039,October,2020,El Paso,CO,Passenger,2,0,2,699,701,0.29,Mid-Distance
16040,October,2020,Hamilton,IN,Passenger,2,0,2,37,39,5.13,Furthest
16041,October,2020,Riverside,CA,Passenger,4,1,5,600,605,0.83,Nearest
16042,October,2020,St. Clair,IL,Passenger,1,0,1,136,137,0.73,Mid-Distance
16043,October,2020,New York,NY,Passenger,1,0,1,56,57,1.75,Furthest
16044,October,2020,Hennepin,MN,Passenger,2,0,2,83,85,2.35,Mid-Distance
16045,October,2020,Richland,SC,Passenger,0,1,1,143,144,0.69,Furthest
16046,October,2020,DuPage,IL,Passenger,3,0,3,54,57,5.26,Mid-Distance
16047,October,2020,Grant,WA,Passenger,71,81,152,65747,65899,0.23,Washington
16048,October,2020,Houston,GA,Passenger,1,0,1,52,53,1.89,Furthest
16049,October,2020,Jefferson,WA,Truck,0,0,0,9575,9575,0.0,Washington
16050,October,2020,Pend Oreille,WA,Truck,0,0,0,5717,5717,0.0,Washington
16051,October,2020,Fairbanks North Star,AK,Passenger,0,1,1,94,95,1.05,Nearest
16052,October,2020,Jones,GA,Passenger,1,0,1,1,2,50.0,Furthest
16053,October,2020,Rockingham,NH,Passenger,1,0,1,22,23,4.35,Furthest
16054,October,2020,King,WA,Truck,5,1,6,184061,184067,0.0,Washington
16055,October,2020,Pend Oreille,WA,Passenger,8,4,12,9158,9170,0.13,Washington
16056,October,2020,Snohomish,WA,Truck,0,0,0,125318,125318,0.0,Washington
16057,October,2020,Ada,ID,Passenger,0,1,1,250,251,0.4,Nearest
16058,October,2020,Benton,WA,Passenger,403,339,742,134682,135424,0.55,Washington
16059,October,2020,Jefferson,WA,Passenger,260,151,411,24723,25134,1.64,Washington
16060,October,2020,Ulster,NY,Passenger,1,0,1,8,9,11.11,Furthest
16061,October,2020,Mason,WA,Truck,0,0,0,20836,20836,0.0,Washington
16062,October,2020,Carroll,MD,Passenger,0,1,1,21,22,4.55,Furthest
16063,October,2020,San Diego,CA,Passenger,14,4,18,2724,2742,0.66,Nearest
16064,October,2020,Suffolk,VA,Passenger,1,0,1,126,127,0.79,Furthest
16065,October,2020,Flathead,MT,Passenger,1,0,1,54,55,1.82,Nearest
16066,October,2020,Garfield,WA,Truck,0,0,0,991,991,0.0,Washington
16067,October,2020,Utah,UT,Passenger,0,1,1,128,129,0.78,Nearest
16068,October,2020,Sedgwick,KS,Passenger,1,1,2,91,93,2.15,Mid-Distance
16069,October,2020,Nassau,NY,Passenger,4,0,4,28,32,12.5,Furthest
16070,October,2020,Bucks,PA,Passenger,1,0,1,18,19,5.26,Furthest
16071,October,2020,Maricopa,AZ,Passenger,5,6,11,1330,1341,0.82,Nearest
16072,October,2020,Grays Harbor,WA,Passenger,118,117,235,48521,48756,0.48,Washington
16073,October,2020,San Mateo,CA,Passenger,1,1,2,105,107,1.87,Nearest
16074,October,2020,St. Mary's,MD,Passenger,1,0,1,215,216,0.46,Furthest
16075,October,2020,Alameda,CA,Passenger,2,0,2,255,257,0.78,Nearest
16076,October,2020,Saginaw,MI,Passenger,1,0,1,9,10,10.0,Furthest
16077,October,2020,Virginia Beach,VA,Passenger,1,0,1,646,647,0.15,Furthest
16078,October,2020,Albemarle,VA,Passenger,1,0,1,21,22,4.55,Furthest
16079,October,2020,Carson City,NV,Passenger,1,0,1,11,12,8.33,Nearest
16080,October,2020,Grays Harbor,WA,Truck,0,0,0,21123,21123,0.0,Washington
16081,October,2020,Maui,HI,Passenger,1,0,1,28,29,3.45,Nearest
16082,October,2020,Travis,TX,Passenger,2,1,3,168,171,1.75,Mid-Distance
16083,October,2020,Columbia,WA,Passenger,4,3,7,2439,2446,0.29,Washington
16084,October,2020,Powhatan,VA,Passenger,1,0,1,0,1,100.0,Furthest
16085,October,2020,Norfolk,VA,Passenger,2,3,5,345,350,1.43,Furthest
16086,October,2020,Charleston,SC,Passenger,2,0,2,91,93,2.15,Furthest
16087,October,2020,Carroll,NH,Passenger,0,1,1,5,6,16.67,Furthest
16088,October,2020,Denver,CO,Passenger,1,0,1,113,114,0.88,Mid-Distance
16089,October,2020,Lewis,WA,Passenger,114,115,229,58451,58680,0.39,Washington
16090,October,2020,Camden,NJ,Passenger,0,1,1,22,23,4.35,Furthest
16091,October,2020,Bradley,TN,Passenger,1,0,1,0,1,100.0,Furthest
16092,October,2020,Pierce,WA,Passenger,2660,1740,4400,554816,559216,0.79,Washington
16093,October,2020,Asotin,WA,Passenger,17,14,31,12401,12432,0.25,Washington
16094,October,2020,Whitman,WA,Truck,0,0,0,8487,8487,0.0,Washington
16095,October,2020,Snohomish,WA,Passenger,4831,1816,6647,537854,544501,1.22,Washington
16096,October,2020,Adams,WA,Truck,0,0,0,5335,5335,0.0,Washington
16097,October,2020,Island,WA,Truck,1,0,1,21311,21312,0.0,Washington
16098,October,2020,Lake,IL,Passenger,2,0,2,160,162,1.23,Mid-Distance
16099,October,2020,Hampshire,MA,Passenger,1,0,1,6,7,14.29,Furthest
16100,October,2021,Clark,NV,Passenger,4,2,6,573,579,1.04,Nearest
16101,October,2021,St. Mary's,MD,Passenger,1,0,1,203,204,0.49,Furthest
16103,October,2021,Kitsap,WA,Passenger,2042,916,2958,180643,183601,1.61,Washington
16104,October,2021,Ferry,WA,Passenger,11,3,14,4446,4460,0.31,Washington
16105,October,2021,Milwaukee,WI,Passenger,1,0,1,36,37,2.7,Mid-Distance
16106,October,2021,Richmond,GA,Passenger,0,1,1,71,72,1.39,Furthest
16107,October,2021,Stafford,VA,Passenger,2,1,3,96,99,3.03,Furthest
16108,October,2021,Monterey,CA,Passenger,0,1,1,142,143,0.7,Nearest
16109,October,2021,Carroll,NH,Passenger,0,1,1,5,6,16.67,Furthest
16110,October,2021,Snohomish,WA,Truck,2,0,2,125795,125797,0.0,Washington
16111,October,2021,Stevens,WA,Truck,0,0,0,18891,18891,0.0,Washington
16112,October,2021,Juneau,AK,Passenger,0,1,1,27,28,3.57,Nearest
16113,October,2021,Island,WA,Truck,0,0,0,21569,21569,0.0,Washington
16114,October,2021,Fairbanks North Star,AK,Passenger,0,1,1,77,78,1.28,Nearest
16115,October,2021,Rockdale,GA,Passenger,1,0,1,7,8,12.5,Furthest
16116,October,2021,Chelan,WA,Truck,0,0,0,23075,23075,0.0,Washington
16117,October,2021,Walla Walla,WA,Passenger,132,82,214,36363,36577,0.59,Washington
16118,October,2021,Las Animas,CO,Passenger,1,0,1,0,1,100.0,Mid-Distance
16119,October,2021,Grays Harbor,WA,Truck,0,0,0,21396,21396,0.0,Washington
16120,October,2021,Klickitat,WA,Passenger,87,51,138,15357,15495,0.89,Washington
16121,October,2021,Ventura,CA,Passenger,2,1,3,248,251,1.2,Nearest
16122,October,2021,Cowlitz,WA,Truck,0,1,1,29069,29070,0.0,Washington
16123,October,2021,Grant,WA,Passenger,133,95,228,66824,67052,0.34,Washington
16124,October,2021,Whatcom,WA,Truck,4,0,4,43778,43782,0.01,Washington
16125,October,2021,Champaign,IL,Passenger,1,0,1,10,11,9.09,Mid-Distance
16126,October,2021,Fresno,CA,Passenger,1,0,1,160,161,0.62,Nearest
16127,October,2021,Montgomery,PA,Passenger,2,0,2,23,25,8.0,Furthest
16128,October,2021,Harrison,MS,Passenger,2,0,2,48,50,4.0,Mid-Distance
16129,October,2021,Hudson,NJ,Passenger,1,0,1,41,42,2.38,Furthest
16130,October,2021,Hawaii,HI,Passenger,1,0,1,41,42,2.38,Nearest
16131,October,2021,Montgomery,TX,Passenger,1,1,2,37,39,5.13,Mid-Distance
16132,October,2021,Suffolk,VA,Passenger,1,0,1,122,123,0.81,Furthest
16133,October,2021,Yamhill,OR,Passenger,1,0,1,32,33,3.03,Nearest
16134,October,2021,DeKalb,GA,Passenger,1,0,1,56,57,1.75,Furthest
16135,October,2021,Asotin,WA,Passenger,21,17,38,12770,12808,0.3,Washington
16136,October,2021,Grant,WA,Truck,0,0,0,28018,28018,0.0,Washington
16137,October,2021,Wahkiakum,WA,Passenger,17,8,25,3065,3090,0.81,Washington
16138,October,2021,Fairfax,VA,Passenger,4,4,8,664,672,1.19,Furthest
16139,October,2021,Portsmouth,VA,Passenger,0,1,1,77,78,1.28,Furthest
16140,October,2021,Harnett,NC,Passenger,1,1,2,153,155,1.29,Furthest
16141,October,2021,Hillsborough,FL,Passenger,0,1,1,142,143,0.7,Furthest
16142,October,2021,Arlington,VA,Passenger,1,1,2,128,130,1.54,Furthest
16143,October,2021,Lewis,WA,Passenger,194,158,352,59631,59983,0.59,Washington
16144,October,2021,Adams,WA,Truck,0,0,0,5409,5409,0.0,Washington
16145,October,2021,Lake,IL,Passenger,3,0,3,154,157,1.91,Mid-Distance
16146,October,2021,Honolulu,HI,Passenger,5,3,8,363,371,2.16,Nearest
16147,October,2021,Whatcom,WA,Passenger,1581,646,2227,150431,152658,1.46,Washington
16148,October,2021,Orange,FL,Passenger,1,0,1,107,108,0.93,Furthest
16149,October,2021,Rogers,OK,Passenger,1,0,1,3,4,25.0,Mid-Distance
16150,October,2021,Penobscot,ME,Passenger,0,1,1,8,9,11.11,Furthest
16151,October,2021,Pacific,WA,Truck,0,0,0,7990,7990,0.0,Washington
16152,October,2021,Washington,MD,Passenger,2,0,2,13,15,13.33,Furthest
16153,October,2021,Sarpy,NE,Passenger,1,0,1,58,59,1.69,Mid-Distance
16154,October,2021,Yakima,WA,Passenger,270,165,435,168835,169270,0.26,Washington
16155,October,2021,Goochland,VA,Passenger,3,2,5,197,202,2.48,Furthest
16156,October,2021,Pierce,WA,Passenger,4001,2085,6086,557924,564010,1.08,Washington
16157,October,2021,Columbia,WA,Passenger,7,2,9,2439,2448,0.37,Washington
16158,October,2021,Clark,WA,Truck,0,0,0,84034,84034,0.0,Washington
16159,October,2021,Harris,TX,Passenger,1,1,2,170,172,1.16,Mid-Distance
16160,October,2021,Pend Oreille,WA,Passenger,18,7,25,9206,9231,0.27,Washington
16161,October,2021,Wichita,TX,Passenger,1,0,1,43,44,2.27,Mid-Distance
16162,October,2021,Snohomish,WA,Passenger,6655,2197,8852,538791,547643,1.62,Washington
16163,October,2021,Montgomery,OH,Passenger,0,1,1,53,54,1.85,Furthest
16164,October,2021,Carson City,NV,Passenger,1,0,1,10,11,9.09,Nearest
16165,October,2021,Middlesex,MA,Passenger,1,1,2,86,88,2.27,Furthest
16166,October,2021,King,WA,Passenger,33841,9915,43756,1363940,1407696,3.11,Washington
16167,October,2021,Jefferson,WA,Passenger,362,191,553,24778,25331,2.18,Washington
16168,October,2021,Placer,CA,Passenger,2,0,2,71,73,2.74,Nearest
16169,October,2021,Klickitat,WA,Truck,0,0,0,8316,8316,0.0,Washington
16170,October,2021,Charles,MD,Passenger,1,1,2,68,70,2.86,Furthest
16171,October,2021,Boone,MO,Passenger,0,1,1,9,10,10.0,Furthest
16172,October,2021,Sedgwick,KS,Passenger,1,1,2,79,81,2.47,Mid-Distance
16173,October,2021,Shelby,OH,Passenger,0,1,1,2,3,33.33,Furthest
16174,October,2021,Riverside,CA,Passenger,5,1,6,514,520,1.15,Nearest
16175,October,2021,Larimer,CO,Passenger,1,0,1,49,50,2.0,Mid-Distance
16176,October,2021,Charleston,SC,Passenger,2,1,3,79,82,3.66,Furthest
16177,October,2021,Douglas,CO,Passenger,0,1,1,75,76,1.32,Mid-Distance
16178,October,2021,Garfield,WA,Passenger,0,3,3,1355,1358,0.22,Washington
16179,October,2021,Cook,IL,Passenger,2,0,2,195,197,1.02,Mid-Distance
16180,October,2021,Ulster,NY,Passenger,1,0,1,9,10,10.0,Furthest
16181,October,2021,Lewis,WA,Truck,0,0,0,26738,26738,0.0,Washington
16182,October,2021,Island,WA,Passenger,679,333,1012,63091,64103,1.58,Washington
16183,October,2021,Saratoga,NY,Passenger,1,0,1,41,42,2.38,Furthest
16184,October,2021,Sacramento,CA,Passenger,2,0,2,215,217,0.92,Nearest
16185,October,2021,Clark,WA,Passenger,3253,1514,4767,321077,325844,1.46,Washington
16186,October,2021,Wilson,TX,Passenger,0,1,1,2,3,33.33,Mid-Distance
16187,October,2021,Hamilton,IN,Passenger,2,0,2,28,30,6.67,Furthest
16188,October,2021,Lincoln,WA,Passenger,7,16,23,7707,7730,0.3,Washington
16189,October,2021,Salt Lake,UT,Passenger,0,1,1,158,159,0.63,Nearest
16190,October,2021,Richland,SC,Passenger,0,1,1,129,130,0.77,Furthest
16191,October,2021,Douglas,WA,Passenger,103,51,154,28576,28730,0.54,Washington
16192,October,2021,Powhatan,VA,Passenger,1,0,1,1,2,50.0,Furthest
16193,October,2021,Broward,FL,Passenger,2,0,2,97,99,2.02,Furthest
16194,October,2021,Greene,MO,Passenger,0,1,1,26,27,3.7,Furthest
16195,October,2021,Houston,GA,Passenger,1,0,1,44,45,2.22,Furthest
16196,October,2021,Hidalgo,TX,Passenger,0,1,1,54,55,1.82,Mid-Distance
16197,October,2021,Burlington,NJ,Passenger,0,1,1,120,121,0.83,Furthest
16198,October,2021,Chesapeake,VA,Passenger,1,3,4,376,380,1.05,Furthest
16199,October,2021,St. Clair,IL,Passenger,2,0,2,123,125,1.6,Mid-Distance
16200,October,2021,Whitman,WA,Truck,0,0,0,8556,8556,0.0,Washington
16201,October,2021,Geary,KS,Passenger,1,0,1,96,97,1.03,Mid-Distance
16202,October,2021,Sumter,SC,Passenger,0,1,1,36,37,2.7,Furthest
16203,October,2021,Tarrant,TX,Passenger,1,0,1,136,137,0.73,Mid-Distance
16204,October,2021,Escambia,FL,Passenger,0,1,1,139,140,0.71,Furthest
16205,October,2021,Spartanburg,SC,Passenger,0,1,1,48,49,2.04,Furthest
16206,October,2021,Kittitas,WA,Passenger,193,72,265,29844,30109,0.88,Washington
16207,October,2021,Manassas,VA,Passenger,0,1,1,7,8,12.5,Furthest
16208,October,2021,Spokane,WA,Truck,0,0,0,102587,102587,0.0,Washington
16209,October,2021,Williamson,TX,Passenger,1,2,3,97,100,3.0,Mid-Distance
16210,October,2021,Cape May,NJ,Passenger,0,1,1,8,9,11.11,Furthest
16211,October,2021,New York,NY,Passenger,1,0,1,37,38,2.63,Furthest
16212,October,2021,Duval,FL,Passenger,0,2,2,321,323,0.62,Furthest
16213,October,2021,Mason,WA,Passenger,246,156,402,47894,48296,0.83,Washington
16214,October,2021,Howard,IN,Passenger,0,1,1,6,7,14.29,Furthest
16215,October,2021,Rockingham,NH,Passenger,1,0,1,19,20,5.0,Furthest
16216,October,2021,Cumberland,NC,Passenger,0,2,2,399,401,0.5,Furthest
16217,October,2021,Pima,AZ,Passenger,1,1,2,251,253,0.79,Nearest
16218,October,2021,Nueces,TX,Passenger,1,0,1,64,65,1.54,Mid-Distance
16219,October,2021,Cowlitz,WA,Passenger,258,154,412,71857,72269,0.57,Washington
16220,October,2021,New London,CT,Passenger,1,4,5,212,217,2.3,Furthest
16221,October,2021,Fort Bend,TX,Passenger,1,0,1,35,36,2.78,Mid-Distance
16222,October,2021,Missoula,MT,Passenger,1,0,1,52,53,1.89,Nearest
16223,October,2021,Wake,NC,Passenger,1,0,1,112,113,0.88,Furthest
16224,October,2021,Sonoma,CA,Passenger,0,1,1,82,83,1.2,Nearest
16225,October,2021,Denton,TX,Passenger,1,0,1,76,77,1.3,Mid-Distance
16226,October,2021,Lee,FL,Passenger,1,0,1,33,34,2.94,Furthest
16227,October,2021,Richmond,NY,Passenger,1,0,1,6,7,14.29,Furthest
16228,October,2021,Franklin,WA,Passenger,144,102,246,62082,62328,0.39,Washington
16229,October,2021,Baltimore,MD,Passenger,1,0,1,86,87,1.15,Furthest
16230,October,2021,RÃ­o Grande,PR,Passenger,1,0,1,0,1,100.0,Mid-Distance
16231,October,2021,Multnomah,OR,Passenger,2,6,8,622,630,1.27,Nearest
16232,October,2021,Skamania,WA,Truck,0,0,0,4019,4019,0.0,Washington
16233,October,2021,Solano,CA,Passenger,1,0,1,177,178,0.56,Nearest
16234,October,2021,Calvert,MD,Passenger,0,2,2,83,85,2.35,Furthest
16235,October,2021,Onslow,NC,Passenger,0,1,1,170,171,0.58,Furthest
16236,October,2021,Douglas,NE,Passenger,1,1,2,49,51,3.92,Mid-Distance
16237,October,2021,Williams,ND,Passenger,0,1,1,8,9,11.11,Mid-Distance
16238,October,2021,Thurston,WA,Passenger,1803,921,2724,197240,199964,1.36,Washington
16239,October,2021,Clallam,WA,Truck,1,0,1,22063,22064,0.0,Washington
16240,October,2021,Clackamas,OR,Passenger,2,0,2,165,167,1.2,Nearest
16241,October,2021,Kings,CA,Passenger,2,0,2,322,324,0.62,Nearest
16242,October,2021,Saginaw,MI,Passenger,1,0,1,5,6,16.67,Furthest
16243,October,2021,Pacific,WA,Passenger,49,59,108,16114,16222,0.67,Washington
16244,October,2021,Platte,MO,Passenger,1,0,1,17,18,5.56,Furthest
16245,October,2021,Clallam,WA,Passenger,365,235,600,50522,51122,1.17,Washington
16246,October,2021,Whitman,WA,Passenger,63,58,121,21932,22053,0.55,Washington
16247,October,2021,Garfield,WA,Truck,0,0,0,999,999,0.0,Washington
16248,October,2021,Sevier,AR,Passenger,0,1,1,0,1,100.0,Mid-Distance
16249,October,2021,Moore,NC,Passenger,0,1,1,123,124,0.81,Furthest
16250,October,2021,Columbia,WA,Truck,0,0,0,1537,1537,0.0,Washington
16251,October,2021,San Joaquin,CA,Passenger,1,1,2,96,98,2.04,Nearest
16252,October,2021,Kern,CA,Passenger,0,1,1,196,197,0.51,Nearest
16253,October,2021,San Luis Obispo,CA,Passenger,1,0,1,58,59,1.69,Nearest
16254,October,2021,Suffolk,MA,Passenger,0,2,2,27,29,6.9,Furthest
16255,October,2021,Anne Arundel,MD,Passenger,4,3,7,363,370,1.89,Furthest
16256,October,2021,Alexandria,VA,Passenger,2,0,2,122,124,1.61,Furthest
16257,October,2021,Wahkiakum,WA,Truck,0,0,0,1827,1827,0.0,Washington
16258,October,2021,San Juan,WA,Truck,0,0,0,5976,5976,0.0,Washington
16259,October,2021,Montgomery,MD,Passenger,3,2,5,206,211,2.37,Furthest
16260,October,2021,Pierce,WA,Truck,0,0,0,145249,145249,0.0,Washington
16261,October,2021,Bexar,TX,Passenger,3,5,8,489,497,1.61,Mid-Distance
16262,October,2021,Erie,NY,Passenger,1,0,1,31,32,3.12,Furthest
16263,October,2021,Allegheny,PA,Passenger,1,1,2,60,62,3.23,Furthest
16264,October,2021,Loudoun,VA,Passenger,1,0,1,67,68,1.47,Furthest
16265,October,2021,Frederick,MD,Passenger,1,1,2,69,71,2.82,Furthest
16266,October,2021,Pend Oreille,WA,Truck,0,0,0,5687,5687,0.0,Washington
16267,October,2021,Jefferson,WA,Truck,0,0,0,9592,9592,0.0,Washington
16268,October,2021,Kitsap,WA,Truck,0,0,0,54245,54245,0.0,Washington
16269,October,2021,Asotin,WA,Truck,0,0,0,6748,6748,0.0,Washington
16270,October,2021,New Haven,CT,Passenger,0,2,2,28,30,6.67,Furthest
16271,October,2021,Mason,WA,Truck,0,0,0,21283,21283,0.0,Washington
16272,October,2021,Coryell,TX,Passenger,1,0,1,108,109,0.92,Mid-Distance
16273,October,2021,Randolph,NC,Passenger,1,0,1,5,6,16.67,Furthest
16274,October,2021,Hamilton,OH,Passenger,1,0,1,33,34,2.94,Furthest
16275,October,2021,Los Angeles,CA,Passenger,7,9,16,833,849,1.88,Nearest
16276,October,2021,Okanogan,WA,Passenger,66,44,110,26572,26682,0.41,Washington
16277,October,2021,Kings,NY,Passenger,1,0,1,70,71,1.41,Furthest
16278,October,2021,Douglas,WA,Truck,0,0,0,12679,12679,0.0,Washington
16279,October,2021,Collin,TX,Passenger,1,0,1,100,101,0.99,Mid-Distance
16280,October,2021,Benton,WA,Truck,0,0,0,43707,43707,0.0,Washington
16281,October,2021,Flathead,MT,Passenger,1,0,1,43,44,2.27,Nearest
16282,October,2021,Pinellas,FL,Passenger,0,1,1,89,90,1.11,Furthest
16283,October,2021,Okaloosa,FL,Passenger,0,1,1,112,113,0.88,Furthest
16284,October,2021,Benton,WA,Passenger,595,426,1021,136009,137030,0.75,Washington
16285,October,2021,Skamania,WA,Passenger,58,39,97,8335,8432,1.15,Washington
16286,October,2021,Franklin,WA,Truck,0,0,0,20773,20773,0.0,Washington
16287,October,2021,Vigo,IN,Passenger,1,0,1,5,6,16.67,Furthest
16288,October,2021,San Juan,WA,Passenger,469,146,615,14189,14804,4.15,Washington
16289,October,2021,Grays Harbor,WA,Passenger,187,151,338,49486,49824,0.68,Washington
16290,October,2021,Dorchester,SC,Passenger,1,0,1,65,66,1.52,Furthest
16291,October,2021,San Francisco,CA,Passenger,0,1,1,81,82,1.22,Nearest
16292,October,2021,Nassau,NY,Passenger,2,0,2,25,27,7.41,Furthest
16293,October,2021,Ferry,WA,Truck,0,0,0,3592,3592,0.0,Washington
16294,October,2021,El Paso,TX,Passenger,3,0,3,349,352,0.85,Mid-Distance
16295,October,2021,Thurston,WA,Truck,0,0,0,56195,56195,0.0,Washington
16296,October,2021,Albemarle,VA,Passenger,1,0,1,19,20,5.0,Furthest
16297,October,2021,Owyhee,ID,Passenger,1,0,1,2,3,33.33,Nearest
16298,October,2021,Contra Costa,CA,Passenger,1,4,5,264,269,1.86,Nearest
16299,October,2021,Santa Clara,CA,Passenger,7,2,9,237,246,3.66,Nearest
16300,October,2021,Carroll,MD,Passenger,0,1,1,16,17,5.88,Furthest
16301,October,2021,Washington,OR,Passenger,1,0,1,355,356,0.28,Nearest
16302,October,2021,Allen,IN,Passenger,1,0,1,15,16,6.25,Furthest
16303,October,2021,Walla Walla,WA,Truck,0,0,0,14050,14050,0.0,Washington
16304,October,2021,Alameda,CA,Passenger,4,0,4,212,216,1.85,Nearest
16305,October,2021,Klamath,OR,Passenger,1,0,1,28,29,3.45,Nearest
16306,October,2021,Queens,NY,Passenger,1,0,1,44,45,2.22,Furthest
16307,October,2021,Philadelphia,PA,Passenger,1,0,1,40,41,2.44,Furthest
16308,October,2021,Skagit,WA,Truck,1,0,1,32836,32837,0.0,Washington
16309,October,2021,Yakima,WA,Truck,0,0,0,61670,61670,0.0,Washington
16310,October,2021,Adams,WA,Passenger,16,14,30,13034,13064,0.23,Washington
16311,October,2021,Hennepin,MN,Passenger,3,0,3,69,72,4.17,Mid-Distance
16312,October,2021,Miami-Dade,FL,Passenger,1,0,1,94,95,1.05,Furthest
16313,October,2021,Louisa,VA,Passenger,0,1,1,1,2,50.0,Furthest
16314,October,2021,Anchorage,AK,Passenger,1,0,1,130,131,0.76,Nearest
16315,October,2021,Prince William,VA,Passenger,1,1,2,201,203,0.99,Furthest
16316,October,2021,Boulder,CO,Passenger,1,1,2,37,39,5.13,Mid-Distance
16317,October,2021,Polk,FL,Passenger,1,0,1,53,54,1.85,Furthest
16318,October,2021,Sarasota,FL,Passenger,2,0,2,30,32,6.25,Furthest
16319,October,2021,Essex,NJ,Passenger,2,0,2,10,12,16.67,Furthest
16320,October,2021,District of Columbia,DC,Passenger,5,0,5,193,198,2.53,Furthest
16321,October,2021,Orange,CA,Passenger,5,2,7,389,396,1.77,Nearest
16322,October,2021,King,WA,Truck,4,1,5,183489,183494,0.0,Washington
16323,October,2021,Stevens,WA,Passenger,52,43,95,30243,30338,0.31,Washington
16324,October,2021,Howard,MD,Passenger,0,1,1,54,55,1.82,Furthest
16325,October,2021,Camden,NJ,Passenger,0,1,1,14,15,6.67,Furthest
16326,October,2021,Pennington,SD,Passenger,1,0,1,30,31,3.23,Mid-Distance
16327,October,2021,Bartow,GA,Passenger,0,1,1,3,4,25.0,Furthest
16328,October,2021,Skagit,WA,Passenger,649,295,944,91478,92422,1.02,Washington
16329,October,2021,Spokane,WA,Passenger,1218,727,1945,326533,328478,0.59,Washington
16330,October,2021,Bernalillo,NM,Passenger,1,0,1,111,112,0.89,Mid-Distance
16331,October,2021,Kittitas,WA,Truck,0,0,0,14773,14773,0.0,Washington
16332,October,2021,Leavenworth,KS,Passenger,0,1,1,108,109,0.92,Mid-Distance
16333,October,2021,Chelan,WA,Passenger,385,110,495,54679,55174,0.9,Washington
16334,October,2021,Lane,OR,Passenger,0,1,1,114,115,0.87,Nearest
16335,October,2021,Gwinnett,GA,Passenger,1,0,1,58,59,1.69,Furthest
16336,October,2021,Wilson,NC,Passenger,1,0,1,0,1,100.0,Furthest
16337,October,2021,Kauai,HI,Passenger,1,0,1,17,18,5.56,Nearest
16338,October,2021,Travis,TX,Passenger,3,3,6,132,138,4.35,Mid-Distance
16339,October,2021,Oldham,KY,Passenger,0,1,1,4,5,20.0,Furthest
16340,October,2021,Jefferson,NY,Passenger,0,1,1,206,207,0.48,Furthest
16341,October,2021,Santa Cruz,CA,Passenger,1,0,1,25,26,3.85,Nearest
16342,October,2021,Lincoln,WA,Truck,0,0,0,4804,4804,0.0,Washington
16343,October,2021,San Diego,CA,Passenger,16,8,24,2467,2491,0.96,Nearest
16344,October,2021,Virginia Beach,VA,Passenger,2,0,2,576,578,0.35,Furthest
16345,October,2021,DuPage,IL,Passenger,1,0,1,50,51,1.96,Mid-Distance
16346,October,2021,Norfolk,VA,Passenger,3,3,6,312,318,1.89,Furthest
16347,October,2021,Ray,MO,Passenger,0,1,1,1,2,50.0,Furthest
16348,October,2021,Okanogan,WA,Truck,0,0,0,16678,16678,0.0,Washington
16349,October,2021,El Paso,CO,Passenger,3,0,3,655,658,0.46,Mid-Distance
16350,October,2021,San Mateo,CA,Passenger,2,0,2,83,85,2.35,Nearest
16351,October,2021,Danville,VA,Passenger,1,0,1,0,1,100.0,Furthest
16352,October,2021,Maricopa,AZ,Passenger,8,2,10,1080,1090,0.92,Nearest
16353,October,2021,St. Louis,MO,Passenger,1,0,1,72,73,1.37,Furthest
16354,October,2021,Lake,FL,Passenger,1,0,1,22,23,4.35,Furthest
16355,October,2021,Prince George's,MD,Passenger,2,1,3,138,141,2.13,Furthest
16356,October,2021,Plaquemines,LA,Passenger,0,1,1,17,18,5.56,Mid-Distance
16357,October,2021,Dallas,TX,Passenger,1,0,1,144,145,0.69,Mid-Distance
16358,October,2022,Hamilton,OH,Passenger,1,0,1,28,29,3.45,Furthest
16359,October,2022,Walla Walla,WA,Passenger,190,107,297,35711,36008,0.82,Washington
16360,October,2022,Lane,OR,Passenger,0,1,1,75,76,1.32,Nearest
16361,October,2022,Pend Oreille,WA,Passenger,18,12,30,9012,9042,0.33,Washington
16362,October,2022,Montgomery,AL,Passenger,0,1,1,29,30,3.33,Furthest
16363,October,2022,Ferry,WA,Passenger,24,4,28,4384,4412,0.63,Washington
16364,October,2022,Hudson,NJ,Passenger,2,0,2,30,32,6.25,Furthest
16365,October,2022,Santa Cruz,CA,Passenger,1,0,1,19,20,5.0,Nearest
16366,October,2022,Mason,WA,Passenger,350,187,537,46978,47515,1.13,Washington
16367,October,2022,Kern,CA,Passenger,1,1,2,186,188,1.06,Nearest
16368,October,2022,Collin,TX,Passenger,2,0,2,60,62,3.23,Mid-Distance
16369,October,2022,Yakima,WA,Passenger,394,214,608,166433,167041,0.36,Washington
16370,October,2022,Middlesex,MA,Passenger,2,1,3,61,64,4.69,Furthest
16371,October,2022,New Haven,CT,Passenger,0,2,2,24,26,7.69,Furthest
16372,October,2022,Geary,KS,Passenger,1,0,1,78,79,1.27,Mid-Distance
16373,October,2022,Escambia,FL,Passenger,0,1,1,119,120,0.83,Furthest
16374,October,2022,Solano,CA,Passenger,2,0,2,148,150,1.33,Nearest
16375,October,2022,Moore,NC,Passenger,0,1,1,108,109,0.92,Furthest
16376,October,2022,Walla Walla,WA,Truck,3,0,3,13949,13952,0.02,Washington
16377,October,2022,Whitman,WA,Passenger,103,65,168,21978,22146,0.76,Washington
16378,October,2022,Washington,MD,Passenger,2,0,2,14,16,12.5,Furthest
16379,October,2022,Snohomish,WA,Passenger,9424,2670,12094,531029,543123,2.23,Washington
16380,October,2022,Wilson,TX,Passenger,0,1,1,2,3,33.33,Mid-Distance
16381,October,2022,Norfolk,VA,Passenger,3,3,6,273,279,2.15,Furthest
16382,October,2022,Grant,WA,Truck,2,0,2,28024,28026,0.01,Washington
16383,October,2022,Manassas,VA,Passenger,0,1,1,7,8,12.5,Furthest
16384,October,2022,Goochland,VA,Passenger,0,1,1,74,75,1.33,Furthest
16385,October,2022,District of Columbia,DC,Passenger,4,0,4,158,162,2.47,Furthest
16386,October,2022,Wichita,TX,Passenger,2,0,2,36,38,5.26,Mid-Distance
16387,October,2022,Pierce,WA,Passenger,5747,2449,8196,540967,549163,1.49,Washington
16388,October,2022,Thurston,WA,Truck,30,0,30,54906,54936,0.05,Washington
16389,October,2022,Grays Harbor,WA,Truck,2,0,2,21098,21100,0.01,Washington
16390,October,2022,Chelan,WA,Truck,8,0,8,23087,23095,0.03,Washington
16391,October,2022,Montgomery,PA,Passenger,1,0,1,19,20,5.0,Furthest
16392,October,2022,Pend Oreille,WA,Truck,0,0,0,5614,5614,0.0,Washington
16393,October,2022,Fairfax,VA,Passenger,6,3,9,570,579,1.55,Furthest
16394,October,2022,Clark,WA,Truck,31,0,31,82151,82182,0.04,Washington
16395,October,2022,Sedgwick,KS,Passenger,1,1,2,65,67,2.99,Mid-Distance
16396,October,2022,Spartanburg,SC,Passenger,0,1,1,29,30,3.33,Furthest
16397,October,2022,Alexandria,VA,Passenger,4,0,4,97,101,3.96,Furthest
16398,October,2022,Whatcom,WA,Truck,20,0,20,43123,43143,0.05,Washington
16399,October,2022,Jefferson,WA,Truck,5,0,5,9394,9399,0.05,Washington
16400,October,2022,Bexar,TX,Passenger,5,3,8,389,397,2.02,Mid-Distance
16401,October,2022,Sumter,SC,Passenger,0,1,1,33,34,2.94,Furthest
16402,October,2022,Portsmouth,VA,Passenger,0,1,1,71,72,1.39,Furthest
16403,October,2022,Travis,TX,Passenger,1,0,1,88,89,1.12,Mid-Distance
16404,October,2022,Placer,CA,Passenger,2,0,2,58,60,3.33,Nearest
16405,October,2022,Bell,TX,Passenger,1,0,1,283,284,0.35,Mid-Distance
16406,October,2022,Calvert,MD,Passenger,0,2,2,74,76,2.63,Furthest
16407,October,2022,Asotin,WA,Truck,0,0,0,6692,6692,0.0,Washington
16408,October,2022,Denton,TX,Passenger,1,0,1,54,55,1.82,Mid-Distance
16409,October,2022,Essex,NJ,Passenger,2,0,2,8,10,20.0,Furthest
16410,October,2022,Adams,CO,Passenger,1,0,1,35,36,2.78,Mid-Distance
16411,October,2022,Chesapeake,VA,Passenger,3,3,6,299,305,1.97,Furthest
16412,October,2022,El Paso,CO,Passenger,3,1,4,536,540,0.74,Mid-Distance
16413,October,2022,Elmore,ID,Passenger,1,0,1,12,13,7.69,Nearest
16414,October,2022,Monterey,CA,Passenger,1,1,2,120,122,1.64,Nearest
16415,October,2022,Kittitas,WA,Passenger,291,94,385,29590,29975,1.28,Washington
16416,October,2022,Jackson,OK,Passenger,0,1,1,32,33,3.03,Mid-Distance
16417,October,2022,Rockingham,NH,Passenger,1,0,1,12,13,7.69,Furthest
16418,October,2022,Sheridan,WY,Passenger,1,0,1,5,6,16.67,Nearest
16419,October,2022,Garfield,WA,Passenger,1,3,4,1315,1319,0.3,Washington
16420,October,2022,Champaign,IL,Passenger,1,0,1,8,9,11.11,Mid-Distance
16421,October,2022,Miami-Dade,FL,Passenger,1,0,1,67,68,1.47,Furthest
16422,October,2022,Contra Costa,CA,Passenger,0,3,3,214,217,1.38,Nearest
16423,October,2022,Oldham,KY,Passenger,0,1,1,4,5,20.0,Furthest
16424,October,2022,Santa Clara,CA,Passenger,9,2,11,184,195,5.64,Nearest
16425,October,2022,Jefferson,WA,Passenger,464,225,689,24416,25105,2.74,Washington
16426,October,2022,Prince George's,MD,Passenger,3,1,4,110,114,3.51,Furthest
16427,October,2022,Salt Lake,UT,Passenger,1,1,2,108,110,1.82,Nearest
16428,October,2022,Hamilton,OH,Truck,1,0,1,2,3,33.33,Furthest
16429,October,2022,Stafford,VA,Passenger,2,1,3,81,84,3.57,Furthest
16430,October,2022,Kings,CA,Passenger,2,1,3,284,287,1.05,Nearest
16431,October,2022,San Juan,WA,Truck,7,0,7,5952,5959,0.12,Washington
16432,October,2022,Skagit,WA,Truck,8,0,8,32247,32255,0.02,Washington
16433,October,2022,Franklin,WA,Passenger,239,112,351,61817,62168,0.56,Washington
16434,October,2022,San Juan,WA,Passenger,549,165,714,13992,14706,4.86,Washington
16435,October,2022,Lincoln,WA,Truck,0,0,0,4863,4863,0.0,Washington
16436,October,2022,Rockdale,GA,Passenger,1,0,1,6,7,14.29,Furthest
16437,October,2022,DeKalb,GA,Passenger,1,0,1,41,42,2.38,Furthest
16439,October,2022,Pulaski,AR,Passenger,3,0,3,27,30,10.0,Mid-Distance
16440,October,2022,Carroll,NH,Passenger,0,1,1,5,6,16.67,Furthest
16441,October,2022,Charles,MD,Passenger,1,1,2,51,53,3.77,Furthest
16442,October,2022,Loudoun,VA,Passenger,3,1,4,61,65,6.15,Furthest
16443,October,2022,Lewis,WA,Truck,2,0,2,26372,26374,0.01,Washington
16444,October,2022,Louisa,VA,Passenger,0,1,1,1,2,50.0,Furthest
16445,October,2022,Galveston,TX,Passenger,0,1,1,16,17,5.88,Mid-Distance
16446,October,2022,Ray,MO,Passenger,0,1,1,1,2,50.0,Furthest
16447,October,2022,Clark,WA,Passenger,4606,1925,6531,315200,321731,2.03,Washington
16448,October,2022,Spokane,WA,Truck,14,0,14,101936,101950,0.01,Washington
16449,October,2022,Douglas,WA,Passenger,158,59,217,28437,28654,0.76,Washington
16450,October,2022,Fairbanks North Star,AK,Passenger,0,1,1,63,64,1.56,Nearest
16451,October,2022,Hidalgo,TX,Passenger,0,1,1,50,51,1.96,Mid-Distance
16452,October,2022,Allegheny,PA,Passenger,1,1,2,48,50,4.0,Furthest
16453,October,2022,Stevens,WA,Passenger,84,56,140,30055,30195,0.46,Washington
16454,October,2022,Danville,VA,Passenger,1,0,1,0,1,100.0,Furthest
16455,October,2022,Philadelphia,PA,Passenger,1,0,1,36,37,2.7,Furthest
16456,October,2022,Queens,NY,Passenger,1,0,1,33,34,2.94,Furthest
16457,October,2022,Columbia,WA,Passenger,8,1,9,2442,2451,0.37,Washington
16458,October,2022,Chelan,WA,Passenger,508,140,648,54201,54849,1.18,Washington
16459,October,2022,Hoke,NC,Passenger,1,0,1,60,61,1.64,Furthest
16460,October,2022,Harrison,MS,Passenger,1,0,1,34,35,2.86,Mid-Distance
16461,October,2022,Fairfax,VA,Truck,1,0,1,105,106,0.94,Furthest
16462,October,2022,Clark,NV,Passenger,4,2,6,441,447,1.34,Nearest
16463,October,2022,Cumberland,PA,Passenger,1,0,1,35,36,2.78,Furthest
16464,October,2022,Virginia Beach,VA,Passenger,2,0,2,469,471,0.42,Furthest
16465,October,2022,Whitman,WA,Truck,3,0,3,8609,8612,0.03,Washington
16466,October,2022,Garfield,WA,Truck,0,0,0,977,977,0.0,Washington
16467,October,2022,Kittitas,WA,Truck,5,0,5,14601,14606,0.03,Washington
16468,October,2022,Sonoma,CA,Passenger,1,1,2,67,69,2.9,Nearest
16469,October,2022,Wahkiakum,WA,Truck,1,0,1,1800,1801,0.06,Washington
16470,October,2022,Whatcom,WA,Passenger,1993,786,2779,148767,151546,1.83,Washington
16471,October,2022,Arapahoe,CO,Passenger,0,1,1,72,73,1.37,Mid-Distance
16472,October,2022,Alameda,CA,Passenger,4,0,4,165,169,2.37,Nearest
16473,October,2022,Leavenworth,KS,Passenger,0,1,1,93,94,1.06,Mid-Distance
16474,October,2022,El Paso,TX,Passenger,2,0,2,296,298,0.67,Mid-Distance
16475,October,2022,Honolulu,HI,Passenger,3,3,6,294,300,2.0,Nearest
16476,October,2022,Harnett,NC,Passenger,2,0,2,134,136,1.47,Furthest
16477,October,2022,San Diego,CA,Passenger,17,10,27,2100,2127,1.27,Nearest
16478,October,2022,Cowlitz,WA,Truck,4,0,4,28459,28463,0.01,Washington
16479,October,2022,Franklin,WA,Truck,2,0,2,20887,20889,0.01,Washington
16480,October,2022,Williamson,TX,Passenger,0,2,2,66,68,2.94,Mid-Distance
16481,October,2022,Carroll,MD,Passenger,0,1,1,17,18,5.56,Furthest
16482,October,2022,Rock Island,IL,Passenger,0,1,1,15,16,6.25,Mid-Distance
16483,October,2022,Owyhee,ID,Passenger,1,0,1,3,4,25.0,Nearest
16484,October,2022,Platte,MO,Passenger,1,0,1,19,20,5.0,Furthest
16485,October,2022,Richmond,GA,Passenger,0,1,1,57,58,1.72,Furthest
16486,October,2022,Yellowstone,MT,Passenger,0,1,1,18,19,5.26,Nearest
16487,October,2022,Okanogan,WA,Truck,1,0,1,16478,16479,0.01,Washington
16488,October,2022,Lewis,WA,Passenger,261,179,440,59898,60338,0.73,Washington
16489,October,2022,Gwinnett,GA,Passenger,1,0,1,47,48,2.08,Furthest
16490,October,2022,King,WA,Passenger,45341,11925,57266,1343327,1400593,4.09,Washington
16491,October,2022,Sevier,AR,Passenger,0,1,1,0,1,100.0,Mid-Distance
16492,October,2022,Wood,OH,Passenger,0,1,1,3,4,25.0,Furthest
16493,October,2022,Onslow,NC,Passenger,0,1,1,153,154,0.65,Furthest
16494,October,2022,St. Clair,IL,Passenger,2,0,2,115,117,1.71,Mid-Distance
16495,October,2022,Benton,WA,Passenger,867,485,1352,135773,137125,0.99,Washington
16496,October,2022,Grant,WA,Passenger,210,108,318,66743,67061,0.47,Washington
16497,October,2022,Asotin,WA,Passenger,26,19,45,12566,12611,0.36,Washington
16498,October,2022,Clallam,WA,Passenger,456,256,712,49453,50165,1.42,Washington
16499,October,2022,Pierce,WA,Truck,62,0,62,140244,140306,0.04,Washington
16500,October,2022,Frederick,MD,Passenger,1,0,1,57,58,1.72,Furthest
16501,October,2022,Bartow,GA,Passenger,0,1,1,3,4,25.0,Furthest
16502,October,2022,Plaquemines,LA,Passenger,1,1,2,16,18,11.11,Mid-Distance
16503,October,2022,St. Tammany,LA,Passenger,1,0,1,33,34,2.94,Mid-Distance
16504,October,2022,Hillsborough,FL,Passenger,0,1,1,112,113,0.88,Furthest
16505,October,2022,Napa,CA,Passenger,0,1,1,10,11,9.09,Nearest
16506,October,2022,Richmond,NY,Passenger,1,0,1,6,7,14.29,Furthest
16507,October,2022,San Bernardino,CA,Passenger,1,1,2,291,293,0.68,Nearest
16508,October,2022,Kauai,HI,Passenger,1,0,1,14,15,6.67,Nearest
16509,October,2022,Kitsap,WA,Passenger,2634,1125,3759,177642,181401,2.07,Washington
16510,October,2022,Yakima,WA,Truck,5,0,5,61277,61282,0.01,Washington
16511,October,2022,Spokane,WA,Passenger,1837,910,2747,324785,327532,0.84,Washington
16512,October,2022,Nassau,NY,Passenger,1,0,1,21,22,4.55,Furthest
16513,October,2022,Lee,FL,Passenger,1,0,1,24,25,4.0,Furthest
16514,October,2022,Los Angeles,CA,Passenger,6,6,12,685,697,1.72,Nearest
16515,October,2022,Saratoga,NY,Passenger,1,0,1,37,38,2.63,Furthest
16516,October,2022,Cook,IL,Passenger,2,0,2,162,164,1.22,Mid-Distance
16517,October,2022,Maricopa,AZ,Passenger,7,2,9,739,748,1.2,Nearest
16518,October,2022,Penobscot,ME,Passenger,0,1,1,8,9,11.11,Furthest
16519,October,2022,Camden,NJ,Passenger,0,1,1,12,13,7.69,Furthest
16520,October,2022,Polk,OR,Passenger,0,1,1,19,20,5.0,Nearest
16521,October,2022,Anne Arundel,MD,Passenger,4,4,8,304,312,2.56,Furthest
16522,October,2022,Montgomery,MD,Passenger,4,2,6,177,183,3.28,Furthest
16523,October,2022,Hennepin,MN,Passenger,1,0,1,41,42,2.38,Mid-Distance
16524,October,2022,Williams,ND,Passenger,0,1,1,5,6,16.67,Mid-Distance
16525,October,2022,Skagit,WA,Passenger,886,349,1235,89523,90758,1.36,Washington
16526,October,2022,Bryan,GA,Passenger,0,1,1,37,38,2.63,Furthest
16527,October,2022,Hawaii,HI,Passenger,1,0,1,29,30,3.33,Nearest
16528,October,2022,Duval,FL,Passenger,1,2,3,246,249,1.2,Furthest
16529,October,2022,Lincoln,WA,Passenger,12,17,29,7735,7764,0.37,Washington
16530,October,2022,Nueces,TX,Passenger,0,1,1,49,50,2.0,Mid-Distance
16531,October,2022,Harris,TX,Passenger,1,0,1,126,127,0.79,Mid-Distance
16532,October,2022,Skamania,WA,Truck,0,0,0,3897,3897,0.0,Washington
16533,October,2022,Broward,FL,Passenger,1,0,1,65,66,1.52,Furthest
16534,October,2022,Boulder,CO,Passenger,1,0,1,31,32,3.12,Mid-Distance
16535,October,2022,Sarasota,FL,Passenger,1,0,1,17,18,5.56,Furthest
16536,October,2022,Benton,WA,Truck,7,0,7,43350,43357,0.02,Washington
16537,October,2022,Mason,WA,Truck,6,0,6,20938,20944,0.03,Washington
16538,October,2022,Ferry,WA,Truck,0,0,0,3593,3593,0.0,Washington
16539,October,2022,Las Animas,CO,Passenger,1,0,1,1,2,50.0,Mid-Distance
16540,October,2022,Allen,IN,Passenger,1,0,1,12,13,7.69,Furthest
16541,October,2022,Lincoln,OR,Passenger,0,1,1,19,20,5.0,Nearest
16542,October,2022,Randolph,NC,Passenger,1,0,1,5,6,16.67,Furthest
16543,October,2022,Jefferson,NY,Passenger,0,1,1,193,194,0.52,Furthest
16544,October,2022,Suffolk,VA,Passenger,1,0,1,114,115,0.87,Furthest
16545,October,2022,St. Mary's,MD,Passenger,1,0,1,171,172,0.58,Furthest
16546,October,2022,Berkeley,SC,Passenger,0,1,1,111,112,0.89,Furthest
16547,October,2022,Lake,IL,Passenger,1,0,1,119,120,0.83,Mid-Distance
16548,October,2022,Island,WA,Passenger,901,389,1290,61684,62974,2.05,Washington
16549,October,2022,Cape May,NJ,Passenger,0,1,1,7,8,12.5,Furthest
16550,October,2022,Houston,GA,Passenger,1,0,1,27,28,3.57,Furthest
16551,October,2022,Ulster,NY,Passenger,1,0,1,5,6,16.67,Furthest
16552,October,2022,Douglas,WA,Truck,2,0,2,12811,12813,0.02,Washington
16553,October,2022,Kootenai,ID,Truck,1,0,1,30,31,3.23,Nearest
16554,October,2022,Sarpy,NE,Passenger,1,0,1,49,50,2.0,Mid-Distance
16555,October,2022,New London,CT,Passenger,2,4,6,185,191,3.14,Furthest
16556,October,2022,Howard,MD,Passenger,0,1,1,49,50,2.0,Furthest
16557,October,2022,Wahkiakum,WA,Passenger,24,12,36,3064,3100,1.16,Washington
16558,October,2022,Thurston,WA,Passenger,2467,1109,3576,192794,196370,1.82,Washington
16559,October,2022,Douglas,CO,Passenger,0,1,1,61,62,1.61,Mid-Distance
16560,October,2022,Grays Harbor,WA,Passenger,231,166,397,48742,49139,0.81,Washington
16561,October,2022,Dorchester,SC,Passenger,1,0,1,45,46,2.17,Furthest
16562,October,2022,Island,WA,Truck,14,0,14,21277,21291,0.07,Washington
16563,October,2022,Marin,CA,Passenger,0,1,1,28,29,3.45,Nearest
16564,October,2022,Okanogan,WA,Passenger,95,49,144,26284,26428,0.54,Washington
16565,October,2022,Pacific,WA,Passenger,68,74,142,15756,15898,0.89,Washington
16566,October,2022,Pacific,WA,Truck,1,0,1,7875,7876,0.01,Washington
16567,October,2022,Adams,WA,Truck,1,0,1,5429,5430,0.02,Washington
16568,October,2022,Columbia,WA,Truck,0,0,0,1583,1583,0.0,Washington
16569,October,2022,Cumberland,NC,Passenger,1,2,3,326,329,0.91,Furthest
16570,October,2022,Orange,CA,Passenger,5,2,7,308,315,2.22,Nearest
16571,October,2022,Burlington,NJ,Passenger,0,2,2,96,98,2.04,Furthest
16572,October,2022,Lake,FL,Passenger,1,0,1,16,17,5.88,Furthest
16573,October,2022,Cowlitz,WA,Passenger,381,184,565,70323,70888,0.8,Washington
16574,October,2022,Stevens,WA,Truck,2,0,2,18903,18905,0.01,Washington
16575,October,2022,Dallas,TX,Passenger,1,0,1,91,92,1.09,Mid-Distance
16576,October,2022,Adams,WA,Passenger,22,12,34,13045,13079,0.26,Washington
16577,October,2022,San Joaquin,CA,Passenger,1,0,1,76,77,1.3,Nearest
16578,October,2022,Sacramento,CA,Passenger,3,0,3,177,180,1.67,Nearest
16579,October,2022,Pennington,SD,Passenger,2,0,2,24,26,7.69,Mid-Distance
16580,October,2022,Fort Bend,TX,Passenger,1,0,1,22,23,4.35,Mid-Distance
16581,October,2022,Ventura,CA,Passenger,2,1,3,213,216,1.39,Nearest
16582,October,2022,Douglas,NE,Passenger,2,2,4,31,35,11.43,Mid-Distance
16583,October,2022,Snohomish,WA,Truck,76,0,76,122941,123017,0.06,Washington
16584,October,2022,King,WA,Truck,300,2,302,179312,179614,0.17,Washington
16585,October,2022,Multnomah,OR,Passenger,0,3,3,469,472,0.64,Nearest
16586,October,2022,Klickitat,WA,Passenger,114,51,165,15116,15281,1.08,Washington
16587,October,2022,Skamania,WA,Passenger,85,51,136,8110,8246,1.65,Washington
16588,October,2022,Beaufort,SC,Passenger,1,0,1,21,22,4.55,Furthest
16589,October,2022,Klickitat,WA,Truck,3,0,3,8250,8253,0.04,Washington
16590,October,2022,Charleston,SC,Passenger,2,2,4,53,57,7.02,Furthest
16591,October,2022,Clallam,WA,Truck,7,0,7,21890,21897,0.03,Washington
16592,October,2022,Riverside,CA,Passenger,7,0,7,417,424,1.65,Nearest
16593,October,2022,Kitsap,WA,Truck,25,0,25,53166,53191,0.05,Washington
16594,October,2022,Clackamas,OR,Passenger,1,0,1,121,122,0.82,Nearest
16595,October,2022,St. Louis,MO,Passenger,1,0,1,55,56,1.79,Furthest
16596,October,2022,Arlington,VA,Passenger,1,0,1,107,108,0.93,Furthest
16597,October,2022,Okaloosa,FL,Passenger,0,1,1,92,93,1.08,Furthest
16598,September,2017,Santa Fe,NM,Passenger,0,1,1,42,43,2.33,Mid-Distance
16599,September,2017,Kittitas,WA,Passenger,33,21,54,27988,28042,0.19,Washington
16600,September,2017,Ferry,WA,Truck,0,0,0,3538,3538,0.0,Washington
16601,September,2017,Pierce,WA,Passenger,1012,898,1910,525165,527075,0.36,Washington
16602,September,2017,Prince William,VA,Passenger,0,3,3,268,271,1.11,Furthest
16603,September,2017,Norfolk,MA,Passenger,1,0,1,38,39,2.56,Furthest
16604,September,2017,Madison,ID,Passenger,1,0,1,37,38,2.63,Nearest
16605,September,2017,Arlington,VA,Passenger,1,2,3,163,166,1.81,Furthest
16606,September,2017,Virginia Beach,VA,Passenger,2,1,3,656,659,0.46,Furthest
16607,September,2017,Grant,WA,Passenger,20,33,53,61457,61510,0.09,Washington
16608,September,2017,Adams,WA,Passenger,3,3,6,12263,12269,0.05,Washington
16609,September,2017,Sangamon,IL,Passenger,1,0,1,11,12,8.33,Mid-Distance
16610,September,2017,King,WA,Truck,7,1,8,186365,186373,0.0,Washington
16611,September,2017,Travis,TX,Passenger,0,1,1,190,191,0.52,Mid-Distance
16612,September,2017,Pend Oreille,WA,Passenger,3,4,7,9371,9378,0.07,Washington
16613,September,2017,Lane,OR,Passenger,0,1,1,218,219,0.46,Nearest
16614,September,2017,Wahkiakum,WA,Truck,0,0,0,1667,1667,0.0,Washington
16615,September,2017,El Paso,CO,Passenger,2,0,2,774,776,0.26,Mid-Distance
16616,September,2017,Whitman,WA,Passenger,12,22,34,22193,22227,0.15,Washington
16617,September,2017,Frederick,MD,Passenger,0,1,1,83,84,1.19,Furthest
16618,September,2017,Riverside,CA,Passenger,1,2,3,751,754,0.4,Nearest
16619,September,2017,Okanogan,WA,Passenger,5,18,23,25690,25713,0.09,Washington
16620,September,2017,Sedgwick,KS,Passenger,0,1,1,102,103,0.97,Mid-Distance
16621,September,2017,Los Angeles,CA,Passenger,5,2,7,1234,1241,0.56,Nearest
16622,September,2017,Lincoln,WA,Truck,0,0,0,4472,4472,0.0,Washington
16623,September,2017,Spokane,WA,Truck,1,0,1,91172,91173,0.0,Washington
16624,September,2017,Kent,MI,Passenger,0,1,1,36,37,2.7,Furthest
16625,September,2017,Lewis,WA,Passenger,53,38,91,56022,56113,0.16,Washington
16626,September,2017,Portsmouth,VA,Passenger,0,1,1,66,67,1.49,Furthest
16627,September,2017,Whitman,WA,Truck,0,0,0,8428,8428,0.0,Washington
16628,September,2017,Wayne,MI,Passenger,0,1,1,67,68,1.47,Furthest
16629,September,2017,Wahkiakum,WA,Passenger,0,2,2,2836,2838,0.07,Washington
16630,September,2017,Montgomery,TX,Passenger,1,0,1,61,62,1.61,Mid-Distance
16631,September,2017,Stevens,WA,Passenger,8,22,30,31547,31577,0.1,Washington
16632,September,2017,Canyon,ID,Passenger,0,1,1,92,93,1.08,Nearest
16633,September,2017,Duval,FL,Passenger,1,1,2,367,369,0.54,Furthest
16634,September,2017,Walla Walla,WA,Passenger,27,28,55,35036,35091,0.16,Washington
16635,September,2017,Benton,WA,Passenger,163,150,313,129262,129575,0.24,Washington
16636,September,2017,Anne Arundel,MD,Passenger,0,1,1,494,495,0.2,Furthest
16637,September,2017,Manatee,FL,Passenger,1,0,1,42,43,2.33,Furthest
16638,September,2017,Howard,MD,Passenger,0,2,2,88,90,2.22,Furthest
16639,September,2017,Pacific,WA,Passenger,12,9,21,15262,15283,0.14,Washington
16640,September,2017,Nassau,NY,Passenger,1,1,2,39,41,4.88,Furthest
16641,September,2017,Skagit,WA,Passenger,148,120,268,88642,88910,0.3,Washington
16642,September,2017,Lee,AL,Passenger,1,0,1,34,35,2.86,Furthest
16643,September,2017,Kitsap,WA,Truck,1,0,1,52599,52600,0.0,Washington
16644,September,2017,Cowlitz,WA,Passenger,52,64,116,70272,70388,0.16,Washington
16645,September,2017,Okaloosa,FL,Passenger,1,0,1,186,187,0.53,Furthest
16646,September,2017,Sacramento,CA,Passenger,1,0,1,334,335,0.3,Nearest
16647,September,2017,DeKalb,GA,Passenger,1,0,1,84,85,1.18,Furthest
16648,September,2017,Columbia,WA,Passenger,1,1,2,2378,2380,0.08,Washington
16649,September,2017,Okanogan,WA,Truck,0,0,0,16235,16235,0.0,Washington
16650,September,2017,Norfolk,VA,Passenger,1,1,2,312,314,0.64,Furthest
16651,September,2017,Klickitat,WA,Passenger,22,26,48,14774,14822,0.32,Washington
16652,September,2017,Garfield,WA,Passenger,1,0,1,1295,1296,0.08,Washington
16653,September,2017,Gwinnett,GA,Passenger,0,1,1,84,85,1.18,Furthest
16654,September,2017,Hamilton,IN,Passenger,1,0,1,58,59,1.69,Furthest
16655,September,2017,Grays Harbor,WA,Truck,0,0,0,19976,19976,0.0,Washington
16656,September,2017,Juneau,AK,Passenger,0,1,1,45,46,2.17,Nearest
16657,September,2017,Polk,FL,Passenger,1,0,1,62,63,1.59,Furthest
16658,September,2017,Prince George's,MD,Passenger,0,1,1,182,183,0.55,Furthest
16659,September,2017,San Mateo,CA,Passenger,0,1,1,147,148,0.68,Nearest
16660,September,2017,Pacific,WA,Truck,0,0,0,7514,7514,0.0,Washington
16661,September,2017,Charles,MD,Passenger,0,1,1,84,85,1.18,Furthest
16662,September,2017,Maricopa,AZ,Passenger,2,0,2,1647,1649,0.12,Nearest
16663,September,2017,Skamania,WA,Passenger,10,7,17,8572,8589,0.2,Washington
16664,September,2017,Morris,NJ,Passenger,1,0,1,22,23,4.35,Furthest
16665,September,2017,Clay,FL,Passenger,0,1,1,113,114,0.88,Furthest
16666,September,2017,Cobb,GA,Passenger,0,1,1,68,69,1.45,Furthest
16667,September,2017,Multnomah,OR,Passenger,1,3,4,924,928,0.43,Nearest
16668,September,2017,Flathead,MT,Passenger,1,0,1,56,57,1.75,Nearest
16669,September,2017,Kitsap,WA,Passenger,653,346,999,174309,175308,0.57,Washington
16670,September,2017,Clark,WA,Passenger,810,542,1352,301404,302756,0.45,Washington
16671,September,2017,Lincoln,WA,Passenger,2,6,8,7563,7571,0.11,Washington
16672,September,2017,Island,WA,Passenger,129,149,278,60853,61131,0.45,Washington
16673,September,2017,Honolulu,HI,Passenger,2,2,4,561,565,0.71,Nearest
16674,September,2017,Nueces,TX,Passenger,0,1,1,93,94,1.06,Mid-Distance
16675,September,2017,Tuolumne,CA,Passenger,0,1,1,15,16,6.25,Nearest
16676,September,2017,Deschutes,OR,Passenger,1,0,1,193,194,0.52,Nearest
16677,September,2017,District of Columbia,DC,Passenger,0,2,2,204,206,0.97,Furthest
16678,September,2017,Contra Costa,CA,Passenger,0,1,1,506,507,0.2,Nearest
16679,September,2017,Clallam,WA,Passenger,95,83,178,48609,48787,0.36,Washington
16680,September,2017,Richland,SC,Passenger,0,1,1,185,186,0.54,Furthest
16681,September,2017,Jefferson,WA,Passenger,114,65,179,24008,24187,0.74,Washington
16682,September,2017,Chelan,WA,Truck,0,0,0,21414,21414,0.0,Washington
16683,September,2017,Moore,NC,Passenger,0,1,1,202,203,0.49,Furthest
16684,September,2017,Snohomish,WA,Passenger,1911,975,2886,514376,517262,0.56,Washington
16685,September,2017,Walla Walla,WA,Truck,0,0,0,13243,13243,0.0,Washington
16686,September,2017,Pend Oreille,WA,Truck,0,0,0,5552,5552,0.0,Washington
16687,September,2017,Orleans,LA,Passenger,0,1,1,45,46,2.17,Mid-Distance
16688,September,2017,Franklin,MA,Passenger,0,1,1,4,5,20.0,Furthest
16689,September,2017,Hawaii,HI,Passenger,1,0,1,77,78,1.28,Nearest
16690,September,2017,Bexar,TX,Passenger,1,1,2,837,839,0.24,Mid-Distance
16691,September,2017,Cape May,NJ,Passenger,0,1,1,19,20,5.0,Furthest
16692,September,2017,Albemarle,VA,Passenger,0,1,1,32,33,3.03,Furthest
16693,September,2017,San Juan,WA,Passenger,117,42,159,13676,13835,1.15,Washington
16694,September,2017,Yakima,WA,Passenger,57,69,126,160618,160744,0.08,Washington
16695,September,2017,New London,CT,Passenger,1,1,2,250,252,0.79,Furthest
16696,September,2017,Columbia,WA,Truck,0,0,0,1557,1557,0.0,Washington
16697,September,2017,Mason,WA,Truck,0,0,0,19379,19379,0.0,Washington
16698,September,2017,Hamilton,TN,Passenger,1,0,1,21,22,4.55,Furthest
16699,September,2017,Jefferson,WA,Truck,0,0,0,9419,9419,0.0,Washington
16700,September,2017,Richmond,GA,Passenger,0,1,1,90,91,1.1,Furthest
16701,September,2017,Clark,WA,Truck,0,0,0,77868,77868,0.0,Washington
16702,September,2017,Asotin,WA,Passenger,7,5,12,12463,12475,0.1,Washington
16703,September,2017,Maui,HI,Passenger,1,0,1,70,71,1.41,Nearest
16704,September,2017,San Diego,CA,Passenger,6,1,7,2641,2648,0.26,Nearest
16705,September,2017,Whatcom,WA,Passenger,496,190,686,143859,144545,0.47,Washington
16706,September,2017,Fulton,GA,Passenger,1,0,1,110,111,0.9,Furthest
16707,September,2017,St. Lucie,FL,Passenger,1,0,1,27,28,3.57,Furthest
16708,September,2017,Thurston,WA,Passenger,435,363,798,188247,189045,0.42,Washington
16709,September,2017,Yakima,WA,Truck,0,0,0,57707,57707,0.0,Washington
16710,September,2017,Island,WA,Truck,0,0,0,20564,20564,0.0,Washington
16711,September,2017,Benton,WA,Truck,0,0,0,40273,40273,0.0,Washington
16712,September,2017,Santa Clara,CA,Passenger,5,2,7,388,395,1.77,Nearest
16713,September,2017,Snohomish,WA,Truck,1,0,1,121526,121527,0.0,Washington
16714,September,2017,Chelan,WA,Passenger,75,37,112,52503,52615,0.21,Washington
16715,September,2017,St. Clair,IL,Passenger,0,1,1,165,166,0.6,Mid-Distance
16716,September,2017,Manassas,VA,Passenger,0,1,1,9,10,10.0,Furthest
16717,September,2017,Sumter,FL,Passenger,0,1,1,10,11,9.09,Furthest
16718,September,2017,Shelby,TN,Passenger,0,1,1,106,107,0.93,Furthest
16719,September,2017,Dale,AL,Passenger,0,1,1,63,64,1.56,Furthest
16720,September,2017,Missoula,MT,Passenger,1,0,1,70,71,1.41,Nearest
16721,September,2017,Saratoga,NY,Passenger,1,1,2,72,74,2.7,Furthest
16722,September,2017,Franklin,OH,Passenger,0,1,1,112,113,0.88,Furthest
16723,September,2017,Mason,WA,Passenger,61,73,134,44172,44306,0.3,Washington
16724,September,2017,Lewis,WA,Truck,0,0,0,25113,25113,0.0,Washington
16725,September,2017,Douglas,WA,Truck,0,0,0,11592,11592,0.0,Washington
16726,September,2017,Douglas,WA,Passenger,35,29,64,26927,26991,0.24,Washington
16727,September,2017,King,WA,Passenger,10654,4350,15004,1372562,1387566,1.08,Washington
16728,September,2017,Monterey,CA,Passenger,0,2,2,195,197,1.02,Nearest
16729,September,2017,Volusia,FL,Passenger,0,1,1,43,44,2.27,Furthest
16730,September,2017,Grant,WA,Truck,0,0,0,25425,25425,0.0,Washington
16731,September,2017,Allegheny,PA,Passenger,1,0,1,87,88,1.14,Furthest
16732,September,2017,Fairfax,VA,Passenger,2,2,4,845,849,0.47,Furthest
16733,September,2017,Clallam,WA,Truck,0,0,0,21085,21085,0.0,Washington
16734,September,2017,Franklin,WA,Passenger,29,48,77,56181,56258,0.14,Washington
16735,September,2017,Skagit,WA,Truck,1,0,1,31550,31551,0.0,Washington
16736,September,2017,San Juan,WA,Truck,0,0,0,5559,5559,0.0,Washington
16737,September,2017,Palm Beach,FL,Passenger,0,1,1,96,97,1.03,Furthest
16738,September,2017,Skamania,WA,Truck,0,0,0,3878,3878,0.0,Washington
16739,September,2017,Twin Falls,ID,Passenger,0,1,1,22,23,4.35,Nearest
16740,September,2017,Marin,CA,Passenger,1,0,1,59,60,1.67,Nearest
16741,September,2017,Santa Rosa,FL,Passenger,1,0,1,109,110,0.91,Furthest
16742,September,2017,Franklin,WA,Truck,0,0,0,18248,18248,0.0,Washington
16743,September,2017,Whatcom,WA,Truck,2,0,2,41837,41839,0.0,Washington
16744,September,2017,Northampton,PA,Passenger,0,1,1,83,84,1.19,Furthest
16745,September,2017,Klickitat,WA,Truck,0,0,0,7988,7988,0.0,Washington
16746,September,2017,Grays Harbor,WA,Passenger,38,38,76,45132,45208,0.17,Washington
16747,September,2017,Montgomery,PA,Passenger,1,0,1,37,38,2.63,Furthest
16748,September,2017,Latah,ID,Passenger,0,1,1,91,92,1.09,Nearest
16749,September,2017,Carroll,NH,Passenger,0,1,1,1,2,50.0,Furthest
16750,September,2017,Ferry,WA,Passenger,1,1,2,4380,4382,0.05,Washington
16751,September,2017,Kittitas,WA,Truck,0,0,0,13657,13657,0.0,Washington
16752,September,2017,New Haven,CT,Passenger,0,1,1,54,55,1.82,Furthest
16753,September,2017,DeKalb,IN,Passenger,1,0,1,1,2,50.0,Furthest
16754,September,2017,Alameda,CA,Passenger,0,1,1,351,352,0.28,Nearest
16755,September,2017,Tulare,CA,Passenger,1,0,1,197,198,0.51,Nearest
16756,September,2017,Tarrant,TX,Passenger,1,0,1,235,236,0.42,Mid-Distance
16757,September,2017,El Paso,TX,Passenger,1,0,1,545,546,0.18,Mid-Distance
16758,September,2017,Ramsey,MN,Passenger,1,0,1,40,41,2.44,Mid-Distance
16759,September,2017,Orange,FL,Passenger,1,1,2,144,146,1.37,Furthest
16760,September,2017,Adams,WA,Truck,0,0,0,5123,5123,0.0,Washington
16761,September,2017,Pinal,AZ,Passenger,2,0,2,226,228,0.88,Nearest
16762,September,2017,Dallas,TX,Passenger,0,1,1,179,180,0.56,Mid-Distance
16763,September,2017,Utah,UT,Passenger,0,1,1,145,146,0.68,Nearest
16764,September,2017,Essex,NJ,Passenger,1,0,1,13,14,7.14,Furthest
16765,September,2017,Thurston,WA,Truck,0,0,0,53500,53500,0.0,Washington
16766,September,2017,Garfield,WA,Truck,0,0,0,940,940,0.0,Washington
16767,September,2017,Montgomery,TN,Passenger,1,0,1,276,277,0.36,Furthest
16768,September,2017,Hardin,KY,Passenger,0,1,1,116,117,0.85,Furthest
16769,September,2017,Jefferson,NY,Passenger,1,0,1,242,243,0.41,Furthest
16770,September,2017,Pierce,WA,Truck,0,0,0,137078,137078,0.0,Washington
16772,September,2017,Nantucket,MA,Passenger,1,0,1,3,4,25.0,Furthest
16773,September,2017,Pima,AZ,Passenger,1,1,2,418,420,0.48,Nearest
16774,September,2017,Spokane,WA,Passenger,276,229,505,298150,298655,0.17,Washington
16775,September,2017,Clark,NV,Passenger,1,2,3,774,777,0.39,Nearest
16776,September,2017,Lumpkin,GA,Passenger,1,0,1,9,10,10.0,Furthest
16777,September,2017,Cowlitz,WA,Truck,0,0,0,28041,28041,0.0,Washington
16778,September,2017,Asotin,WA,Truck,0,0,0,6507,6507,0.0,Washington
16779,September,2017,Montgomery,MD,Passenger,1,0,1,305,306,0.33,Furthest
16780,September,2017,Orange,CA,Passenger,3,1,4,607,611,0.65,Nearest
16781,September,2017,Stevens,WA,Truck,0,0,0,18251,18251,0.0,Washington
16782,September,2017,Dakota,MN,Passenger,0,2,2,36,38,5.26,Mid-Distance
16783,September,2018,Volusia,FL,Passenger,0,1,1,38,39,2.56,Furthest
16784,September,2018,Cowlitz,WA,Passenger,63,85,148,72024,72172,0.21,Washington
16785,September,2018,Cumberland,NC,Passenger,0,1,1,526,527,0.19,Furthest
16786,September,2018,Walla Walla,WA,Truck,0,0,0,13492,13492,0.0,Washington
16787,September,2018,Skagit,WA,Passenger,222,176,398,90860,91258,0.44,Washington
16788,September,2018,Collin,TX,Passenger,1,1,2,152,154,1.3,Mid-Distance
16789,September,2018,Nantucket,MA,Passenger,1,0,1,4,5,20.0,Furthest
16790,September,2018,Maui,HI,Passenger,1,0,1,56,57,1.75,Nearest
16791,September,2018,El Paso,CO,Passenger,3,1,4,761,765,0.52,Mid-Distance
16792,September,2018,Klickitat,WA,Passenger,24,32,56,15362,15418,0.36,Washington
16793,September,2018,Brevard,FL,Passenger,0,1,1,92,93,1.08,Furthest
16794,September,2018,Palm Beach,FL,Passenger,0,1,1,88,89,1.12,Furthest
16795,September,2018,Ferry,WA,Truck,0,0,0,3559,3559,0.0,Washington
16796,September,2018,Kootenai,ID,Passenger,0,1,1,216,217,0.46,Nearest
16797,September,2018,Whatcom,WA,Truck,2,0,2,42433,42435,0.0,Washington
16798,September,2018,Carson City,NV,Passenger,1,0,1,14,15,6.67,Nearest
16799,September,2018,Chelan,WA,Passenger,117,59,176,53803,53979,0.33,Washington
16800,September,2018,Snohomish,WA,Passenger,2516,1329,3845,524563,528408,0.73,Washington
16801,September,2018,Guadalupe,TX,Passenger,1,0,1,83,84,1.19,Mid-Distance
16802,September,2018,Shelby,TN,Passenger,0,1,1,102,103,0.97,Furthest
16803,September,2018,DuPage,IL,Passenger,1,0,1,56,57,1.75,Mid-Distance
16804,September,2018,Bexar,TX,Passenger,3,4,7,732,739,0.95,Mid-Distance
16805,September,2018,Williamson,TX,Passenger,0,1,1,160,161,0.62,Mid-Distance
16806,September,2018,Franklin,MA,Passenger,0,1,1,1,2,50.0,Furthest
16807,September,2018,Wahkiakum,WA,Passenger,1,1,2,2980,2982,0.07,Washington
16808,September,2018,St. Lucie,FL,Passenger,1,0,1,30,31,3.23,Furthest
16809,September,2018,Juneau,AK,Passenger,0,1,1,43,44,2.27,Nearest
16810,September,2018,Mecklenburg,NC,Passenger,1,0,1,82,83,1.2,Furthest
16811,September,2018,Skamania,WA,Truck,0,0,0,3967,3967,0.0,Washington
16812,September,2018,Pacific,WA,Passenger,18,22,40,15733,15773,0.25,Washington
16813,September,2018,Wahkiakum,WA,Truck,0,0,0,1691,1691,0.0,Washington
16814,September,2018,Ada,ID,Passenger,0,2,2,315,317,0.63,Nearest
16815,September,2018,Madison,ID,Passenger,1,0,1,38,39,2.56,Nearest
16816,September,2018,Latah,ID,Passenger,0,1,1,72,73,1.37,Nearest
16817,September,2018,Stevens,WA,Truck,0,0,0,18680,18680,0.0,Washington
16818,September,2018,Frederick,MD,Passenger,0,1,1,87,88,1.14,Furthest
16819,September,2018,St. Clair,IL,Passenger,0,1,1,158,159,0.63,Mid-Distance
16820,September,2018,Duval,FL,Passenger,1,2,3,383,386,0.78,Furthest
16821,September,2018,New Haven,CT,Passenger,0,1,1,48,49,2.04,Furthest
16822,September,2018,Virginia Beach,VA,Passenger,2,1,3,697,700,0.43,Furthest
16823,September,2018,King,WA,Truck,7,1,8,182870,182878,0.0,Washington
16824,September,2018,Jefferson,WA,Passenger,153,99,252,24693,24945,1.01,Washington
16825,September,2018,Walla Walla,WA,Passenger,36,50,86,35925,36011,0.24,Washington
16826,September,2018,Kent,MI,Passenger,0,1,1,27,28,3.57,Furthest
16827,September,2018,Jefferson,WA,Truck,0,0,0,9644,9644,0.0,Washington
16828,September,2018,St. Mary's,MD,Passenger,1,0,1,217,218,0.46,Furthest
16829,September,2018,Washoe,NV,Passenger,1,0,1,111,112,0.89,Nearest
16830,September,2018,Montgomery,MD,Passenger,1,0,1,283,284,0.35,Furthest
16831,September,2018,Adams,WA,Truck,0,0,0,5158,5158,0.0,Washington
16832,September,2018,Jefferson,NY,Passenger,0,1,1,225,226,0.44,Furthest
16833,September,2018,Houston,GA,Passenger,1,0,1,54,55,1.82,Furthest
16834,September,2018,Mason,WA,Passenger,94,100,194,46187,46381,0.42,Washington
16835,September,2018,Kittitas,WA,Truck,0,0,0,14105,14105,0.0,Washington
16836,September,2018,Klamath,OR,Passenger,1,0,1,35,36,2.78,Nearest
16837,September,2018,Montgomery,PA,Passenger,2,0,2,36,38,5.26,Furthest
16838,September,2018,Norfolk,MA,Passenger,1,0,1,37,38,2.63,Furthest
16839,September,2018,Washington,OR,Passenger,0,1,1,469,470,0.21,Nearest
16840,September,2018,Gwinnett,GA,Passenger,0,1,1,84,85,1.18,Furthest
16841,September,2018,Manatee,FL,Passenger,1,0,1,37,38,2.63,Furthest
16842,September,2018,Carroll,NH,Passenger,0,1,1,1,2,50.0,Furthest
16843,September,2018,Grant,WA,Truck,0,0,0,26068,26068,0.0,Washington
16844,September,2018,Clark,WA,Passenger,1089,784,1873,309720,311593,0.6,Washington
16845,September,2018,Hawaii,HI,Passenger,1,0,1,70,71,1.41,Nearest
16846,September,2018,Hardin,KY,Passenger,0,1,1,121,122,0.82,Furthest
16847,September,2018,DeKalb,IN,Passenger,1,0,1,1,2,50.0,Furthest
16848,September,2018,Anne Arundel,MD,Passenger,0,1,1,450,451,0.22,Furthest
16849,September,2018,Arlington,VA,Passenger,1,1,2,170,172,1.16,Furthest
16850,September,2018,Columbia,WA,Passenger,2,2,4,2429,2433,0.16,Washington
16851,September,2018,Marion,IN,Passenger,1,0,1,118,119,0.84,Furthest
16852,September,2018,Los Angeles,CA,Passenger,7,5,12,1130,1142,1.05,Nearest
16853,September,2018,Nassau,NY,Passenger,2,0,2,37,39,5.13,Furthest
16854,September,2018,Richland,SC,Passenger,0,1,1,167,168,0.6,Furthest
16855,September,2018,Lewis,WA,Truck,0,0,0,25568,25568,0.0,Washington
16856,September,2018,Tarrant,TX,Passenger,1,0,1,210,211,0.47,Mid-Distance
16857,September,2018,Clark,WA,Truck,0,0,0,79366,79366,0.0,Washington
16858,September,2018,San Juan,PR,Passenger,0,1,1,4,5,20.0,Mid-Distance
16859,September,2018,Clallam,WA,Passenger,129,122,251,50164,50415,0.5,Washington
16860,September,2018,Benton,WA,Passenger,188,209,397,132434,132831,0.3,Washington
16861,September,2018,Orange,CA,Passenger,4,1,5,549,554,0.9,Nearest
16862,September,2018,Okanogan,WA,Truck,0,0,0,16497,16497,0.0,Washington
16863,September,2018,New London,CT,Passenger,0,1,1,253,254,0.39,Furthest
16864,September,2018,Grays Harbor,WA,Passenger,55,65,120,47163,47283,0.25,Washington
16865,September,2018,Santa Fe,NM,Passenger,0,1,1,44,45,2.22,Mid-Distance
16866,September,2018,Tuolumne,CA,Passenger,0,1,1,12,13,7.69,Nearest
16867,September,2018,Yakima,WA,Passenger,67,93,160,164243,164403,0.1,Washington
16868,September,2018,Sangamon,IL,Passenger,1,0,1,11,12,8.33,Mid-Distance
16869,September,2018,Multnomah,OR,Passenger,3,4,7,775,782,0.9,Nearest
16870,September,2018,Charles,MD,Passenger,0,1,1,82,83,1.2,Furthest
16871,September,2018,Santa Clara,CA,Passenger,8,0,8,373,381,2.1,Nearest
16872,September,2018,Island,WA,Truck,0,0,0,21101,21101,0.0,Washington
16873,September,2018,Middlesex,MA,Passenger,0,1,1,139,140,0.71,Furthest
16874,September,2018,San Diego,CA,Passenger,7,2,9,2558,2567,0.35,Nearest
16875,September,2018,Caddo,LA,Passenger,0,1,1,23,24,4.17,Mid-Distance
16876,September,2018,Camden,NJ,Passenger,0,1,1,27,28,3.57,Furthest
16877,September,2018,Skamania,WA,Passenger,15,11,26,8710,8736,0.3,Washington
16878,September,2018,Columbia,WA,Truck,0,0,0,1521,1521,0.0,Washington
16879,September,2018,Monroe,IL,Passenger,1,0,1,5,6,16.67,Mid-Distance
16880,September,2018,Lee,AL,Passenger,1,0,1,37,38,2.63,Furthest
16881,September,2018,Flathead,MT,Passenger,1,0,1,51,52,1.92,Nearest
16882,September,2018,Monterey,CA,Passenger,0,1,1,189,190,0.53,Nearest
16883,September,2018,Whitman,WA,Passenger,20,32,52,22690,22742,0.23,Washington
16884,September,2018,Klickitat,WA,Truck,0,0,0,8137,8137,0.0,Washington
16885,September,2018,Pierce,WA,Passenger,1325,1267,2592,535571,538163,0.48,Washington
16886,September,2018,Grant,WA,Passenger,33,50,83,63766,63849,0.13,Washington
16887,September,2018,Sumter,FL,Passenger,0,1,1,10,11,9.09,Furthest
16888,September,2018,Cochise,AZ,Passenger,0,1,1,120,121,0.83,Nearest
16889,September,2018,Douglas,NE,Passenger,0,1,1,68,69,1.45,Mid-Distance
16890,September,2018,Fairfax,VA,Passenger,2,2,4,809,813,0.49,Furthest
16891,September,2018,Hamilton,IN,Passenger,1,0,1,47,48,2.08,Furthest
16892,September,2018,Oldham,KY,Passenger,0,1,1,5,6,16.67,Furthest
16893,September,2018,Snohomish,WA,Truck,1,0,1,121775,121776,0.0,Washington
16894,September,2018,Norfolk,VA,Passenger,2,2,4,331,335,1.19,Furthest
16895,September,2018,Kitsap,WA,Passenger,841,499,1340,179462,180802,0.74,Washington
16896,September,2018,Whatcom,WA,Passenger,666,335,1001,148503,149504,0.67,Washington
16897,September,2018,Dallas,TX,Passenger,0,1,1,196,197,0.51,Mid-Distance
16898,September,2018,Clallam,WA,Truck,0,0,0,21492,21492,0.0,Washington
16899,September,2018,King,WA,Passenger,14203,6079,20282,1373990,1394272,1.45,Washington
16900,September,2018,Clackamas,OR,Passenger,0,1,1,217,218,0.46,Nearest
16901,September,2018,Lincoln,WA,Truck,0,0,0,4580,4580,0.0,Washington
16902,September,2018,Allegheny,PA,Passenger,1,0,1,80,81,1.23,Furthest
16903,September,2018,Kitsap,WA,Truck,1,0,1,53537,53538,0.0,Washington
16904,September,2018,Benton,WA,Truck,0,0,0,41347,41347,0.0,Washington
16905,September,2018,Pend Oreille,WA,Passenger,5,5,10,9589,9599,0.1,Washington
16906,September,2018,Montgomery,TX,Passenger,2,0,2,61,63,3.17,Mid-Distance
16907,September,2018,Maricopa,AZ,Passenger,2,1,3,1561,1564,0.19,Nearest
16908,September,2018,Island,WA,Passenger,227,208,435,62869,63304,0.69,Washington
16909,September,2018,Pinal,AZ,Passenger,2,0,2,201,203,0.99,Nearest
16910,September,2018,District of Columbia,DC,Passenger,0,3,3,197,200,1.5,Furthest
16911,September,2018,Ferry,WA,Passenger,2,2,4,4406,4410,0.09,Washington
16912,September,2018,Prince George,VA,Passenger,0,1,1,76,77,1.3,Furthest
16913,September,2018,Contra Costa,CA,Passenger,0,2,2,423,425,0.47,Nearest
16914,September,2018,Fulton,GA,Passenger,1,2,3,107,110,2.73,Furthest
16915,September,2018,Morris,NJ,Passenger,1,0,1,17,18,5.56,Furthest
16916,September,2018,Denver,CO,Passenger,1,0,1,134,135,0.74,Mid-Distance
16917,September,2018,Okanogan,WA,Passenger,10,20,30,26057,26087,0.11,Washington
16918,September,2018,Howard,MD,Passenger,0,1,1,87,88,1.14,Furthest
16919,September,2018,Orange,FL,Passenger,2,1,3,165,168,1.79,Furthest
16920,September,2018,Douglas,WA,Passenger,48,33,81,27849,27930,0.29,Washington
16921,September,2018,Alameda,CA,Passenger,0,2,2,333,335,0.6,Nearest
16922,September,2018,Utah,UT,Passenger,0,1,1,138,139,0.72,Nearest
16923,September,2018,Washtenaw,MI,Passenger,1,0,1,38,39,2.56,Furthest
16924,September,2018,Clay,FL,Passenger,0,1,1,91,92,1.09,Furthest
16925,September,2018,Beaufort,SC,Passenger,1,0,1,37,38,2.63,Furthest
16926,September,2018,Cowlitz,WA,Truck,0,0,0,28600,28600,0.0,Washington
16927,September,2018,Saratoga,NY,Passenger,1,0,1,62,63,1.59,Furthest
16928,September,2018,Twin Falls,ID,Passenger,0,1,1,21,22,4.55,Nearest
16929,September,2018,Lewis,WA,Passenger,84,66,150,57934,58084,0.26,Washington
16930,September,2018,Dale,AL,Passenger,0,1,1,57,58,1.72,Furthest
16931,September,2018,Prince George's,MD,Passenger,1,1,2,180,182,1.1,Furthest
16932,September,2018,Garfield,WA,Passenger,1,1,2,1320,1322,0.15,Washington
16933,September,2018,Pima,AZ,Passenger,1,1,2,410,412,0.49,Nearest
16934,September,2018,Lincoln,WA,Passenger,2,6,8,7748,7756,0.1,Washington
16935,September,2018,Stevens,WA,Passenger,13,27,40,31699,31739,0.13,Washington
16936,September,2018,Moore,NC,Passenger,0,1,1,196,197,0.51,Furthest
16937,September,2018,Spokane,WA,Passenger,359,344,703,305145,305848,0.23,Washington
16938,September,2018,Grays Harbor,WA,Truck,0,0,0,20307,20307,0.0,Washington
16939,September,2018,Asotin,WA,Passenger,11,8,19,12678,12697,0.15,Washington
16940,September,2018,Ramsey,MN,Passenger,1,0,1,40,41,2.44,Mid-Distance
16941,September,2018,Deschutes,OR,Passenger,2,0,2,162,164,1.22,Nearest
16942,September,2018,Polk,FL,Passenger,1,0,1,63,64,1.56,Furthest
16944,September,2018,Thurston,WA,Truck,0,0,0,54640,54640,0.0,Washington
16945,September,2018,Douglas,WA,Truck,0,0,0,12012,12012,0.0,Washington
16946,September,2018,Jefferson,CO,Passenger,0,1,1,64,65,1.54,Mid-Distance
16947,September,2018,Honolulu,HI,Passenger,1,2,3,524,527,0.57,Nearest
16948,September,2018,Cape May,NJ,Passenger,0,1,1,22,23,4.35,Furthest
16949,September,2018,Garfield,OK,Passenger,1,0,1,15,16,6.25,Mid-Distance
16950,September,2018,Marion,OR,Passenger,1,0,1,122,123,0.81,Nearest
16951,September,2018,Spokane,WA,Truck,1,0,1,93185,93186,0.0,Washington
16952,September,2018,Portsmouth,VA,Passenger,0,1,1,76,77,1.3,Furthest
16953,September,2018,Whitman,WA,Truck,0,0,0,8517,8517,0.0,Washington
16954,September,2018,Thurston,WA,Passenger,621,527,1148,194606,195754,0.59,Washington
16955,September,2018,San Francisco,CA,Passenger,1,1,2,117,119,1.68,Nearest
16956,September,2018,Ventura,CA,Passenger,0,2,2,311,313,0.64,Nearest
16957,September,2018,Suffolk,MA,Passenger,0,1,1,43,44,2.27,Furthest
16958,September,2018,Dakota,MN,Passenger,0,2,2,33,35,5.71,Mid-Distance
16959,September,2018,Richmond,GA,Passenger,0,1,1,92,93,1.08,Furthest
16960,September,2018,Pacific,WA,Truck,0,0,0,7632,7632,0.0,Washington
16961,September,2018,Pend Oreille,WA,Truck,0,0,0,5744,5744,0.0,Washington
16962,September,2018,Lee,FL,Passenger,1,0,1,57,58,1.72,Furthest
16963,September,2018,Yakima,WA,Truck,0,0,0,58690,58690,0.0,Washington
16964,September,2018,Prince William,VA,Passenger,0,4,4,260,264,1.52,Furthest
16965,September,2018,Franklin,WA,Passenger,37,65,102,58512,58614,0.17,Washington
16966,September,2018,Cook,IL,Passenger,1,0,1,256,257,0.39,Mid-Distance
16967,September,2018,Riverside,CA,Passenger,2,2,4,688,692,0.58,Nearest
16968,September,2018,Mason,WA,Truck,0,0,0,20090,20090,0.0,Washington
16969,September,2018,Broward,FL,Passenger,1,1,2,135,137,1.46,Furthest
16970,September,2018,Sedgwick,KS,Passenger,0,1,1,97,98,1.02,Mid-Distance
16971,September,2018,San Juan,WA,Truck,0,0,0,5761,5761,0.0,Washington
16972,September,2018,Asotin,WA,Truck,0,0,0,6631,6631,0.0,Washington
16973,September,2018,Manassas,VA,Passenger,0,1,1,9,10,10.0,Furthest
16974,September,2018,Lumpkin,GA,Passenger,1,0,1,7,8,12.5,Furthest
16975,September,2018,Charleston,SC,Passenger,1,0,1,129,130,0.77,Furthest
16976,September,2018,San Juan,WA,Passenger,161,68,229,14183,14412,1.59,Washington
16977,September,2018,Lane,OR,Passenger,0,1,1,177,178,0.56,Nearest
16978,September,2018,Chelan,WA,Truck,0,0,0,22027,22027,0.0,Washington
16979,September,2018,DeKalb,GA,Passenger,1,0,1,78,79,1.27,Furthest
16980,September,2018,Skagit,WA,Truck,1,0,1,32261,32262,0.0,Washington
16981,September,2018,Hennepin,MN,Passenger,1,0,1,110,111,0.9,Mid-Distance
16982,September,2018,Santa Rosa,FL,Passenger,1,0,1,89,90,1.11,Furthest
16983,September,2018,Fresno,CA,Passenger,1,0,1,191,192,0.52,Nearest
16984,September,2018,Garfield,WA,Truck,0,0,0,966,966,0.0,Washington
16985,September,2018,Nueces,TX,Passenger,1,1,2,88,90,2.22,Mid-Distance
16986,September,2018,Queens,NY,Passenger,1,0,1,61,62,1.61,Furthest
16987,September,2018,Larimer,CO,Passenger,1,0,1,61,62,1.61,Mid-Distance
16988,September,2018,Franklin,WA,Truck,0,0,0,18876,18876,0.0,Washington
16989,September,2018,Clark,NV,Passenger,1,2,3,732,735,0.41,Nearest
16990,September,2018,Tulsa,OK,Passenger,1,1,2,47,49,4.08,Mid-Distance
16991,September,2018,Pierce,WA,Truck,0,0,0,138460,138460,0.0,Washington
16992,September,2018,El Paso,TX,Passenger,1,0,1,498,499,0.2,Mid-Distance
16993,September,2018,Adams,WA,Passenger,5,5,10,12682,12692,0.08,Washington
16994,September,2018,Kittitas,WA,Passenger,55,36,91,29200,29291,0.31,Washington
16995,September,2018,San Mateo,CA,Passenger,1,1,2,132,134,1.49,Nearest
16996,September,2019,Clark,NV,Passenger,4,2,6,684,690,0.87,Nearest
16997,September,2019,Franklin,MA,Passenger,0,1,1,1,2,50.0,Furthest
16998,September,2019,Twin Falls,ID,Passenger,0,1,1,26,27,3.7,Nearest
16999,September,2019,Cowlitz,WA,Passenger,106,106,212,73309,73521,0.29,Washington
17000,September,2019,Anne Arundel,MD,Passenger,1,2,3,437,440,0.68,Furthest
17001,September,2019,Stafford,VA,Passenger,1,1,2,96,98,2.04,Furthest
17002,September,2019,King,WA,Passenger,20421,7282,27703,1394905,1422608,1.95,Washington
17003,September,2019,Wahkiakum,WA,Passenger,2,3,5,3049,3054,0.16,Washington
17004,September,2019,Duval,FL,Passenger,1,2,3,369,372,0.81,Furthest
17005,September,2019,District of Columbia,DC,Passenger,1,1,2,210,212,0.94,Furthest
17006,September,2019,Montgomery,TX,Passenger,1,0,1,58,59,1.69,Mid-Distance
17007,September,2019,Pacific,WA,Truck,0,0,0,7676,7676,0.0,Washington
17008,September,2019,Jones,GA,Passenger,1,0,1,1,2,50.0,Furthest
17009,September,2019,Jefferson,CO,Passenger,0,2,2,59,61,3.28,Mid-Distance
17010,September,2019,Walla Walla,WA,Passenger,59,63,122,36254,36376,0.34,Washington
17011,September,2019,Chesapeake,VA,Passenger,0,1,1,442,443,0.23,Furthest
17012,September,2019,Sedgwick,KS,Passenger,1,1,2,99,101,1.98,Mid-Distance
17013,September,2019,Orange,CA,Passenger,7,3,10,513,523,1.91,Nearest
17014,September,2019,Sumter,FL,Passenger,0,1,1,9,10,10.0,Furthest
17015,September,2019,Osceola,FL,Passenger,1,0,1,40,41,2.44,Furthest
17016,September,2019,Snohomish,WA,Truck,0,0,0,122968,122968,0.0,Washington
17017,September,2019,Kern,CA,Passenger,0,1,1,217,218,0.46,Nearest
17018,September,2019,Broward,FL,Passenger,2,1,3,128,131,2.29,Furthest
17019,September,2019,St. Mary's,MD,Passenger,1,0,1,218,219,0.46,Furthest
17020,September,2019,Fulton,GA,Passenger,0,2,2,102,104,1.92,Furthest
17021,September,2019,DuPage,IL,Passenger,3,0,3,61,64,4.69,Mid-Distance
17022,September,2019,Manassas,VA,Passenger,0,1,1,7,8,12.5,Furthest
17023,September,2019,Riverside,CA,Passenger,4,1,5,650,655,0.76,Nearest
17024,September,2019,Moore,NC,Passenger,0,1,1,180,181,0.55,Furthest
17025,September,2019,Mason,WA,Passenger,133,129,262,47444,47706,0.55,Washington
17026,September,2019,Shasta,CA,Passenger,1,0,1,39,40,2.5,Nearest
17027,September,2019,Wayne,MI,Passenger,0,1,1,63,64,1.56,Furthest
17028,September,2019,Nassau,NY,Passenger,4,0,4,37,41,9.76,Furthest
17029,September,2019,Deschutes,OR,Passenger,3,0,3,153,156,1.92,Nearest
17030,September,2019,Pacific,WA,Passenger,25,29,54,16078,16132,0.33,Washington
17031,September,2019,Larimer,CO,Passenger,1,0,1,60,61,1.64,Mid-Distance
17032,September,2019,Thurston,WA,Truck,0,0,0,55538,55538,0.0,Washington
17033,September,2019,Santa Rosa,FL,Passenger,1,0,1,87,88,1.14,Furthest
17034,September,2019,Chelan,WA,Passenger,174,71,245,54511,54756,0.45,Washington
17035,September,2019,Houston,GA,Passenger,1,0,1,56,57,1.75,Furthest
17036,September,2019,Tuolumne,CA,Passenger,0,1,1,11,12,8.33,Nearest
17037,September,2019,Snohomish,WA,Passenger,3740,1661,5401,533934,539335,1.0,Washington
17038,September,2019,DeKalb,IN,Passenger,1,0,1,1,2,50.0,Furthest
17039,September,2019,Ramsey,MN,Passenger,1,0,1,40,41,2.44,Mid-Distance
17040,September,2019,Clay,FL,Passenger,0,1,1,85,86,1.16,Furthest
17041,September,2019,Bexar,TX,Passenger,1,5,6,651,657,0.91,Mid-Distance
17042,September,2019,Albemarle,VA,Passenger,1,0,1,23,24,4.17,Furthest
17043,September,2019,Guadalupe,TX,Passenger,1,0,1,70,71,1.41,Mid-Distance
17044,September,2019,Frederick,MD,Passenger,1,1,2,80,82,2.44,Furthest
17045,September,2019,Lake,FL,Passenger,1,0,1,21,22,4.55,Furthest
17046,September,2019,Spokane,WA,Truck,1,0,1,95761,95762,0.0,Washington
17047,September,2019,El Paso,CO,Passenger,2,1,3,739,742,0.4,Mid-Distance
17048,September,2019,Whatcom,WA,Passenger,922,460,1382,151337,152719,0.9,Washington
17049,September,2019,Columbia,WA,Truck,0,0,0,1536,1536,0.0,Washington
17050,September,2019,Douglas,NE,Passenger,0,1,1,59,60,1.67,Mid-Distance
17051,September,2019,Ferry,WA,Truck,0,0,0,3583,3583,0.0,Washington
17052,September,2019,Lake,IL,Passenger,1,0,1,165,166,0.6,Mid-Distance
17053,September,2019,Sarasota,FL,Passenger,1,0,1,26,27,3.7,Furthest
17054,September,2019,Cowlitz,WA,Truck,0,0,0,28959,28959,0.0,Washington
17055,September,2019,Clallam,WA,Truck,1,0,1,21843,21844,0.0,Washington
17056,September,2019,Solano,CA,Passenger,1,0,1,207,208,0.48,Nearest
17057,September,2019,Ferry,WA,Passenger,5,2,7,4423,4430,0.16,Washington
17058,September,2019,Vigo,IN,Passenger,1,0,1,6,7,14.29,Furthest
17059,September,2019,Yakima,WA,Truck,0,0,0,59399,59399,0.0,Washington
17060,September,2019,Nueces,TX,Passenger,1,1,2,92,94,2.13,Mid-Distance
17061,September,2019,Lewis,WA,Passenger,107,101,208,59362,59570,0.35,Washington
17062,September,2019,Richland,SC,Passenger,0,1,1,156,157,0.64,Furthest
17063,September,2019,Skagit,WA,Passenger,315,210,525,92513,93038,0.56,Washington
17064,September,2019,Kitsap,WA,Passenger,1135,641,1776,181617,183393,0.97,Washington
17065,September,2019,Carson City,NV,Passenger,1,0,1,10,11,9.09,Nearest
17066,September,2019,Clark,WA,Passenger,1700,982,2682,316090,318772,0.84,Washington
17067,September,2019,Asotin,WA,Passenger,12,8,20,12631,12651,0.16,Washington
17068,September,2019,Oldham,KY,Passenger,0,1,1,5,6,16.67,Furthest
17069,September,2019,Polk,FL,Passenger,1,0,1,66,67,1.49,Furthest
17070,September,2019,San Diego,CA,Passenger,10,3,13,2770,2783,0.47,Nearest
17071,September,2019,Island,WA,Passenger,346,249,595,63481,64076,0.93,Washington
17072,September,2019,Asotin,WA,Truck,0,0,0,6682,6682,0.0,Washington
17073,September,2019,San Mateo,CA,Passenger,2,1,3,119,122,2.46,Nearest
17074,September,2019,Cascade,MT,Passenger,0,1,1,58,59,1.69,Nearest
17075,September,2019,Charleston,SC,Passenger,1,0,1,113,114,0.88,Furthest
17076,September,2019,Lewis,WA,Truck,0,0,0,25970,25970,0.0,Washington
17077,September,2019,Monroe,IL,Passenger,1,0,1,5,6,16.67,Mid-Distance
17078,September,2019,Tarrant,TX,Passenger,2,0,2,195,197,1.02,Mid-Distance
17079,September,2019,Dallas,TX,Passenger,1,0,1,209,210,0.48,Mid-Distance
17080,September,2019,Cumberland,NC,Passenger,0,2,2,490,492,0.41,Furthest
17081,September,2019,Wilson,TX,Passenger,0,1,1,6,7,14.29,Mid-Distance
17082,September,2019,El Paso,TX,Passenger,3,0,3,472,475,0.63,Mid-Distance
17083,September,2019,Oklahoma,OK,Passenger,0,1,1,127,128,0.78,Mid-Distance
17084,September,2019,Boone,MO,Passenger,0,1,1,10,11,9.09,Furthest
17085,September,2019,Dakota,MN,Passenger,0,1,1,37,38,2.63,Mid-Distance
17086,September,2019,Kitsap,WA,Truck,1,0,1,54211,54212,0.0,Washington
17087,September,2019,Kittitas,WA,Truck,0,0,0,14565,14565,0.0,Washington
17088,September,2019,Fairbanks North Star,AK,Passenger,0,1,1,98,99,1.01,Nearest
17089,September,2019,Thurston,WA,Passenger,953,672,1625,198595,200220,0.81,Washington
17090,September,2019,Pend Oreille,WA,Passenger,6,6,12,9472,9484,0.13,Washington
17091,September,2019,Williamson,TX,Passenger,0,2,2,144,146,1.37,Mid-Distance
17092,September,2019,Alexandria,VA,Passenger,1,0,1,147,148,0.68,Furthest
17093,September,2019,Grays Harbor,WA,Passenger,89,89,178,48096,48274,0.37,Washington
17094,September,2019,Skamania,WA,Truck,0,0,0,4086,4086,0.0,Washington
17095,September,2019,Norfolk,MA,Passenger,1,0,1,36,37,2.7,Furthest
17096,September,2019,Pima,AZ,Passenger,2,1,3,379,382,0.79,Nearest
17097,September,2019,Boulder,CO,Passenger,0,1,1,49,50,2.0,Mid-Distance
17098,September,2019,Santa Clara,CA,Passenger,4,2,6,358,364,1.65,Nearest
17099,September,2019,Klickitat,WA,Passenger,38,36,74,15624,15698,0.47,Washington
17100,September,2019,Maui,HI,Passenger,1,0,1,41,42,2.38,Nearest
17101,September,2019,Okanogan,WA,Passenger,24,26,50,26237,26287,0.19,Washington
17102,September,2019,Rogers,OK,Passenger,1,0,1,5,6,16.67,Mid-Distance
17103,September,2019,Klickitat,WA,Truck,0,0,0,8298,8298,0.0,Washington
17104,September,2019,Travis,TX,Passenger,2,1,3,203,206,1.46,Mid-Distance
17105,September,2019,Ventura,CA,Passenger,0,2,2,305,307,0.65,Nearest
17106,September,2019,Fairfax,VA,Passenger,3,2,5,759,764,0.65,Furthest
17107,September,2019,Alameda,CA,Passenger,4,1,5,295,300,1.67,Nearest
17108,September,2019,Allegheny,PA,Passenger,1,0,1,79,80,1.25,Furthest
17109,September,2019,San Francisco,CA,Passenger,2,1,3,105,108,2.78,Nearest
17110,September,2019,Pierce,WA,Passenger,1966,1602,3568,545437,549005,0.65,Washington
17111,September,2019,Whitman,WA,Passenger,36,45,81,22710,22791,0.36,Washington
17112,September,2019,Island,WA,Truck,0,0,0,21294,21294,0.0,Washington
17113,September,2019,Maricopa,AZ,Passenger,7,4,11,1521,1532,0.72,Nearest
17114,September,2019,Garfield,WA,Truck,0,0,0,970,970,0.0,Washington
17115,September,2019,Lincoln,WA,Passenger,2,10,12,7807,7819,0.15,Washington
17116,September,2019,Los Angeles,CA,Passenger,9,7,16,1087,1103,1.45,Nearest
17117,September,2019,Grays Harbor,WA,Truck,0,0,0,20636,20636,0.0,Washington
17118,September,2019,Prince William,VA,Passenger,1,3,4,242,246,1.63,Furthest
17119,September,2019,Suffolk,MA,Passenger,0,1,1,38,39,2.56,Furthest
17120,September,2019,Spartanburg,SC,Passenger,0,1,1,39,40,2.5,Furthest
17121,September,2019,Arlington,VA,Passenger,0,2,2,152,154,1.3,Furthest
17122,September,2019,Penobscot,ME,Passenger,0,1,1,13,14,7.14,Furthest
17123,September,2019,Juneau,AK,Passenger,0,2,2,28,30,6.67,Nearest
17124,September,2019,San Juan,WA,Truck,0,0,0,5916,5916,0.0,Washington
17125,September,2019,Chelan,WA,Truck,0,0,0,22420,22420,0.0,Washington
17126,September,2019,Fresno,CA,Passenger,1,0,1,194,195,0.51,Nearest
17127,September,2019,Whitman,WA,Truck,0,0,0,8604,8604,0.0,Washington
17128,September,2019,Clackamas,OR,Passenger,2,1,3,211,214,1.4,Nearest
17129,September,2019,San Juan,WA,Passenger,229,73,302,14431,14733,2.05,Washington
17130,September,2019,Pinellas,FL,Passenger,1,1,2,110,112,1.79,Furthest
17131,September,2019,Shelby,TN,Passenger,0,1,1,94,95,1.05,Furthest
17132,September,2019,Clallam,WA,Passenger,185,151,336,50854,51190,0.66,Washington
17133,September,2019,Denver,CO,Passenger,1,0,1,129,130,0.77,Mid-Distance
17134,September,2019,New London,CT,Passenger,0,2,2,242,244,0.82,Furthest
17135,September,2019,Carroll,NH,Passenger,0,1,1,3,4,25.0,Furthest
17136,September,2019,Ada,ID,Passenger,0,2,2,302,304,0.66,Nearest
17137,September,2019,Jefferson,NY,Passenger,0,2,2,216,218,0.92,Furthest
17138,September,2019,Powhatan,VA,Passenger,1,0,1,0,1,100.0,Furthest
17139,September,2019,Kootenai,ID,Passenger,1,1,2,222,224,0.89,Nearest
17140,September,2019,Pinal,AZ,Passenger,2,0,2,190,192,1.04,Nearest
17141,September,2019,Walla Walla,WA,Truck,0,0,0,13687,13687,0.0,Washington
17142,September,2019,Yakima,WA,Passenger,111,113,224,165657,165881,0.14,Washington
17143,September,2019,Washoe,NV,Passenger,2,0,2,107,109,1.83,Nearest
17144,September,2019,Cochise,AZ,Passenger,0,1,1,107,108,0.93,Nearest
17145,September,2019,Hawaii,HI,Passenger,1,0,1,57,58,1.72,Nearest
17146,September,2019,Pend Oreille,WA,Truck,0,0,0,5712,5712,0.0,Washington
17147,September,2019,Richmond,GA,Passenger,0,1,1,92,93,1.08,Furthest
17148,September,2019,Camden,NJ,Passenger,0,1,1,24,25,4.0,Furthest
17149,September,2019,Lincoln,WA,Truck,0,0,0,4690,4690,0.0,Washington
17150,September,2019,Benton,WA,Truck,0,0,0,42229,42229,0.0,Washington
17151,September,2019,Harris,TX,Passenger,1,1,2,246,248,0.81,Mid-Distance
17152,September,2019,Franklin,WA,Truck,0,0,0,19536,19536,0.0,Washington
17153,September,2019,King,WA,Truck,6,1,7,182395,182402,0.0,Washington
17154,September,2019,New Haven,CT,Passenger,0,2,2,47,49,4.08,Furthest
17155,September,2019,RÃ­o Grande,PR,Passenger,1,0,1,1,2,50.0,Mid-Distance
17156,September,2019,Franklin,WA,Passenger,51,73,124,60363,60487,0.21,Washington
17157,September,2019,Placer,CA,Passenger,1,0,1,96,97,1.03,Nearest
17158,September,2019,Multnomah,OR,Passenger,5,6,11,739,750,1.47,Nearest
17159,September,2019,Cape May,NJ,Passenger,0,1,1,13,14,7.14,Furthest
17160,September,2019,Kittitas,WA,Passenger,81,44,125,29832,29957,0.42,Washington
17161,September,2019,Klamath,OR,Passenger,1,0,1,39,40,2.5,Nearest
17162,September,2019,Tulsa,OK,Passenger,1,1,2,49,51,3.92,Mid-Distance
17163,September,2019,Jefferson,WA,Truck,0,0,0,9682,9682,0.0,Washington
17164,September,2019,Goochland,VA,Passenger,2,1,3,264,267,1.12,Furthest
17165,September,2019,Santa Cruz,CA,Passenger,1,0,1,36,37,2.7,Nearest
17166,September,2019,Stevens,WA,Truck,0,0,0,18754,18754,0.0,Washington
17167,September,2019,Skamania,WA,Passenger,26,18,44,8787,8831,0.5,Washington
17168,September,2019,Washtenaw,MI,Passenger,1,0,1,41,42,2.38,Furthest
17169,September,2019,Volusia,FL,Passenger,0,1,1,38,39,2.56,Furthest
17170,September,2019,Calvert,MD,Passenger,0,2,2,91,93,2.15,Furthest
17171,September,2019,Flathead,MT,Passenger,1,0,1,64,65,1.54,Nearest
17172,September,2019,Prince George's,MD,Passenger,1,1,2,176,178,1.12,Furthest
17173,September,2019,Stevens,WA,Passenger,27,28,55,31672,31727,0.17,Washington
17174,September,2019,Palm Beach,FL,Passenger,0,1,1,84,85,1.18,Furthest
17175,September,2019,Kent,MI,Passenger,0,1,1,23,24,4.17,Furthest
17176,September,2019,Valencia,NM,Passenger,1,0,1,6,7,14.29,Mid-Distance
17177,September,2019,San Joaquin,CA,Passenger,1,0,1,135,136,0.74,Nearest
17178,September,2019,Santa Fe,NM,Passenger,0,1,1,42,43,2.33,Mid-Distance
17179,September,2019,Cook,IL,Passenger,1,0,1,240,241,0.41,Mid-Distance
17180,September,2019,Loudoun,VA,Passenger,1,0,1,94,95,1.05,Furthest
17181,September,2019,Montgomery,PA,Passenger,2,0,2,36,38,5.26,Furthest
17182,September,2019,Greene,MO,Passenger,0,1,1,31,32,3.12,Furthest
17183,September,2019,Virginia Beach,VA,Passenger,1,0,1,700,701,0.14,Furthest
17184,September,2019,Grant,WA,Truck,0,0,0,26789,26789,0.0,Washington
17185,September,2019,Harrison,MS,Passenger,1,0,1,61,62,1.61,Mid-Distance
17186,September,2019,Columbia,WA,Passenger,3,2,5,2446,2451,0.2,Washington
17187,September,2019,Contra Costa,CA,Passenger,2,2,4,367,371,1.08,Nearest
17188,September,2019,Harnett,NC,Passenger,1,1,2,212,214,0.93,Furthest
17189,September,2019,Portsmouth,VA,Passenger,0,1,1,79,80,1.25,Furthest
17190,September,2019,Owyhee,ID,Passenger,1,0,1,4,5,20.0,Nearest
17191,September,2019,Middlesex,MA,Passenger,1,1,2,109,111,1.8,Furthest
17192,September,2019,Skagit,WA,Truck,1,0,1,32515,32516,0.0,Washington
17193,September,2019,DeKalb,GA,Passenger,1,0,1,79,80,1.25,Furthest
17194,September,2019,Wahkiakum,WA,Truck,0,0,0,1760,1760,0.0,Washington
17195,September,2019,Sangamon,IL,Passenger,1,0,1,6,7,14.29,Mid-Distance
17196,September,2019,Hennepin,MN,Passenger,3,1,4,103,107,3.74,Mid-Distance
17197,September,2019,Okanogan,WA,Truck,0,0,0,16497,16497,0.0,Washington
17198,September,2019,Shelby,OH,Passenger,0,1,1,1,2,50.0,Furthest
17199,September,2019,Benton,WA,Passenger,291,297,588,134616,135204,0.43,Washington
17200,September,2019,Brevard,FL,Passenger,0,1,1,87,88,1.14,Furthest
17201,September,2019,Honolulu,HI,Passenger,4,2,6,492,498,1.2,Nearest
17202,September,2019,Adams,WA,Passenger,5,5,10,12887,12897,0.08,Washington
17203,September,2019,Putnam,TN,Passenger,0,1,1,3,4,25.0,Furthest
17204,September,2019,Garfield,WA,Passenger,0,1,1,1311,1312,0.08,Washington
17205,September,2019,Pierce,WA,Truck,0,0,0,140471,140471,0.0,Washington
17206,September,2019,Charles,MD,Passenger,0,1,1,86,87,1.15,Furthest
17207,September,2019,Randolph,NC,Passenger,1,0,1,6,7,14.29,Furthest
17208,September,2019,Howard,MD,Passenger,0,1,1,76,77,1.3,Furthest
17209,September,2019,Whatcom,WA,Truck,2,0,2,43030,43032,0.0,Washington
17210,September,2019,Mason,WA,Truck,0,0,0,20438,20438,0.0,Washington
17211,September,2019,Adams,WA,Truck,0,0,0,5139,5139,0.0,Washington
17212,September,2019,Norfolk,VA,Passenger,2,2,4,344,348,1.15,Furthest
17213,September,2019,Douglas,WA,Truck,0,0,0,12275,12275,0.0,Washington
17215,September,2019,Clark,WA,Truck,0,0,0,80968,80968,0.0,Washington
17216,September,2019,Collin,TX,Passenger,1,1,2,128,130,1.54,Mid-Distance
17217,September,2019,Spokane,WA,Passenger,596,445,1041,313551,314592,0.33,Washington
17218,September,2019,Berkshire,MA,Passenger,0,1,1,4,5,20.0,Furthest
17219,September,2019,Saginaw,MI,Passenger,1,0,1,11,12,8.33,Furthest
17220,September,2019,Bucks,PA,Passenger,1,0,1,23,24,4.17,Furthest
17221,September,2019,Jefferson,WA,Passenger,207,126,333,25125,25458,1.31,Washington
17222,September,2019,Lee,FL,Passenger,1,0,1,50,51,1.96,Furthest
17223,September,2019,Grant,WA,Passenger,48,63,111,65170,65281,0.17,Washington
17224,September,2019,Montgomery,AL,Passenger,0,1,1,42,43,2.33,Furthest
17225,September,2019,Douglas,WA,Passenger,62,37,99,28207,28306,0.35,Washington
17226,September,2020,Washoe,NV,Passenger,1,0,1,99,100,1.0,Nearest
17227,September,2020,Cowlitz,WA,Passenger,157,120,277,72161,72438,0.38,Washington
17228,September,2020,Duval,FL,Passenger,0,2,2,357,359,0.56,Furthest
17229,September,2020,Mason,WA,Truck,0,0,0,20804,20804,0.0,Washington
17230,September,2020,Adams,WA,Truck,0,0,0,5309,5309,0.0,Washington
17231,September,2020,Hamilton,IN,Passenger,1,0,1,37,38,2.63,Furthest
17232,September,2020,Skamania,WA,Truck,0,0,0,4005,4005,0.0,Washington
17233,September,2020,New London,CT,Passenger,1,2,3,237,240,1.25,Furthest
17234,September,2020,DeKalb,IN,Passenger,1,0,1,1,2,50.0,Furthest
17235,September,2020,Bexar,TX,Passenger,4,5,9,582,591,1.52,Mid-Distance
17236,September,2020,Prince William,VA,Passenger,2,2,4,219,223,1.79,Furthest
17237,September,2020,Cascade,MT,Passenger,0,1,1,53,54,1.85,Nearest
17238,September,2020,Grant,WA,Truck,0,0,0,27301,27301,0.0,Washington
17239,September,2020,Walla Walla,WA,Truck,0,0,0,13789,13789,0.0,Washington
17240,September,2020,Pacific,WA,Passenger,32,34,66,15716,15782,0.42,Washington
17241,September,2020,Portsmouth,VA,Passenger,0,1,1,74,75,1.33,Furthest
17242,September,2020,Kauai,HI,Passenger,1,0,1,14,15,6.67,Nearest
17243,September,2020,Greene,MO,Passenger,0,1,1,32,33,3.03,Furthest
17244,September,2020,Maricopa,AZ,Passenger,5,7,12,1347,1359,0.88,Nearest
17245,September,2020,DeKalb,GA,Passenger,1,0,1,77,78,1.28,Furthest
17246,September,2020,Spartanburg,SC,Passenger,0,1,1,49,50,2.0,Furthest
17247,September,2020,Oldham,KY,Passenger,0,1,1,4,5,20.0,Furthest
17248,September,2020,Garfield,WA,Passenger,0,1,1,1348,1349,0.07,Washington
17249,September,2020,San Francisco,CA,Passenger,2,1,3,89,92,3.26,Nearest
17250,September,2020,Howard,MD,Passenger,0,1,1,63,64,1.56,Furthest
17251,September,2020,Wahkiakum,WA,Passenger,6,6,12,3016,3028,0.4,Washington
17252,September,2020,Prince George's,MD,Passenger,2,1,3,149,152,1.97,Furthest
17253,September,2020,Clackamas,OR,Passenger,2,0,2,183,185,1.08,Nearest
17254,September,2020,Santa Clara,CA,Passenger,6,2,8,276,284,2.82,Nearest
17255,September,2020,Travis,TX,Passenger,2,1,3,169,172,1.74,Mid-Distance
17256,September,2020,Montgomery,TX,Passenger,1,0,1,47,48,2.08,Mid-Distance
17257,September,2020,Sacramento,CA,Passenger,1,0,1,251,252,0.4,Nearest
17258,September,2020,Harnett,NC,Passenger,1,0,1,191,192,0.52,Furthest
17259,September,2020,Clark,WA,Passenger,2174,1098,3272,318408,321680,1.02,Washington
17260,September,2020,Erie,NY,Passenger,1,0,1,46,47,2.13,Furthest
17261,September,2020,Fresno,CA,Passenger,1,0,1,173,174,0.57,Nearest
17262,September,2020,Stafford,VA,Passenger,1,1,2,93,95,2.11,Furthest
17263,September,2020,Placer,CA,Passenger,2,0,2,85,87,2.3,Nearest
17264,September,2020,San Juan,WA,Passenger,331,100,431,13907,14338,3.01,Washington
17265,September,2020,El Dorado,CA,Passenger,1,0,1,33,34,2.94,Nearest
17266,September,2020,Frederick,MD,Passenger,1,1,2,72,74,2.7,Furthest
17267,September,2020,Manassas,VA,Passenger,0,1,1,5,6,16.67,Furthest
17268,September,2020,El Paso,CO,Passenger,2,0,2,707,709,0.28,Mid-Distance
17269,September,2020,Asotin,WA,Passenger,17,14,31,12398,12429,0.25,Washington
17270,September,2020,Miami-Dade,FL,Passenger,1,0,1,104,105,0.95,Furthest
17271,September,2020,Rockingham,NH,Passenger,1,0,1,22,23,4.35,Furthest
17272,September,2020,Walla Walla,WA,Passenger,86,62,148,35944,36092,0.41,Washington
17273,September,2020,Leavenworth,KS,Passenger,0,1,1,120,121,0.83,Mid-Distance
17274,September,2020,Grant,WA,Passenger,67,80,147,65582,65729,0.22,Washington
17275,September,2020,Whatcom,WA,Passenger,1140,525,1665,149401,151066,1.1,Washington
17276,September,2020,Cumberland,NC,Passenger,0,3,3,452,455,0.66,Furthest
17277,September,2020,Kittitas,WA,Passenger,113,48,161,29701,29862,0.54,Washington
17278,September,2020,Kings,NY,Passenger,1,0,1,65,66,1.52,Furthest
17279,September,2020,San Joaquin,CA,Passenger,1,0,1,115,116,0.86,Nearest
17280,September,2020,Lake,IL,Passenger,1,0,1,163,164,0.61,Mid-Distance
17281,September,2020,Sedgwick,KS,Passenger,1,1,2,92,94,2.13,Mid-Distance
17282,September,2020,Williamson,TX,Passenger,0,2,2,128,130,1.54,Mid-Distance
17283,September,2020,Douglas,WA,Passenger,79,45,124,28040,28164,0.44,Washington
17284,September,2020,New York,NY,Passenger,1,0,1,55,56,1.79,Furthest
17285,September,2020,Loudoun,VA,Passenger,1,0,1,82,83,1.2,Furthest
17286,September,2020,Virginia Beach,VA,Passenger,1,0,1,655,656,0.15,Furthest
17287,September,2020,Houston,GA,Passenger,1,0,1,53,54,1.85,Furthest
17288,September,2020,Snohomish,WA,Truck,0,0,0,124936,124936,0.0,Washington
17289,September,2020,Ferry,WA,Truck,0,0,0,3582,3582,0.0,Washington
17290,September,2020,Spokane,WA,Passenger,797,513,1310,318772,320082,0.41,Washington
17291,September,2020,St. Mary's,MD,Passenger,1,0,1,217,218,0.46,Furthest
17292,September,2020,Richmond,GA,Passenger,0,1,1,81,82,1.22,Furthest
17293,September,2020,Douglas,NE,Passenger,0,1,1,48,49,2.04,Mid-Distance
17294,September,2020,Bartow,GA,Passenger,0,1,1,4,5,20.0,Furthest
17295,September,2020,Lee,FL,Passenger,1,0,1,47,48,2.08,Furthest
17296,September,2020,Kern,CA,Passenger,0,1,1,223,224,0.45,Nearest
17297,September,2020,St. Clair,IL,Passenger,1,0,1,137,138,0.72,Mid-Distance
17298,September,2020,Gwinnett,GA,Passenger,1,0,1,69,70,1.43,Furthest
17299,September,2020,Boulder,CO,Passenger,0,1,1,43,44,2.27,Mid-Distance
17300,September,2020,Okanogan,WA,Passenger,45,36,81,25965,26046,0.31,Washington
17301,September,2020,Monroe,IL,Passenger,1,0,1,3,4,25.0,Mid-Distance
17302,September,2020,San Diego,CA,Passenger,15,5,20,2735,2755,0.73,Nearest
17303,September,2020,Calvert,MD,Passenger,0,2,2,85,87,2.3,Furthest
17304,September,2020,Tulsa,OK,Passenger,1,1,2,40,42,4.76,Mid-Distance
17305,September,2020,Saginaw,MI,Passenger,1,0,1,9,10,10.0,Furthest
17306,September,2020,San Juan,WA,Truck,0,0,0,5848,5848,0.0,Washington
17307,September,2020,Pacific,WA,Truck,0,0,0,7742,7742,0.0,Washington
17308,September,2020,Shelby,OH,Passenger,0,1,1,1,2,50.0,Furthest
17309,September,2020,Harrison,MS,Passenger,1,0,1,51,52,1.92,Mid-Distance
17310,September,2020,Nueces,TX,Passenger,1,0,1,86,87,1.15,Mid-Distance
17311,September,2020,Alexandria,VA,Passenger,2,0,2,135,137,1.46,Furthest
17312,September,2020,Penobscot,ME,Passenger,0,1,1,12,13,7.69,Furthest
17313,September,2020,Benton,WA,Passenger,394,329,723,134382,135105,0.54,Washington
17314,September,2020,Fulton,GA,Passenger,1,2,3,94,97,3.09,Furthest
17315,September,2020,Collin,TX,Passenger,1,1,2,119,121,1.65,Mid-Distance
17316,September,2020,Allegheny,PA,Passenger,1,0,1,68,69,1.45,Furthest
17317,September,2020,Dallas,TX,Passenger,1,0,1,179,180,0.56,Mid-Distance
17318,September,2020,Yakima,WA,Passenger,154,124,278,166493,166771,0.17,Washington
17319,September,2020,Washington,OR,Passenger,1,0,1,423,424,0.24,Nearest
17320,September,2020,Wilson,TX,Passenger,0,1,1,5,6,16.67,Mid-Distance
17321,September,2020,Suffolk,VA,Passenger,1,0,1,125,126,0.79,Furthest
17322,September,2020,Pierce,WA,Truck,0,0,0,143993,143993,0.0,Washington
17323,September,2020,Douglas,CO,Passenger,0,1,1,77,78,1.28,Mid-Distance
17324,September,2020,Snohomish,WA,Passenger,4694,1808,6502,537221,543723,1.2,Washington
17325,September,2020,Polk,FL,Passenger,1,0,1,60,61,1.64,Furthest
17326,September,2020,Utah,UT,Passenger,0,1,1,129,130,0.77,Nearest
17327,September,2020,Ferry,WA,Passenger,8,3,11,4305,4316,0.25,Washington
17328,September,2020,Clallam,WA,Passenger,245,173,418,49886,50304,0.83,Washington
17329,September,2020,Alameda,CA,Passenger,2,0,2,263,265,0.75,Nearest
17330,September,2020,Skagit,WA,Truck,1,0,1,32643,32644,0.0,Washington
17331,September,2020,Garfield,WA,Truck,0,0,0,987,987,0.0,Washington
17332,September,2020,Ada,ID,Passenger,0,1,1,249,250,0.4,Nearest
17333,September,2020,Harris,TX,Passenger,1,0,1,223,224,0.45,Mid-Distance
17334,September,2020,Lewis,WA,Truck,0,0,0,26446,26446,0.0,Washington
17335,September,2020,Boone,MO,Passenger,0,1,1,10,11,9.09,Furthest
17336,September,2020,Arlington,VA,Passenger,0,2,2,146,148,1.35,Furthest
17337,September,2020,El Paso,TX,Passenger,3,0,3,415,418,0.72,Mid-Distance
17338,September,2020,Fort Bend,TX,Passenger,1,0,1,44,45,2.22,Mid-Distance
17339,September,2020,New Haven,CT,Passenger,0,2,2,34,36,5.56,Furthest
17340,September,2020,Montgomery,AL,Passenger,0,1,1,39,40,2.5,Furthest
17341,September,2020,Klamath,OR,Passenger,1,0,1,31,32,3.12,Nearest
17342,September,2020,Columbia,WA,Passenger,4,3,7,2421,2428,0.29,Washington
17343,September,2020,Albemarle,VA,Passenger,1,0,1,20,21,4.76,Furthest
17344,September,2020,Salt Lake,UT,Passenger,0,1,1,176,177,0.56,Nearest
17345,September,2020,Camden,NJ,Passenger,0,1,1,23,24,4.17,Furthest
17346,September,2020,Flathead,MT,Passenger,1,0,1,56,57,1.75,Nearest
17347,September,2020,Klickitat,WA,Passenger,58,42,100,15023,15123,0.66,Washington
17348,September,2020,King,WA,Passenger,25389,7895,33284,1371586,1404870,2.37,Washington
17349,September,2020,Benton,WA,Truck,0,0,0,43090,43090,0.0,Washington
17350,September,2020,Morris,NJ,Passenger,1,0,1,18,19,5.26,Furthest
17351,September,2020,Chelan,WA,Passenger,260,80,340,54306,54646,0.62,Washington
17353,September,2020,Jefferson,CO,Passenger,0,1,1,55,56,1.79,Mid-Distance
17354,September,2020,District of Columbia,DC,Passenger,2,1,3,197,200,1.5,Furthest
17355,September,2020,Putnam,TN,Passenger,0,1,1,2,3,33.33,Furthest
17356,September,2020,Honolulu,HI,Passenger,5,2,7,428,435,1.61,Nearest
17357,September,2020,Nassau,FL,Passenger,1,0,1,36,37,2.7,Furthest
17358,September,2020,St. Louis,MO,Passenger,1,0,1,96,97,1.03,Furthest
17359,September,2020,Juneau,AK,Passenger,0,1,1,28,29,3.45,Nearest
17360,September,2020,Montgomery,OH,Passenger,0,1,1,47,48,2.08,Furthest
17361,September,2020,Maui,HI,Passenger,1,0,1,29,30,3.33,Nearest
17362,September,2020,Thurston,WA,Passenger,1211,753,1964,197219,199183,0.99,Washington
17363,September,2020,Hennepin,MN,Passenger,2,0,2,83,85,2.35,Mid-Distance
17364,September,2020,Stevens,WA,Passenger,35,38,73,30417,30490,0.24,Washington
17365,September,2020,Ramsey,MN,Passenger,1,0,1,36,37,2.7,Mid-Distance
17366,September,2020,Twin Falls,ID,Passenger,0,1,1,23,24,4.17,Nearest
17367,September,2020,Williams,ND,Passenger,0,1,1,11,12,8.33,Mid-Distance
17368,September,2020,Jefferson,WA,Truck,0,0,0,9541,9541,0.0,Washington
17369,September,2020,Suffolk,MA,Passenger,0,2,2,34,36,5.56,Furthest
17370,September,2020,Spokane,WA,Truck,1,0,1,99865,99866,0.0,Washington
17371,September,2020,Kootenai,ID,Passenger,1,0,1,220,221,0.45,Nearest
17372,September,2020,Owyhee,ID,Passenger,1,0,1,3,4,25.0,Nearest
17373,September,2020,San Mateo,CA,Passenger,0,1,1,105,106,0.94,Nearest
17374,September,2020,Chelan,WA,Truck,0,0,0,22729,22729,0.0,Washington
17375,September,2020,Denver,CO,Passenger,1,0,1,113,114,0.88,Mid-Distance
17376,September,2020,Goochland,VA,Passenger,3,2,5,247,252,1.98,Furthest
17377,September,2020,Arapahoe,CO,Passenger,1,0,1,127,128,0.78,Mid-Distance
17378,September,2020,Anne Arundel,MD,Passenger,1,1,2,400,402,0.5,Furthest
17379,September,2020,Fairbanks North Star,AK,Passenger,0,1,1,94,95,1.05,Nearest
17380,September,2020,Riverside,CA,Passenger,3,0,3,607,610,0.49,Nearest
17381,September,2020,Douglas,WA,Truck,0,0,0,12380,12380,0.0,Washington
17382,September,2020,Pierce,WA,Passenger,2575,1710,4285,553881,558166,0.77,Washington
17383,September,2020,Fairfax,VA,Passenger,4,3,7,730,737,0.95,Furthest
17384,September,2020,Cowlitz,WA,Truck,0,0,0,28936,28936,0.0,Washington
17385,September,2020,Asotin,WA,Truck,0,0,0,6693,6693,0.0,Washington
17386,September,2020,Powhatan,VA,Passenger,1,0,1,0,1,100.0,Furthest
17387,September,2020,Palm Beach,FL,Passenger,0,1,1,78,79,1.27,Furthest
17388,September,2020,Skagit,WA,Passenger,447,228,675,91505,92180,0.73,Washington
17389,September,2020,Middlesex,MA,Passenger,1,1,2,91,93,2.15,Furthest
17390,September,2020,Nassau,NY,Passenger,4,0,4,28,32,12.5,Furthest
17391,September,2020,Multnomah,OR,Passenger,4,6,10,696,706,1.42,Nearest
17392,September,2020,Sumter,FL,Passenger,0,1,1,11,12,8.33,Furthest
17393,September,2020,Monterey,CA,Passenger,0,1,1,157,158,0.63,Nearest
17394,September,2020,Montgomery,PA,Passenger,1,0,1,27,28,3.57,Furthest
17395,September,2020,Thurston,WA,Truck,0,0,0,56132,56132,0.0,Washington
17396,September,2020,Santa Cruz,CA,Passenger,1,0,1,31,32,3.12,Nearest
17397,September,2020,Lincoln,WA,Passenger,5,10,15,7595,7610,0.2,Washington
17398,September,2020,Clallam,WA,Truck,1,0,1,21773,21774,0.0,Washington
17399,September,2020,Charles,MD,Passenger,1,1,2,74,76,2.63,Furthest
17400,September,2020,Bucks,PA,Passenger,1,0,1,19,20,5.0,Furthest
17401,September,2020,Lincoln,WA,Truck,0,0,0,4640,4640,0.0,Washington
17402,September,2020,Island,WA,Passenger,444,280,724,62886,63610,1.14,Washington
17403,September,2020,Queens,NY,Passenger,1,0,1,53,54,1.85,Furthest
17404,September,2020,Adams,WA,Passenger,8,7,15,12918,12933,0.12,Washington
17405,September,2020,Hawaii,HI,Passenger,1,0,1,51,52,1.92,Nearest
17406,September,2020,Island,WA,Truck,1,0,1,21261,21262,0.0,Washington
17407,September,2020,Plaquemines,LA,Passenger,0,1,1,14,15,6.67,Mid-Distance
17408,September,2020,Kent,MI,Passenger,0,1,1,23,24,4.17,Furthest
17409,September,2020,Kittitas,WA,Truck,0,0,0,14601,14601,0.0,Washington
17410,September,2020,King,WA,Truck,5,1,6,183674,183680,0.0,Washington
17411,September,2020,Dakota,MN,Passenger,0,1,1,31,32,3.12,Mid-Distance
17412,September,2020,Pend Oreille,WA,Truck,0,0,0,5727,5727,0.0,Washington
17413,September,2020,Lake,FL,Passenger,1,0,1,23,24,4.17,Furthest
17414,September,2020,Vigo,IN,Passenger,1,0,1,6,7,14.29,Furthest
17415,September,2020,Chesapeake,VA,Passenger,0,3,3,412,415,0.72,Furthest
17416,September,2020,DuPage,IL,Passenger,3,0,3,55,58,5.17,Mid-Distance
17417,September,2020,Whitman,WA,Truck,0,0,0,8497,8497,0.0,Washington
17418,September,2020,Ventura,CA,Passenger,1,2,3,272,275,1.09,Nearest
17419,September,2020,Grays Harbor,WA,Truck,0,0,0,21093,21093,0.0,Washington
17420,September,2020,Bradley,TN,Passenger,1,0,1,1,2,50.0,Furthest
17421,September,2020,Solano,CA,Passenger,1,0,1,205,206,0.49,Nearest
17422,September,2020,RÃ­o Grande,PR,Passenger,1,0,1,1,2,50.0,Mid-Distance
17423,September,2020,Randolph,NC,Passenger,1,0,1,7,8,12.5,Furthest
17424,September,2020,Wahkiakum,WA,Truck,0,0,0,1759,1759,0.0,Washington
17425,September,2020,Cape May,NJ,Passenger,0,1,1,11,12,8.33,Furthest
17426,September,2020,Skamania,WA,Passenger,32,22,54,8373,8427,0.64,Washington
17427,September,2020,Mason,WA,Passenger,162,131,293,47460,47753,0.61,Washington
17428,September,2020,Carson City,NV,Passenger,1,0,1,10,11,9.09,Nearest
17429,September,2020,Denton,TX,Passenger,1,0,1,87,88,1.14,Mid-Distance
17430,September,2020,Moore,NC,Passenger,0,1,1,156,157,0.64,Furthest
17431,September,2020,Ulster,NY,Passenger,1,0,1,8,9,11.11,Furthest
17432,September,2020,Lewis,WA,Passenger,111,117,228,58309,58537,0.39,Washington
17433,September,2020,Larimer,CO,Passenger,1,0,1,52,53,1.89,Mid-Distance
17434,September,2020,Contra Costa,CA,Passenger,4,3,7,296,303,2.31,Nearest
17435,September,2020,Jefferson,NY,Passenger,0,1,1,210,211,0.47,Furthest
17436,September,2020,Carroll,MD,Passenger,0,1,1,21,22,4.55,Furthest
17437,September,2020,Whatcom,WA,Truck,3,0,3,43388,43391,0.01,Washington
17438,September,2020,Deschutes,OR,Passenger,1,0,1,125,126,0.79,Nearest
17439,September,2020,Richland,SC,Passenger,0,1,1,143,144,0.69,Furthest
17440,September,2020,Charleston,SC,Passenger,2,0,2,93,95,2.11,Furthest
17441,September,2020,Carroll,NH,Passenger,0,1,1,5,6,16.67,Furthest
17442,September,2020,Shelby,TN,Passenger,0,1,1,79,80,1.25,Furthest
17443,September,2020,Orange,CA,Passenger,5,3,8,464,472,1.69,Nearest
17444,September,2020,Sarasota,FL,Passenger,2,0,2,23,25,8.0,Furthest
17445,September,2020,Grays Harbor,WA,Passenger,115,116,231,48482,48713,0.47,Washington
17446,September,2020,Whitman,WA,Passenger,47,47,94,21996,22090,0.43,Washington
17447,September,2020,Washtenaw,MI,Passenger,1,0,1,34,35,2.86,Furthest
17448,September,2020,Pinellas,FL,Passenger,1,1,2,103,105,1.9,Furthest
17449,September,2020,Jones,GA,Passenger,1,0,1,1,2,50.0,Furthest
17450,September,2020,Klickitat,WA,Truck,0,0,0,8105,8105,0.0,Washington
17451,September,2020,Clark,NV,Passenger,2,2,4,663,667,0.6,Nearest
17452,September,2020,Rogers,OK,Passenger,1,0,1,4,5,20.0,Mid-Distance
17453,September,2020,Jefferson,WA,Passenger,257,148,405,24734,25139,1.61,Washington
17454,September,2020,Clark,WA,Truck,0,0,0,82868,82868,0.0,Washington
17455,September,2020,Los Angeles,CA,Passenger,9,11,20,976,996,2.01,Nearest
17456,September,2020,Kitsap,WA,Truck,0,0,0,54186,54186,0.0,Washington
17457,September,2020,Yakima,WA,Truck,0,0,0,60573,60573,0.0,Washington
17458,September,2020,Pend Oreille,WA,Passenger,8,4,12,9189,9201,0.13,Washington
17459,September,2020,Brevard,FL,Passenger,0,1,1,81,82,1.22,Furthest
17460,September,2020,Franklin,WA,Truck,0,0,0,20289,20289,0.0,Washington
17461,September,2020,Broward,FL,Passenger,1,1,2,108,110,1.82,Furthest
17462,September,2020,Norfolk,VA,Passenger,2,2,4,347,351,1.14,Furthest
17463,September,2020,Howard,IN,Passenger,0,1,1,3,4,25.0,Furthest
17464,September,2020,Franklin,WA,Passenger,68,76,144,60928,61072,0.24,Washington
17465,September,2020,Stevens,WA,Truck,0,0,0,18704,18704,0.0,Washington
17466,September,2020,Okaloosa,FL,Passenger,0,1,1,140,141,0.71,Furthest
17467,September,2020,Pima,AZ,Passenger,3,1,4,326,330,1.21,Nearest
17468,September,2020,Hudson,NJ,Passenger,1,0,1,39,40,2.5,Furthest
17469,September,2020,Okanogan,WA,Truck,0,0,0,16547,16547,0.0,Washington
17470,September,2020,Columbia,WA,Truck,0,0,0,1532,1532,0.0,Washington
17471,September,2020,Kitsap,WA,Passenger,1426,713,2139,179647,181786,1.18,Washington
17472,September,2021,Rogers,OK,Passenger,1,0,1,3,4,25.0,Mid-Distance
17473,September,2021,Walla Walla,WA,Truck,0,0,0,14076,14076,0.0,Washington
17474,September,2021,Hennepin,MN,Passenger,3,0,3,71,74,4.05,Mid-Distance
17475,September,2021,Nueces,TX,Passenger,1,0,1,65,66,1.52,Mid-Distance
17476,September,2021,Baltimore,MD,Passenger,1,0,1,90,91,1.1,Furthest
17477,September,2021,Fort Bend,TX,Passenger,1,0,1,37,38,2.63,Mid-Distance
17478,September,2021,Montgomery,OH,Passenger,0,1,1,56,57,1.75,Furthest
17479,September,2021,Lewis,WA,Truck,0,0,0,26704,26704,0.0,Washington
17480,September,2021,Grant,WA,Passenger,125,97,222,66876,67098,0.33,Washington
17481,September,2021,Houston,GA,Passenger,1,0,1,44,45,2.22,Furthest
17482,September,2021,Saratoga,NY,Passenger,1,0,1,42,43,2.33,Furthest
17483,September,2021,Calvert,MD,Passenger,0,2,2,85,87,2.3,Furthest
17484,September,2021,Arlington,VA,Passenger,1,1,2,132,134,1.49,Furthest
17485,September,2021,Orange,CA,Passenger,5,2,7,397,404,1.73,Nearest
17486,September,2021,Okaloosa,FL,Passenger,0,1,1,110,111,0.9,Furthest
17488,September,2021,Philadelphia,PA,Passenger,1,0,1,43,44,2.27,Furthest
17489,September,2021,St. Louis,MO,Passenger,1,0,1,78,79,1.27,Furthest
17490,September,2021,Sedgwick,KS,Passenger,1,1,2,81,83,2.41,Mid-Distance
17491,September,2021,Loudoun,VA,Passenger,1,0,1,70,71,1.41,Furthest
17492,September,2021,Suffolk,MA,Passenger,0,2,2,27,29,6.9,Furthest
17493,September,2021,Oldham,KY,Passenger,0,1,1,4,5,20.0,Furthest
17494,September,2021,Skagit,WA,Truck,1,0,1,32933,32934,0.0,Washington
17495,September,2021,Cowlitz,WA,Truck,0,1,1,29037,29038,0.0,Washington
17496,September,2021,Multnomah,OR,Passenger,2,6,8,623,631,1.27,Nearest
17497,September,2021,Flathead,MT,Passenger,1,0,1,43,44,2.27,Nearest
17498,September,2021,San Diego,CA,Passenger,16,8,24,2494,2518,0.95,Nearest
17499,September,2021,Shelby,OH,Passenger,0,1,1,2,3,33.33,Furthest
17500,September,2021,Hillsborough,FL,Passenger,0,1,1,144,145,0.69,Furthest
17501,September,2021,Vigo,IN,Passenger,1,0,1,5,6,16.67,Furthest
17502,September,2021,Walla Walla,WA,Passenger,128,82,210,36440,36650,0.57,Washington
17503,September,2021,Leavenworth,KS,Passenger,0,1,1,112,113,0.88,Mid-Distance
17504,September,2021,Duval,FL,Passenger,0,2,2,325,327,0.61,Furthest
17505,September,2021,Frederick,MD,Passenger,1,1,2,68,70,2.86,Furthest
17506,September,2021,Sacramento,CA,Passenger,2,0,2,218,220,0.91,Nearest
17507,September,2021,El Paso,TX,Passenger,3,0,3,355,358,0.84,Mid-Distance
17508,September,2021,Kittitas,WA,Truck,0,0,0,14782,14782,0.0,Washington
17509,September,2021,Sonoma,CA,Passenger,0,1,1,82,83,1.2,Nearest
17510,September,2021,Mason,WA,Passenger,239,151,390,47982,48372,0.81,Washington
17511,September,2021,Columbia,WA,Passenger,7,2,9,2451,2460,0.37,Washington
17512,September,2021,Travis,TX,Passenger,3,3,6,134,140,4.29,Mid-Distance
17513,September,2021,Erie,NY,Passenger,1,0,1,32,33,3.03,Furthest
17514,September,2021,Franklin,WA,Passenger,138,100,238,62127,62365,0.38,Washington
17515,September,2021,Clackamas,OR,Passenger,2,0,2,163,165,1.21,Nearest
17516,September,2021,Yakima,WA,Passenger,257,164,421,168958,169379,0.25,Washington
17517,September,2021,Broward,FL,Passenger,2,0,2,99,101,1.98,Furthest
17518,September,2021,Goochland,VA,Passenger,3,2,5,202,207,2.42,Furthest
17519,September,2021,Clark,NV,Passenger,4,2,6,584,590,1.02,Nearest
17520,September,2021,Saginaw,MI,Passenger,1,0,1,5,6,16.67,Furthest
17521,September,2021,Skagit,WA,Passenger,641,291,932,91682,92614,1.01,Washington
17522,September,2021,Clark,WA,Passenger,3150,1486,4636,321804,326440,1.42,Washington
17523,September,2021,Ferry,WA,Passenger,10,3,13,4403,4416,0.29,Washington
17524,September,2021,Essex,NJ,Passenger,2,0,2,10,12,16.67,Furthest
17525,September,2021,Owyhee,ID,Passenger,1,0,1,2,3,33.33,Nearest
17526,September,2021,Douglas,WA,Passenger,103,51,154,28572,28726,0.54,Washington
17527,September,2021,Chelan,WA,Truck,0,0,0,23103,23103,0.0,Washington
17528,September,2021,Suffolk,VA,Passenger,1,0,1,126,127,0.79,Furthest
17529,September,2021,Geary,KS,Passenger,1,0,1,97,98,1.02,Mid-Distance
17530,September,2021,Louisa,VA,Passenger,0,1,1,1,2,50.0,Furthest
17531,September,2021,Wahkiakum,WA,Passenger,16,8,24,3071,3095,0.78,Washington
17532,September,2021,Pierce,WA,Truck,0,0,0,145459,145459,0.0,Washington
17533,September,2021,RÃ­o Grande,PR,Passenger,1,0,1,0,1,100.0,Mid-Distance
17534,September,2021,Anchorage,AK,Passenger,1,0,1,134,135,0.74,Nearest
17535,September,2021,Wichita,TX,Passenger,1,0,1,41,42,2.38,Mid-Distance
17536,September,2021,Thurston,WA,Passenger,1751,908,2659,197543,200202,1.33,Washington
17537,September,2021,Hamilton,IN,Passenger,2,0,2,28,30,6.67,Furthest
17538,September,2021,San Luis Obispo,CA,Passenger,1,0,1,59,60,1.67,Nearest
17539,September,2021,Rockdale,GA,Passenger,1,0,1,7,8,12.5,Furthest
17540,September,2021,Manassas,VA,Passenger,0,1,1,7,8,12.5,Furthest
17541,September,2021,San Joaquin,CA,Passenger,1,1,2,97,99,2.02,Nearest
17542,September,2021,Hidalgo,TX,Passenger,0,1,1,53,54,1.85,Mid-Distance
17543,September,2021,Kitsap,WA,Truck,0,0,0,54327,54327,0.0,Washington
17544,September,2021,Columbia,WA,Truck,0,0,0,1537,1537,0.0,Washington
17545,September,2021,Thurston,WA,Truck,0,0,0,56349,56349,0.0,Washington
17546,September,2021,Hudson,NJ,Passenger,1,0,1,40,41,2.44,Furthest
17547,September,2021,Danville,VA,Passenger,1,0,1,0,1,100.0,Furthest
17548,September,2021,Snohomish,WA,Truck,1,0,1,125958,125959,0.0,Washington
17549,September,2021,Douglas,NE,Passenger,1,1,2,48,50,4.0,Mid-Distance
17550,September,2021,Pennington,SD,Passenger,1,0,1,31,32,3.12,Mid-Distance
17551,September,2021,Lee,FL,Passenger,1,0,1,34,35,2.86,Furthest
17552,September,2021,Allegheny,PA,Passenger,1,1,2,63,65,3.08,Furthest
17553,September,2021,Okanogan,WA,Truck,0,0,0,16701,16701,0.0,Washington
17554,September,2021,Burlington,NJ,Passenger,0,1,1,119,120,0.83,Furthest
17555,September,2021,Ferry,WA,Truck,0,0,0,3592,3592,0.0,Washington
17556,September,2021,Sarasota,FL,Passenger,2,0,2,28,30,6.67,Furthest
17557,September,2021,Juneau,AK,Passenger,0,1,1,26,27,3.7,Nearest
17558,September,2021,Howard,IN,Passenger,0,1,1,6,7,14.29,Furthest
17559,September,2021,DuPage,IL,Passenger,1,0,1,52,53,1.89,Mid-Distance
17560,September,2021,Randolph,NC,Passenger,1,0,1,5,6,16.67,Furthest
17561,September,2021,St. Mary's,MD,Passenger,1,0,1,203,204,0.49,Furthest
17562,September,2021,Adams,WA,Truck,0,0,0,5403,5403,0.0,Washington
17563,September,2021,Los Angeles,CA,Passenger,7,9,16,847,863,1.85,Nearest
17564,September,2021,Honolulu,HI,Passenger,5,3,8,364,372,2.15,Nearest
17565,September,2021,Carroll,NH,Passenger,0,1,1,5,6,16.67,Furthest
17566,September,2021,Whatcom,WA,Truck,4,0,4,43814,43818,0.01,Washington
17567,September,2021,Gwinnett,GA,Passenger,1,0,1,57,58,1.72,Furthest
17568,September,2021,Norfolk,VA,Passenger,3,3,6,309,315,1.9,Furthest
17569,September,2021,Washington,MD,Passenger,2,0,2,13,15,13.33,Furthest
17570,September,2021,Ventura,CA,Passenger,1,2,3,253,256,1.17,Nearest
17571,September,2021,Jefferson,NY,Passenger,0,1,1,208,209,0.48,Furthest
17572,September,2021,Kittitas,WA,Passenger,180,72,252,29865,30117,0.84,Washington
17573,September,2021,El Paso,CO,Passenger,3,0,3,656,659,0.46,Mid-Distance
17574,September,2021,Kauai,HI,Passenger,1,0,1,17,18,5.56,Nearest
17575,September,2021,Montgomery,PA,Passenger,2,0,2,22,24,8.33,Furthest
17576,September,2021,Santa Cruz,CA,Passenger,1,0,1,25,26,3.85,Nearest
17577,September,2021,Missoula,MT,Passenger,1,0,1,52,53,1.89,Nearest
17578,September,2021,Spokane,WA,Passenger,1187,703,1890,326207,328097,0.58,Washington
17579,September,2021,Bexar,TX,Passenger,3,4,7,499,506,1.38,Mid-Distance
17580,September,2021,New London,CT,Passenger,1,4,5,210,215,2.33,Furthest
17581,September,2021,Moore,NC,Passenger,0,1,1,123,124,0.81,Furthest
17582,September,2021,Lake,FL,Passenger,1,0,1,22,23,4.35,Furthest
17583,September,2021,Richland,SC,Passenger,0,1,1,132,133,0.75,Furthest
17584,September,2021,Whitman,WA,Truck,0,0,0,8558,8558,0.0,Washington
17585,September,2021,Harrison,MS,Passenger,2,0,2,50,52,3.85,Mid-Distance
17586,September,2021,San Francisco,CA,Passenger,0,1,1,82,83,1.2,Nearest
17587,September,2021,King,WA,Truck,5,1,6,183901,183907,0.0,Washington
17588,September,2021,Penobscot,ME,Passenger,0,1,1,8,9,11.11,Furthest
17589,September,2021,Mason,WA,Truck,0,0,0,21291,21291,0.0,Washington
17590,September,2021,Lincoln,WA,Passenger,7,16,23,7682,7705,0.3,Washington
17591,September,2021,Williamson,TX,Passenger,1,2,3,98,101,2.97,Mid-Distance
17592,September,2021,Polk,FL,Passenger,1,0,1,55,56,1.79,Furthest
17593,September,2021,Yakima,WA,Truck,0,0,0,61737,61737,0.0,Washington
17594,September,2021,Cape May,NJ,Passenger,0,1,1,8,9,11.11,Furthest
17595,September,2021,Dallas,TX,Passenger,1,0,1,146,147,0.68,Mid-Distance
17596,September,2021,Sumter,SC,Passenger,0,1,1,36,37,2.7,Furthest
17597,September,2021,Portsmouth,VA,Passenger,0,1,1,77,78,1.28,Furthest
17598,September,2021,Montgomery,TX,Passenger,1,1,2,36,38,5.26,Mid-Distance
17599,September,2021,Howard,MD,Passenger,0,1,1,56,57,1.75,Furthest
17600,September,2021,San Mateo,CA,Passenger,1,0,1,88,89,1.12,Nearest
17601,September,2021,Chesapeake,VA,Passenger,1,3,4,381,385,1.04,Furthest
17602,September,2021,Salt Lake,UT,Passenger,0,1,1,156,157,0.64,Nearest
17603,September,2021,Greene,MO,Passenger,0,1,1,27,28,3.57,Furthest
17604,September,2021,Queens,NY,Passenger,2,0,2,44,46,4.35,Furthest
17605,September,2021,Harris,TX,Passenger,1,1,2,174,176,1.14,Mid-Distance
17606,September,2021,Skamania,WA,Passenger,53,39,92,8385,8477,1.09,Washington
17607,September,2021,Miami-Dade,FL,Passenger,1,0,1,95,96,1.04,Furthest
17608,September,2021,Garfield,WA,Truck,0,0,0,998,998,0.0,Washington
17609,September,2021,Fresno,CA,Passenger,1,0,1,161,162,0.62,Nearest
17610,September,2021,Kings,CA,Passenger,1,0,1,320,321,0.31,Nearest
17611,September,2021,Jefferson,WA,Passenger,358,186,544,24810,25354,2.15,Washington
17612,September,2021,Pend Oreille,WA,Passenger,17,7,24,9240,9264,0.26,Washington
17613,September,2021,Island,WA,Truck,0,0,0,21574,21574,0.0,Washington
17614,September,2021,Chelan,WA,Passenger,375,104,479,54762,55241,0.87,Washington
17615,September,2021,Lane,OR,Passenger,0,1,1,115,116,0.86,Nearest
17616,September,2021,Richmond,GA,Passenger,0,1,1,72,73,1.37,Furthest
17617,September,2021,Albemarle,VA,Passenger,1,0,1,19,20,5.0,Furthest
17618,September,2021,Pierce,WA,Passenger,3877,2069,5946,559042,564988,1.05,Washington
17619,September,2021,Skamania,WA,Truck,0,0,0,4043,4043,0.0,Washington
17620,September,2021,Garfield,WA,Passenger,0,3,3,1366,1369,0.22,Washington
17621,September,2021,Camden,NJ,Passenger,0,1,1,14,15,6.67,Furthest
17622,September,2021,Larimer,CO,Passenger,1,0,1,47,48,2.08,Mid-Distance
17623,September,2021,Champaign,IL,Passenger,1,0,1,10,11,9.09,Mid-Distance
17624,September,2021,Pima,AZ,Passenger,1,1,2,255,257,0.78,Nearest
17625,September,2021,Stafford,VA,Passenger,2,1,3,95,98,3.06,Furthest
17626,September,2021,Franklin,WA,Truck,0,0,0,20718,20718,0.0,Washington
17627,September,2021,Grant,WA,Truck,0,0,0,28010,28010,0.0,Washington
17628,September,2021,Douglas,WA,Truck,0,0,0,12713,12713,0.0,Washington
17629,September,2021,Lincoln,WA,Truck,0,0,0,4784,4784,0.0,Washington
17630,September,2021,Clark,WA,Truck,0,0,0,84157,84157,0.0,Washington
17631,September,2021,Benton,WA,Truck,0,0,0,43672,43672,0.0,Washington
17632,September,2021,Ulster,NY,Passenger,1,0,1,8,9,11.11,Furthest
17633,September,2021,Carroll,MD,Passenger,0,1,1,16,17,5.88,Furthest
17634,September,2021,Stevens,WA,Truck,0,0,0,18892,18892,0.0,Washington
17635,September,2021,New Haven,CT,Passenger,0,2,2,28,30,6.67,Furthest
17636,September,2021,Grays Harbor,WA,Truck,0,0,0,21400,21400,0.0,Washington
17637,September,2021,Kitsap,WA,Passenger,1993,907,2900,180805,183705,1.58,Washington
17638,September,2021,Cook,IL,Passenger,2,0,2,201,203,0.99,Mid-Distance
17639,September,2021,Alameda,CA,Passenger,4,0,4,221,225,1.78,Nearest
17640,September,2021,Rockingham,NH,Passenger,1,0,1,19,20,5.0,Furthest
17641,September,2021,Spokane,WA,Truck,0,0,0,102568,102568,0.0,Washington
17642,September,2021,Richmond,NY,Passenger,1,0,1,8,9,11.11,Furthest
17643,September,2021,Contra Costa,CA,Passenger,2,4,6,263,269,2.23,Nearest
17644,September,2021,Prince William,VA,Passenger,1,1,2,205,207,0.97,Furthest
17645,September,2021,Asotin,WA,Passenger,20,17,37,12736,12773,0.29,Washington
17646,September,2021,Wake,NC,Passenger,1,0,1,113,114,0.88,Furthest
17647,September,2021,Cowlitz,WA,Passenger,246,154,400,72035,72435,0.55,Washington
17648,September,2021,Lewis,WA,Passenger,185,149,334,59589,59923,0.56,Washington
17649,September,2021,Spartanburg,SC,Passenger,0,1,1,48,49,2.04,Furthest
17650,September,2021,Wilson,TX,Passenger,0,1,1,2,3,33.33,Mid-Distance
17651,September,2021,Yamhill,OR,Passenger,1,0,1,31,32,3.12,Nearest
17652,September,2021,Lake,IL,Passenger,2,0,2,155,157,1.27,Mid-Distance
17653,September,2021,Williams,ND,Passenger,0,1,1,8,9,11.11,Mid-Distance
17654,September,2021,Maricopa,AZ,Passenger,7,3,10,1092,1102,0.91,Nearest
17655,September,2021,Kings,NY,Passenger,1,0,1,67,68,1.47,Furthest
17656,September,2021,Adams,WA,Passenger,16,14,30,13045,13075,0.23,Washington
17657,September,2021,Orange,FL,Passenger,1,0,1,108,109,0.92,Furthest
17658,September,2021,San Juan,WA,Truck,0,0,0,5983,5983,0.0,Washington
17659,September,2021,Snohomish,WA,Passenger,6456,2164,8620,539501,548121,1.57,Washington
17660,September,2021,Plaquemines,LA,Passenger,0,1,1,17,18,5.56,Mid-Distance
17661,September,2021,Carson City,NV,Passenger,1,0,1,10,11,9.09,Nearest
17662,September,2021,Harnett,NC,Passenger,1,1,2,156,158,1.27,Furthest
17663,September,2021,Fairfax,VA,Passenger,5,4,9,673,682,1.32,Furthest
17664,September,2021,Pend Oreille,WA,Truck,0,0,0,5690,5690,0.0,Washington
17665,September,2021,Nassau,NY,Passenger,2,0,2,25,27,7.41,Furthest
17666,September,2021,Douglas,CO,Passenger,0,1,1,76,77,1.3,Mid-Distance
17667,September,2021,Ray,MO,Passenger,0,1,1,1,2,50.0,Furthest
17668,September,2021,Milwaukee,WI,Passenger,1,0,1,38,39,2.56,Mid-Distance
17669,September,2021,Prince George's,MD,Passenger,2,1,3,137,140,2.14,Furthest
17670,September,2021,Wahkiakum,WA,Truck,0,0,0,1815,1815,0.0,Washington
17671,September,2021,Jefferson,WA,Truck,0,0,0,9619,9619,0.0,Washington
17672,September,2021,St. Clair,IL,Passenger,2,0,2,127,129,1.55,Mid-Distance
17673,September,2021,Clallam,WA,Passenger,359,229,588,50550,51138,1.15,Washington
17674,September,2021,Wilson,NC,Passenger,1,0,1,0,1,100.0,Furthest
17675,September,2021,Whitman,WA,Passenger,64,56,120,21929,22049,0.54,Washington
17676,September,2021,Denton,TX,Passenger,1,0,1,74,75,1.33,Mid-Distance
17677,September,2021,Grays Harbor,WA,Passenger,183,150,333,49489,49822,0.67,Washington
17678,September,2021,Platte,MO,Passenger,1,0,1,16,17,5.88,Furthest
17679,September,2021,King,WA,Passenger,32879,9690,42569,1365552,1408121,3.02,Washington
17680,September,2021,Boulder,CO,Passenger,0,1,1,39,40,2.5,Mid-Distance
17681,September,2021,Charles,MD,Passenger,1,1,2,67,69,2.9,Furthest
17682,September,2021,Monterey,CA,Passenger,0,1,1,143,144,0.69,Nearest
17683,September,2021,Benton,WA,Passenger,581,414,995,136268,137263,0.72,Washington
17684,September,2021,Klamath,OR,Passenger,1,0,1,28,29,3.45,Nearest
17685,September,2021,Pacific,WA,Truck,0,0,0,7998,7998,0.0,Washington
17686,September,2021,Riverside,CA,Passenger,4,1,5,522,527,0.95,Nearest
17687,September,2021,Virginia Beach,VA,Passenger,2,0,2,590,592,0.34,Furthest
17688,September,2021,Okanogan,WA,Passenger,67,44,111,26541,26652,0.42,Washington
17689,September,2021,DeKalb,GA,Passenger,1,0,1,57,58,1.72,Furthest
17690,September,2021,Las Animas,CO,Passenger,1,0,1,0,1,100.0,Mid-Distance
17691,September,2021,Asotin,WA,Truck,0,0,0,6755,6755,0.0,Washington
17692,September,2021,Alexandria,VA,Passenger,2,0,2,122,124,1.61,Furthest
17693,September,2021,Sevier,AR,Passenger,0,1,1,0,1,100.0,Mid-Distance
17694,September,2021,Hawaii,HI,Passenger,1,0,1,42,43,2.33,Nearest
17695,September,2021,Escambia,FL,Passenger,0,1,1,143,144,0.69,Furthest
17696,September,2021,Onslow,NC,Passenger,0,1,1,174,175,0.57,Furthest
17697,September,2021,Middlesex,MA,Passenger,1,1,2,87,89,2.25,Furthest
17698,September,2021,Placer,CA,Passenger,2,0,2,70,72,2.78,Nearest
17699,September,2021,Santa Clara,CA,Passenger,8,2,10,241,251,3.98,Nearest
17700,September,2021,Whatcom,WA,Passenger,1540,641,2181,150546,152727,1.43,Washington
17701,September,2021,Kern,CA,Passenger,0,1,1,197,198,0.51,Nearest
17702,September,2021,Pinellas,FL,Passenger,0,1,1,90,91,1.1,Furthest
17703,September,2021,Charleston,SC,Passenger,2,1,3,81,84,3.57,Furthest
17704,September,2021,Montgomery,MD,Passenger,3,2,5,206,211,2.37,Furthest
17705,September,2021,Allen,IN,Passenger,1,0,1,15,16,6.25,Furthest
17706,September,2021,Stevens,WA,Passenger,51,42,93,30327,30420,0.31,Washington
17707,September,2021,Island,WA,Passenger,661,329,990,63226,64216,1.54,Washington
17708,September,2021,Pacific,WA,Passenger,49,57,106,16073,16179,0.66,Washington
17709,September,2021,Bartow,GA,Passenger,0,1,1,3,4,25.0,Furthest
17710,September,2021,Anne Arundel,MD,Passenger,4,3,7,368,375,1.87,Furthest
17711,September,2021,New York,NY,Passenger,1,0,1,38,39,2.56,Furthest
17712,September,2021,District of Columbia,DC,Passenger,5,0,5,196,201,2.49,Furthest
17713,September,2021,Cumberland,NC,Passenger,0,2,2,404,406,0.49,Furthest
17714,September,2021,Powhatan,VA,Passenger,1,0,1,1,2,50.0,Furthest
17715,September,2021,Washington,OR,Passenger,1,0,1,363,364,0.27,Nearest
17716,September,2021,Klickitat,WA,Passenger,83,51,134,15391,15525,0.86,Washington
17717,September,2021,Collin,TX,Passenger,1,0,1,102,103,0.97,Mid-Distance
17718,September,2021,San Juan,WA,Passenger,462,143,605,14187,14792,4.09,Washington
17719,September,2021,Klickitat,WA,Truck,0,0,0,8341,8341,0.0,Washington
17720,September,2021,Fairbanks North Star,AK,Passenger,0,1,1,79,80,1.25,Nearest
17721,September,2021,Boone,MO,Passenger,0,1,1,9,10,10.0,Furthest
17722,September,2021,Clallam,WA,Truck,1,0,1,22018,22019,0.0,Washington
17723,September,2022,Calvert,MD,Passenger,0,2,2,74,76,2.63,Furthest
17724,September,2022,Pend Oreille,WA,Truck,0,0,0,5638,5638,0.0,Washington
17725,September,2022,St. Louis,MO,Passenger,1,0,1,55,56,1.79,Furthest
17726,September,2022,Douglas,WA,Truck,1,0,1,12781,12782,0.01,Washington
17727,September,2022,Walla Walla,WA,Truck,2,0,2,13946,13948,0.01,Washington
17728,September,2022,Collin,TX,Passenger,2,0,2,67,69,2.9,Mid-Distance
17729,September,2022,Skagit,WA,Passenger,869,349,1218,89712,90930,1.34,Washington
17730,September,2022,Denton,TX,Passenger,1,0,1,57,58,1.72,Mid-Distance
17731,September,2022,Grays Harbor,WA,Passenger,224,166,390,48799,49189,0.79,Washington
17732,September,2022,Randolph,NC,Passenger,1,0,1,5,6,16.67,Furthest
17733,September,2022,Thurston,WA,Passenger,2380,1102,3482,192946,196428,1.77,Washington
17734,September,2022,Ventura,CA,Passenger,2,1,3,218,221,1.36,Nearest
17735,September,2022,Whitman,WA,Passenger,96,64,160,21991,22151,0.72,Washington
17736,September,2022,Anchorage,AK,Passenger,1,0,1,107,108,0.93,Nearest
17737,September,2022,Kootenai,ID,Truck,1,0,1,33,34,2.94,Nearest
17738,September,2022,King,WA,Passenger,43484,11789,55273,1345189,1400462,3.95,Washington
17739,September,2022,Juneau,AK,Passenger,0,1,1,28,29,3.45,Nearest
17740,September,2022,Broward,FL,Passenger,1,0,1,67,68,1.47,Furthest
17741,September,2022,Galveston,TX,Passenger,0,1,1,17,18,5.56,Mid-Distance
17742,September,2022,St. Mary's,MD,Passenger,1,0,1,178,179,0.56,Furthest
17743,September,2022,Skagit,WA,Truck,6,0,6,32229,32235,0.02,Washington
17744,September,2022,Bartow,GA,Passenger,0,1,1,3,4,25.0,Furthest
17745,September,2022,Essex,NJ,Passenger,2,0,2,8,10,20.0,Furthest
17746,September,2022,Fairbanks North Star,AK,Passenger,0,1,1,64,65,1.54,Nearest
17747,September,2022,Wood,OH,Passenger,0,1,1,3,4,25.0,Furthest
17748,September,2022,King,WA,Truck,241,2,243,179679,179922,0.14,Washington
17749,September,2022,Columbia,WA,Passenger,8,0,8,2439,2447,0.33,Washington
17750,September,2022,Clark,WA,Truck,19,0,19,82316,82335,0.02,Washington
17751,September,2022,Fairfax,VA,Truck,1,0,1,106,107,0.93,Furthest
17752,September,2022,Lewis,WA,Truck,1,0,1,26365,26366,0.0,Washington
17753,September,2022,Clark,WA,Passenger,4480,1890,6370,315618,321988,1.98,Washington
17754,September,2022,Okaloosa,FL,Passenger,0,1,1,93,94,1.06,Furthest
17755,September,2022,Wichita,TX,Passenger,2,0,2,35,37,5.41,Mid-Distance
17756,September,2022,Salt Lake,UT,Passenger,1,1,2,112,114,1.75,Nearest
17757,September,2022,Santa Cruz,CA,Passenger,1,0,1,19,20,5.0,Nearest
17758,September,2022,El Paso,TX,Passenger,2,0,2,301,303,0.66,Mid-Distance
17759,September,2022,Arapahoe,CO,Passenger,0,1,1,70,71,1.41,Mid-Distance
17760,September,2022,Allen,IN,Passenger,1,0,1,12,13,7.69,Furthest
17761,September,2022,Pacific,WA,Truck,0,0,0,7871,7871,0.0,Washington
17762,September,2022,Benton,WA,Passenger,833,480,1313,135629,136942,0.96,Washington
17763,September,2022,Monterey,CA,Passenger,1,1,2,118,120,1.67,Nearest
17764,September,2022,Napa,CA,Passenger,0,1,1,10,11,9.09,Nearest
17765,September,2022,Pacific,WA,Passenger,70,74,144,15784,15928,0.9,Washington
17766,September,2022,Hudson,NJ,Passenger,2,0,2,30,32,6.25,Furthest
17767,September,2022,Cowlitz,WA,Passenger,368,180,548,70395,70943,0.77,Washington
17768,September,2022,Klickitat,WA,Truck,2,0,2,8263,8265,0.02,Washington
17769,September,2022,Grant,WA,Passenger,200,108,308,66776,67084,0.46,Washington
17770,September,2022,Douglas,CO,Passenger,0,1,1,62,63,1.59,Mid-Distance
17771,September,2022,Fairfax,VA,Passenger,6,3,9,579,588,1.53,Furthest
17772,September,2022,Allegheny,PA,Passenger,1,1,2,49,51,3.92,Furthest
17773,September,2022,Chelan,WA,Passenger,495,135,630,54143,54773,1.15,Washington
17774,September,2022,Lincoln,WA,Passenger,10,16,26,7725,7751,0.34,Washington
17775,September,2022,Oldham,KY,Passenger,0,1,1,4,5,20.0,Furthest
17776,September,2022,Suffolk,VA,Passenger,1,0,1,116,117,0.85,Furthest
17777,September,2022,San Diego,CA,Passenger,17,10,27,2135,2162,1.25,Nearest
17778,September,2022,Portsmouth,VA,Passenger,0,1,1,72,73,1.37,Furthest
17779,September,2022,Stevens,WA,Passenger,81,56,137,30090,30227,0.45,Washington
17780,September,2022,Pierce,WA,Passenger,5530,2431,7961,541956,549917,1.45,Washington
17781,September,2022,St. Clair,IL,Passenger,2,0,2,114,116,1.72,Mid-Distance
17782,September,2022,Richmond,GA,Passenger,0,1,1,58,59,1.69,Furthest
17783,September,2022,Lane,OR,Passenger,0,1,1,78,79,1.27,Nearest
17784,September,2022,Yakima,WA,Passenger,376,210,586,166551,167137,0.35,Washington
17785,September,2022,Travis,TX,Passenger,1,0,1,95,96,1.04,Mid-Distance
17786,September,2022,Douglas,WA,Passenger,147,61,208,28445,28653,0.73,Washington
17787,September,2022,Bexar,TX,Passenger,5,3,8,401,409,1.96,Mid-Distance
17788,September,2022,Hoke,NC,Passenger,1,0,1,59,60,1.67,Furthest
17789,September,2022,Whatcom,WA,Truck,14,0,14,43119,43133,0.03,Washington
17790,September,2022,Kings,CA,Passenger,2,1,3,286,289,1.04,Nearest
17791,September,2022,Burlington,NJ,Passenger,0,2,2,99,101,1.98,Furthest
17792,September,2022,Frederick,MD,Passenger,1,0,1,58,59,1.69,Furthest
17793,September,2022,Charleston,SC,Passenger,2,2,4,56,60,6.67,Furthest
17794,September,2022,Ray,MO,Passenger,0,1,1,1,2,50.0,Furthest
17795,September,2022,Carroll,MD,Passenger,0,1,1,17,18,5.56,Furthest
17796,September,2022,Grant,WA,Truck,2,0,2,28018,28020,0.01,Washington
17797,September,2022,Spokane,WA,Passenger,1770,889,2659,324764,327423,0.81,Washington
17798,September,2022,Island,WA,Truck,10,0,10,21293,21303,0.05,Washington
17799,September,2022,Solano,CA,Passenger,2,0,2,151,153,1.31,Nearest
17800,September,2022,Asotin,WA,Passenger,25,19,44,12615,12659,0.35,Washington
17801,September,2022,Rockdale,GA,Passenger,1,0,1,6,7,14.29,Furthest
17802,September,2022,Hawaii,HI,Passenger,1,0,1,30,31,3.23,Nearest
17803,September,2022,Sheridan,WY,Passenger,1,0,1,5,6,16.67,Nearest
17804,September,2022,Jefferson,WA,Truck,3,0,3,9383,9386,0.03,Washington
17805,September,2022,Howard,MD,Passenger,0,1,1,51,52,1.92,Furthest
17806,September,2022,Richmond,NY,Passenger,1,0,1,6,7,14.29,Furthest
17807,September,2022,Snohomish,WA,Truck,59,0,59,123094,123153,0.05,Washington
17808,September,2022,Alameda,CA,Passenger,4,0,4,169,173,2.31,Nearest
17809,September,2022,Wahkiakum,WA,Truck,1,0,1,1801,1802,0.06,Washington
17810,September,2022,Owyhee,ID,Passenger,1,0,1,3,4,25.0,Nearest
17811,September,2022,Asotin,WA,Truck,0,0,0,6710,6710,0.0,Washington
17812,September,2022,Kern,CA,Passenger,1,1,2,188,190,1.05,Nearest
17813,September,2022,Saratoga,NY,Passenger,1,0,1,37,38,2.63,Furthest
17814,September,2022,Bryan,GA,Passenger,0,1,1,37,38,2.63,Furthest
17815,September,2022,Elmore,ID,Passenger,1,0,1,12,13,7.69,Nearest
17816,September,2022,Nueces,TX,Passenger,1,1,2,49,51,3.92,Mid-Distance
17817,September,2022,Lake,FL,Passenger,1,0,1,16,17,5.88,Furthest
17818,September,2022,Whitman,WA,Truck,2,0,2,8588,8590,0.02,Washington
17819,September,2022,Plaquemines,LA,Passenger,1,1,2,16,18,11.11,Mid-Distance
17820,September,2022,San Joaquin,CA,Passenger,1,0,1,78,79,1.27,Nearest
17821,September,2022,Montgomery,AL,Passenger,0,1,1,32,33,3.03,Furthest
17822,September,2022,Franklin,WA,Passenger,231,112,343,61926,62269,0.55,Washington
17823,September,2022,Yakima,WA,Truck,3,0,3,61428,61431,0.0,Washington
17824,September,2022,Cook,IL,Passenger,2,0,2,164,166,1.2,Mid-Distance
17825,September,2022,Rockingham,NH,Passenger,1,0,1,13,14,7.14,Furthest
17826,September,2022,Klickitat,WA,Passenger,109,53,162,15150,15312,1.06,Washington
17827,September,2022,Wilson,TX,Passenger,0,1,1,2,3,33.33,Mid-Distance
17828,September,2022,Yellowstone,MT,Passenger,0,1,1,19,20,5.0,Nearest
17829,September,2022,Grays Harbor,WA,Truck,2,0,2,21184,21186,0.01,Washington
17830,September,2022,Spartanburg,SC,Passenger,0,1,1,32,33,3.03,Furthest
17831,September,2022,Montgomery,MD,Passenger,4,2,6,178,184,3.26,Furthest
17832,September,2022,Middlesex,MA,Passenger,2,1,3,65,68,4.41,Furthest
17833,September,2022,Virginia Beach,VA,Passenger,2,0,2,481,483,0.41,Furthest
17834,September,2022,Philadelphia,PA,Passenger,1,0,1,37,38,2.63,Furthest
17835,September,2022,Columbia,WA,Truck,0,0,0,1577,1577,0.0,Washington
17836,September,2022,Moore,NC,Passenger,0,1,1,107,108,0.93,Furthest
17837,September,2022,Onslow,NC,Passenger,0,1,1,157,158,0.63,Furthest
17838,September,2022,Dorchester,SC,Passenger,1,0,1,48,49,2.04,Furthest
17839,September,2022,New London,CT,Passenger,2,4,6,186,192,3.12,Furthest
17840,September,2022,El Paso,CO,Passenger,3,1,4,548,552,0.72,Mid-Distance
17841,September,2022,Adams,WA,Truck,1,0,1,5425,5426,0.02,Washington
17842,September,2022,Okanogan,WA,Truck,1,0,1,16528,16529,0.01,Washington
17843,September,2022,Wahkiakum,WA,Passenger,24,12,36,3078,3114,1.16,Washington
17844,September,2022,Clackamas,OR,Passenger,1,0,1,128,129,0.78,Nearest
17845,September,2022,Escambia,FL,Passenger,0,1,1,121,122,0.82,Furthest
17846,September,2022,Garfield,WA,Truck,0,0,0,970,970,0.0,Washington
17847,September,2022,San Bernardino,CA,Passenger,1,1,2,295,297,0.67,Nearest
17848,September,2022,San Mateo,CA,Passenger,1,0,1,70,71,1.41,Nearest
17849,September,2022,Kitsap,WA,Passenger,2572,1110,3682,177870,181552,2.03,Washington
17850,September,2022,Stevens,WA,Truck,1,0,1,18922,18923,0.01,Washington
17851,September,2022,Leavenworth,KS,Passenger,0,1,1,94,95,1.05,Mid-Distance
17852,September,2022,Pulaski,AR,Passenger,1,0,1,27,28,3.57,Mid-Distance
17853,September,2022,Cowlitz,WA,Truck,3,0,3,28470,28473,0.01,Washington
17854,September,2022,Ulster,NY,Passenger,1,0,1,7,8,12.5,Furthest
17855,September,2022,Kittitas,WA,Passenger,290,91,381,29618,29999,1.27,Washington
17856,September,2022,Sedgwick,KS,Passenger,1,1,2,65,67,2.99,Mid-Distance
17857,September,2022,Goochland,VA,Passenger,0,1,1,83,84,1.19,Furthest
17858,September,2022,San Juan,WA,Truck,6,0,6,5955,5961,0.1,Washington
17859,September,2022,Lewis,WA,Passenger,252,176,428,59836,60264,0.71,Washington
17860,September,2022,DeKalb,GA,Passenger,1,0,1,42,43,2.33,Furthest
17861,September,2022,Orange,CA,Passenger,5,2,7,313,320,2.19,Nearest
17862,September,2022,Polk,OR,Passenger,0,1,1,20,21,4.76,Nearest
17863,September,2022,San Juan,WA,Passenger,536,162,698,14006,14704,4.75,Washington
17864,September,2022,Lincoln,OR,Passenger,0,1,1,22,23,4.35,Nearest
17865,September,2022,Las Animas,CO,Passenger,1,0,1,1,2,50.0,Mid-Distance
17866,September,2022,Thurston,WA,Truck,21,0,21,55058,55079,0.04,Washington
17867,September,2022,Adams,CO,Passenger,1,0,1,36,37,2.7,Mid-Distance
17868,September,2022,Lincoln,WA,Truck,0,0,0,4853,4853,0.0,Washington
17869,September,2022,Sevier,AR,Passenger,0,1,1,0,1,100.0,Mid-Distance
17870,September,2022,District of Columbia,DC,Passenger,4,0,4,158,162,2.47,Furthest
17871,September,2022,Charles,MD,Passenger,1,1,2,52,54,3.7,Furthest
17872,September,2022,Contra Costa,CA,Passenger,0,3,3,222,225,1.33,Nearest
17873,September,2022,Louisa,VA,Passenger,0,1,1,1,2,50.0,Furthest
17874,September,2022,Franklin,WA,Truck,2,0,2,20933,20935,0.01,Washington
17875,September,2022,Ferry,WA,Truck,0,0,0,3616,3616,0.0,Washington
17877,September,2022,Alexandria,VA,Passenger,3,0,3,99,102,2.94,Furthest
17878,September,2022,Cape May,NJ,Passenger,0,1,1,7,8,12.5,Furthest
17879,September,2022,Camden,NJ,Passenger,0,1,1,12,13,7.69,Furthest
17880,September,2022,Cumberland,NC,Passenger,1,2,3,330,333,0.9,Furthest
17881,September,2022,Harrison,MS,Passenger,1,0,1,35,36,2.78,Mid-Distance
17882,September,2022,Chelan,WA,Truck,6,0,6,23093,23099,0.03,Washington
17883,September,2022,Multnomah,OR,Passenger,0,3,3,482,485,0.62,Nearest
17884,September,2022,Snohomish,WA,Passenger,9066,2624,11690,531280,542970,2.15,Washington
17885,September,2022,Pennington,SD,Passenger,2,0,2,24,26,7.69,Mid-Distance
17886,September,2022,Benton,WA,Truck,5,0,5,43402,43407,0.01,Washington
17887,September,2022,Skamania,WA,Passenger,85,51,136,8126,8262,1.65,Washington
17888,September,2022,Stafford,VA,Passenger,2,1,3,83,86,3.49,Furthest
17889,September,2022,Harnett,NC,Passenger,2,0,2,135,137,1.46,Furthest
17890,September,2022,Maricopa,AZ,Passenger,7,1,8,771,779,1.03,Nearest
17891,September,2022,Jackson,OK,Passenger,0,1,1,32,33,3.03,Mid-Distance
17892,September,2022,Penobscot,ME,Passenger,0,1,1,8,9,11.11,Furthest
17893,September,2022,Sacramento,CA,Passenger,3,0,3,181,184,1.63,Nearest
17894,September,2022,Boulder,CO,Passenger,1,0,1,31,32,3.12,Mid-Distance
17895,September,2022,Santa Clara,CA,Passenger,10,2,12,194,206,5.83,Nearest
17896,September,2022,Adams,WA,Passenger,22,10,32,13017,13049,0.25,Washington
17897,September,2022,Lake,IL,Passenger,2,0,2,121,123,1.63,Mid-Distance
17898,September,2022,Sonoma,CA,Passenger,0,1,1,67,68,1.47,Nearest
17899,September,2022,Dallas,TX,Passenger,1,0,1,95,96,1.04,Mid-Distance
17900,September,2022,Garfield,WA,Passenger,1,3,4,1324,1328,0.3,Washington
17901,September,2022,Anne Arundel,MD,Passenger,4,4,8,318,326,2.45,Furthest
17902,September,2022,Honolulu,HI,Passenger,3,3,6,301,307,1.95,Nearest
17903,September,2022,Washington,MD,Passenger,2,0,2,15,17,11.76,Furthest
17904,September,2022,Geary,KS,Passenger,1,0,1,80,81,1.23,Mid-Distance
17905,September,2022,Okanogan,WA,Passenger,93,49,142,26316,26458,0.54,Washington
17906,September,2022,Whatcom,WA,Passenger,1952,772,2724,148826,151550,1.8,Washington
17907,September,2022,Riverside,CA,Passenger,7,0,7,425,432,1.62,Nearest
17908,September,2022,Mason,WA,Truck,4,0,4,21008,21012,0.02,Washington
17909,September,2022,Platte,MO,Passenger,1,0,1,21,22,4.55,Furthest
17910,September,2022,Hennepin,MN,Passenger,1,0,1,43,44,2.27,Mid-Distance
17911,September,2022,Island,WA,Passenger,877,382,1259,61751,63010,2.0,Washington
17912,September,2022,Hidalgo,TX,Passenger,0,1,1,53,54,1.85,Mid-Distance
17913,September,2022,Norfolk,VA,Passenger,3,3,6,275,281,2.14,Furthest
17914,September,2022,Walla Walla,WA,Passenger,187,105,292,35831,36123,0.81,Washington
17915,September,2022,Tarrant,TX,Passenger,1,0,1,93,94,1.06,Mid-Distance
17916,September,2022,Sumter,SC,Passenger,0,1,1,32,33,3.03,Furthest
17917,September,2022,Harris,TX,Passenger,1,0,1,127,128,0.78,Mid-Distance
17918,September,2022,Chesapeake,VA,Passenger,3,3,6,306,312,1.92,Furthest
17919,September,2022,Spokane,WA,Truck,12,0,12,101973,101985,0.01,Washington
17920,September,2022,Danville,VA,Passenger,1,0,1,0,1,100.0,Furthest
17921,September,2022,Sarpy,NE,Passenger,1,0,1,49,50,2.0,Mid-Distance
17922,September,2022,Kitsap,WA,Truck,23,0,23,53242,53265,0.04,Washington
17923,September,2022,St. Tammany,LA,Passenger,1,0,1,33,34,2.94,Mid-Distance
17924,September,2022,Jefferson,WA,Passenger,454,224,678,24444,25122,2.7,Washington
17925,September,2022,Rock Island,IL,Passenger,0,1,1,15,16,6.25,Mid-Distance
17926,September,2022,Bell,TX,Passenger,1,0,1,292,293,0.34,Mid-Distance
17927,September,2022,Arlington,VA,Passenger,1,0,1,114,115,0.87,Furthest
17928,September,2022,Douglas,NE,Passenger,2,2,4,34,38,10.53,Mid-Distance
17929,September,2022,Berkeley,SC,Passenger,0,1,1,112,113,0.88,Furthest
17930,September,2022,Pierce,WA,Truck,46,0,46,140496,140542,0.03,Washington
17931,September,2022,Pend Oreille,WA,Passenger,18,12,30,9024,9054,0.33,Washington
17932,September,2022,Clallam,WA,Passenger,442,249,691,49482,50173,1.38,Washington
17933,September,2022,Hillsborough,FL,Passenger,0,1,1,111,112,0.89,Furthest
17934,September,2022,Cumberland,PA,Passenger,1,0,1,35,36,2.78,Furthest
17935,September,2022,Lee,FL,Passenger,1,0,1,24,25,4.0,Furthest
17936,September,2022,Miami-Dade,FL,Passenger,1,0,1,71,72,1.39,Furthest
17937,September,2022,Duval,FL,Passenger,1,2,3,254,257,1.17,Furthest
17938,September,2022,Williams,ND,Passenger,0,1,1,5,6,16.67,Mid-Distance
17939,September,2022,Los Angeles,CA,Passenger,7,6,13,695,708,1.84,Nearest
17940,September,2022,Loudoun,VA,Passenger,2,1,3,62,65,4.62,Furthest
17941,September,2022,Clallam,WA,Truck,6,0,6,21889,21895,0.03,Washington
17942,September,2022,Kauai,HI,Passenger,1,0,1,15,16,6.25,Nearest
17943,September,2022,Manassas,VA,Passenger,0,1,1,8,9,11.11,Furthest
17944,September,2022,Williamson,TX,Passenger,0,2,2,71,73,2.74,Mid-Distance
17945,September,2022,Hamilton,OH,Passenger,1,0,1,27,28,3.57,Furthest
17946,September,2022,New Haven,CT,Passenger,0,2,2,24,26,7.69,Furthest
17947,September,2022,Prince George's,MD,Passenger,3,1,4,112,116,3.45,Furthest
17948,September,2022,Nassau,NY,Passenger,1,0,1,21,22,4.55,Furthest
17949,September,2022,Kittitas,WA,Truck,4,0,4,14604,14608,0.03,Washington
17950,September,2022,Montgomery,PA,Passenger,1,0,1,20,21,4.76,Furthest
17951,September,2022,Gwinnett,GA,Passenger,1,0,1,49,50,2.0,Furthest
17952,September,2022,Skamania,WA,Truck,0,0,0,3908,3908,0.0,Washington
17953,September,2022,Placer,CA,Passenger,2,0,2,61,63,3.17,Nearest
17954,September,2022,Queens,NY,Passenger,1,0,1,36,37,2.7,Furthest
17955,September,2022,Carroll,NH,Passenger,0,1,1,5,6,16.67,Furthest
17956,September,2022,Ferry,WA,Passenger,22,4,26,4400,4426,0.59,Washington
17957,September,2022,Houston,GA,Passenger,1,0,1,30,31,3.23,Furthest
17958,September,2022,Jefferson,NY,Passenger,0,1,1,195,196,0.51,Furthest
17959,September,2022,Clark,NV,Passenger,4,2,6,453,459,1.31,Nearest
17960,September,2022,Sarasota,FL,Passenger,1,0,1,20,21,4.76,Furthest
17961,September,2022,Coryell,TX,Passenger,1,0,1,86,87,1.15,Mid-Distance
17962,September,2022,Fort Bend,TX,Passenger,1,0,1,24,25,4.0,Mid-Distance
17963,September,2022,Mason,WA,Passenger,339,178,517,46951,47468,1.09,Washington
17964,September,2022,Marin,CA,Passenger,0,1,1,27,28,3.57,Nearest
