,Month_ending,Year,County,State,Primary_use,Battery_BEVs,Hybrid_(PHEVs),EV_Total,Non-Electric_Total,Total_Veh,%_Electric
0,April,2017,Pinal,AZ,Passenger,2,0,2,254,256,0.78
1,April,2017,Island,WA,Passenger,108,128,236,59768,60004,0.39
2,April,2017,Clark,WA,Truck,0,0,0,77561,77561,0.0
3,April,2017,Allegheny,PA,Passenger,1,0,1,93,94,1.06
4,April,2017,Shelby,TN,Passenger,0,1,1,109,110,0.91
5,April,2017,Dale,AL,Passenger,0,1,1,65,66,1.52
6,April,2017,Jefferson,WA,Passenger,98,56,154,23744,23898,0.64
8,April,2017,Harnett,NC,Passenger,1,0,1,257,258,0.39
9,April,2017,Salt Lake,UT,Passenger,0,1,1,289,290,0.34
10,April,2017,Yakima,WA,Truck,0,0,0,57219,57219,0.0
11,April,2017,Montgomery,PA,Passenger,1,0,1,41,42,2.38
12,April,2017,Skamania,WA,Truck,0,0,0,3874,3874,0.0
13,April,2017,Whitman,WA,Passenger,9,19,28,21964,21992,0.13
14,April,2017,Utah,UT,Passenger,0,1,1,164,165,0.61
15,April,2017,Clark,WA,Passenger,755,471,1226,298474,299700,0.41
16,April,2017,Adams,WA,Passenger,2,3,5,12128,12133,0.04
17,April,2017,Franklin,WA,Passenger,27,47,74,55348,55422,0.13
18,April,2017,Ferry,WA,Truck,0,0,0,3549,3549,0.0
19,April,2017,San Juan,WA,Truck,0,0,0,5551,5551,0.0
20,April,2017,Los Angeles,CA,Passenger,3,1,4,1345,1349,0.3
21,April,2017,Lee,AL,Passenger,1,0,1,35,36,2.78
22,April,2017,Klickitat,WA,Passenger,22,23,45,14768,14813,0.3
23,April,2017,Clark,NV,Passenger,1,3,4,857,861,0.46
24,April,2017,Tarrant,TX,Passenger,0,2,2,273,275,0.73
25,April,2017,Skagit,WA,Truck,1,0,1,31395,31396,0.0
26,April,2017,Monterey,CA,Passenger,0,1,1,210,211,0.47
27,April,2017,San Juan,WA,Passenger,98,35,133,13479,13612,0.98
28,April,2017,Douglas,OR,Passenger,0,1,1,74,75,1.33
29,April,2017,Montgomery,TN,Passenger,1,0,1,293,294,0.34
30,April,2017,Adams,WA,Truck,0,0,0,5072,5072,0.0
31,April,2017,Lewis,WA,Passenger,46,33,79,55192,55271,0.14
32,April,2017,Lane,OR,Passenger,0,1,1,247,248,0.4
33,April,2017,Whatcom,WA,Truck,2,0,2,41449,41451,0.0
34,April,2017,Lincoln,WA,Truck,0,0,0,4464,4464,0.0
35,April,2017,Cobb,GA,Passenger,0,1,1,77,78,1.28
36,April,2017,Juneau,AK,Passenger,0,1,1,53,54,1.85
37,April,2017,Morris,NJ,Passenger,1,0,1,22,23,4.35
38,April,2017,Grays Harbor,WA,Truck,0,0,0,19850,19850,0.0
39,April,2017,Wayne,MI,Passenger,0,1,1,70,71,1.41
40,April,2017,Okanogan,WA,Passenger,3,16,19,25595,25614,0.07
41,April,2017,Canyon,ID,Passenger,0,1,1,102,103,0.97
42,April,2017,Kitsap,WA,Truck,1,0,1,52312,52313,0.0
43,April,2017,Fulton,GA,Passenger,1,1,2,119,121,1.65
44,April,2017,Manatee,FL,Passenger,1,0,1,48,49,2.04
45,April,2017,Garfield,WA,Truck,0,0,0,938,938,0.0
46,April,2017,Nassau,NY,Passenger,0,1,1,40,41,2.44
47,April,2017,Multnomah,OR,Passenger,0,3,3,1068,1071,0.28
48,April,2017,Lewis,WA,Truck,0,0,0,24797,24797,0.0
49,April,2017,Asotin,WA,Passenger,6,2,8,12343,12351,0.06
50,April,2017,Latah,ID,Passenger,0,1,1,120,121,0.83
51,April,2017,Santa Clara,CA,Passenger,6,2,8,411,419,1.91
52,April,2017,Moore,NC,Passenger,0,1,1,205,206,0.49
53,April,2017,Thurston,WA,Passenger,385,319,704,185729,186433,0.38
54,April,2017,Middlesex,MA,Passenger,1,0,1,148,149,0.67
55,April,2017,Bexar,TX,Passenger,1,0,1,1025,1026,0.1
56,April,2017,Walla Walla,WA,Passenger,22,24,46,34828,34874,0.13
57,April,2017,Stevens,WA,Passenger,8,22,30,31233,31263,0.1
58,April,2017,Okanogan,WA,Truck,0,0,0,16256,16256,0.0
59,April,2017,Pierce,WA,Truck,0,0,0,137818,137818,0.0
60,April,2017,Douglas,WA,Passenger,31,21,52,26603,26655,0.2
61,April,2017,Franklin,WA,Truck,0,0,0,17995,17995,0.0
62,April,2017,Manassas,VA,Passenger,0,1,1,10,11,9.09
63,April,2017,Albemarle,VA,Passenger,0,1,1,31,32,3.12
64,April,2017,Prince George's,MD,Passenger,0,1,1,182,183,0.55
65,April,2017,Hamilton,TN,Passenger,1,0,1,26,27,3.7
66,April,2017,Tulare,CA,Passenger,1,0,1,194,195,0.51
67,April,2017,Franklin,MA,Passenger,0,1,1,4,5,20.0
68,April,2017,Hardin,KY,Passenger,0,1,1,123,124,0.81
69,April,2017,Fairfax,VA,Passenger,2,2,4,860,864,0.46
70,April,2017,Okaloosa,FL,Passenger,1,0,1,194,195,0.51
71,April,2017,Spokane,WA,Truck,1,0,1,90266,90267,0.0
72,April,2017,Hamilton,IN,Passenger,1,0,1,61,62,1.61
73,April,2017,Muscogee,GA,Passenger,0,1,1,247,248,0.4
74,April,2017,Nueces,TX,Passenger,0,1,1,98,99,1.01
75,April,2017,King,WA,Truck,8,1,9,188938,188947,0.0
76,April,2017,Franklin,OH,Passenger,0,1,1,126,127,0.79
77,April,2017,Klickitat,WA,Truck,0,0,0,7954,7954,0.0
78,April,2017,Virginia Beach,VA,Passenger,2,1,3,645,648,0.46
79,April,2017,Bergen,NJ,Passenger,0,2,2,32,34,5.88
80,April,2017,Orleans,LA,Passenger,0,1,1,49,50,2.0
81,April,2017,San Diego,CA,Passenger,5,1,6,2768,2774,0.22
82,April,2017,Clallam,WA,Passenger,80,68,148,48127,48275,0.31
83,April,2017,Thurston,WA,Truck,0,0,0,53255,53255,0.0
84,April,2017,Anne Arundel,MD,Passenger,0,1,1,500,501,0.2
85,April,2017,Saratoga,NY,Passenger,1,1,2,75,77,2.6
86,April,2017,Pacific,WA,Truck,0,0,0,7464,7464,0.0
87,April,2017,Cumberland,NC,Passenger,1,0,1,612,613,0.16
88,April,2017,Marion,OR,Passenger,1,0,1,181,182,0.55
89,April,2017,Marin,CA,Passenger,1,0,1,60,61,1.64
90,April,2017,Columbia,WA,Truck,0,0,0,1536,1536,0.0
91,April,2017,El Paso,CO,Passenger,1,1,2,820,822,0.24
92,April,2017,Lincoln,WA,Passenger,2,4,6,7481,7487,0.08
93,April,2017,St. Lucie,FL,Passenger,1,0,1,32,33,3.03
94,April,2017,DeKalb,IN,Passenger,1,0,1,1,2,50.0
95,April,2017,Richmond,GA,Passenger,0,1,1,93,94,1.06
96,April,2017,Essex,NJ,Passenger,1,0,1,16,17,5.88
97,April,2017,Santa Fe,NM,Passenger,0,1,1,44,45,2.22
98,April,2017,Travis,TX,Passenger,0,1,1,195,196,0.51
99,April,2017,Deschutes,OR,Passenger,1,0,1,198,199,0.5
100,April,2017,Gwinnett,GA,Passenger,0,1,1,87,88,1.14
101,April,2017,Grant,WA,Truck,0,0,0,25091,25091,0.0
102,April,2017,Norfolk,MA,Passenger,1,0,1,38,39,2.56
103,April,2017,Clackamas,OR,Passenger,1,1,2,325,327,0.61
104,April,2017,Ventura,CA,Passenger,0,1,1,362,363,0.28
105,April,2017,Pacific,WA,Passenger,9,8,17,15082,15099,0.11
106,April,2017,Jefferson,WA,Truck,0,0,0,9442,9442,0.0
107,April,2017,Missoula,MT,Passenger,1,0,1,77,78,1.28
108,April,2017,Charles,MD,Passenger,0,1,1,90,91,1.1
109,April,2017,Volusia,FL,Passenger,0,1,1,47,48,2.08
110,April,2017,Yakima,WA,Passenger,38,54,92,159283,159375,0.06
111,April,2017,Duval,FL,Passenger,1,1,2,378,380,0.53
112,April,2017,Prince William,VA,Passenger,0,3,3,275,278,1.08
113,April,2017,Orange,CA,Passenger,2,1,3,646,649,0.46
114,April,2017,Walla Walla,WA,Truck,0,0,0,13177,13177,0.0
115,April,2017,Chelan,WA,Truck,0,0,0,21208,21208,0.0
116,April,2017,Madison,ID,Passenger,1,0,1,41,42,2.38
117,April,2017,Grant,WA,Passenger,18,21,39,60489,60528,0.06
118,April,2017,Whitman,WA,Truck,0,0,0,8380,8380,0.0
119,April,2017,Lewis,NY,Passenger,0,1,1,10,11,9.09
120,April,2017,Maui,HI,Passenger,1,0,1,72,73,1.37
121,April,2017,Santa Rosa,FL,Passenger,1,0,1,109,110,0.91
122,April,2017,Spokane,WA,Passenger,236,208,444,295746,296190,0.15
123,April,2017,Grays Harbor,WA,Passenger,29,30,59,44477,44536,0.13
124,April,2017,Maricopa,AZ,Passenger,2,0,2,1800,1802,0.11
125,April,2017,Wahkiakum,WA,Passenger,0,2,2,2848,2850,0.07
126,April,2017,Nantucket,MA,Passenger,1,0,1,3,4,25.0
127,April,2017,Skamania,WA,Passenger,9,8,17,8521,8538,0.2
128,April,2017,Arlington,VA,Passenger,1,1,2,166,168,1.19
129,April,2017,New London,CT,Passenger,1,1,2,257,259,0.77
130,April,2017,Mason,WA,Truck,0,0,0,19242,19242,0.0
131,April,2017,Pima,AZ,Passenger,0,2,2,442,444,0.45
132,April,2017,New Haven,CT,Passenger,0,1,1,60,61,1.64
133,April,2017,Norfolk,VA,Passenger,1,1,2,301,303,0.66
134,April,2017,DeKalb,GA,Passenger,1,0,1,84,85,1.18
135,April,2017,Hidalgo,TX,Passenger,0,1,1,98,99,1.01
136,April,2017,King,WA,Passenger,9558,3882,13440,1378548,1391988,0.97
137,April,2017,Orange,FL,Passenger,1,1,2,149,151,1.32
138,April,2017,Clallam,WA,Truck,0,0,0,20962,20962,0.0
139,April,2017,Sumter,FL,Passenger,0,1,1,10,11,9.09
140,April,2017,Pierce,WA,Passenger,917,807,1724,525754,527478,0.33
141,April,2017,Jefferson,NY,Passenger,1,1,2,255,257,0.78
142,April,2017,Benton,WA,Passenger,143,140,283,128087,128370,0.22
143,April,2017,Island,WA,Truck,0,0,0,20526,20526,0.0
144,April,2017,Cape May,NJ,Passenger,0,1,1,18,19,5.26
145,April,2017,Guilford,NC,Passenger,1,0,1,31,32,3.12
146,April,2017,Kittitas,WA,Truck,0,0,0,13478,13478,0.0
147,April,2017,San Mateo,CA,Passenger,0,1,1,158,159,0.63
148,April,2017,District of Columbia,DC,Passenger,0,3,3,225,228,1.32
149,April,2017,Skagit,WA,Passenger,123,97,220,87597,87817,0.25
150,April,2017,Stevens,WA,Truck,0,0,0,18286,18286,0.0
151,April,2017,Cowlitz,WA,Truck,0,0,0,27856,27856,0.0
152,April,2017,Snohomish,WA,Passenger,1709,861,2570,512767,515337,0.5
153,April,2017,Riverside,CA,Passenger,1,1,2,829,831,0.24
154,April,2017,Dallas,TX,Passenger,0,1,1,196,197,0.51
155,April,2017,Alameda,CA,Passenger,2,1,3,379,382,0.79
156,April,2017,Portsmouth,VA,Passenger,0,1,1,68,69,1.45
157,April,2017,Jackson,MO,Passenger,1,0,1,68,69,1.45
158,April,2017,Ferry,WA,Passenger,2,1,3,4397,4400,0.07
159,April,2017,Kitsap,WA,Passenger,584,298,882,172672,173554,0.51
160,April,2017,Dakota,MN,Passenger,0,1,1,40,41,2.44
161,April,2017,Douglas,WA,Truck,0,0,0,11451,11451,0.0
162,April,2017,Wahkiakum,WA,Truck,0,0,0,1631,1631,0.0
163,April,2017,Honolulu,HI,Passenger,4,2,6,604,610,0.98
164,April,2017,Montgomery,MD,Passenger,1,0,1,308,309,0.32
165,April,2017,Chelan,WA,Passenger,55,31,86,51695,51781,0.17
166,April,2017,Mason,WA,Passenger,49,64,113,43002,43115,0.26
167,April,2017,Polk,FL,Passenger,1,0,1,67,68,1.47
168,April,2017,Kent,MI,Passenger,0,1,1,37,38,2.63
169,April,2017,Hawaii,HI,Passenger,1,0,1,84,85,1.18
170,April,2017,Cascade,MT,Passenger,0,1,1,61,62,1.61
171,April,2017,Northampton,PA,Passenger,2,0,2,192,194,1.03
172,April,2017,Columbia,WA,Passenger,0,1,1,2358,2359,0.04
173,April,2017,Asotin,WA,Truck,0,0,0,6504,6504,0.0
174,April,2017,Dane,WI,Passenger,1,0,1,138,139,0.72
175,April,2017,Whatcom,WA,Passenger,441,159,600,142459,143059,0.42
176,April,2017,Carroll,NH,Passenger,0,1,1,0,1,100.0
177,April,2017,Monroe,NY,Passenger,1,0,1,27,28,3.57
178,April,2017,Garfield,WA,Passenger,0,0,0,1283,1283,0.0
179,April,2017,Palm Beach,FL,Passenger,0,1,1,100,101,0.99
180,April,2017,Pend Oreille,WA,Truck,0,0,0,5586,5586,0.0
181,April,2017,Benton,WA,Truck,0,0,0,39892,39892,0.0
182,April,2017,Pend Oreille,WA,Passenger,1,4,5,9320,9325,0.05
183,April,2017,Cowlitz,WA,Passenger,52,48,100,69320,69420,0.14
184,April,2017,Kittitas,WA,Passenger,21,17,38,27202,27240,0.14
185,April,2017,Snohomish,WA,Truck,1,0,1,122009,122010,0.0
186,April,2017,Howard,MD,Passenger,0,2,2,90,92,2.17
187,April,2018,Howard,MD,Passenger,0,1,1,85,86,1.16
188,April,2018,Lincoln,WA,Truck,0,0,0,4532,4532,0.0
189,April,2018,Norfolk,VA,Passenger,1,2,3,326,329,0.91
190,April,2018,Santa Clara,CA,Passenger,6,1,7,380,387,1.81
191,April,2018,Franklin,WA,Truck,0,0,0,18597,18597,0.0
192,April,2018,Los Angeles,CA,Passenger,6,4,10,1172,1182,0.85
193,April,2018,Charles,MD,Passenger,0,1,1,82,83,1.2
194,April,2018,Grays Harbor,WA,Passenger,47,52,99,46287,46386,0.21
195,April,2018,Ferry,WA,Truck,0,0,0,3499,3499,0.0
196,April,2018,Riverside,CA,Passenger,2,2,4,706,710,0.56
197,April,2018,Spokane,WA,Truck,1,0,1,92061,92062,0.0
198,April,2018,Gwinnett,GA,Passenger,0,1,1,80,81,1.23
199,April,2018,Latah,ID,Passenger,0,1,1,78,79,1.27
200,April,2018,Montgomery,TX,Passenger,1,0,1,63,64,1.56
201,April,2018,Lee,FL,Passenger,1,0,1,58,59,1.69
202,April,2018,Yakima,WA,Truck,0,0,0,58216,58216,0.0
203,April,2018,Flathead,MT,Passenger,1,0,1,51,52,1.92
204,April,2018,Monterey,CA,Passenger,0,1,1,188,189,0.53
205,April,2018,Benton,WA,Passenger,178,188,366,130946,131312,0.28
206,April,2018,Skamania,WA,Truck,0,0,0,3922,3922,0.0
207,April,2018,Thurston,WA,Truck,0,0,0,54065,54065,0.0
208,April,2018,Tulsa,OK,Passenger,0,1,1,47,48,2.08
209,April,2018,Whatcom,WA,Truck,2,0,2,42122,42124,0.0
210,April,2018,Columbia,WA,Passenger,2,1,3,2414,2417,0.12
211,April,2018,Montgomery,TN,Passenger,1,0,1,270,271,0.37
212,April,2018,Douglas,WA,Passenger,41,32,73,27438,27511,0.27
213,April,2018,Franklin,MA,Passenger,0,1,1,2,3,33.33
214,April,2018,Thurston,WA,Passenger,523,444,967,191803,192770,0.5
215,April,2018,Essex,NJ,Passenger,1,0,1,11,12,8.33
216,April,2018,Fairfax,VA,Passenger,2,2,4,832,836,0.48
217,April,2018,Kent,MI,Passenger,0,1,1,33,34,2.94
218,April,2018,Volusia,FL,Passenger,0,1,1,33,34,2.94
219,April,2018,Cowlitz,WA,Passenger,55,73,128,71356,71484,0.18
220,April,2018,San Juan,WA,Passenger,141,53,194,13961,14155,1.37
221,April,2018,Richland,SC,Passenger,0,1,1,173,174,0.57
222,April,2018,Garfield,WA,Passenger,1,0,1,1330,1331,0.08
223,April,2018,Walla Walla,WA,Truck,0,0,0,13332,13332,0.0
224,April,2018,Beaufort,SC,Passenger,1,0,1,38,39,2.56
225,April,2018,Cowlitz,WA,Truck,0,0,0,28292,28292,0.0
226,April,2018,Mason,WA,Passenger,71,87,158,45392,45550,0.35
227,April,2018,Pacific,WA,Passenger,14,19,33,15488,15521,0.21
228,April,2018,Santa Rosa,FL,Passenger,1,0,1,100,101,0.99
229,April,2018,Nantucket,MA,Passenger,1,0,1,4,5,20.0
230,April,2018,Prince George,VA,Passenger,0,1,1,73,74,1.35
231,April,2018,Northampton,PA,Passenger,0,1,1,64,65,1.54
232,April,2018,Maricopa,AZ,Passenger,2,1,3,1572,1575,0.19
233,April,2018,Okaloosa,FL,Passenger,1,0,1,172,173,0.58
234,April,2018,Pinal,AZ,Passenger,2,0,2,207,209,0.96
235,April,2018,Ventura,CA,Passenger,0,1,1,319,320,0.31
236,April,2018,Snohomish,WA,Truck,1,0,1,121256,121257,0.0
237,April,2018,Lane,OR,Passenger,0,1,1,190,191,0.52
238,April,2018,Yakima,WA,Passenger,62,84,146,163240,163386,0.09
239,April,2018,Twin Falls,ID,Passenger,0,1,1,23,24,4.17
240,April,2018,Prince William,VA,Passenger,0,4,4,265,269,1.49
241,April,2018,New Haven,CT,Passenger,0,1,1,50,51,1.96
242,April,2018,Anne Arundel,MD,Passenger,0,2,2,448,450,0.44
243,April,2018,Skamania,WA,Passenger,12,8,20,8705,8725,0.23
244,April,2018,Chelan,WA,Passenger,98,45,143,53398,53541,0.27
245,April,2018,Skagit,WA,Passenger,182,155,337,90035,90372,0.37
246,April,2018,Wahkiakum,WA,Passenger,1,3,4,2887,2891,0.14
247,April,2018,Cape May,NJ,Passenger,0,1,1,21,22,4.55
248,April,2018,Santa Fe,NM,Passenger,0,1,1,41,42,2.38
249,April,2018,Allegheny,PA,Passenger,1,0,1,76,77,1.3
250,April,2018,Montgomery,MD,Passenger,1,0,1,293,294,0.34
251,April,2018,Asotin,WA,Truck,0,0,0,6594,6594,0.0
252,April,2018,Grays Harbor,WA,Truck,0,0,0,20130,20130,0.0
253,April,2018,Stevens,WA,Truck,0,0,0,18512,18512,0.0
254,April,2018,Lewis,WA,Truck,0,0,0,25310,25310,0.0
255,April,2018,Snohomish,WA,Passenger,2189,1194,3383,518822,522205,0.65
256,April,2018,Kootenai,ID,Passenger,0,1,1,224,225,0.44
257,April,2018,Columbia,WA,Truck,0,0,0,1523,1523,0.0
258,April,2018,Dallas,TX,Passenger,0,1,1,188,189,0.53
259,April,2018,Clark,WA,Passenger,943,657,1600,306447,308047,0.52
260,April,2018,Lee,AL,Passenger,1,0,1,32,33,3.03
261,April,2018,Utah,UT,Passenger,0,1,1,136,137,0.73
262,April,2018,Washtenaw,MI,Passenger,1,0,1,39,40,2.5
263,April,2018,Marion,IN,Passenger,1,0,1,116,117,0.85
264,April,2018,Adams,WA,Passenger,5,4,9,12523,12532,0.07
265,April,2018,Lewis,WA,Passenger,78,51,129,57351,57480,0.22
266,April,2018,Moore,NC,Passenger,0,1,1,195,196,0.51
267,April,2018,Canyon,ID,Passenger,0,1,1,87,88,1.14
268,April,2018,Sacramento,CA,Passenger,1,0,1,298,299,0.33
269,April,2018,Pend Oreille,WA,Passenger,4,5,9,9474,9483,0.09
270,April,2018,Jefferson,NY,Passenger,1,0,1,220,221,0.45
271,April,2018,Pierce,WA,Passenger,1154,1091,2245,529160,531405,0.42
272,April,2018,Shelby,TN,Passenger,0,1,1,101,102,0.98
273,April,2018,Monroe,IL,Passenger,1,0,1,5,6,16.67
274,April,2018,Travis,TX,Passenger,0,1,1,189,190,0.53
275,April,2018,Jefferson,CO,Passenger,0,1,1,72,73,1.37
276,April,2018,El Paso,TX,Passenger,1,0,1,518,519,0.19
277,April,2018,Clallam,WA,Passenger,117,105,222,49605,49827,0.45
278,April,2018,San Mateo,CA,Passenger,1,1,2,133,135,1.48
279,April,2018,Douglas,WA,Truck,0,0,0,11882,11882,0.0
280,April,2018,Williamson,TX,Passenger,0,1,1,157,158,0.63
281,April,2018,Richmond,GA,Passenger,0,1,1,91,92,1.09
282,April,2018,Morris,NJ,Passenger,1,0,1,18,19,5.26
283,April,2018,Benton,WA,Truck,0,0,0,40852,40852,0.0
284,April,2018,Fulton,GA,Passenger,1,1,2,100,102,1.96
285,April,2018,Klickitat,WA,Truck,0,0,0,8070,8070,0.0
286,April,2018,Duval,FL,Passenger,1,2,3,377,380,0.79
287,April,2018,Whatcom,WA,Passenger,593,269,862,146611,147473,0.58
288,April,2018,Hawaii,HI,Passenger,1,0,1,75,76,1.32
289,April,2018,Dakota,MN,Passenger,0,2,2,37,39,5.13
290,April,2018,Walla Walla,WA,Passenger,34,40,74,35454,35528,0.21
291,April,2018,Spokane,WA,Passenger,318,288,606,301923,302529,0.2
292,April,2018,Adams,WA,Truck,0,0,0,5150,5150,0.0
293,April,2018,Hardin,KY,Passenger,0,1,1,118,119,0.84
294,April,2018,Pacific,WA,Truck,0,0,0,7596,7596,0.0
295,April,2018,St. Clair,IL,Passenger,0,1,1,150,151,0.66
296,April,2018,Kitsap,WA,Passenger,742,441,1183,177372,178555,0.66
297,April,2018,Stevens,WA,Passenger,10,24,34,31585,31619,0.11
298,April,2018,Prince George's,MD,Passenger,1,1,2,185,187,1.07
299,April,2018,San Juan,WA,Truck,0,0,0,5698,5698,0.0
300,April,2018,Manassas,VA,Passenger,0,1,1,9,10,10.0
301,April,2018,Nueces,TX,Passenger,1,1,2,96,98,2.04
302,April,2018,Kittitas,WA,Passenger,40,32,72,28774,28846,0.25
303,April,2018,Clark,NV,Passenger,1,2,3,746,749,0.4
304,April,2018,Polk,FL,Passenger,1,0,1,63,64,1.56
305,April,2018,Broward,FL,Passenger,0,1,1,130,131,0.76
306,April,2018,Grant,WA,Passenger,31,42,73,62794,62867,0.12
307,April,2018,Kitsap,WA,Truck,1,0,1,52991,52992,0.0
308,April,2018,Clallam,WA,Truck,0,0,0,21359,21359,0.0
309,April,2018,Sedgwick,KS,Passenger,0,1,1,99,100,1.0
310,April,2018,Whitman,WA,Passenger,20,24,44,22555,22599,0.19
311,April,2018,Whitman,WA,Truck,0,0,0,8463,8463,0.0
312,April,2018,Island,WA,Truck,0,0,0,20845,20845,0.0
313,April,2018,Carroll,NH,Passenger,0,1,1,1,2,50.0
314,April,2018,Asotin,WA,Passenger,8,6,14,12640,12654,0.11
315,April,2018,San Francisco,CA,Passenger,0,1,1,133,134,0.75
316,April,2018,Marin,CA,Passenger,1,0,1,56,57,1.75
317,April,2018,Hamilton,TN,Passenger,1,0,1,23,24,4.17
318,April,2018,Sumter,FL,Passenger,0,1,1,10,11,9.09
319,April,2018,Klamath,OR,Passenger,1,0,1,34,35,2.86
320,April,2018,Orleans,LA,Passenger,0,1,1,47,48,2.08
321,April,2018,Tuolumne,CA,Passenger,0,1,1,13,14,7.14
322,April,2018,Queens,NY,Passenger,1,0,1,62,63,1.59
323,April,2018,Clackamas,OR,Passenger,0,1,1,227,228,0.44
324,April,2018,Deschutes,OR,Passenger,1,0,1,172,173,0.58
325,April,2018,Ferry,WA,Passenger,2,3,5,4414,4419,0.11
326,April,2018,Garfield,WA,Truck,0,0,0,950,950,0.0
327,April,2018,Honolulu,HI,Passenger,2,2,4,532,536,0.75
328,April,2018,Lumpkin,GA,Passenger,1,0,1,7,8,12.5
329,April,2018,Wahkiakum,WA,Truck,0,0,0,1668,1668,0.0
330,April,2018,Pend Oreille,WA,Truck,0,0,0,5654,5654,0.0
331,April,2018,Pima,AZ,Passenger,1,1,2,415,417,0.48
332,April,2018,New London,CT,Passenger,0,1,1,250,251,0.4
333,April,2018,Norfolk,MA,Passenger,1,0,1,36,37,2.7
334,April,2018,Virginia Beach,VA,Passenger,2,1,3,683,686,0.44
335,April,2018,Arlington,VA,Passenger,1,2,3,172,175,1.71
336,April,2018,Franklin,WA,Passenger,37,59,96,57403,57499,0.17
337,April,2018,Garfield,OK,Passenger,1,0,1,19,20,5.0
338,April,2018,Bexar,TX,Passenger,2,2,4,777,781,0.51
339,April,2018,Multnomah,OR,Passenger,4,4,8,816,824,0.97
340,April,2018,Manatee,FL,Passenger,1,0,1,38,39,2.56
341,April,2018,Mason,WA,Truck,0,0,0,19808,19808,0.0
342,April,2018,St. Lucie,FL,Passenger,1,0,1,26,27,3.7
343,April,2018,Ada,ID,Passenger,0,2,2,331,333,0.6
344,April,2018,El Paso,CO,Passenger,2,0,2,751,753,0.27
345,April,2018,Sangamon,IL,Passenger,1,0,1,11,12,8.33
346,April,2018,Brevard,FL,Passenger,0,1,1,102,103,0.97
347,April,2018,San Diego,CA,Passenger,7,1,8,2553,2561,0.31
348,April,2018,Tarrant,TX,Passenger,1,0,1,216,217,0.46
349,April,2018,Klickitat,WA,Passenger,24,29,53,15050,15103,0.35
350,April,2018,Palm Beach,FL,Passenger,0,1,1,87,88,1.14
351,April,2018,Madison,ID,Passenger,1,0,1,37,38,2.63
352,April,2018,DeKalb,GA,Passenger,1,0,1,83,84,1.19
353,April,2018,Caddo,LA,Passenger,0,1,1,22,23,4.35
354,April,2018,Frederick,MD,Passenger,0,1,1,86,87,1.15
355,April,2018,King,WA,Truck,7,1,8,183356,183364,0.0
356,April,2018,Orange,CA,Passenger,3,1,4,568,572,0.7
357,April,2018,King,WA,Passenger,12284,5290,17574,1368427,1386001,1.27
358,April,2018,District of Columbia,DC,Passenger,0,3,3,192,195,1.54
359,April,2018,Island,WA,Passenger,184,177,361,62281,62642,0.58
360,April,2018,Pierce,WA,Truck,0,0,0,137364,137364,0.0
361,April,2018,Jefferson,WA,Truck,0,0,0,9525,9525,0.0
362,April,2018,Ramsey,MN,Passenger,1,0,1,39,40,2.5
363,April,2018,Kittitas,WA,Truck,0,0,0,13993,13993,0.0
364,April,2018,Nassau,NY,Passenger,1,0,1,37,38,2.63
366,April,2018,Skagit,WA,Truck,1,0,1,31980,31981,0.0
367,April,2018,Okanogan,WA,Passenger,8,19,27,25823,25850,0.1
368,April,2018,Clay,FL,Passenger,0,1,1,100,101,0.99
369,April,2018,Lincoln,WA,Passenger,2,6,8,7613,7621,0.1
370,April,2018,DuPage,IL,Passenger,1,0,1,63,64,1.56
371,April,2018,Okanogan,WA,Truck,0,0,0,16350,16350,0.0
372,April,2018,Alameda,CA,Passenger,0,1,1,352,353,0.28
373,April,2018,Saratoga,NY,Passenger,1,1,2,66,68,2.94
374,April,2018,Orange,FL,Passenger,2,1,3,169,172,1.74
375,April,2018,Hamilton,IN,Passenger,1,0,1,47,48,2.08
376,April,2018,Portsmouth,VA,Passenger,0,1,1,73,74,1.35
377,April,2018,Juneau,AK,Passenger,0,1,1,46,47,2.13
378,April,2018,Maui,HI,Passenger,1,0,1,58,59,1.69
379,April,2018,Cook,IL,Passenger,1,0,1,271,272,0.37
380,April,2018,Grant,WA,Truck,0,0,0,25855,25855,0.0
381,April,2018,Chelan,WA,Truck,0,0,0,21764,21764,0.0
382,April,2018,Montgomery,PA,Passenger,1,0,1,35,36,2.78
383,April,2018,Dale,AL,Passenger,0,1,1,63,64,1.56
384,April,2018,Contra Costa,CA,Passenger,0,1,1,461,462,0.22
385,April,2018,Clark,WA,Truck,0,0,0,78735,78735,0.0
386,April,2018,DeKalb,IN,Passenger,1,0,1,1,2,50.0
387,April,2018,Jefferson,WA,Passenger,134,88,222,24353,24575,0.9
388,April,2019,Pierce,WA,Passenger,1692,1486,3178,540913,544091,0.58
389,April,2019,New London,CT,Passenger,0,2,2,250,252,0.79
390,April,2019,Clark,WA,Truck,0,0,0,80105,80105,0.0
391,April,2019,Grant,WA,Truck,0,0,0,26430,26430,0.0
392,April,2019,Anne Arundel,MD,Passenger,0,2,2,448,450,0.44
393,April,2019,Wahkiakum,WA,Truck,0,0,0,1733,1733,0.0
394,April,2019,Travis,TX,Passenger,2,1,3,196,199,1.51
395,April,2019,Jefferson,NY,Passenger,0,2,2,219,221,0.9
396,April,2019,Wahkiakum,WA,Passenger,1,1,2,3014,3016,0.07
397,April,2019,Hennepin,MN,Passenger,2,0,2,103,105,1.9
398,April,2019,Yakima,WA,Passenger,93,103,196,164616,164812,0.12
399,April,2019,Douglas,NE,Passenger,0,1,1,63,64,1.56
400,April,2019,Montgomery,PA,Passenger,2,0,2,38,40,5.0
401,April,2019,Nueces,TX,Passenger,1,1,2,96,98,2.04
402,April,2019,Whitman,WA,Passenger,29,45,74,22711,22785,0.32
403,April,2019,Skamania,WA,Truck,0,0,0,4039,4039,0.0
404,April,2019,San Juan,PR,Passenger,0,1,1,3,4,25.0
405,April,2019,Benton,WA,Passenger,248,263,511,133307,133818,0.38
406,April,2019,Whitman,WA,Truck,0,0,0,8517,8517,0.0
407,April,2019,Manassas,VA,Passenger,0,1,1,8,9,11.11
408,April,2019,Nantucket,MA,Passenger,1,0,1,3,4,25.0
409,April,2019,Norfolk,VA,Passenger,2,2,4,352,356,1.12
410,April,2019,Jefferson,WA,Passenger,187,118,305,24901,25206,1.21
411,April,2019,Walla Walla,WA,Passenger,46,57,103,36137,36240,0.28
412,April,2019,Lake,FL,Passenger,1,0,1,19,20,5.0
413,April,2019,St. Clair,IL,Passenger,0,1,1,160,161,0.62
414,April,2019,Ramsey,MN,Passenger,1,0,1,43,44,2.27
415,April,2019,Owyhee,ID,Passenger,1,0,1,5,6,16.67
416,April,2019,San Mateo,CA,Passenger,2,1,3,122,125,2.4
417,April,2019,Brevard,FL,Passenger,0,1,1,85,86,1.16
418,April,2019,Cochise,AZ,Passenger,0,1,1,116,117,0.85
419,April,2019,Pinal,AZ,Passenger,2,0,2,195,197,1.02
420,April,2019,Chelan,WA,Truck,0,0,0,22173,22173,0.0
421,April,2019,Cape May,NJ,Passenger,0,1,1,17,18,5.56
422,April,2019,Pierce,WA,Truck,0,0,0,139350,139350,0.0
423,April,2019,Columbia,WA,Passenger,2,2,4,2441,2445,0.16
424,April,2019,Honolulu,HI,Passenger,2,3,5,503,508,0.98
425,April,2019,Charleston,SC,Passenger,1,0,1,119,120,0.83
426,April,2019,Arlington,VA,Passenger,1,2,3,160,163,1.84
427,April,2019,Dale,AL,Passenger,0,1,1,56,57,1.75
428,April,2019,Yakima,WA,Truck,0,0,0,58948,58948,0.0
429,April,2019,Skamania,WA,Passenger,21,16,37,8713,8750,0.42
430,April,2019,Allegheny,PA,Passenger,1,0,1,84,85,1.18
431,April,2019,San Joaquin,CA,Passenger,1,0,1,133,134,0.75
432,April,2019,Sedgwick,KS,Passenger,0,1,1,102,103,0.97
433,April,2019,Washtenaw,MI,Passenger,1,0,1,37,38,2.63
434,April,2019,Bucks,PA,Passenger,1,0,1,17,18,5.56
435,April,2019,Okanogan,WA,Passenger,20,22,42,26020,26062,0.16
436,April,2019,Garfield,WA,Truck,0,0,0,958,958,0.0
437,April,2019,Duval,FL,Passenger,1,2,3,382,385,0.78
438,April,2019,Clark,WA,Passenger,1414,896,2310,312581,314891,0.73
439,April,2019,San Diego,CA,Passenger,10,3,13,2654,2667,0.49
440,April,2019,Cowlitz,WA,Truck,0,0,0,28852,28852,0.0
441,April,2019,Ventura,CA,Passenger,0,2,2,311,313,0.64
442,April,2019,Kern,CA,Passenger,0,1,1,225,226,0.44
443,April,2019,Montgomery,MD,Passenger,1,0,1,272,273,0.37
444,April,2019,Palm Beach,FL,Passenger,0,1,1,92,93,1.08
445,April,2019,Caddo,LA,Passenger,0,1,1,23,24,4.17
446,April,2019,Charles,MD,Passenger,0,1,1,82,83,1.2
447,April,2019,DeKalb,GA,Passenger,1,0,1,80,81,1.23
448,April,2019,Alexandria,VA,Passenger,1,0,1,154,155,0.65
449,April,2019,Multnomah,OR,Passenger,4,5,9,749,758,1.19
450,April,2019,St. Lucie,FL,Passenger,1,0,1,30,31,3.23
452,April,2019,Bexar,TX,Passenger,3,4,7,677,684,1.02
453,April,2019,Montgomery,AL,Passenger,0,1,1,44,45,2.22
454,April,2019,Shasta,CA,Passenger,1,0,1,40,41,2.44
455,April,2019,Sumter,FL,Passenger,0,1,1,10,11,9.09
456,April,2019,Richmond,GA,Passenger,0,1,1,93,94,1.06
457,April,2019,Los Angeles,CA,Passenger,8,5,13,1095,1108,1.17
458,April,2019,Orange,CA,Passenger,6,1,7,529,536,1.31
459,April,2019,Harnett,NC,Passenger,1,1,2,214,216,0.93
460,April,2019,Asotin,WA,Passenger,12,8,20,12659,12679,0.16
461,April,2019,Cascade,MT,Passenger,0,1,1,58,59,1.69
462,April,2019,King,WA,Passenger,18277,6871,25148,1384099,1409247,1.78
463,April,2019,Whatcom,WA,Truck,2,0,2,42771,42773,0.0
464,April,2019,Whatcom,WA,Passenger,823,394,1217,150081,151298,0.8
465,April,2019,Santa Rosa,FL,Passenger,1,0,1,87,88,1.14
466,April,2019,Deschutes,OR,Passenger,2,0,2,154,156,1.28
467,April,2019,Santa Fe,NM,Passenger,0,1,1,40,41,2.44
468,April,2019,Broward,FL,Passenger,2,1,3,128,131,2.29
469,April,2019,Penobscot,ME,Passenger,0,1,1,13,14,7.14
470,April,2019,Douglas,WA,Truck,0,0,0,12176,12176,0.0
471,April,2019,Sangamon,IL,Passenger,2,0,2,7,9,22.22
472,April,2019,Pacific,WA,Truck,0,0,0,7660,7660,0.0
473,April,2019,Chelan,WA,Passenger,147,66,213,54294,54507,0.39
474,April,2019,Pend Oreille,WA,Truck,0,0,0,5753,5753,0.0
475,April,2019,Dakota,MN,Passenger,0,2,2,36,38,5.26
476,April,2019,Grant,WA,Passenger,35,60,95,64382,64477,0.15
477,April,2019,Klickitat,WA,Passenger,33,33,66,15507,15573,0.42
478,April,2019,Fresno,CA,Passenger,1,0,1,187,188,0.53
479,April,2019,Volusia,FL,Passenger,0,1,1,36,37,2.7
480,April,2019,Walla Walla,WA,Truck,0,0,0,13603,13603,0.0
481,April,2019,Howard,MD,Passenger,0,1,1,77,78,1.28
482,April,2019,Richland,SC,Passenger,0,1,1,161,162,0.62
483,April,2019,Fairfax,VA,Passenger,3,2,5,781,786,0.64
484,April,2019,Kitsap,WA,Passenger,1009,575,1584,180200,181784,0.87
485,April,2019,DuPage,IL,Passenger,1,0,1,60,61,1.64
486,April,2019,Tulsa,OK,Passenger,1,1,2,46,48,4.17
487,April,2019,Mecklenburg,NC,Passenger,1,0,1,83,84,1.19
488,April,2019,Santa Clara,CA,Passenger,8,1,9,362,371,2.43
489,April,2019,Portsmouth,VA,Passenger,0,1,1,75,76,1.32
490,April,2019,Kittitas,WA,Passenger,71,35,106,29489,29595,0.36
491,April,2019,Mason,WA,Truck,0,0,0,20326,20326,0.0
492,April,2019,Pend Oreille,WA,Passenger,4,5,9,9505,9514,0.09
493,April,2019,Franklin,MA,Passenger,0,1,1,1,2,50.0
494,April,2019,Clay,FL,Passenger,0,1,1,87,88,1.14
495,April,2019,Thurston,WA,Passenger,821,613,1434,196770,198204,0.72
496,April,2019,Saratoga,NY,Passenger,1,0,1,58,59,1.69
497,April,2019,Tarrant,TX,Passenger,2,0,2,200,202,0.99
498,April,2019,Asotin,WA,Truck,0,0,0,6629,6629,0.0
499,April,2019,Berkshire,MA,Passenger,0,1,1,4,5,20.0
500,April,2019,Spokane,WA,Truck,1,0,1,94382,94383,0.0
501,April,2019,Clallam,WA,Passenger,160,132,292,50458,50750,0.58
502,April,2019,Oldham,KY,Passenger,0,1,1,5,6,16.67
503,April,2019,King,WA,Truck,5,1,6,181820,181826,0.0
504,April,2019,New Haven,CT,Passenger,0,2,2,49,51,3.92
505,April,2019,El Paso,TX,Passenger,3,0,3,486,489,0.61
506,April,2019,Stevens,WA,Truck,0,0,0,18683,18683,0.0
507,April,2019,Klamath,OR,Passenger,1,0,1,38,39,2.56
508,April,2019,St. Mary's,MD,Passenger,1,0,1,210,211,0.47
509,April,2019,Thurston,WA,Truck,0,0,0,55024,55024,0.0
510,April,2019,Adams,WA,Passenger,5,6,11,12657,12668,0.09
511,April,2019,Ferry,WA,Passenger,4,2,6,4370,4376,0.14
512,April,2019,Washoe,NV,Passenger,2,0,2,110,112,1.79
513,April,2019,Lee,AL,Passenger,1,0,1,35,36,2.78
514,April,2019,Rogers,OK,Passenger,1,0,1,5,6,16.67
515,April,2019,Bergen,NJ,Passenger,1,0,1,26,27,3.7
516,April,2019,Santa Cruz,CA,Passenger,1,0,1,39,40,2.5
517,April,2019,Harris,TX,Passenger,0,1,1,248,249,0.4
518,April,2019,Polk,FL,Passenger,1,0,1,65,66,1.52
519,April,2019,Tuolumne,CA,Passenger,0,1,1,12,13,7.69
520,April,2019,Frederick,MD,Passenger,1,1,2,78,80,2.5
521,April,2019,Benton,WA,Truck,0,0,0,41655,41655,0.0
522,April,2019,Lincoln,WA,Truck,0,0,0,4700,4700,0.0
523,April,2019,Randolph,NC,Passenger,1,0,1,6,7,14.29
524,April,2019,Riverside,CA,Passenger,2,2,4,663,667,0.6
525,April,2019,Calvert,MD,Passenger,0,2,2,86,88,2.27
526,April,2019,Norfolk,MA,Passenger,1,0,1,37,38,2.63
527,April,2019,Contra Costa,CA,Passenger,2,2,4,389,393,1.02
528,April,2019,Moore,NC,Passenger,0,1,1,181,182,0.55
529,April,2019,San Juan,WA,Truck,0,0,0,5834,5834,0.0
530,April,2019,Larimer,CO,Passenger,1,0,1,58,59,1.69
531,April,2019,Lumpkin,GA,Passenger,1,0,1,6,7,14.29
532,April,2019,Carson City,NV,Passenger,1,0,1,14,15,6.67
533,April,2019,Grays Harbor,WA,Truck,0,0,0,20395,20395,0.0
534,April,2019,Middlesex,MA,Passenger,1,1,2,116,118,1.69
535,April,2019,Klickitat,WA,Truck,0,0,0,8222,8222,0.0
536,April,2019,Ada,ID,Passenger,0,2,2,309,311,0.64
537,April,2019,Williamson,TX,Passenger,0,1,1,143,144,0.69
538,April,2019,Maricopa,AZ,Passenger,6,2,8,1537,1545,0.52
539,April,2019,Okanogan,WA,Truck,0,0,0,16478,16478,0.0
540,April,2019,Prince George's,MD,Passenger,1,1,2,185,187,1.07
541,April,2019,Flathead,MT,Passenger,1,0,1,60,61,1.64
542,April,2019,DeKalb,IN,Passenger,1,0,1,1,2,50.0
543,April,2019,Spokane,WA,Passenger,512,407,919,309575,310494,0.3
544,April,2019,Kent,MI,Passenger,0,1,1,22,23,4.35
545,April,2019,Lee,FL,Passenger,1,0,1,53,54,1.85
546,April,2019,Cowlitz,WA,Passenger,89,101,190,72747,72937,0.26
547,April,2019,Alameda,CA,Passenger,3,2,5,311,316,1.58
548,April,2019,Mason,WA,Passenger,117,118,235,46864,47099,0.5
549,April,2019,Stevens,WA,Passenger,19,27,46,31638,31684,0.15
550,April,2019,Kootenai,ID,Passenger,1,1,2,215,217,0.92
551,April,2019,Snohomish,WA,Truck,1,0,1,122012,122013,0.0
552,April,2019,Grays Harbor,WA,Passenger,70,84,154,47665,47819,0.32
553,April,2019,Prince William,VA,Passenger,1,4,5,257,262,1.91
554,April,2019,Island,WA,Passenger,310,241,551,63255,63806,0.86
555,April,2019,Pacific,WA,Passenger,23,28,51,15922,15973,0.32
556,April,2019,Island,WA,Truck,0,0,0,21247,21247,0.0
557,April,2019,Pima,AZ,Passenger,1,1,2,398,400,0.5
558,April,2019,Lewis,WA,Truck,0,0,0,25826,25826,0.0
559,April,2019,San Francisco,CA,Passenger,2,1,3,111,114,2.63
560,April,2019,Suffolk,MA,Passenger,0,1,1,40,41,2.44
561,April,2019,District of Columbia,DC,Passenger,1,1,2,207,209,0.96
562,April,2019,Lincoln,WA,Passenger,3,6,9,7756,7765,0.12
563,April,2019,Camden,NJ,Passenger,0,1,1,25,26,3.85
564,April,2019,Franklin,WA,Truck,0,0,0,19218,19218,0.0
565,April,2019,Franklin,WA,Passenger,53,67,120,59469,59589,0.2
566,April,2019,Collin,TX,Passenger,1,1,2,132,134,1.49
567,April,2019,Marion,OR,Passenger,1,0,1,115,116,0.86
568,April,2019,San Juan,WA,Passenger,204,69,273,14332,14605,1.87
569,April,2019,Shelby,TN,Passenger,0,1,1,94,95,1.05
570,April,2019,Monroe,IL,Passenger,1,0,1,4,5,20.0
571,April,2019,Hawaii,HI,Passenger,1,0,1,61,62,1.61
572,April,2019,Wayne,MI,Passenger,0,1,1,69,70,1.43
573,April,2019,Valencia,NM,Passenger,1,0,1,8,9,11.11
574,April,2019,Guadalupe,TX,Passenger,1,0,1,76,77,1.3
575,April,2019,Douglas,WA,Passenger,55,34,89,27972,28061,0.32
576,April,2019,Virginia Beach,VA,Passenger,1,1,2,702,704,0.28
577,April,2019,Cumberland,NC,Passenger,0,2,2,507,509,0.39
578,April,2019,Clark,NV,Passenger,3,2,5,690,695,0.72
579,April,2019,Jefferson,WA,Truck,0,0,0,9652,9652,0.0
580,April,2019,Snohomish,WA,Passenger,3292,1539,4831,529161,533992,0.9
581,April,2019,Jefferson,CO,Passenger,0,2,2,59,61,3.28
582,April,2019,Denver,CO,Passenger,1,0,1,130,131,0.76
583,April,2019,Montgomery,TX,Passenger,2,0,2,59,61,3.28
584,April,2019,Adams,WA,Truck,0,0,0,5104,5104,0.0
585,April,2019,Ferry,WA,Truck,0,0,0,3592,3592,0.0
586,April,2019,Skagit,WA,Passenger,292,197,489,91537,92026,0.53
587,April,2019,Vigo,IN,Passenger,1,0,1,5,6,16.67
588,April,2019,Clallam,WA,Truck,0,0,0,21681,21681,0.0
589,April,2019,Fulton,GA,Passenger,1,2,3,112,115,2.61
590,April,2019,Carroll,NH,Passenger,0,1,1,2,3,33.33
591,April,2019,Kitsap,WA,Truck,1,0,1,53874,53875,0.0
592,April,2019,Nassau,NY,Passenger,3,0,3,40,43,6.98
593,April,2019,Lewis,WA,Passenger,95,91,186,58821,59007,0.32
594,April,2019,Spartanburg,SC,Passenger,0,1,1,33,34,2.94
595,April,2019,Kittitas,WA,Truck,0,0,0,14296,14296,0.0
596,April,2019,Twin Falls,ID,Passenger,0,1,1,22,23,4.35
597,April,2019,Garfield,WA,Passenger,1,1,2,1298,1300,0.15
598,April,2019,Clackamas,OR,Passenger,1,1,2,206,208,0.96
599,April,2019,Maui,HI,Passenger,1,0,1,47,48,2.08
600,April,2019,Goochland,VA,Passenger,1,1,2,251,253,0.79
601,April,2019,El Paso,CO,Passenger,3,2,5,751,756,0.66
602,April,2019,Skagit,WA,Truck,1,0,1,32325,32326,0.0
603,April,2019,Albemarle,VA,Passenger,1,0,1,25,26,3.85
604,April,2019,Manatee,FL,Passenger,1,0,1,32,33,3.03
605,April,2019,Columbia,WA,Truck,0,0,0,1531,1531,0.0
606,April,2019,Juneau,AK,Passenger,0,2,2,32,34,5.88
607,April,2019,Cook,IL,Passenger,1,0,1,241,242,0.41
608,April,2019,Houston,GA,Passenger,1,0,1,54,55,1.82
609,April,2020,Sumter,FL,Passenger,0,1,1,9,10,10.0
610,April,2020,Placer,CA,Passenger,2,0,2,89,91,2.2
611,April,2020,New Haven,CT,Passenger,0,2,2,41,43,4.65
612,April,2020,King,WA,Passenger,24085,7696,31781,1386024,1417805,2.24
613,April,2020,Pend Oreille,WA,Truck,0,0,0,5739,5739,0.0
614,April,2020,DeKalb,GA,Passenger,1,0,1,80,81,1.23
615,April,2020,Pierce,WA,Passenger,2347,1682,4029,548871,552900,0.73
616,April,2020,Garfield,WA,Truck,0,0,0,968,968,0.0
617,April,2020,Cowlitz,WA,Truck,0,0,0,28765,28765,0.0
618,April,2020,Frederick,MD,Passenger,1,1,2,76,78,2.56
619,April,2020,Shelby,OH,Passenger,0,1,1,1,2,50.0
620,April,2020,Tarrant,TX,Passenger,1,0,1,178,179,0.56
621,April,2020,San Diego,CA,Passenger,13,5,18,2764,2782,0.65
622,April,2020,Alexandria,VA,Passenger,1,0,1,140,141,0.71
623,April,2020,Camden,NJ,Passenger,0,2,2,21,23,8.7
624,April,2020,Dallas,TX,Passenger,1,0,1,202,203,0.49
625,April,2020,Adams,WA,Truck,0,0,0,5206,5206,0.0
626,April,2020,Montgomery,AL,Passenger,0,1,1,38,39,2.56
627,April,2020,Manassas,VA,Passenger,0,1,1,5,6,16.67
628,April,2020,Prince George's,MD,Passenger,1,1,2,164,166,1.2
629,April,2020,Rockingham,NH,Passenger,1,0,1,27,28,3.57
630,April,2020,Montgomery,OH,Passenger,0,1,1,46,47,2.13
631,April,2020,Yakima,WA,Passenger,129,115,244,165261,165505,0.15
632,April,2020,Williams,ND,Passenger,0,1,1,13,14,7.14
633,April,2020,Shelby,TN,Passenger,0,1,1,89,90,1.11
634,April,2020,DuPage,IL,Passenger,3,0,3,58,61,4.92
635,April,2020,Ferry,WA,Passenger,5,3,8,4331,4339,0.18
636,April,2020,Nassau,NY,Passenger,4,0,4,33,37,10.81
637,April,2020,St. Clair,IL,Passenger,1,0,1,139,140,0.71
638,April,2020,Hudson,NJ,Passenger,1,0,1,38,39,2.56
639,April,2020,Denton,TX,Passenger,1,0,1,90,91,1.1
640,April,2020,Mason,WA,Truck,0,0,0,20531,20531,0.0
641,April,2020,Fresno,CA,Passenger,1,0,1,183,184,0.54
642,April,2020,Hawaii,HI,Passenger,1,0,1,57,58,1.72
643,April,2020,Monroe,IL,Passenger,1,0,1,4,5,20.0
644,April,2020,Montgomery,PA,Passenger,1,0,1,31,32,3.12
645,April,2020,Klickitat,WA,Truck,0,0,0,8193,8193,0.0
646,April,2020,Palm Beach,FL,Passenger,0,1,1,80,81,1.23
647,April,2020,Ramsey,MN,Passenger,1,0,1,39,40,2.5
648,April,2020,Prince William,VA,Passenger,2,3,5,222,227,2.2
649,April,2020,Greene,MO,Passenger,0,1,1,31,32,3.12
650,April,2020,Whitman,WA,Passenger,44,48,92,22313,22405,0.41
651,April,2020,Ventura,CA,Passenger,0,3,3,287,290,1.03
652,April,2020,Asotin,WA,Truck,0,0,0,6617,6617,0.0
653,April,2020,Columbia,WA,Truck,0,0,0,1524,1524,0.0
654,April,2020,Shasta,CA,Passenger,1,0,1,37,38,2.63
655,April,2020,El Paso,TX,Passenger,3,0,3,436,439,0.68
656,April,2020,Kitsap,WA,Truck,1,0,1,53907,53908,0.0
657,April,2020,Virginia Beach,VA,Passenger,1,0,1,672,673,0.15
658,April,2020,Wahkiakum,WA,Passenger,6,5,11,2973,2984,0.37
659,April,2020,Pinellas,FL,Passenger,1,1,2,109,111,1.8
660,April,2020,Moore,NC,Passenger,0,1,1,162,163,0.61
661,April,2020,Duval,FL,Passenger,0,2,2,358,360,0.56
662,April,2020,Collin,TX,Passenger,1,1,2,124,126,1.59
663,April,2020,Benton,WA,Passenger,348,321,669,134556,135225,0.49
664,April,2020,Juneau,AK,Passenger,0,2,2,31,33,6.06
665,April,2020,Putnam,TN,Passenger,0,1,1,3,4,25.0
666,April,2020,Cascade,MT,Passenger,0,1,1,55,56,1.79
667,April,2020,Spokane,WA,Passenger,711,473,1184,316298,317482,0.37
668,April,2020,Houston,GA,Passenger,1,0,1,58,59,1.69
669,April,2020,Arlington,VA,Passenger,0,2,2,150,152,1.32
670,April,2020,Oldham,KY,Passenger,0,1,1,4,5,20.0
671,April,2020,Chelan,WA,Truck,0,0,0,22460,22460,0.0
672,April,2020,Valencia,NM,Passenger,1,0,1,5,6,16.67
673,April,2020,Washington,OR,Passenger,1,0,1,446,447,0.22
674,April,2020,Clallam,WA,Passenger,219,166,385,50341,50726,0.76
675,April,2020,District of Columbia,DC,Passenger,1,1,2,202,204,0.98
676,April,2020,Richland,SC,Passenger,0,1,1,156,157,0.64
677,April,2020,Clark,WA,Passenger,1992,1056,3048,318746,321794,0.95
678,April,2020,Washtenaw,MI,Passenger,1,0,1,36,37,2.7
679,April,2020,Cowlitz,WA,Passenger,136,115,251,72718,72969,0.34
680,April,2020,Skagit,WA,Truck,1,0,1,32387,32388,0.0
681,April,2020,Fort Bend,TX,Passenger,1,0,1,46,47,2.13
682,April,2020,Riverside,CA,Passenger,3,1,4,629,633,0.63
683,April,2020,Jefferson,WA,Passenger,234,142,376,24908,25284,1.49
684,April,2020,Middlesex,MA,Passenger,1,1,2,96,98,2.04
685,April,2020,Spartanburg,SC,Passenger,0,1,1,49,50,2.0
686,April,2020,Charles,MD,Passenger,0,1,1,74,75,1.33
687,April,2020,Skamania,WA,Passenger,29,17,46,8615,8661,0.53
688,April,2020,Stevens,WA,Truck,0,0,0,18611,18611,0.0
689,April,2020,Tulsa,OK,Passenger,1,1,2,43,45,4.44
690,April,2020,Polk,FL,Passenger,1,0,1,65,66,1.52
691,April,2020,Spokane,WA,Truck,1,0,1,97398,97399,0.0
692,April,2020,King,WA,Truck,5,1,6,181518,181524,0.0
693,April,2020,Denver,CO,Passenger,1,0,1,120,121,0.83
694,April,2020,Guadalupe,TX,Passenger,1,0,1,65,66,1.52
695,April,2020,Garfield,WA,Passenger,0,1,1,1341,1342,0.07
696,April,2020,Boone,MO,Passenger,0,1,1,12,13,7.69
697,April,2020,Anne Arundel,MD,Passenger,0,1,1,415,416,0.24
698,April,2020,Pierce,WA,Truck,0,0,0,141140,141140,0.0
699,April,2020,Ferry,WA,Truck,0,0,0,3543,3543,0.0
700,April,2020,Los Angeles,CA,Passenger,7,11,18,1001,1019,1.77
701,April,2020,Harris,TX,Passenger,1,0,1,233,234,0.43
702,April,2020,Ada,ID,Passenger,0,1,1,282,283,0.35
703,April,2020,Harrison,MS,Passenger,1,0,1,57,58,1.72
704,April,2020,Maui,HI,Passenger,1,0,1,34,35,2.86
705,April,2020,Walla Walla,WA,Passenger,69,63,132,36000,36132,0.37
706,April,2020,Lake,FL,Passenger,1,0,1,20,21,4.76
707,April,2020,Osceola,FL,Passenger,1,0,1,41,42,2.38
708,April,2020,Orange,CA,Passenger,7,2,9,493,502,1.79
709,April,2020,Thurston,WA,Truck,0,0,0,55499,55499,0.0
710,April,2020,San Juan,WA,Truck,0,0,0,5898,5898,0.0
711,April,2020,Carroll,NH,Passenger,0,1,1,4,5,20.0
712,April,2020,Richmond,GA,Passenger,0,1,1,86,87,1.15
713,April,2020,Grant,WA,Truck,0,0,0,26995,26995,0.0
714,April,2020,Penobscot,ME,Passenger,0,1,1,15,16,6.25
715,April,2020,Okanogan,WA,Passenger,34,31,65,25891,25956,0.25
716,April,2020,Harnett,NC,Passenger,1,0,1,201,202,0.5
717,April,2020,Stevens,WA,Passenger,33,33,66,30969,31035,0.21
718,April,2020,St. Mary's,MD,Passenger,1,0,1,217,218,0.46
719,April,2020,Deschutes,OR,Passenger,3,0,3,139,142,2.11
720,April,2020,Hamilton,IN,Passenger,1,0,1,40,41,2.44
721,April,2020,Kittitas,WA,Passenger,101,49,150,29857,30007,0.5
722,April,2020,Tuolumne,CA,Passenger,0,1,1,10,11,9.09
723,April,2020,Klamath,OR,Passenger,1,0,1,34,35,2.86
724,April,2020,San Mateo,CA,Passenger,0,1,1,116,117,0.85
725,April,2020,Jones,GA,Passenger,1,0,1,1,2,50.0
726,April,2020,Island,WA,Truck,1,0,1,21149,21150,0.0
727,April,2020,Clark,NV,Passenger,3,2,5,674,679,0.74
728,April,2020,Okanogan,WA,Truck,0,0,0,16384,16384,0.0
729,April,2020,Broward,FL,Passenger,3,1,4,115,119,3.36
730,April,2020,Mason,WA,Passenger,155,135,290,47212,47502,0.61
731,April,2020,Jefferson,CO,Passenger,0,1,1,58,59,1.69
732,April,2020,Lee,FL,Passenger,1,0,1,51,52,1.92
733,April,2020,Pacific,WA,Passenger,30,34,64,15837,15901,0.4
734,April,2020,Bexar,TX,Passenger,2,5,7,613,620,1.13
735,April,2020,Hennepin,MN,Passenger,3,1,4,90,94,4.26
736,April,2020,Clackamas,OR,Passenger,2,0,2,201,203,0.99
737,April,2020,Randolph,NC,Passenger,1,0,1,7,8,12.5
738,April,2020,San Francisco,CA,Passenger,2,1,3,98,101,2.97
739,April,2020,Ulster,NY,Passenger,1,0,1,8,9,11.11
740,April,2020,Cochise,AZ,Passenger,0,1,1,101,102,0.98
742,April,2020,DeKalb,IN,Passenger,1,0,1,1,2,50.0
743,April,2020,Kootenai,ID,Passenger,1,0,1,225,226,0.44
744,April,2020,Chelan,WA,Passenger,224,80,304,54232,54536,0.56
745,April,2020,Loudoun,VA,Passenger,1,0,1,89,90,1.11
746,April,2020,Alameda,CA,Passenger,3,1,4,277,281,1.42
747,April,2020,Benton,WA,Truck,0,0,0,42485,42485,0.0
748,April,2020,Williamson,TX,Passenger,0,2,2,139,141,1.42
749,April,2020,Cape May,NJ,Passenger,0,1,1,13,14,7.14
750,April,2020,Lewis,WA,Passenger,99,106,205,58652,58857,0.35
751,April,2020,Pacific,WA,Truck,0,0,0,7665,7665,0.0
752,April,2020,Queens,NY,Passenger,1,0,1,53,54,1.85
753,April,2020,Fulton,GA,Passenger,1,2,3,104,107,2.8
754,April,2020,Kent,MI,Passenger,0,1,1,23,24,4.17
755,April,2020,Clallam,WA,Truck,1,0,1,21696,21697,0.0
756,April,2020,Allegheny,PA,Passenger,1,0,1,74,75,1.33
757,April,2020,Bucks,PA,Passenger,1,0,1,20,21,4.76
758,April,2020,Chesapeake,VA,Passenger,0,2,2,422,424,0.47
759,April,2020,Island,WA,Passenger,405,270,675,62863,63538,1.06
760,April,2020,Franklin,WA,Truck,0,0,0,19844,19844,0.0
761,April,2020,St. Louis,MO,Passenger,1,0,1,99,100,1.0
762,April,2020,Rogers,OK,Passenger,1,0,1,5,6,16.67
763,April,2020,Charleston,SC,Passenger,1,0,1,105,106,0.94
764,April,2020,Multnomah,OR,Passenger,4,7,11,721,732,1.5
765,April,2020,Wahkiakum,WA,Truck,0,0,0,1760,1760,0.0
766,April,2020,Norfolk,VA,Passenger,2,2,4,347,351,1.14
767,April,2020,Carson City,NV,Passenger,1,0,1,11,12,8.33
768,April,2020,Clay,FL,Passenger,0,1,1,80,81,1.23
769,April,2020,Skamania,WA,Truck,0,0,0,4054,4054,0.0
770,April,2020,Grays Harbor,WA,Truck,0,0,0,20728,20728,0.0
771,April,2020,Erie,NY,Passenger,1,0,1,44,45,2.22
772,April,2020,Arapahoe,CO,Passenger,1,0,1,136,137,0.73
773,April,2020,Suffolk,MA,Passenger,0,2,2,36,38,5.26
774,April,2020,Santa Cruz,CA,Passenger,1,0,1,37,38,2.63
775,April,2020,Sacramento,CA,Passenger,1,0,1,268,269,0.37
776,April,2020,Whitman,WA,Truck,0,0,0,8532,8532,0.0
777,April,2020,Grant,WA,Passenger,59,71,130,65268,65398,0.2
778,April,2020,Santa Clara,CA,Passenger,7,2,9,318,327,2.75
779,April,2020,Vigo,IN,Passenger,1,0,1,5,6,16.67
780,April,2020,Solano,CA,Passenger,1,0,1,211,212,0.47
781,April,2020,Montgomery,TX,Passenger,1,0,1,52,53,1.89
782,April,2020,El Paso,CO,Passenger,2,0,2,722,724,0.28
783,April,2020,Twin Falls,ID,Passenger,0,1,1,28,29,3.45
784,April,2020,Thurston,WA,Passenger,1141,730,1871,197497,199368,0.94
785,April,2020,Lincoln,WA,Truck,0,0,0,4627,4627,0.0
786,April,2020,Pima,AZ,Passenger,3,1,4,351,355,1.13
787,April,2020,Kitsap,WA,Passenger,1312,676,1988,180568,182556,1.09
788,April,2020,Suffolk,VA,Passenger,1,0,1,126,127,0.79
789,April,2020,Walla Walla,WA,Truck,0,0,0,13622,13622,0.0
790,April,2020,Douglas,WA,Truck,0,0,0,12271,12271,0.0
791,April,2020,Cumberland,NC,Passenger,0,2,2,471,473,0.42
792,April,2020,Snohomish,WA,Truck,0,0,0,123316,123316,0.0
793,April,2020,Columbia,WA,Passenger,3,3,6,2407,2413,0.25
794,April,2020,Sedgwick,KS,Passenger,1,1,2,93,95,2.11
795,April,2020,Honolulu,HI,Passenger,4,2,6,457,463,1.3
796,April,2020,Boulder,CO,Passenger,0,1,1,46,47,2.13
797,April,2020,Pend Oreille,WA,Passenger,8,6,14,9257,9271,0.15
798,April,2020,Franklin,WA,Passenger,58,76,134,60733,60867,0.22
799,April,2020,Nueces,TX,Passenger,1,0,1,82,83,1.2
800,April,2020,Brevard,FL,Passenger,0,1,1,86,87,1.15
801,April,2020,Larimer,CO,Passenger,1,0,1,52,53,1.89
802,April,2020,Douglas,NE,Passenger,0,1,1,55,56,1.79
803,April,2020,Asotin,WA,Passenger,16,12,28,12444,12472,0.22
804,April,2020,Douglas,WA,Passenger,69,40,109,28017,28126,0.39
805,April,2020,Lake,IL,Passenger,1,0,1,164,165,0.61
806,April,2020,Travis,TX,Passenger,2,1,3,183,186,1.61
807,April,2020,Calvert,MD,Passenger,0,2,2,89,91,2.2
808,April,2020,Jefferson,WA,Truck,0,0,0,9531,9531,0.0
809,April,2020,Fairfax,VA,Passenger,4,3,7,740,747,0.94
810,April,2020,Portsmouth,VA,Passenger,0,1,1,79,80,1.25
811,April,2020,Washoe,NV,Passenger,1,0,1,106,107,0.93
812,April,2020,Howard,MD,Passenger,0,1,1,71,72,1.39
813,April,2020,Bartow,GA,Passenger,0,1,1,3,4,25.0
814,April,2020,Adams,WA,Passenger,7,7,14,12756,12770,0.11
815,April,2020,Sarasota,FL,Passenger,2,0,2,24,26,7.69
816,April,2020,Skagit,WA,Passenger,397,215,612,91480,92092,0.66
817,April,2020,Jefferson,NY,Passenger,0,1,1,212,213,0.47
818,April,2020,San Joaquin,CA,Passenger,1,0,1,130,131,0.76
819,April,2020,RÃ­o Grande,PR,Passenger,1,0,1,1,2,50.0
820,April,2020,Whatcom,WA,Passenger,1058,490,1548,150136,151684,1.02
821,April,2020,Fairbanks North Star,AK,Passenger,0,1,1,98,99,1.01
822,April,2020,Stafford,VA,Passenger,1,1,2,90,92,2.17
823,April,2020,New London,CT,Passenger,1,2,3,243,246,1.22
824,April,2020,Kern,CA,Passenger,0,1,1,225,226,0.44
825,April,2020,Kittitas,WA,Truck,0,0,0,14593,14593,0.0
826,April,2020,Saginaw,MI,Passenger,1,0,1,10,11,9.09
827,April,2020,Dakota,MN,Passenger,0,1,1,32,33,3.03
828,April,2020,Maricopa,AZ,Passenger,7,6,13,1447,1460,0.89
829,April,2020,Albemarle,VA,Passenger,1,0,1,21,22,4.55
830,April,2020,Lewis,WA,Truck,0,0,0,25979,25979,0.0
831,April,2020,Gwinnett,GA,Passenger,1,0,1,73,74,1.35
832,April,2020,Powhatan,VA,Passenger,1,0,1,0,1,100.0
833,April,2020,Wilson,TX,Passenger,0,1,1,7,8,12.5
834,April,2020,Yakima,WA,Truck,0,0,0,59516,59516,0.0
835,April,2020,Goochland,VA,Passenger,2,1,3,258,261,1.15
836,April,2020,Oklahoma,OK,Passenger,0,1,1,126,127,0.79
837,April,2020,Contra Costa,CA,Passenger,3,2,5,322,327,1.53
838,April,2020,Clark,WA,Truck,0,0,0,81837,81837,0.0
839,April,2020,Snohomish,WA,Passenger,4400,1751,6151,535202,541353,1.14
840,April,2020,Owyhee,ID,Passenger,1,0,1,3,4,25.0
841,April,2020,Flathead,MT,Passenger,1,0,1,63,64,1.56
842,April,2020,Grays Harbor,WA,Passenger,106,110,216,48072,48288,0.45
843,April,2020,Lincoln,WA,Passenger,4,12,16,7676,7692,0.21
844,April,2020,Klickitat,WA,Passenger,53,41,94,15425,15519,0.61
845,April,2020,Whatcom,WA,Truck,3,0,3,42832,42835,0.01
846,April,2020,Pinal,AZ,Passenger,1,0,1,185,186,0.54
847,April,2020,San Juan,WA,Passenger,295,88,383,14157,14540,2.63
848,April,2021,Thurston,WA,Truck,0,0,0,56710,56710,0.0
849,April,2021,Snohomish,WA,Truck,1,0,1,126400,126401,0.0
850,April,2021,Skagit,WA,Truck,1,0,1,33024,33025,0.0
851,April,2021,Carroll,MD,Passenger,0,1,1,18,19,5.26
852,April,2021,Jones,GA,Passenger,1,0,1,1,2,50.0
853,April,2021,Dakota,MN,Passenger,0,1,1,25,26,3.85
854,April,2021,Douglas,CO,Passenger,0,1,1,76,77,1.3
855,April,2021,Utah,UT,Passenger,0,1,1,119,120,0.83
856,April,2021,Clackamas,OR,Passenger,2,0,2,176,178,1.12
857,April,2021,Saginaw,MI,Passenger,2,0,2,10,12,16.67
858,April,2021,Boone,MO,Passenger,0,1,1,9,10,10.0
859,April,2021,Charleston,SC,Passenger,2,0,2,85,87,2.3
860,April,2021,Douglas,WA,Passenger,88,46,134,28472,28606,0.47
861,April,2021,Columbia,WA,Truck,0,0,0,1560,1560,0.0
862,April,2021,Sumter,FL,Passenger,0,1,1,10,11,9.09
863,April,2021,Walla Walla,WA,Passenger,108,71,179,36527,36706,0.49
864,April,2021,District of Columbia,DC,Passenger,4,1,5,194,199,2.51
865,April,2021,Salt Lake,UT,Passenger,0,1,1,171,172,0.58
866,April,2021,Harrison,MS,Passenger,2,0,2,50,52,3.85
867,April,2021,Pend Oreille,WA,Passenger,14,5,19,9302,9321,0.2
868,April,2021,Bexar,TX,Passenger,4,5,9,538,547,1.65
869,April,2021,Ventura,CA,Passenger,1,1,2,265,267,0.75
870,April,2021,Santa Clara,CA,Passenger,8,2,10,260,270,3.7
871,April,2021,Spartanburg,SC,Passenger,0,1,1,51,52,1.92
872,April,2021,Montgomery,MD,Passenger,1,0,1,228,229,0.44
873,April,2021,Grays Harbor,WA,Truck,0,0,0,21415,21415,0.0
874,April,2021,Louisa,VA,Passenger,0,1,1,1,2,50.0
875,April,2021,Boulder,CO,Passenger,0,1,1,46,47,2.13
876,April,2021,Jefferson,NY,Passenger,0,1,1,211,212,0.47
877,April,2021,Chelan,WA,Truck,0,0,0,23068,23068,0.0
878,April,2021,New York,NY,Passenger,1,0,1,47,48,2.08
879,April,2021,Nassau,FL,Passenger,1,0,1,32,33,3.03
880,April,2021,Island,WA,Truck,0,0,0,21561,21561,0.0
881,April,2021,Prince William,VA,Passenger,1,1,2,213,215,0.93
882,April,2021,Norfolk,VA,Passenger,2,3,5,324,329,1.52
883,April,2021,Asotin,WA,Passenger,19,14,33,12659,12692,0.26
884,April,2021,Arapahoe,CO,Passenger,1,0,1,116,117,0.85
885,April,2021,Whatcom,WA,Truck,4,0,4,43870,43874,0.01
886,April,2021,Stevens,WA,Truck,0,0,0,18874,18874,0.0
887,April,2021,Manassas,VA,Passenger,0,1,1,6,7,14.29
888,April,2021,Okaloosa,FL,Passenger,0,1,1,124,125,0.8
889,April,2021,Lewis,WA,Truck,0,0,0,26910,26910,0.0
890,April,2021,Prince George's,MD,Passenger,2,1,3,142,145,2.07
891,April,2021,Sarasota,FL,Passenger,2,0,2,27,29,6.9
892,April,2021,Philadelphia,PA,Passenger,1,0,1,51,52,1.92
893,April,2021,RÃ­o Grande,PR,Passenger,1,0,1,1,2,50.0
894,April,2021,Kittitas,WA,Passenger,153,58,211,29983,30194,0.7
895,April,2021,Whatcom,WA,Passenger,1355,582,1937,151158,153095,1.27
896,April,2021,Camden,NJ,Passenger,0,1,1,15,16,6.25
897,April,2021,Pima,AZ,Passenger,2,1,3,290,293,1.02
898,April,2021,Asotin,WA,Truck,0,0,0,6769,6769,0.0
899,April,2021,Anchorage,AK,Passenger,1,0,1,141,142,0.7
900,April,2021,Polk,FL,Passenger,1,0,1,54,55,1.82
901,April,2021,Wilson,TX,Passenger,0,1,1,3,4,25.0
902,April,2021,Harris,TX,Passenger,1,1,2,200,202,0.99
903,April,2021,Thurston,WA,Passenger,1494,834,2328,198087,200415,1.16
904,April,2021,Anne Arundel,MD,Passenger,4,2,6,393,399,1.5
905,April,2021,Hudson,NJ,Passenger,1,0,1,43,44,2.27
906,April,2021,El Paso,CO,Passenger,3,0,3,683,686,0.44
907,April,2021,Suffolk,MA,Passenger,0,2,2,33,35,5.71
908,April,2021,Sedgwick,KS,Passenger,1,1,2,86,88,2.27
909,April,2021,Rockingham,NH,Passenger,1,0,1,23,24,4.17
910,April,2021,Howard,MD,Passenger,0,1,1,63,64,1.56
911,April,2021,Owyhee,ID,Passenger,1,0,1,3,4,25.0
912,April,2021,Douglas,NE,Passenger,1,1,2,50,52,3.85
913,April,2021,San Mateo,CA,Passenger,1,1,2,102,104,1.92
914,April,2021,Richland,SC,Passenger,0,1,1,139,140,0.71
915,April,2021,Portsmouth,VA,Passenger,0,1,1,78,79,1.27
916,April,2021,Hampshire,MA,Passenger,1,0,1,6,7,14.29
917,April,2021,Danville,VA,Passenger,1,0,1,0,1,100.0
918,April,2021,Allegheny,PA,Passenger,1,1,2,64,66,3.03
919,April,2021,Carroll,NH,Passenger,0,1,1,5,6,16.67
920,April,2021,Carson City,NV,Passenger,1,0,1,11,12,8.33
921,April,2021,Pierce,WA,Passenger,3272,1903,5175,559851,565026,0.92
922,April,2021,Bartow,GA,Passenger,0,1,1,4,5,20.0
923,April,2021,Klamath,OR,Passenger,1,0,1,31,32,3.12
924,April,2021,Richmond,NY,Passenger,1,0,1,8,9,11.11
925,April,2021,Nassau,NY,Passenger,4,0,4,26,30,13.33
926,April,2021,Franklin,WA,Passenger,109,95,204,61946,62150,0.33
927,April,2021,Los Angeles,CA,Passenger,10,11,21,903,924,2.27
928,April,2021,Klickitat,WA,Truck,0,0,0,8248,8248,0.0
929,April,2021,Jefferson,WA,Truck,0,0,0,9623,9623,0.0
930,April,2021,Skagit,WA,Passenger,562,268,830,91975,92805,0.89
931,April,2021,Larimer,CO,Passenger,1,0,1,52,53,1.89
933,April,2021,Yamhill,OR,Passenger,1,0,1,37,38,2.63
934,April,2021,Leavenworth,KS,Passenger,0,1,1,119,120,0.83
935,April,2021,Houston,GA,Passenger,1,0,1,50,51,1.96
936,April,2021,Greene,MO,Passenger,0,1,1,31,32,3.12
937,April,2021,Placer,CA,Passenger,2,0,2,79,81,2.47
938,April,2021,Hamilton,IN,Passenger,2,0,2,34,36,5.56
939,April,2021,Pend Oreille,WA,Truck,0,0,0,5738,5738,0.0
940,April,2021,Collin,TX,Passenger,1,1,2,115,117,1.71
941,April,2021,Stafford,VA,Passenger,2,1,3,99,102,2.94
942,April,2021,Riverside,CA,Passenger,5,1,6,567,573,1.05
943,April,2021,Hennepin,MN,Passenger,2,0,2,78,80,2.5
944,April,2021,Grays Harbor,WA,Passenger,156,134,290,49368,49658,0.58
945,April,2021,Okanogan,WA,Truck,0,0,0,16751,16751,0.0
946,April,2021,Sacramento,CA,Passenger,2,0,2,227,229,0.87
947,April,2021,Bucks,PA,Passenger,1,0,1,17,18,5.56
948,April,2021,Kings,NY,Passenger,1,0,1,67,68,1.47
949,April,2021,San Diego,CA,Passenger,16,6,22,2633,2655,0.83
950,April,2021,Pennington,SD,Passenger,1,0,1,32,33,3.03
951,April,2021,Milwaukee,WI,Passenger,1,0,1,38,39,2.56
952,April,2021,DeKalb,GA,Passenger,1,0,1,62,63,1.59
953,April,2021,Garfield,WA,Passenger,0,2,2,1376,1378,0.15
954,April,2021,Montgomery,TX,Passenger,1,1,2,43,45,4.44
955,April,2021,Alameda,CA,Passenger,3,0,3,243,246,1.22
956,April,2021,Montgomery,OH,Passenger,0,1,1,57,58,1.72
957,April,2021,Walla Walla,WA,Truck,0,0,0,14047,14047,0.0
958,April,2021,Fort Bend,TX,Passenger,1,0,1,39,40,2.5
959,April,2021,Gwinnett,GA,Passenger,1,0,1,66,67,1.49
960,April,2021,Vigo,IN,Passenger,1,0,1,5,6,16.67
961,April,2021,Missoula,MT,Passenger,1,0,1,61,62,1.61
962,April,2021,Contra Costa,CA,Passenger,3,4,7,278,285,2.46
963,April,2021,Cape May,NJ,Passenger,0,1,1,8,9,11.11
964,April,2021,Yakima,WA,Truck,0,0,0,61656,61656,0.0
965,April,2021,Lee,FL,Passenger,1,0,1,38,39,2.56
966,April,2021,King,WA,Truck,6,1,7,184931,184938,0.0
967,April,2021,Orange,CA,Passenger,4,3,7,434,441,1.59
968,April,2021,DuPage,IL,Passenger,2,0,2,55,57,3.51
969,April,2021,St. Louis,MO,Passenger,1,0,1,88,89,1.12
970,April,2021,King,WA,Passenger,29460,8753,38213,1369496,1407709,2.71
971,April,2021,Benton,WA,Passenger,496,377,873,136100,136973,0.64
972,April,2021,Benton,WA,Truck,0,0,0,43685,43685,0.0
973,April,2021,Denver,CO,Passenger,1,0,1,113,114,0.88
974,April,2021,Adams,WA,Truck,0,0,0,5406,5406,0.0
975,April,2021,Middlesex,MA,Passenger,1,1,2,92,94,2.13
976,April,2021,Franklin,WA,Truck,0,0,0,20683,20683,0.0
977,April,2021,Yakima,WA,Passenger,206,139,345,169220,169565,0.2
978,April,2021,Jefferson,WA,Passenger,310,178,488,24904,25392,1.92
979,April,2021,San Francisco,CA,Passenger,1,1,2,89,91,2.2
980,April,2021,San Juan,WA,Passenger,406,125,531,14147,14678,3.62
981,April,2021,Fulton,GA,Passenger,0,1,1,80,81,1.23
982,April,2021,Howard,IN,Passenger,0,1,1,3,4,25.0
983,April,2021,Adams,WA,Passenger,11,9,20,13054,13074,0.15
984,April,2021,Rogers,OK,Passenger,1,0,1,3,4,25.0
985,April,2021,Powhatan,VA,Passenger,1,0,1,1,2,50.0
986,April,2021,Cumberland,NC,Passenger,0,2,2,432,434,0.46
987,April,2021,Ferry,WA,Passenger,10,3,13,4406,4419,0.29
988,April,2021,New Haven,CT,Passenger,0,2,2,31,33,6.06
989,April,2021,St. Mary's,MD,Passenger,1,0,1,211,212,0.47
990,April,2021,Miami-Dade,FL,Passenger,1,0,1,97,98,1.02
991,April,2021,Kauai,HI,Passenger,1,0,1,16,17,5.88
992,April,2021,San Joaquin,CA,Passenger,1,0,1,105,106,0.94
993,April,2021,Island,WA,Passenger,582,308,890,63254,64144,1.39
994,April,2021,Shelby,OH,Passenger,0,1,1,1,2,50.0
995,April,2021,Monterey,CA,Passenger,0,1,1,147,148,0.68
996,April,2021,New London,CT,Passenger,1,2,3,223,226,1.33
997,April,2021,Plaquemines,LA,Passenger,0,1,1,16,17,5.88
998,April,2021,Cowlitz,WA,Passenger,211,134,345,72518,72863,0.47
999,April,2021,Tulsa,OK,Passenger,1,0,1,41,42,2.38
1000,April,2021,Lake,IL,Passenger,2,0,2,153,155,1.29
1001,April,2021,Clallam,WA,Passenger,309,206,515,50403,50918,1.01
1002,April,2021,Mason,WA,Passenger,191,134,325,48096,48421,0.67
1003,April,2021,Calvert,MD,Passenger,0,2,2,87,89,2.25
1004,April,2021,Frederick,MD,Passenger,1,1,2,70,72,2.78
1005,April,2021,Klickitat,WA,Passenger,67,47,114,15186,15300,0.75
1006,April,2021,Ramsey,MN,Passenger,1,0,1,30,31,3.23
1007,April,2021,Travis,TX,Passenger,2,3,5,160,165,3.03
1008,April,2021,Columbia,WA,Passenger,5,4,9,2478,2487,0.36
1009,April,2021,Williamson,TX,Passenger,0,2,2,111,113,1.77
1010,April,2021,Whitman,WA,Passenger,59,44,103,21991,22094,0.47
1011,April,2021,Multnomah,OR,Passenger,2,5,7,656,663,1.06
1012,April,2021,Sevier,AR,Passenger,0,1,1,0,1,100.0
1013,April,2021,Wahkiakum,WA,Truck,0,0,0,1806,1806,0.0
1014,April,2021,Putnam,TN,Passenger,0,1,1,0,1,100.0
1015,April,2021,Wichita,TX,Passenger,1,0,1,41,42,2.38
1016,April,2021,Loudoun,VA,Passenger,1,0,1,72,73,1.37
1017,April,2021,Montgomery,PA,Passenger,1,0,1,24,25,4.0
1018,April,2021,Moore,NC,Passenger,0,1,1,135,136,0.74
1019,April,2021,Skamania,WA,Passenger,40,30,70,8366,8436,0.83
1020,April,2021,Deschutes,OR,Passenger,1,0,1,116,117,0.85
1021,April,2021,Douglas,WA,Truck,0,0,0,12625,12625,0.0
1022,April,2021,Erie,NY,Passenger,1,0,1,39,40,2.5
1023,April,2021,Cowlitz,WA,Truck,0,0,0,29173,29173,0.0
1024,April,2021,Kitsap,WA,Passenger,1733,814,2547,180539,183086,1.39
1025,April,2021,Penobscot,ME,Passenger,0,1,1,9,10,10.0
1026,April,2021,Grant,WA,Passenger,102,86,188,66806,66994,0.28
1027,April,2021,Burlington,NJ,Passenger,0,1,1,133,134,0.75
1028,April,2021,Lincoln,WA,Truck,0,0,0,4751,4751,0.0
1029,April,2021,Clallam,WA,Truck,1,0,1,21992,21993,0.0
1030,April,2021,Garfield,WA,Truck,0,0,0,1007,1007,0.0
1031,April,2021,Fairbanks North Star,AK,Passenger,0,1,1,82,83,1.2
1032,April,2021,Lane,OR,Passenger,0,1,1,127,128,0.78
1033,April,2021,Alexandria,VA,Passenger,2,0,2,134,136,1.47
1034,April,2021,Stevens,WA,Passenger,40,43,83,30581,30664,0.27
1035,April,2021,Richmond,GA,Passenger,0,1,1,75,76,1.32
1036,April,2021,Pinellas,FL,Passenger,1,1,2,93,95,2.11
1037,April,2021,Pacific,WA,Truck,0,0,0,7919,7919,0.0
1038,April,2021,Goochland,VA,Passenger,4,2,6,232,238,2.52
1039,April,2021,Oldham,KY,Passenger,0,1,1,4,5,20.0
1040,April,2021,Pierce,WA,Truck,0,0,0,145966,145966,0.0
1041,April,2021,Spokane,WA,Truck,0,0,0,101932,101932,0.0
1042,April,2021,Platte,MO,Passenger,1,0,1,18,19,5.26
1043,April,2021,Fresno,CA,Passenger,1,0,1,170,171,0.58
1044,April,2021,San Juan,WA,Truck,0,0,0,5911,5911,0.0
1045,April,2021,Lewis,WA,Passenger,146,135,281,59779,60060,0.47
1046,April,2021,Duval,FL,Passenger,0,2,2,341,343,0.58
1047,April,2021,Maui,HI,Passenger,1,0,1,27,28,3.57
1048,April,2021,Chelan,WA,Passenger,314,93,407,54673,55080,0.74
1049,April,2021,Kittitas,WA,Truck,0,0,0,14775,14775,0.0
1050,April,2021,Dallas,TX,Passenger,1,0,1,163,164,0.61
1051,April,2021,Wahkiakum,WA,Passenger,11,6,17,3113,3130,0.54
1052,April,2021,El Paso,TX,Passenger,3,0,3,377,380,0.79
1053,April,2021,Albemarle,VA,Passenger,1,0,1,20,21,4.76
1054,April,2021,Suffolk,VA,Passenger,1,0,1,127,128,0.78
1055,April,2021,Chesapeake,VA,Passenger,0,3,3,391,394,0.76
1056,April,2021,Hawaii,HI,Passenger,1,0,1,48,49,2.04
1057,April,2021,Mason,WA,Truck,0,0,0,21291,21291,0.0
1058,April,2021,Skamania,WA,Truck,0,0,0,4022,4022,0.0
1059,April,2021,Flathead,MT,Passenger,1,0,1,43,44,2.27
1060,April,2021,Clark,NV,Passenger,4,2,6,632,638,0.94
1061,April,2021,Randolph,NC,Passenger,1,0,1,7,8,12.5
1062,April,2021,Pacific,WA,Passenger,41,41,82,16071,16153,0.51
1063,April,2021,Williams,ND,Passenger,0,1,1,9,10,10.0
1064,April,2021,Kern,CA,Passenger,0,1,1,213,214,0.47
1065,April,2021,El Dorado,CA,Passenger,1,0,1,31,32,3.12
1066,April,2021,Lincoln,WA,Passenger,5,13,18,7751,7769,0.23
1067,April,2021,Whitman,WA,Truck,0,0,0,8564,8564,0.0
1068,April,2021,Broward,FL,Passenger,1,0,1,105,106,0.94
1069,April,2021,Clark,WA,Passenger,2681,1330,4011,321630,325641,1.23
1070,April,2021,Orange,FL,Passenger,1,0,1,112,113,0.88
1071,April,2021,Harnett,NC,Passenger,1,1,2,174,176,1.14
1072,April,2021,Okanogan,WA,Passenger,60,36,96,26414,26510,0.36
1073,April,2021,St. Clair,IL,Passenger,1,0,1,135,136,0.74
1074,April,2021,Juneau,AK,Passenger,0,1,1,26,27,3.7
1075,April,2021,Lake,FL,Passenger,1,0,1,22,23,4.35
1076,April,2021,Virginia Beach,VA,Passenger,3,0,3,621,624,0.48
1077,April,2021,Bradley,TN,Passenger,1,0,1,0,1,100.0
1078,April,2021,Queens,NY,Passenger,2,0,2,49,51,3.92
1079,April,2021,Maricopa,AZ,Passenger,5,4,9,1211,1220,0.74
1080,April,2021,Fairfax,VA,Passenger,4,4,8,693,701,1.14
1081,April,2021,Sumter,SC,Passenger,0,1,1,39,40,2.5
1082,April,2021,Santa Cruz,CA,Passenger,1,0,1,26,27,3.7
1083,April,2021,Clark,WA,Truck,0,0,0,84198,84198,0.0
1084,April,2021,Grant,WA,Truck,0,0,0,27879,27879,0.0
1085,April,2021,Spokane,WA,Passenger,1000,611,1611,324879,326490,0.49
1086,April,2021,Ray,MO,Passenger,0,1,1,1,2,50.0
1087,April,2021,Kitsap,WA,Truck,0,0,0,54575,54575,0.0
1088,April,2021,Nueces,TX,Passenger,1,0,1,78,79,1.27
1089,April,2021,Washington,MD,Passenger,1,0,1,12,13,7.69
1090,April,2021,Honolulu,HI,Passenger,5,2,7,402,409,1.71
1091,April,2021,Ferry,WA,Truck,0,0,0,3649,3649,0.0
1092,April,2021,Morris,NJ,Passenger,1,0,1,16,17,5.88
1093,April,2021,Arlington,VA,Passenger,0,1,1,138,139,0.72
1094,April,2021,Washington,OR,Passenger,1,0,1,394,395,0.25
1095,April,2021,Snohomish,WA,Passenger,5588,1967,7555,540438,547993,1.38
1096,April,2021,Allen,IN,Passenger,1,0,1,15,16,6.25
1097,April,2021,Ulster,NY,Passenger,1,0,1,7,8,12.5
1098,April,2021,Charles,MD,Passenger,1,1,2,69,71,2.82
1099,April,2022,Okaloosa,FL,Passenger,0,1,1,99,100,1.0
1100,April,2022,Whitman,WA,Truck,0,0,0,8586,8586,0.0
1101,April,2022,Moore,NC,Passenger,0,1,1,117,118,0.85
1102,April,2022,Prince George's,MD,Passenger,2,1,3,124,127,2.36
1103,April,2022,Anchorage,AK,Passenger,1,0,1,123,124,0.81
1104,April,2022,Harrison,MS,Passenger,2,0,2,44,46,4.35
1105,April,2022,Cowlitz,WA,Truck,0,1,1,28734,28735,0.0
1106,April,2022,Sedgwick,KS,Passenger,1,1,2,78,80,2.5
1107,April,2022,Clackamas,OR,Passenger,2,0,2,146,148,1.35
1108,April,2022,Richmond,GA,Passenger,0,1,1,67,68,1.47
1109,April,2022,New London,CT,Passenger,2,5,7,197,204,3.43
1110,April,2022,Montgomery,AL,Passenger,0,1,1,33,34,2.94
1111,April,2022,Wood,OH,Passenger,0,1,1,4,5,20.0
1112,April,2022,Wichita,TX,Passenger,1,0,1,39,40,2.5
1113,April,2022,Clark,NV,Passenger,4,2,6,529,535,1.12
1114,April,2022,El Paso,TX,Passenger,2,0,2,338,340,0.59
1115,April,2022,Lincoln,OR,Passenger,0,1,1,30,31,3.23
1116,April,2022,Plaquemines,LA,Passenger,1,1,2,16,18,11.11
1117,April,2022,Marin,CA,Passenger,0,1,1,30,31,3.23
1118,April,2022,Rockingham,NH,Passenger,1,0,1,16,17,5.88
1119,April,2022,Fresno,CA,Passenger,1,0,1,142,143,0.7
1120,April,2022,Alameda,CA,Passenger,4,0,4,192,196,2.04
1121,April,2022,Goochland,VA,Passenger,3,2,5,138,143,3.5
1122,April,2022,Hudson,NJ,Passenger,2,0,2,34,36,5.56
1123,April,2022,Denton,TX,Passenger,1,0,1,63,64,1.56
1124,April,2022,Pierce,WA,Truck,3,0,3,143016,143019,0.0
1125,April,2022,Camden,NJ,Passenger,0,1,1,13,14,7.14
1126,April,2022,Leavenworth,KS,Passenger,0,1,1,102,103,0.97
1127,April,2022,St. Mary's,MD,Passenger,1,0,1,192,193,0.52
1128,April,2022,Essex,NJ,Passenger,2,0,2,9,11,18.18
1129,April,2022,Duval,FL,Passenger,0,2,2,282,284,0.7
1130,April,2022,Mason,WA,Passenger,294,178,472,47516,47988,0.98
1131,April,2022,Walla Walla,WA,Passenger,163,92,255,36040,36295,0.7
1132,April,2022,Columbia,WA,Truck,0,0,0,1588,1588,0.0
1133,April,2022,Richmond,NY,Passenger,1,0,1,6,7,14.29
1134,April,2022,Wahkiakum,WA,Truck,0,0,0,1817,1817,0.0
1135,April,2022,Tarrant,TX,Passenger,1,0,1,118,119,0.84
1136,April,2022,Santa Cruz,CA,Passenger,1,0,1,24,25,4.0
1137,April,2022,Manassas,VA,Passenger,0,1,1,7,8,12.5
1138,April,2022,Houston,GA,Passenger,1,0,1,37,38,2.63
1139,April,2022,Bexar,TX,Passenger,4,4,8,442,450,1.78
1140,April,2022,Pennington,SD,Passenger,2,0,2,28,30,6.67
1141,April,2022,Rock Island,IL,Passenger,0,1,1,15,16,6.25
1142,April,2022,Skamania,WA,Truck,0,0,0,3981,3981,0.0
1143,April,2022,Philadelphia,PA,Passenger,1,0,1,35,36,2.78
1144,April,2022,Nassau,NY,Passenger,2,0,2,26,28,7.14
1145,April,2022,Burlington,NJ,Passenger,0,2,2,109,111,1.8
1146,April,2022,Island,WA,Passenger,779,367,1146,62227,63373,1.81
1147,April,2022,Clark,WA,Truck,3,0,3,83236,83239,0.0
1148,April,2022,Cumberland,NC,Passenger,1,2,3,369,372,0.81
1149,April,2022,Chesapeake,VA,Passenger,2,3,5,346,351,1.42
1150,April,2022,Adams,CO,Passenger,1,0,1,37,38,2.63
1151,April,2022,Fairbanks North Star,AK,Passenger,0,1,1,77,78,1.28
1152,April,2022,King,WA,Truck,26,1,27,181794,181821,0.01
1153,April,2022,Pinellas,FL,Passenger,0,1,1,77,78,1.28
1154,April,2022,Orange,FL,Passenger,1,0,1,94,95,1.05
1155,April,2022,Ventura,CA,Passenger,2,1,3,231,234,1.28
1156,April,2022,Sonoma,CA,Passenger,0,1,1,72,73,1.37
1157,April,2022,Honolulu,HI,Passenger,5,4,9,331,340,2.65
1158,April,2022,Columbia,WA,Passenger,7,0,7,2446,2453,0.29
1159,April,2022,Rogers,OK,Passenger,1,0,1,2,3,33.33
1160,April,2022,Randolph,NC,Passenger,1,0,1,5,6,16.67
1161,April,2022,Yakima,WA,Truck,0,0,0,61533,61533,0.0
1162,April,2022,Thurston,WA,Passenger,2073,1015,3088,195014,198102,1.56
1163,April,2022,Pacific,WA,Truck,0,0,0,7978,7978,0.0
1164,April,2022,Miami-Dade,FL,Passenger,1,0,1,84,85,1.18
1165,April,2022,Ferry,WA,Truck,0,0,0,3568,3568,0.0
1166,April,2022,San Diego,CA,Passenger,13,8,21,2307,2328,0.9
1167,April,2022,Benton,WA,Truck,1,0,1,43588,43589,0.0
1168,April,2022,Lewis,WA,Truck,0,0,0,26439,26439,0.0
1169,April,2022,Las Animas,CO,Passenger,1,0,1,1,2,50.0
1170,April,2022,Yakima,WA,Passenger,318,183,501,167415,167916,0.3
1171,April,2022,Chelan,WA,Truck,0,0,0,23067,23067,0.0
1172,April,2022,Arlington,VA,Passenger,1,0,1,129,130,0.77
1173,April,2022,San Juan,WA,Passenger,494,155,649,14128,14777,4.39
1174,April,2022,San Luis Obispo,CA,Passenger,1,0,1,55,56,1.79
1175,April,2022,Skagit,WA,Truck,1,0,1,32485,32486,0.0
1176,April,2022,Wilson,TX,Passenger,0,1,1,2,3,33.33
1177,April,2022,Cowlitz,WA,Passenger,314,172,486,70917,71403,0.68
1178,April,2022,Queens,NY,Passenger,1,0,1,41,42,2.38
1179,April,2022,Stevens,WA,Truck,0,0,0,18994,18994,0.0
1180,April,2022,DuPage,IL,Passenger,1,0,1,45,46,2.17
1181,April,2022,Arapahoe,CO,Passenger,0,1,1,80,81,1.23
1182,April,2022,Walla Walla,WA,Truck,0,0,0,14018,14018,0.0
1183,April,2022,Saratoga,NY,Passenger,1,0,1,38,39,2.56
1184,April,2022,Elmore,ID,Passenger,1,0,1,12,13,7.69
1185,April,2022,Baltimore,MD,Passenger,1,0,1,73,74,1.35
1186,April,2022,Lane,OR,Passenger,0,1,1,98,99,1.01
1187,April,2022,Anne Arundel,MD,Passenger,4,3,7,355,362,1.93
1188,April,2022,Kittitas,WA,Passenger,236,77,313,29746,30059,1.04
1189,April,2022,Platte,MO,Passenger,1,0,1,20,21,4.76
1190,April,2022,Solano,CA,Passenger,1,0,1,160,161,0.62
1191,April,2022,Middlesex,MA,Passenger,1,1,2,80,82,2.44
1192,April,2022,Douglas,WA,Passenger,126,57,183,28526,28709,0.64
1193,April,2022,Boulder,CO,Passenger,1,0,1,34,35,2.86
1194,April,2022,Sarpy,NE,Passenger,1,0,1,51,52,1.92
1195,April,2022,Hidalgo,TX,Passenger,0,1,1,52,53,1.89
1196,April,2022,RÃ­o Grande,PR,Passenger,1,0,1,0,1,100.0
1197,April,2022,Virginia Beach,VA,Passenger,2,0,2,523,525,0.38
1198,April,2022,Franklin,WA,Passenger,179,105,284,62000,62284,0.46
1199,April,2022,St. Clair,IL,Passenger,2,0,2,121,123,1.63
1200,April,2022,Frederick,MD,Passenger,1,1,2,66,68,2.94
1201,April,2022,Grant,WA,Truck,0,0,0,28082,28082,0.0
1202,April,2022,Loudoun,VA,Passenger,2,1,3,64,67,4.48
1203,April,2022,Clallam,WA,Passenger,404,241,645,49821,50466,1.28
1204,April,2022,Adams,WA,Truck,0,0,0,5481,5481,0.0
1205,April,2022,Clallam,WA,Truck,1,0,1,21998,21999,0.0
1206,April,2022,San Joaquin,CA,Passenger,1,1,2,89,91,2.2
1207,April,2022,Spokane,WA,Truck,0,0,0,102417,102417,0.0
1208,April,2022,Carroll,NH,Passenger,0,1,1,5,6,16.67
1209,April,2022,Asotin,WA,Truck,0,0,0,6749,6749,0.0
1210,April,2022,Shelby,OH,Passenger,0,1,1,2,3,33.33
1211,April,2022,St. Louis,MO,Passenger,1,0,1,66,67,1.49
1212,April,2022,Allen,IN,Passenger,1,0,1,13,14,7.14
1213,April,2022,Orange,CA,Passenger,5,2,7,357,364,1.92
1214,April,2022,Juneau,AK,Passenger,0,1,1,29,30,3.33
1215,April,2022,Fairfax,VA,Passenger,5,3,8,612,620,1.29
1216,April,2022,Albemarle,VA,Passenger,1,0,1,17,18,5.56
1217,April,2022,Wahkiakum,WA,Passenger,20,11,31,3079,3110,1.0
1218,April,2022,Wilson,NC,Passenger,1,0,1,0,1,100.0
1219,April,2022,Kittitas,WA,Truck,0,0,0,14715,14715,0.0
1220,April,2022,Dorchester,SC,Passenger,1,0,1,57,58,1.72
1221,April,2022,Broward,FL,Passenger,2,0,2,81,83,2.41
1222,April,2022,Whatcom,WA,Truck,4,0,4,43460,43464,0.01
1223,April,2022,Spokane,WA,Passenger,1511,810,2321,325760,328081,0.71
1224,April,2022,Sumter,SC,Passenger,0,1,1,31,32,3.12
1225,April,2022,Yellowstone,MT,Passenger,0,1,1,26,27,3.7
1226,April,2022,San Mateo,CA,Passenger,2,0,2,78,80,2.5
1227,April,2022,Sevier,AR,Passenger,0,1,1,0,1,100.0
1228,April,2022,Thurston,WA,Truck,3,0,3,55595,55598,0.01
1229,April,2022,Montgomery,PA,Passenger,2,0,2,21,23,8.7
1230,April,2022,Kauai,HI,Passenger,1,0,1,18,19,5.26
1231,April,2022,Bell,TX,Passenger,1,0,1,322,323,0.31
1232,April,2022,Oldham,KY,Passenger,0,1,1,4,5,20.0
1233,April,2022,Hawaii,HI,Passenger,1,0,1,36,37,2.7
1234,April,2022,Lincoln,WA,Passenger,7,18,25,7670,7695,0.32
1235,April,2022,Collin,TX,Passenger,2,0,2,92,94,2.13
1236,April,2022,Lewis,WA,Passenger,232,171,403,59518,59921,0.67
1237,April,2022,Santa Clara,CA,Passenger,9,1,10,217,227,4.41
1238,April,2022,Ray,MO,Passenger,0,1,1,1,2,50.0
1239,April,2022,Chelan,WA,Passenger,447,124,571,54522,55093,1.04
1240,April,2022,Douglas,CO,Passenger,0,1,1,73,74,1.35
1241,April,2022,Kitsap,WA,Passenger,2325,1020,3345,179074,182419,1.83
1242,April,2022,Lincoln,WA,Truck,0,0,0,4851,4851,0.0
1243,April,2022,Hamilton,IN,Passenger,1,0,1,21,22,4.55
1244,April,2022,Skagit,WA,Passenger,752,328,1080,90318,91398,1.18
1245,April,2022,Jefferson,WA,Passenger,415,210,625,24734,25359,2.46
1246,April,2022,San Bernardino,CA,Passenger,1,1,2,335,337,0.59
1247,April,2022,Galveston,TX,Passenger,0,1,1,19,20,5.0
1248,April,2022,Larimer,CO,Passenger,1,0,1,48,49,2.04
1249,April,2022,Williams,ND,Passenger,0,1,1,7,8,12.5
1250,April,2022,Greene,MO,Passenger,0,1,1,23,24,4.17
1251,April,2022,Alexandria,VA,Passenger,3,0,3,107,110,2.73
1252,April,2022,Williamson,TX,Passenger,1,2,3,82,85,3.53
1253,April,2022,King,WA,Passenger,39326,10828,50154,1351160,1401314,3.58
1254,April,2022,Nueces,TX,Passenger,1,1,2,57,59,3.39
1255,April,2022,Hennepin,MN,Passenger,3,0,3,57,60,5.0
1256,April,2022,Placer,CA,Passenger,2,0,2,69,71,2.82
1257,April,2022,Pend Oreille,WA,Passenger,16,10,26,9032,9058,0.29
1258,April,2022,Franklin,WA,Truck,0,0,0,20942,20942,0.0
1259,April,2022,Mason,WA,Truck,0,0,0,21131,21131,0.0
1260,April,2022,New York,NY,Passenger,1,0,1,35,36,2.78
1261,April,2022,Sacramento,CA,Passenger,2,0,2,198,200,1.0
1262,April,2022,El Paso,CO,Passenger,3,1,4,602,606,0.66
1263,April,2022,Fort Bend,TX,Passenger,1,0,1,31,32,3.12
1264,April,2022,Clark,WA,Passenger,3864,1692,5556,317894,323450,1.72
1265,April,2022,Dallas,TX,Passenger,1,0,1,114,115,0.87
1266,April,2022,New Haven,CT,Passenger,0,2,2,28,30,6.67
1267,April,2022,Kitsap,WA,Truck,1,0,1,53850,53851,0.0
1268,April,2022,Hillsborough,FL,Passenger,0,2,2,122,124,1.61
1269,April,2022,Harris,TX,Passenger,2,0,2,146,148,1.35
1270,April,2022,Charleston,SC,Passenger,2,1,3,61,64,4.69
1271,April,2022,Onslow,NC,Passenger,0,1,1,159,160,0.62
1272,April,2022,Whatcom,WA,Passenger,1775,717,2492,149078,151570,1.64
1273,April,2022,Douglas,NE,Passenger,1,2,3,43,46,6.52
1274,April,2022,Okanogan,WA,Passenger,79,48,127,26465,26592,0.48
1275,April,2022,Rockdale,GA,Passenger,1,0,1,8,9,11.11
1276,April,2022,Kings,NY,Passenger,1,0,1,59,60,1.67
1277,April,2022,Whitman,WA,Passenger,83,56,139,22051,22190,0.63
1278,April,2022,Spartanburg,SC,Passenger,0,1,1,40,41,2.44
1279,April,2022,Benton,WA,Passenger,715,446,1161,135499,136660,0.85
1280,April,2022,District of Columbia,DC,Passenger,4,0,4,180,184,2.17
1281,April,2022,Stafford,VA,Passenger,2,1,3,89,92,3.26
1282,April,2022,Owyhee,ID,Passenger,1,0,1,2,3,33.33
1283,April,2022,Charles,MD,Passenger,0,1,1,56,57,1.75
1284,April,2022,Danville,VA,Passenger,1,0,1,0,1,100.0
1285,April,2022,Pima,AZ,Passenger,1,1,2,224,226,0.88
1286,April,2022,Pierce,WA,Passenger,4836,2264,7100,548921,556021,1.28
1287,April,2022,Allegheny,PA,Passenger,1,1,2,53,55,3.64
1288,April,2022,Travis,TX,Passenger,1,0,1,110,111,0.9
1289,April,2022,Grant,WA,Passenger,159,98,257,66893,67150,0.38
1290,April,2022,Cape May,NJ,Passenger,0,1,1,7,8,12.5
1291,April,2022,Washington,MD,Passenger,2,0,2,14,16,12.5
1292,April,2022,Klickitat,WA,Truck,0,0,0,8281,8281,0.0
1293,April,2022,Stevens,WA,Passenger,64,52,116,30125,30241,0.38
1294,April,2022,Howard,IN,Passenger,0,1,1,5,6,16.67
1295,April,2022,Ulster,NY,Passenger,1,0,1,8,9,11.11
1296,April,2022,Suffolk,VA,Passenger,1,0,1,121,122,0.82
1297,April,2022,St. Tammany,LA,Passenger,1,0,1,36,37,2.7
1298,April,2022,Lake,FL,Passenger,1,0,1,20,21,4.76
1299,April,2022,Boone,MO,Passenger,0,1,1,9,10,10.0
1300,April,2022,Norfolk,VA,Passenger,3,3,6,294,300,2.0
1301,April,2022,Howard,MD,Passenger,0,1,1,56,57,1.75
1302,April,2022,Gwinnett,GA,Passenger,1,0,1,50,51,1.96
1303,April,2022,Lee,FL,Passenger,1,0,1,28,29,3.45
1304,April,2022,Sarasota,FL,Passenger,2,0,2,25,27,7.41
1305,April,2022,Maricopa,AZ,Passenger,7,2,9,942,951,0.95
1306,April,2022,Okanogan,WA,Truck,0,0,0,16687,16687,0.0
1307,April,2022,Garfield,WA,Truck,0,0,0,990,990,0.0
1308,April,2022,Carroll,MD,Passenger,0,1,1,15,16,6.25
1309,April,2022,Snohomish,WA,Passenger,7965,2418,10383,534060,544443,1.91
1310,April,2022,Bartow,GA,Passenger,0,1,1,3,4,25.0
1311,April,2022,Skamania,WA,Passenger,67,46,113,8227,8340,1.35
1312,April,2022,Grays Harbor,WA,Passenger,200,158,358,49216,49574,0.72
1313,April,2022,Ferry,WA,Passenger,19,4,23,4406,4429,0.52
1315,April,2022,Kern,CA,Passenger,0,1,1,191,192,0.52
1316,April,2022,Coryell,TX,Passenger,1,0,1,100,101,0.99
1317,April,2022,Prince William,VA,Passenger,0,1,1,196,197,0.51
1318,April,2022,Multnomah,OR,Passenger,0,4,4,546,550,0.73
1319,April,2022,Montgomery,MD,Passenger,4,2,6,193,199,3.02
1320,April,2022,Portsmouth,VA,Passenger,0,1,1,74,75,1.33
1321,April,2022,Los Angeles,CA,Passenger,8,7,15,777,792,1.89
1322,April,2022,Wake,NC,Passenger,1,0,1,90,91,1.1
1323,April,2022,Grays Harbor,WA,Truck,0,0,0,21346,21346,0.0
1324,April,2022,Island,WA,Truck,1,0,1,21467,21468,0.0
1325,April,2022,Harnett,NC,Passenger,2,0,2,140,142,1.41
1326,April,2022,Suffolk,MA,Passenger,0,1,1,22,23,4.35
1327,April,2022,Calvert,MD,Passenger,0,2,2,77,79,2.53
1328,April,2022,Cook,IL,Passenger,3,0,3,187,190,1.58
1329,April,2022,Asotin,WA,Passenger,24,19,43,12707,12750,0.34
1330,April,2022,Hamilton,OH,Passenger,1,0,1,28,29,3.45
1331,April,2022,Jefferson,NY,Passenger,0,1,1,203,204,0.49
1332,April,2022,Riverside,CA,Passenger,7,1,8,471,479,1.67
1333,April,2022,Douglas,WA,Truck,0,0,0,12748,12748,0.0
1334,April,2022,Pend Oreille,WA,Truck,0,0,0,5657,5657,0.0
1335,April,2022,Lake,IL,Passenger,3,0,3,140,143,2.1
1336,April,2022,DeKalb,GA,Passenger,1,0,1,48,49,2.04
1337,April,2022,Richland,SC,Passenger,0,1,1,127,128,0.78
1338,April,2022,Powhatan,VA,Passenger,1,0,1,1,2,50.0
1339,April,2022,Montgomery,TX,Passenger,1,0,1,31,32,3.12
1340,April,2022,Penobscot,ME,Passenger,0,1,1,6,7,14.29
1341,April,2022,Klickitat,WA,Passenger,100,55,155,15247,15402,1.01
1342,April,2022,Kings,CA,Passenger,2,1,3,304,307,0.98
1343,April,2022,Contra Costa,CA,Passenger,0,3,3,255,258,1.16
1344,April,2022,Carson City,NV,Passenger,1,0,1,8,9,11.11
1345,April,2022,Escambia,FL,Passenger,0,1,1,132,133,0.75
1346,April,2022,Salt Lake,UT,Passenger,1,1,2,131,133,1.5
1347,April,2022,Adams,WA,Passenger,16,10,26,12985,13011,0.2
1348,April,2022,Snohomish,WA,Truck,4,0,4,124628,124632,0.0
1349,April,2022,Pacific,WA,Passenger,60,68,128,15938,16066,0.8
1350,April,2022,Jefferson,WA,Truck,0,0,0,9522,9522,0.0
1351,April,2022,Geary,KS,Passenger,1,0,1,86,87,1.15
1352,April,2022,Monterey,CA,Passenger,1,1,2,127,129,1.55
1353,April,2022,Garfield,WA,Passenger,0,3,3,1332,1335,0.22
1354,April,2022,San Juan,WA,Truck,1,0,1,5986,5987,0.02
1355,April,2023,Hamilton,OH,Truck,1,0,1,2,3,33.33
1356,April,2023,Kings,CA,Passenger,2,1,3,264,267,1.12
1357,April,2023,Madison,IL,Passenger,1,0,1,16,17,5.88
1358,April,2023,Frederick,MD,Passenger,1,0,1,52,53,1.89
1359,April,2023,Arlington,VA,Passenger,1,0,1,98,99,1.01
1360,April,2023,Mason,WA,Passenger,417,204,621,46162,46783,1.33
1361,April,2023,Sedgwick,KS,Passenger,1,0,1,52,53,1.89
1362,April,2023,Marin,CA,Passenger,0,1,1,26,27,3.7
1363,April,2023,Denton,TX,Passenger,1,0,1,44,45,2.22
1364,April,2023,Newport News,VA,Passenger,1,0,1,91,92,1.09
1365,April,2023,Leavenworth,KS,Passenger,0,1,1,89,90,1.11
1366,April,2023,Richmond,GA,Passenger,0,1,1,54,55,1.82
1367,April,2023,Sonoma,CA,Passenger,1,1,2,51,53,3.77
1368,April,2023,Oldham,KY,Passenger,0,1,1,4,5,20.0
1369,April,2023,Kittitas,WA,Passenger,328,95,423,29339,29762,1.42
1370,April,2023,Okaloosa,FL,Passenger,0,1,1,85,86,1.16
1371,April,2023,Richmond,NY,Passenger,1,0,1,6,7,14.29
1372,April,2023,Ventura,CA,Passenger,2,1,3,194,197,1.52
1373,April,2023,Benton,OR,Passenger,1,0,1,33,34,2.94
1374,April,2023,Rock Island,IL,Passenger,0,1,1,14,15,6.67
1375,April,2023,Carroll,MD,Passenger,0,1,1,17,18,5.56
1376,April,2023,Wichita,TX,Passenger,2,0,2,30,32,6.25
1377,April,2023,Contra Costa,CA,Passenger,0,3,3,193,196,1.53
1378,April,2023,Wahkiakum,WA,Passenger,27,16,43,3044,3087,1.39
1379,April,2023,St. Louis,MO,Passenger,1,0,1,50,51,1.96
1380,April,2023,King,WA,Passenger,53639,13733,67372,1318485,1385857,4.86
1381,April,2023,Elmore,ID,Passenger,1,0,1,9,10,10.0
1382,April,2023,Polk,OR,Passenger,0,1,1,15,16,6.25
1383,April,2023,Asotin,WA,Passenger,33,21,54,12339,12393,0.44
1384,April,2023,Montgomery,PA,Passenger,1,0,1,14,15,6.67
1385,April,2023,Essex,NJ,Passenger,2,0,2,4,6,33.33
1386,April,2023,Grays Harbor,WA,Truck,4,0,4,20911,20915,0.02
1387,April,2023,Stafford,VA,Passenger,3,1,4,73,77,5.19
1388,April,2023,Williamson,TX,Passenger,0,1,1,51,52,1.92
1389,April,2023,Broward,FL,Passenger,1,0,1,54,55,1.82
1390,April,2023,San Bernardino,CA,Passenger,2,1,3,253,256,1.17
1391,April,2023,St. Clair,IL,Passenger,2,0,2,101,103,1.94
1392,April,2023,Honolulu,HI,Passenger,2,3,5,240,245,2.04
1393,April,2023,Montgomery,MD,Passenger,3,3,6,168,174,3.45
1394,April,2023,Adams,CO,Passenger,1,0,1,27,28,3.57
1395,April,2023,Walla Walla,WA,Truck,5,0,5,13674,13679,0.04
1396,April,2023,New London,CT,Passenger,1,4,5,169,174,2.87
1397,April,2023,Escambia,FL,Passenger,0,1,1,106,107,0.93
1398,April,2023,Kern,CA,Passenger,1,1,2,171,173,1.16
1399,April,2023,Klickitat,WA,Truck,8,0,8,8230,8238,0.1
1400,April,2023,Jefferson,WA,Truck,10,0,10,9292,9302,0.11
1401,April,2023,Thurston,WA,Truck,55,0,55,53886,53941,0.1
1402,April,2023,Lane,OR,Passenger,0,1,1,63,64,1.56
1403,April,2023,Fairbanks North Star,AK,Passenger,0,1,1,48,49,2.04
1404,April,2023,Allen,IN,Passenger,1,0,1,9,10,10.0
1405,April,2023,Rockingham,NH,Passenger,1,0,1,10,11,9.09
1406,April,2023,Douglas,WA,Truck,7,0,7,12882,12889,0.05
1407,April,2023,Bell,TX,Passenger,1,0,1,242,243,0.41
1408,April,2023,San Juan,WA,Truck,12,0,12,5895,5907,0.2
1409,April,2023,Cowlitz,WA,Passenger,433,203,636,69749,70385,0.9
1410,April,2023,Spokane,WA,Truck,34,0,34,101402,101436,0.03
1411,April,2023,Douglas,NE,Passenger,1,1,2,25,27,7.41
1412,April,2023,Wahkiakum,WA,Truck,2,0,2,1779,1781,0.11
1413,April,2023,St. Tammany,LA,Passenger,1,0,1,30,31,3.23
1414,April,2023,Douglas,WA,Passenger,189,61,250,28557,28807,0.87
1415,April,2023,Hawaii,HI,Passenger,1,0,1,23,24,4.17
1416,April,2023,Charleston,SC,Passenger,2,2,4,52,56,7.14
1417,April,2023,Washington,MD,Passenger,2,0,2,13,15,13.33
1418,April,2023,Calvert,MD,Passenger,1,1,2,72,74,2.7
1419,April,2023,Whatcom,WA,Passenger,2323,857,3180,147179,150359,2.11
1420,April,2023,Mason,WA,Truck,10,0,10,20712,20722,0.05
1421,April,2023,Lincoln,OR,Passenger,0,1,1,12,13,7.69
1422,April,2023,Norfolk,VA,Passenger,3,2,5,254,259,1.93
1423,April,2023,Multnomah,OR,Passenger,0,2,2,404,406,0.49
1424,April,2023,Santa Barbara,CA,Passenger,1,0,1,61,62,1.61
1425,April,2023,Yakima,WA,Passenger,468,242,710,165211,165921,0.43
1426,April,2023,Suffolk,VA,Passenger,1,0,1,101,102,0.98
1427,April,2023,Travis,TX,Passenger,1,0,1,76,77,1.3
1428,April,2023,Ray,MO,Passenger,0,1,1,0,1,100.0
1429,April,2023,Champaign,IL,Passenger,1,0,1,7,8,12.5
1430,April,2023,Rockdale,GA,Passenger,1,0,1,3,4,25.0
1431,April,2023,Kauai,HI,Passenger,1,1,2,13,15,13.33
1432,April,2023,Solano,CA,Passenger,5,0,5,134,139,3.6
1433,April,2023,Clark,WA,Passenger,5444,2212,7656,312447,320103,2.39
1434,April,2023,Jefferson,NY,Passenger,1,1,2,167,169,1.18
1435,April,2023,Coryell,TX,Passenger,1,0,1,72,73,1.37
1436,April,2023,Placer,CA,Passenger,1,0,1,51,52,1.92
1437,April,2023,Bexar,TX,Passenger,3,3,6,340,346,1.73
1438,April,2023,Hidalgo,TX,Passenger,0,1,1,45,46,2.17
1439,April,2023,Howard,MD,Passenger,0,1,1,42,43,2.33
1440,April,2023,Lake,IL,Passenger,2,0,2,110,112,1.79
1441,April,2023,Chesapeake,VA,Passenger,2,3,5,272,277,1.81
1442,April,2023,Snohomish,WA,Passenger,11666,2925,14591,526766,541357,2.7
1443,April,2023,Stevens,WA,Passenger,108,62,170,29693,29863,0.57
1444,April,2023,Okanogan,WA,Truck,3,0,3,16397,16400,0.02
1445,April,2023,Nassau,NY,Passenger,1,0,1,21,22,4.55
1446,April,2023,District of Columbia,DC,Passenger,4,0,4,147,151,2.65
1447,April,2023,Pacific,WA,Truck,3,0,3,7787,7790,0.04
1448,April,2023,Cowlitz,WA,Truck,8,0,8,28099,28107,0.03
1449,April,2023,Beaufort,SC,Passenger,1,0,1,18,19,5.26
1450,April,2023,Island,WA,Passenger,1012,423,1435,61224,62659,2.29
1451,April,2023,Adams,WA,Truck,2,0,2,5293,5295,0.04
1452,April,2023,Ferry,WA,Passenger,19,4,23,4330,4353,0.53
1453,April,2023,Monterey,CA,Passenger,1,1,2,108,110,1.82
1454,April,2023,DeKalb,GA,Passenger,1,0,1,38,39,2.56
1455,April,2023,Walla Walla,WA,Passenger,213,115,328,35303,35631,0.92
1456,April,2023,Orange,CA,Passenger,7,2,9,269,278,3.24
1457,April,2023,Moore,NC,Passenger,0,1,1,102,103,0.97
1459,April,2023,Hamilton,OH,Passenger,1,0,1,24,25,4.0
1460,April,2023,Skamania,WA,Passenger,99,53,152,8037,8189,1.86
1461,April,2023,Prince George's,MD,Passenger,2,1,3,104,107,2.8
1462,April,2023,Pulaski,AR,Passenger,3,0,3,21,24,12.5
1463,April,2023,Dallas,TX,Passenger,1,0,1,73,74,1.35
1464,April,2023,Chelan,WA,Passenger,605,154,759,54000,54759,1.39
1465,April,2023,Clark,WA,Truck,82,0,82,81044,81126,0.1
1466,April,2023,Galveston,TX,Passenger,0,1,1,15,16,6.25
1467,April,2023,Virginia Beach,VA,Passenger,2,0,2,419,421,0.48
1468,April,2023,Hoke,NC,Passenger,1,0,1,55,56,1.79
1469,April,2023,Salt Lake,UT,Passenger,0,1,1,88,89,1.12
1470,April,2023,Clark,NV,Passenger,4,2,6,375,381,1.57
1471,April,2023,Larimer,CO,Passenger,1,0,1,36,37,2.7
1472,April,2023,Randolph,NC,Passenger,1,0,1,3,4,25.0
1473,April,2023,Vernon,LA,Passenger,1,0,1,68,69,1.45
1474,April,2023,Harnett,NC,Passenger,4,0,4,120,124,3.23
1475,April,2023,Hillsborough,FL,Passenger,0,1,1,100,101,0.99
1476,April,2023,Ferry,WA,Truck,0,0,0,3556,3556,0.0
1477,April,2023,Skagit,WA,Passenger,1055,389,1444,88585,90029,1.6
1478,April,2023,Grant,WA,Truck,10,0,10,27865,27875,0.04
1479,April,2023,San Juan,WA,Passenger,605,173,778,13782,14560,5.34
1480,April,2023,Lincoln,WA,Passenger,18,16,34,7641,7675,0.44
1481,April,2023,New Haven,CT,Passenger,0,2,2,21,23,8.7
1482,April,2023,Lee,AL,Passenger,1,0,1,11,12,8.33
1483,April,2023,Goochland,VA,Passenger,0,1,1,39,40,2.5
1484,April,2023,Anne Arundel,MD,Passenger,4,4,8,287,295,2.71
1485,April,2023,Kootenai,ID,Truck,1,0,1,27,28,3.57
1486,April,2023,Grant,WA,Passenger,265,114,379,66651,67030,0.57
1487,April,2023,San Diego,CA,Passenger,16,9,25,1874,1899,1.32
1488,April,2023,Las Animas,CO,Passenger,1,0,1,0,1,100.0
1489,April,2023,Pend Oreille,WA,Passenger,31,13,44,8881,8925,0.49
1490,April,2023,Yavapai,AZ,Passenger,1,0,1,20,21,4.76
1491,April,2023,Boulder,CO,Passenger,1,0,1,24,25,4.0
1492,April,2023,Camden,NJ,Passenger,0,1,1,12,13,7.69
1493,April,2023,Clallam,WA,Truck,18,0,18,21654,21672,0.08
1494,April,2023,Emmet,MI,Passenger,0,1,1,0,1,100.0
1495,April,2023,Hennepin,MN,Passenger,1,0,1,30,31,3.23
1496,April,2023,Pacific,WA,Passenger,76,89,165,15580,15745,1.05
1497,April,2023,Nueces,TX,Passenger,0,1,1,49,50,2.0
1498,April,2023,Skagit,WA,Truck,18,0,18,31863,31881,0.06
1499,April,2023,Collin,TX,Passenger,2,0,2,39,41,4.88
1500,April,2023,Pierce,WA,Truck,139,0,139,137180,137319,0.1
1501,April,2023,Maricopa,AZ,Passenger,7,3,10,578,588,1.7
1502,April,2023,Santa Clara,CA,Passenger,8,2,10,146,156,6.41
1503,April,2023,Berkeley,SC,Passenger,0,1,1,99,100,1.0
1504,April,2023,Gwinnett,GA,Passenger,1,0,1,41,42,2.38
1505,April,2023,Fairfax,VA,Passenger,4,3,7,529,536,1.31
1506,April,2023,King,WA,Truck,634,2,636,175590,176226,0.36
1507,April,2023,Hudson,NJ,Passenger,1,0,1,16,17,5.88
1508,April,2023,Columbia,WA,Truck,0,0,0,1552,1552,0.0
1509,April,2023,Alexandria,VA,Passenger,3,1,4,87,91,4.4
1510,April,2023,Harrison,MS,Passenger,1,0,1,29,30,3.33
1511,April,2023,Loudoun,VA,Passenger,3,0,3,56,59,5.08
1512,April,2023,Whatcom,WA,Truck,52,0,52,42622,42674,0.12
1513,April,2023,Pierce,WA,Passenger,7128,2668,9796,530958,540754,1.81
1514,April,2023,Clallam,WA,Passenger,518,278,796,48898,49694,1.6
1515,April,2023,Franklin,WA,Passenger,298,132,430,61650,62080,0.69
1516,April,2023,Fairfax,VA,Truck,1,0,1,86,87,1.15
1517,April,2023,El Paso,CO,Passenger,3,1,4,475,479,0.84
1518,April,2023,Portsmouth,VA,Passenger,0,1,1,61,62,1.61
1519,April,2023,Whitman,WA,Truck,4,0,4,8571,8575,0.05
1520,April,2023,Duval,FL,Passenger,1,0,1,221,222,0.45
1521,April,2023,Douglas,CO,Passenger,0,1,1,50,51,1.96
1522,April,2023,Lewis,WA,Truck,6,0,6,26003,26009,0.02
1523,April,2023,Cape May,NJ,Passenger,0,1,1,7,8,12.5
1524,April,2023,Lincoln,WA,Truck,0,0,0,4841,4841,0.0
1525,April,2023,Platte,MO,Passenger,1,0,1,16,17,5.88
1526,April,2023,Snohomish,WA,Truck,145,0,145,121227,121372,0.12
1527,April,2023,Chelan,WA,Truck,26,0,26,23050,23076,0.11
1528,April,2023,Arapahoe,CO,Passenger,1,1,2,66,68,2.94
1529,April,2023,Grays Harbor,WA,Passenger,286,182,468,48238,48706,0.96
1530,April,2023,Los Angeles,CA,Passenger,4,5,9,585,594,1.52
1531,April,2023,Stevens,WA,Truck,1,0,1,18709,18710,0.01
1532,April,2023,El Paso,TX,Passenger,2,0,2,258,260,0.77
1533,April,2023,Dorchester,SC,Passenger,1,0,1,39,40,2.5
1534,April,2023,Alameda,CA,Passenger,3,0,3,149,152,1.97
1535,April,2023,Kittitas,WA,Truck,8,0,8,14470,14478,0.06
1536,April,2023,Jefferson,WA,Passenger,531,253,784,24161,24945,3.14
1537,April,2023,Geary,KS,Passenger,1,0,1,69,70,1.43
1538,April,2023,Cook,IL,Passenger,2,0,2,142,144,1.39
1539,April,2023,St. Mary's,MD,Passenger,1,0,1,163,164,0.61
1540,April,2023,Saratoga,NY,Passenger,1,1,2,30,32,6.25
1541,April,2023,Jackson,OK,Passenger,0,1,1,30,31,3.23
1542,April,2023,Cumberland,PA,Passenger,1,0,1,31,32,3.12
1543,April,2023,Sacramento,CA,Passenger,4,0,4,134,138,2.9
1544,April,2023,Sheridan,WY,Passenger,1,0,1,5,6,16.67
1545,April,2023,Columbia,WA,Passenger,8,1,9,2407,2416,0.37
1546,April,2023,Yellowstone,MT,Passenger,0,1,1,16,17,5.88
1547,April,2023,Wilson,TX,Passenger,0,1,1,2,3,33.33
1548,April,2023,Whitman,WA,Passenger,138,73,211,21935,22146,0.95
1549,April,2023,Spokane,WA,Passenger,2159,1032,3191,321308,324499,0.98
1550,April,2023,Kitsap,WA,Passenger,3049,1231,4280,175820,180100,2.38
1551,April,2023,Yakima,WA,Truck,11,0,11,60803,60814,0.02
1552,April,2023,Plaquemines,LA,Passenger,1,1,2,14,16,12.5
1553,April,2023,Klickitat,WA,Passenger,139,59,198,15114,15312,1.29
1554,April,2023,Island,WA,Truck,28,0,28,21017,21045,0.13
1555,April,2023,Garfield,WA,Truck,0,0,0,976,976,0.0
1556,April,2023,Santa Cruz,CA,Passenger,1,0,1,13,14,7.14
1557,April,2023,Adams,WA,Passenger,24,12,36,12970,13006,0.28
1558,April,2023,Kent,DE,Passenger,1,0,1,44,45,2.22
1559,April,2023,Cumberland,NC,Passenger,1,2,3,285,288,1.04
1560,April,2023,Pend Oreille,WA,Truck,0,0,0,5600,5600,0.0
1561,April,2023,Asotin,WA,Truck,0,0,0,6607,6607,0.0
1562,April,2023,Ulster,NY,Passenger,1,0,1,4,5,20.0
1563,April,2023,Skamania,WA,Truck,1,0,1,3828,3829,0.03
1564,April,2023,Riverside,CA,Passenger,6,1,7,357,364,1.92
1565,April,2023,Benton,WA,Passenger,1089,545,1634,135049,136683,1.2
1566,April,2023,Miami-Dade,FL,Passenger,1,0,1,54,55,1.82
1567,April,2023,Napa,CA,Passenger,0,1,1,10,11,9.09
1568,April,2023,Thurston,WA,Passenger,2918,1188,4106,190129,194235,2.11
1569,April,2023,Sarpy,NE,Passenger,1,0,1,45,46,2.17
1570,April,2023,Kitsap,WA,Truck,64,0,64,52364,52428,0.12
1571,April,2023,Burlington,NJ,Passenger,0,2,2,89,91,2.2
1572,April,2023,Lewis,WA,Passenger,302,195,497,58597,59094,0.84
1573,April,2023,Franklin,WA,Truck,4,0,4,20798,20802,0.02
1574,April,2023,Garfield,WA,Passenger,1,3,4,1316,1320,0.3
1575,April,2023,Okanogan,WA,Passenger,119,58,177,25969,26146,0.68
1576,April,2023,Charles,MD,Passenger,1,1,2,49,51,3.92
1577,April,2023,Sarasota,FL,Passenger,1,0,1,14,15,6.67
1578,April,2023,Houston,GA,Passenger,1,0,1,26,27,3.7
1579,April,2023,Benton,WA,Truck,19,0,19,43089,43108,0.04
1580,April,2023,Middlesex,MA,Passenger,2,1,3,57,60,5.0
1581,April,2023,Onslow,NC,Passenger,0,1,1,136,137,0.73
1582,August,2017,Tuolumne,CA,Passenger,0,1,1,14,15,6.67
1583,August,2017,Lincoln,WA,Passenger,1,5,6,7571,7577,0.08
1584,August,2017,Asotin,WA,Passenger,8,5,13,12444,12457,0.1
1585,August,2017,Thurston,WA,Truck,0,0,0,53429,53429,0.0
1586,August,2017,Hawaii,HI,Passenger,1,0,1,77,78,1.28
1587,August,2017,Essex,NJ,Passenger,1,0,1,13,14,7.14
1588,August,2017,Kitsap,WA,Passenger,637,336,973,173831,174804,0.56
1589,August,2017,Twin Falls,ID,Passenger,0,1,1,22,23,4.35
1590,August,2017,Walla Walla,WA,Truck,0,0,0,13188,13188,0.0
1591,August,2017,Saratoga,NY,Passenger,1,1,2,72,74,2.7
1592,August,2017,Manatee,FL,Passenger,1,0,1,42,43,2.33
1593,August,2017,Jefferson,NY,Passenger,1,0,1,245,246,0.41
1594,August,2017,Lane,OR,Passenger,0,1,1,223,224,0.45
1595,August,2017,Sacramento,CA,Passenger,1,0,1,345,346,0.29
1596,August,2017,Lewis,WA,Truck,0,0,0,25013,25013,0.0
1597,August,2017,Palm Beach,FL,Passenger,0,1,1,98,99,1.01
1598,August,2017,Los Angeles,CA,Passenger,3,2,5,1251,1256,0.4
1599,August,2017,Franklin,WA,Truck,0,0,0,18234,18234,0.0
1600,August,2017,Ferry,WA,Truck,0,0,0,3532,3532,0.0
1601,August,2017,Asotin,WA,Truck,0,0,0,6515,6515,0.0
1602,August,2017,Lee,AL,Passenger,1,0,1,36,37,2.7
1603,August,2017,Santa Clara,CA,Passenger,5,2,7,393,400,1.75
1604,August,2017,Fairfax,VA,Passenger,2,2,4,841,845,0.47
1605,August,2017,Grays Harbor,WA,Passenger,37,37,74,44965,45039,0.16
1606,August,2017,Snohomish,WA,Passenger,1847,942,2789,513730,516519,0.54
1607,August,2017,Wahkiakum,WA,Passenger,0,2,2,2834,2836,0.07
1608,August,2017,Missoula,MT,Passenger,1,0,1,70,71,1.41
1609,August,2017,Skamania,WA,Passenger,10,7,17,8571,8588,0.2
1610,August,2017,Gwinnett,GA,Passenger,0,1,1,84,85,1.18
1611,August,2017,Garfield,WA,Truck,0,0,0,932,932,0.0
1612,August,2017,Orange,FL,Passenger,1,1,2,144,146,1.37
1613,August,2017,Columbia,WA,Truck,0,0,0,1541,1541,0.0
1614,August,2017,Kittitas,WA,Passenger,27,21,48,27891,27939,0.17
1615,August,2017,Pinal,AZ,Passenger,2,0,2,227,229,0.87
1616,August,2017,Albemarle,VA,Passenger,0,1,1,32,33,3.03
1617,August,2017,Ferry,WA,Passenger,1,1,2,4396,4398,0.05
1618,August,2017,Howard,MD,Passenger,0,2,2,89,91,2.2
1619,August,2017,Chelan,WA,Passenger,72,36,108,52309,52417,0.21
1620,August,2017,Duval,FL,Passenger,1,1,2,377,379,0.53
1621,August,2017,Virginia Beach,VA,Passenger,2,1,3,646,649,0.46
1622,August,2017,Sedgwick,KS,Passenger,0,1,1,104,105,0.95
1623,August,2017,Pierce,WA,Truck,0,0,0,137231,137231,0.0
1624,August,2017,Clark,WA,Passenger,794,528,1322,300774,302096,0.44
1625,August,2017,DeKalb,GA,Passenger,1,0,1,86,87,1.15
1626,August,2017,Skamania,WA,Truck,0,0,0,3876,3876,0.0
1627,August,2017,Whitman,WA,Truck,0,0,0,8451,8451,0.0
1628,August,2017,Hamilton,TN,Passenger,1,0,1,20,21,4.76
1630,August,2017,Fulton,GA,Passenger,1,0,1,109,110,0.91
1631,August,2017,Arlington,VA,Passenger,1,2,3,166,169,1.78
1632,August,2017,Jefferson,WA,Passenger,112,64,176,23954,24130,0.73
1633,August,2017,Pend Oreille,WA,Passenger,3,4,7,9358,9365,0.07
1634,August,2017,Franklin,WA,Passenger,27,48,75,55929,56004,0.13
1635,August,2017,Tarrant,TX,Passenger,1,0,1,233,234,0.43
1636,August,2017,Montgomery,PA,Passenger,1,0,1,40,41,2.44
1637,August,2017,Ramsey,MN,Passenger,1,0,1,39,40,2.5
1638,August,2017,Chelan,WA,Truck,0,0,0,21363,21363,0.0
1639,August,2017,Alameda,CA,Passenger,0,1,1,358,359,0.28
1640,August,2017,Kitsap,WA,Truck,1,0,1,52562,52563,0.0
1641,August,2017,Travis,TX,Passenger,0,1,1,194,195,0.51
1642,August,2017,Riverside,CA,Passenger,1,2,3,769,772,0.39
1643,August,2017,Montgomery,TX,Passenger,1,0,1,60,61,1.64
1644,August,2017,Utah,UT,Passenger,0,1,1,147,148,0.68
1645,August,2017,Grant,WA,Truck,0,0,0,25352,25352,0.0
1646,August,2017,Adams,WA,Passenger,3,3,6,12183,12189,0.05
1647,August,2017,Tulare,CA,Passenger,1,0,1,197,198,0.51
1648,August,2017,El Paso,CO,Passenger,2,0,2,777,779,0.26
1649,August,2017,Stevens,WA,Passenger,8,22,30,31514,31544,0.1
1650,August,2017,Cape May,NJ,Passenger,0,1,1,18,19,5.26
1651,August,2017,DeKalb,IN,Passenger,1,0,1,1,2,50.0
1652,August,2017,Kent,MI,Passenger,0,1,1,38,39,2.56
1653,August,2017,Hardin,KY,Passenger,0,1,1,122,123,0.81
1654,August,2017,Shelby,TN,Passenger,0,1,1,103,104,0.96
1655,August,2017,Lewis,WA,Passenger,55,38,93,55794,55887,0.17
1656,August,2017,Clark,WA,Truck,0,0,0,77898,77898,0.0
1657,August,2017,Pacific,WA,Passenger,10,9,19,15248,15267,0.12
1658,August,2017,Klickitat,WA,Truck,0,0,0,7970,7970,0.0
1659,August,2017,St. Clair,IL,Passenger,0,1,1,168,169,0.59
1660,August,2017,Montgomery,TN,Passenger,1,0,1,281,282,0.35
1661,August,2017,Morris,NJ,Passenger,1,0,1,23,24,4.17
1662,August,2017,Dakota,MN,Passenger,0,2,2,36,38,5.26
1663,August,2017,Cowlitz,WA,Truck,0,0,0,27992,27992,0.0
1664,August,2017,Pacific,WA,Truck,0,0,0,7515,7515,0.0
1665,August,2017,Madison,ID,Passenger,1,0,1,37,38,2.63
1666,August,2017,Benton,WA,Truck,0,0,0,40164,40164,0.0
1667,August,2017,Whatcom,WA,Passenger,481,182,663,143561,144224,0.46
1668,August,2017,Wayne,MI,Passenger,0,1,1,67,68,1.47
1669,August,2017,Prince William,VA,Passenger,0,3,3,267,270,1.11
1670,August,2017,Moore,NC,Passenger,0,1,1,200,201,0.5
1671,August,2017,Yakima,WA,Passenger,54,67,121,160149,160270,0.08
1672,August,2017,Frederick,MD,Passenger,0,1,1,83,84,1.19
1673,August,2017,San Juan,WA,Passenger,113,39,152,13645,13797,1.1
1674,August,2017,Snohomish,WA,Truck,1,0,1,121668,121669,0.0
1675,August,2017,Northampton,PA,Passenger,0,1,1,97,98,1.02
1676,August,2017,Nueces,TX,Passenger,0,1,1,94,95,1.05
1677,August,2017,Santa Fe,NM,Passenger,0,1,1,43,44,2.27
1678,August,2017,Juneau,AK,Passenger,0,1,1,43,44,2.27
1679,August,2017,Wahkiakum,WA,Truck,0,0,0,1655,1655,0.0
1680,August,2017,Garfield,WA,Passenger,1,0,1,1302,1303,0.08
1681,August,2017,Montgomery,MD,Passenger,1,0,1,307,308,0.32
1682,August,2017,Monterey,CA,Passenger,0,2,2,195,197,1.02
1683,August,2017,Canyon,ID,Passenger,0,1,1,97,98,1.02
1684,August,2017,Polk,FL,Passenger,1,0,1,64,65,1.54
1685,August,2017,Thurston,WA,Passenger,421,359,780,187775,188555,0.41
1686,August,2017,Flathead,MT,Passenger,1,0,1,59,60,1.67
1687,August,2017,Portsmouth,VA,Passenger,0,1,1,65,66,1.52
1688,August,2017,Stevens,WA,Truck,0,0,0,18218,18218,0.0
1689,August,2017,Charles,MD,Passenger,0,1,1,85,86,1.16
1690,August,2017,Dale,AL,Passenger,0,1,1,63,64,1.56
1691,August,2017,New Haven,CT,Passenger,0,1,1,57,58,1.72
1692,August,2017,Walla Walla,WA,Passenger,27,27,54,34981,35035,0.15
1693,August,2017,Jefferson,WA,Truck,0,0,0,9427,9427,0.0
1694,August,2017,Kittitas,WA,Truck,0,0,0,13610,13610,0.0
1695,August,2017,Pierce,WA,Passenger,999,866,1865,524926,526791,0.35
1696,August,2017,Spokane,WA,Passenger,268,220,488,297411,297899,0.16
1697,August,2017,Skagit,WA,Passenger,140,112,252,88466,88718,0.28
1698,August,2017,Carroll,NH,Passenger,0,1,1,1,2,50.0
1699,August,2017,Norfolk,VA,Passenger,1,1,2,313,315,0.63
1700,August,2017,Maui,HI,Passenger,1,0,1,69,70,1.43
1701,August,2017,Benton,WA,Passenger,161,147,308,129043,129351,0.24
1702,August,2017,Adams,WA,Truck,0,0,0,5097,5097,0.0
1703,August,2017,Orange,CA,Passenger,3,1,4,611,615,0.65
1704,August,2017,Okaloosa,FL,Passenger,1,0,1,184,185,0.54
1705,August,2017,Clark,NV,Passenger,1,2,3,795,798,0.38
1706,August,2017,King,WA,Truck,7,1,8,186770,186778,0.0
1707,August,2017,District of Columbia,DC,Passenger,0,2,2,206,208,0.96
1708,August,2017,Pend Oreille,WA,Truck,0,0,0,5552,5552,0.0
1709,August,2017,Pima,AZ,Passenger,1,2,3,418,421,0.71
1710,August,2017,Douglas,WA,Truck,0,0,0,11570,11570,0.0
1711,August,2017,Clallam,WA,Passenger,96,79,175,48546,48721,0.36
1712,August,2017,Sangamon,IL,Passenger,1,0,1,11,12,8.33
1713,August,2017,Nantucket,MA,Passenger,1,0,1,3,4,25.0
1714,August,2017,Latah,ID,Passenger,0,1,1,92,93,1.08
1715,August,2017,Whatcom,WA,Truck,2,0,2,41764,41766,0.0
1716,August,2017,Spokane,WA,Truck,1,0,1,90996,90997,0.0
1717,August,2017,Okanogan,WA,Passenger,4,18,22,25673,25695,0.09
1718,August,2017,Lincoln,WA,Truck,0,0,0,4457,4457,0.0
1719,August,2017,New London,CT,Passenger,1,1,2,255,257,0.78
1720,August,2017,Okanogan,WA,Truck,0,0,0,16242,16242,0.0
1721,August,2017,Santa Rosa,FL,Passenger,1,0,1,110,111,0.9
1722,August,2017,Grant,WA,Passenger,19,32,51,61193,61244,0.08
1723,August,2017,Multnomah,OR,Passenger,1,3,4,937,941,0.43
1724,August,2017,Allegheny,PA,Passenger,1,0,1,89,90,1.11
1725,August,2017,Douglas,WA,Passenger,35,27,62,26835,26897,0.23
1726,August,2017,Cowlitz,WA,Passenger,50,62,112,70013,70125,0.16
1727,August,2017,San Mateo,CA,Passenger,0,1,1,150,151,0.66
1728,August,2017,Anne Arundel,MD,Passenger,0,1,1,496,497,0.2
1729,August,2017,Jackson,MO,Passenger,1,0,1,57,58,1.72
1730,August,2017,Grays Harbor,WA,Truck,0,0,0,19935,19935,0.0
1731,August,2017,San Juan,WA,Truck,0,0,0,5549,5549,0.0
1732,August,2017,King,WA,Passenger,10441,4267,14708,1372396,1387104,1.06
1733,August,2017,Manassas,VA,Passenger,0,1,1,9,10,10.0
1734,August,2017,Maricopa,AZ,Passenger,2,0,2,1690,1692,0.12
1735,August,2017,Deschutes,OR,Passenger,1,0,1,194,195,0.51
1736,August,2017,Norfolk,MA,Passenger,1,0,1,38,39,2.56
1737,August,2017,Marin,CA,Passenger,1,0,1,58,59,1.69
1738,August,2017,Franklin,MA,Passenger,0,1,1,4,5,20.0
1739,August,2017,Island,WA,Passenger,124,149,273,60582,60855,0.45
1740,August,2017,Richmond,GA,Passenger,0,1,1,88,89,1.12
1741,August,2017,Mason,WA,Truck,0,0,0,19333,19333,0.0
1742,August,2017,Mason,WA,Passenger,59,73,132,43923,44055,0.3
1743,August,2017,Dallas,TX,Passenger,0,1,1,181,182,0.55
1744,August,2017,Prince George's,MD,Passenger,0,1,1,187,188,0.53
1745,August,2017,Columbia,WA,Passenger,1,1,2,2352,2354,0.08
1746,August,2017,Nassau,NY,Passenger,1,1,2,39,41,4.88
1747,August,2017,St. Lucie,FL,Passenger,1,0,1,28,29,3.45
1748,August,2017,Orleans,LA,Passenger,0,1,1,44,45,2.22
1749,August,2017,Richland,SC,Passenger,0,1,1,188,189,0.53
1750,August,2017,Bexar,TX,Passenger,1,1,2,852,854,0.23
1751,August,2017,Cobb,GA,Passenger,0,1,1,73,74,1.35
1752,August,2017,Volusia,FL,Passenger,0,1,1,46,47,2.13
1753,August,2017,Franklin,OH,Passenger,0,1,1,115,116,0.86
1754,August,2017,Island,WA,Truck,0,0,0,20519,20519,0.0
1755,August,2017,Clallam,WA,Truck,0,0,0,21059,21059,0.0
1756,August,2017,Yakima,WA,Truck,0,0,0,57643,57643,0.0
1757,August,2017,Sumter,FL,Passenger,0,1,1,10,11,9.09
1758,August,2017,Skagit,WA,Truck,1,0,1,31515,31516,0.0
1759,August,2017,Hamilton,IN,Passenger,1,0,1,58,59,1.69
1760,August,2017,Klickitat,WA,Passenger,21,24,45,14782,14827,0.3
1761,August,2017,San Diego,CA,Passenger,6,1,7,2660,2667,0.26
1762,August,2017,Lumpkin,GA,Passenger,1,0,1,9,10,10.0
1763,August,2017,Whitman,WA,Passenger,11,22,33,22128,22161,0.15
1764,August,2017,Bergen,NJ,Passenger,0,2,2,30,32,6.25
1765,August,2017,Honolulu,HI,Passenger,3,2,5,561,566,0.88
1766,August,2018,Garfield,WA,Passenger,1,1,2,1318,1320,0.15
1767,August,2018,Whatcom,WA,Passenger,653,321,974,148265,149239,0.65
1768,August,2018,Marion,OR,Passenger,1,0,1,122,123,0.81
1769,August,2018,Bexar,TX,Passenger,3,4,7,737,744,0.94
1770,August,2018,Douglas,NE,Passenger,0,1,1,70,71,1.41
1771,August,2018,Maui,HI,Passenger,1,0,1,55,56,1.79
1772,August,2018,Snohomish,WA,Passenger,2471,1311,3782,523635,527417,0.72
1773,August,2018,Jefferson,WA,Truck,0,0,0,9623,9623,0.0
1774,August,2018,El Paso,TX,Passenger,1,0,1,507,508,0.2
1775,August,2018,Los Angeles,CA,Passenger,7,4,11,1136,1147,0.96
1776,August,2018,Douglas,WA,Passenger,45,31,76,27791,27867,0.27
1777,August,2018,Prince George's,MD,Passenger,1,1,2,181,183,1.09
1778,August,2018,DeKalb,GA,Passenger,1,0,1,79,80,1.25
1779,August,2018,Virginia Beach,VA,Passenger,2,1,3,697,700,0.43
1780,August,2018,St. Lucie,FL,Passenger,1,0,1,30,31,3.23
1781,August,2018,Fulton,GA,Passenger,1,2,3,106,109,2.75
1782,August,2018,Carson City,NV,Passenger,1,0,1,14,15,6.67
1783,August,2018,Travis,TX,Passenger,0,1,1,195,196,0.51
1784,August,2018,Whitman,WA,Passenger,20,30,50,22680,22730,0.22
1785,August,2018,Moore,NC,Passenger,0,1,1,198,199,0.5
1786,August,2018,DuPage,IL,Passenger,1,0,1,56,57,1.75
1788,August,2018,Benton,WA,Truck,0,0,0,41231,41231,0.0
1789,August,2018,Madison,ID,Passenger,1,0,1,36,37,2.7
1790,August,2018,Whitman,WA,Truck,0,0,0,8505,8505,0.0
1791,August,2018,Stevens,WA,Truck,0,0,0,18676,18676,0.0
1792,August,2018,Ferry,WA,Passenger,2,2,4,4420,4424,0.09
1793,August,2018,Essex,NJ,Passenger,1,0,1,11,12,8.33
1794,August,2018,Columbia,WA,Truck,0,0,0,1535,1535,0.0
1795,August,2018,Wahkiakum,WA,Passenger,1,1,2,2961,2963,0.07
1796,August,2018,Garfield,WA,Truck,0,0,0,956,956,0.0
1797,August,2018,Cape May,NJ,Passenger,0,1,1,22,23,4.35
1798,August,2018,Okanogan,WA,Passenger,10,20,30,26065,26095,0.11
1799,August,2018,Clallam,WA,Passenger,128,115,243,50115,50358,0.48
1800,August,2018,Monroe,IL,Passenger,1,0,1,5,6,16.67
1801,August,2018,Allegheny,PA,Passenger,1,0,1,78,79,1.27
1802,August,2018,Pacific,WA,Passenger,19,22,41,15677,15718,0.26
1803,August,2018,Carroll,NH,Passenger,0,1,1,1,2,50.0
1804,August,2018,Hawaii,HI,Passenger,1,0,1,71,72,1.39
1805,August,2018,Lewis,WA,Truck,0,0,0,25605,25605,0.0
1806,August,2018,Franklin,WA,Truck,0,0,0,18794,18794,0.0
1807,August,2018,Cumberland,NC,Passenger,0,1,1,534,535,0.19
1808,August,2018,Clay,FL,Passenger,0,1,1,93,94,1.06
1809,August,2018,Juneau,AK,Passenger,0,1,1,44,45,2.22
1810,August,2018,Yakima,WA,Truck,0,0,0,58619,58619,0.0
1811,August,2018,Washington,OR,Passenger,0,1,1,472,473,0.21
1812,August,2018,Kent,MI,Passenger,0,1,1,27,28,3.57
1813,August,2018,Norfolk,VA,Passenger,2,2,4,334,338,1.18
1814,August,2018,San Juan,PR,Passenger,0,1,1,4,5,20.0
1815,August,2018,Williamson,TX,Passenger,0,1,1,162,163,0.61
1816,August,2018,Ramsey,MN,Passenger,1,0,1,40,41,2.44
1817,August,2018,Kitsap,WA,Truck,1,0,1,53439,53440,0.0
1818,August,2018,Kittitas,WA,Truck,0,0,0,14113,14113,0.0
1819,August,2018,Dallas,TX,Passenger,0,1,1,196,197,0.51
1820,August,2018,Lee,FL,Passenger,1,0,1,58,59,1.69
1821,August,2018,Cowlitz,WA,Passenger,62,81,143,71989,72132,0.2
1822,August,2018,Clackamas,OR,Passenger,0,1,1,219,220,0.45
1823,August,2018,Clark,WA,Truck,0,0,0,79303,79303,0.0
1824,August,2018,Cochise,AZ,Passenger,0,1,1,117,118,0.85
1825,August,2018,Manassas,VA,Passenger,0,1,1,9,10,10.0
1826,August,2018,Skagit,WA,Truck,1,0,1,32229,32230,0.0
1827,August,2018,Suffolk,MA,Passenger,0,1,1,42,43,2.33
1828,August,2018,Sangamon,IL,Passenger,1,0,1,11,12,8.33
1829,August,2018,Collin,TX,Passenger,1,0,1,149,150,0.67
1830,August,2018,Orange,CA,Passenger,4,1,5,553,558,0.9
1831,August,2018,Spokane,WA,Passenger,360,336,696,304743,305439,0.23
1832,August,2018,Duval,FL,Passenger,1,2,3,380,383,0.78
1833,August,2018,Walla Walla,WA,Truck,0,0,0,13497,13497,0.0
1834,August,2018,Tarrant,TX,Passenger,1,0,1,213,214,0.47
1835,August,2018,Lane,OR,Passenger,0,1,1,181,182,0.55
1836,August,2018,San Mateo,CA,Passenger,1,1,2,133,135,1.48
1837,August,2018,Portsmouth,VA,Passenger,0,1,1,75,76,1.32
1838,August,2018,Riverside,CA,Passenger,2,2,4,692,696,0.57
1839,August,2018,Larimer,CO,Passenger,1,0,1,63,64,1.56
1840,August,2018,Pierce,WA,Truck,0,0,0,138304,138304,0.0
1841,August,2018,Jefferson,NY,Passenger,0,1,1,225,226,0.44
1842,August,2018,Prince George,VA,Passenger,0,1,1,78,79,1.27
1843,August,2018,King,WA,Passenger,13801,5938,19739,1373749,1393488,1.42
1844,August,2018,Richmond,GA,Passenger,0,1,1,92,93,1.08
1845,August,2018,Wahkiakum,WA,Truck,0,0,0,1691,1691,0.0
1846,August,2018,Kitsap,WA,Passenger,828,488,1316,179328,180644,0.73
1847,August,2018,Cowlitz,WA,Truck,0,0,0,28606,28606,0.0
1848,August,2018,Jefferson,WA,Passenger,152,101,253,24679,24932,1.01
1849,August,2018,Arlington,VA,Passenger,1,1,2,173,175,1.14
1850,August,2018,New Haven,CT,Passenger,0,1,1,48,49,2.04
1851,August,2018,Klamath,OR,Passenger,1,0,1,35,36,2.78
1852,August,2018,Manatee,FL,Passenger,1,0,1,37,38,2.63
1853,August,2018,Santa Rosa,FL,Passenger,1,0,1,92,93,1.08
1854,August,2018,Clark,NV,Passenger,1,2,3,734,737,0.41
1855,August,2018,San Juan,WA,Truck,0,0,0,5755,5755,0.0
1856,August,2018,Palm Beach,FL,Passenger,0,1,1,86,87,1.15
1857,August,2018,Clark,WA,Passenger,1069,765,1834,309220,311054,0.59
1858,August,2018,Pacific,WA,Truck,0,0,0,7624,7624,0.0
1859,August,2018,Washoe,NV,Passenger,1,0,1,113,114,0.88
1860,August,2018,Whatcom,WA,Truck,2,0,2,42393,42395,0.0
1861,August,2018,Ventura,CA,Passenger,0,2,2,315,317,0.63
1862,August,2018,Prince William,VA,Passenger,0,4,4,260,264,1.52
1863,August,2018,St. Mary's,MD,Passenger,1,0,1,218,219,0.46
1864,August,2018,DeKalb,IN,Passenger,1,0,1,1,2,50.0
1865,August,2018,Pierce,WA,Passenger,1303,1224,2527,534848,537375,0.47
1866,August,2018,Hennepin,MN,Passenger,1,0,1,110,111,0.9
1867,August,2018,Twin Falls,ID,Passenger,0,1,1,23,24,4.17
1868,August,2018,Richland,SC,Passenger,0,1,1,171,172,0.58
1869,August,2018,Thurston,WA,Passenger,603,517,1120,194254,195374,0.57
1870,August,2018,Thurston,WA,Truck,0,0,0,54562,54562,0.0
1871,August,2018,Orange,FL,Passenger,2,1,3,167,170,1.76
1872,August,2018,Gwinnett,GA,Passenger,0,1,1,82,83,1.2
1873,August,2018,Caddo,LA,Passenger,0,1,1,23,24,4.17
1874,August,2018,Columbia,WA,Passenger,2,2,4,2415,2419,0.17
1875,August,2018,Maricopa,AZ,Passenger,2,1,3,1562,1565,0.19
1876,August,2018,Honolulu,HI,Passenger,1,2,3,526,529,0.57
1877,August,2018,Mason,WA,Truck,0,0,0,20084,20084,0.0
1878,August,2018,New London,CT,Passenger,0,1,1,254,255,0.39
1879,August,2018,Middlesex,MA,Passenger,0,1,1,139,140,0.71
1880,August,2018,Grant,WA,Truck,0,0,0,26008,26008,0.0
1881,August,2018,Lincoln,WA,Passenger,3,6,9,7748,7757,0.12
1882,August,2018,Chelan,WA,Passenger,114,55,169,53723,53892,0.31
1883,August,2018,Pend Oreille,WA,Truck,0,0,0,5718,5718,0.0
1884,August,2018,District of Columbia,DC,Passenger,0,3,3,192,195,1.54
1885,August,2018,Benton,WA,Passenger,189,198,387,132209,132596,0.29
1886,August,2018,Washtenaw,MI,Passenger,1,0,1,38,39,2.56
1887,August,2018,Island,WA,Passenger,216,204,420,62724,63144,0.67
1888,August,2018,Latah,ID,Passenger,0,1,1,75,76,1.32
1889,August,2018,Asotin,WA,Truck,0,0,0,6649,6649,0.0
1890,August,2018,Tulsa,OK,Passenger,1,1,2,47,49,4.08
1891,August,2018,Howard,MD,Passenger,0,1,1,86,87,1.15
1892,August,2018,Adams,WA,Passenger,5,5,10,12682,12692,0.08
1893,August,2018,Marion,IN,Passenger,1,0,1,119,120,0.83
1894,August,2018,Dakota,MN,Passenger,0,2,2,35,37,5.41
1895,August,2018,Camden,NJ,Passenger,0,1,1,32,33,3.03
1896,August,2018,Ada,ID,Passenger,0,2,2,314,316,0.63
1897,August,2018,Asotin,WA,Passenger,11,8,19,12663,12682,0.15
1898,August,2018,Klickitat,WA,Passenger,24,32,56,15283,15339,0.37
1899,August,2018,Skagit,WA,Passenger,220,169,389,90837,91226,0.43
1900,August,2018,Fairfax,VA,Passenger,2,2,4,814,818,0.49
1901,August,2018,Houston,GA,Passenger,1,0,1,54,55,1.82
1902,August,2018,Lee,AL,Passenger,1,0,1,37,38,2.63
1903,August,2018,Skamania,WA,Truck,0,0,0,3948,3948,0.0
1904,August,2018,Sumter,FL,Passenger,0,1,1,10,11,9.09
1905,August,2018,Skamania,WA,Passenger,14,10,24,8670,8694,0.28
1906,August,2018,Grays Harbor,WA,Passenger,54,65,119,46989,47108,0.25
1907,August,2018,St. Clair,IL,Passenger,0,1,1,156,157,0.64
1908,August,2018,Snohomish,WA,Truck,1,0,1,121713,121714,0.0
1909,August,2018,Fresno,CA,Passenger,1,0,1,195,196,0.51
1910,August,2018,Douglas,WA,Truck,0,0,0,12028,12028,0.0
1911,August,2018,Polk,FL,Passenger,1,0,1,64,65,1.54
1912,August,2018,Volusia,FL,Passenger,0,1,1,34,35,2.86
1913,August,2018,Yakima,WA,Passenger,67,92,159,164210,164369,0.1
1914,August,2018,Chelan,WA,Truck,0,0,0,21983,21983,0.0
1915,August,2018,Hamilton,IN,Passenger,1,0,1,46,47,2.13
1916,August,2018,Cook,IL,Passenger,1,0,1,252,253,0.4
1917,August,2018,Grant,WA,Passenger,34,49,83,63544,63627,0.13
1918,August,2018,Pend Oreille,WA,Passenger,5,5,10,9583,9593,0.1
1919,August,2018,Charles,MD,Passenger,0,1,1,82,83,1.2
1920,August,2018,San Diego,CA,Passenger,7,2,9,2568,2577,0.35
1921,August,2018,Tuolumne,CA,Passenger,0,1,1,12,13,7.69
1922,August,2018,Utah,UT,Passenger,0,1,1,137,138,0.72
1923,August,2018,Franklin,MA,Passenger,0,1,1,1,2,50.0
1924,August,2018,Nueces,TX,Passenger,1,1,2,88,90,2.22
1925,August,2018,Sedgwick,KS,Passenger,0,1,1,100,101,0.99
1926,August,2018,Adams,WA,Truck,0,0,0,5174,5174,0.0
1927,August,2018,Dale,AL,Passenger,0,1,1,57,58,1.72
1928,August,2018,Mason,WA,Passenger,92,97,189,46050,46239,0.41
1929,August,2018,Lumpkin,GA,Passenger,1,0,1,7,8,12.5
1930,August,2018,Multnomah,OR,Passenger,3,5,8,777,785,1.02
1931,August,2018,Klickitat,WA,Truck,0,0,0,8158,8158,0.0
1932,August,2018,Okanogan,WA,Truck,0,0,0,16469,16469,0.0
1933,August,2018,Frederick,MD,Passenger,0,1,1,85,86,1.16
1934,August,2018,Pinal,AZ,Passenger,2,0,2,203,205,0.98
1935,August,2018,Franklin,WA,Passenger,36,65,101,58372,58473,0.17
1936,August,2018,Charleston,SC,Passenger,1,0,1,128,129,0.78
1937,August,2018,Queens,NY,Passenger,1,0,1,61,62,1.61
1938,August,2018,Norfolk,MA,Passenger,1,0,1,36,37,2.7
1939,August,2018,Kittitas,WA,Passenger,51,34,85,29121,29206,0.29
1940,August,2018,Santa Fe,NM,Passenger,0,1,1,45,46,2.17
1941,August,2018,Lincoln,WA,Truck,0,0,0,4572,4572,0.0
1942,August,2018,Alameda,CA,Passenger,0,1,1,340,341,0.29
1943,August,2018,Ferry,WA,Truck,0,0,0,3550,3550,0.0
1944,August,2018,Nantucket,MA,Passenger,1,0,1,4,5,20.0
1945,August,2018,El Paso,CO,Passenger,3,1,4,756,760,0.53
1946,August,2018,Anne Arundel,MD,Passenger,0,1,1,452,453,0.22
1947,August,2018,Hardin,KY,Passenger,0,1,1,120,121,0.83
1948,August,2018,Lewis,WA,Passenger,83,62,145,57867,58012,0.25
1949,August,2018,Montgomery,PA,Passenger,2,0,2,36,38,5.26
1950,August,2018,Deschutes,OR,Passenger,2,0,2,163,165,1.21
1951,August,2018,Brevard,FL,Passenger,0,1,1,92,93,1.08
1952,August,2018,Monterey,CA,Passenger,0,1,1,186,187,0.53
1953,August,2018,Clallam,WA,Truck,0,0,0,21476,21476,0.0
1954,August,2018,Garfield,OK,Passenger,1,0,1,16,17,5.88
1955,August,2018,Montgomery,TX,Passenger,2,0,2,61,63,3.17
1956,August,2018,Pima,AZ,Passenger,1,1,2,413,415,0.48
1957,August,2018,Broward,FL,Passenger,1,1,2,134,136,1.47
1958,August,2018,Contra Costa,CA,Passenger,0,1,1,440,441,0.23
1959,August,2018,Island,WA,Truck,0,0,0,21052,21052,0.0
1960,August,2018,Jefferson,CO,Passenger,0,1,1,65,66,1.52
1961,August,2018,Morris,NJ,Passenger,1,0,1,16,17,5.88
1962,August,2018,Flathead,MT,Passenger,1,0,1,53,54,1.85
1963,August,2018,Stevens,WA,Passenger,12,26,38,31687,31725,0.12
1964,August,2018,San Juan,WA,Passenger,152,66,218,14152,14370,1.52
1965,August,2018,Nassau,NY,Passenger,2,0,2,36,38,5.26
1966,August,2018,Shelby,TN,Passenger,0,1,1,101,102,0.98
1967,August,2018,King,WA,Truck,7,1,8,182994,183002,0.0
1968,August,2018,San Francisco,CA,Passenger,1,1,2,121,123,1.63
1969,August,2018,Montgomery,MD,Passenger,1,0,1,283,284,0.35
1970,August,2018,Kootenai,ID,Passenger,0,1,1,220,221,0.45
1971,August,2018,Saratoga,NY,Passenger,1,0,1,63,64,1.56
1972,August,2018,Grays Harbor,WA,Truck,0,0,0,20309,20309,0.0
1973,August,2018,Santa Clara,CA,Passenger,8,0,8,376,384,2.08
1974,August,2018,Spokane,WA,Truck,1,0,1,93029,93030,0.0
1975,August,2018,Beaufort,SC,Passenger,1,0,1,38,39,2.56
1976,August,2018,Walla Walla,WA,Passenger,34,48,82,35872,35954,0.23
1977,August,2019,Grays Harbor,WA,Truck,0,0,0,20570,20570,0.0
1978,August,2019,Mason,WA,Passenger,130,127,257,47429,47686,0.54
1979,August,2019,Stevens,WA,Passenger,22,29,51,31707,31758,0.16
1980,August,2019,Lake,FL,Passenger,1,0,1,20,21,4.76
1981,August,2019,Fulton,GA,Passenger,0,2,2,102,104,1.92
1982,August,2019,Multnomah,OR,Passenger,5,6,11,744,755,1.46
1983,August,2019,Portsmouth,VA,Passenger,0,1,1,79,80,1.25
1984,August,2019,Carson City,NV,Passenger,1,0,1,11,12,8.33
1985,August,2019,Cascade,MT,Passenger,0,1,1,60,61,1.64
1986,August,2019,Franklin,WA,Truck,0,0,0,19494,19494,0.0
1987,August,2019,Brevard,FL,Passenger,0,1,1,84,85,1.18
1988,August,2019,Clark,NV,Passenger,4,2,6,691,697,0.86
1989,August,2019,Montgomery,PA,Passenger,2,0,2,37,39,5.13
1990,August,2019,Norfolk,MA,Passenger,1,0,1,38,39,2.56
1991,August,2019,New Haven,CT,Passenger,0,2,2,48,50,4.0
1992,August,2019,Randolph,NC,Passenger,1,0,1,6,7,14.29
1993,August,2019,Chelan,WA,Passenger,165,70,235,54453,54688,0.43
1994,August,2019,San Juan,WA,Passenger,225,73,298,14441,14739,2.02
1995,August,2019,Volusia,FL,Passenger,0,1,1,38,39,2.56
1996,August,2019,Williamson,TX,Passenger,0,2,2,145,147,1.36
1997,August,2019,Whitman,WA,Truck,0,0,0,8627,8627,0.0
1998,August,2019,Ferry,WA,Truck,0,0,0,3579,3579,0.0
1999,August,2019,Monroe,IL,Passenger,1,0,1,5,6,16.67
2000,August,2019,Garfield,WA,Passenger,0,1,1,1306,1307,0.08
2001,August,2019,Whatcom,WA,Passenger,902,450,1352,151212,152564,0.89
2002,August,2019,Alexandria,VA,Passenger,1,0,1,147,148,0.68
2003,August,2019,Collin,TX,Passenger,1,1,2,129,131,1.53
2004,August,2019,Adams,WA,Truck,0,0,0,5138,5138,0.0
2005,August,2019,Powhatan,VA,Passenger,1,0,1,0,1,100.0
2006,August,2019,Adams,WA,Passenger,5,5,10,12843,12853,0.08
2007,August,2019,Solano,CA,Passenger,1,0,1,208,209,0.48
2008,August,2019,Fresno,CA,Passenger,1,0,1,193,194,0.52
2009,August,2019,Houston,GA,Passenger,1,0,1,55,56,1.79
2010,August,2019,Dale,AL,Passenger,0,1,1,56,57,1.75
2011,August,2019,Charleston,SC,Passenger,1,0,1,114,115,0.87
2012,August,2019,Riverside,CA,Passenger,3,2,5,653,658,0.76
2013,August,2019,Charles,MD,Passenger,0,1,1,87,88,1.14
2014,August,2019,Pend Oreille,WA,Passenger,5,6,11,9495,9506,0.12
2015,August,2019,Palm Beach,FL,Passenger,0,1,1,86,87,1.15
2016,August,2019,Juneau,AK,Passenger,0,2,2,31,33,6.06
2017,August,2019,Thurston,WA,Passenger,927,661,1588,198371,199959,0.79
2018,August,2019,Cumberland,NC,Passenger,0,2,2,492,494,0.4
2019,August,2019,Hawaii,HI,Passenger,1,0,1,57,58,1.72
2020,August,2019,Carroll,NH,Passenger,0,1,1,3,4,25.0
2021,August,2019,Lincoln,WA,Truck,0,0,0,4683,4683,0.0
2023,August,2019,Moore,NC,Passenger,0,1,1,182,183,0.55
2024,August,2019,San Diego,CA,Passenger,10,3,13,2757,2770,0.47
2025,August,2019,Lewis,WA,Truck,0,0,0,25986,25986,0.0
2026,August,2019,Dakota,MN,Passenger,0,1,1,38,39,2.56
2027,August,2019,Spartanburg,SC,Passenger,0,1,1,38,39,2.56
2028,August,2019,Jones,GA,Passenger,1,0,1,1,2,50.0
2029,August,2019,Pima,AZ,Passenger,1,1,2,389,391,0.51
2030,August,2019,Travis,TX,Passenger,2,1,3,200,203,1.48
2031,August,2019,Valencia,NM,Passenger,1,0,1,6,7,14.29
2032,August,2019,Lee,FL,Passenger,1,0,1,51,52,1.92
2033,August,2019,Jefferson,NY,Passenger,0,2,2,214,216,0.93
2034,August,2019,Okanogan,WA,Truck,0,0,0,16479,16479,0.0
2035,August,2019,Asotin,WA,Truck,0,0,0,6684,6684,0.0
2036,August,2019,Greene,MO,Passenger,0,1,1,33,34,2.94
2037,August,2019,Snohomish,WA,Truck,0,0,0,122863,122863,0.0
2038,August,2019,Bexar,TX,Passenger,2,5,7,650,657,1.07
2039,August,2019,Broward,FL,Passenger,2,1,3,128,131,2.29
2040,August,2019,Yakima,WA,Truck,0,0,0,59390,59390,0.0
2041,August,2019,Rogers,OK,Passenger,1,0,1,5,6,16.67
2042,August,2019,Benton,WA,Passenger,280,291,571,134343,134914,0.42
2043,August,2019,Deschutes,OR,Passenger,2,0,2,154,156,1.28
2044,August,2019,Pacific,WA,Passenger,23,29,52,16045,16097,0.32
2045,August,2019,Allegheny,PA,Passenger,1,0,1,79,80,1.25
2046,August,2019,Kent,MI,Passenger,0,1,1,23,24,4.17
2047,August,2019,Sangamon,IL,Passenger,1,0,1,6,7,14.29
2048,August,2019,Grant,WA,Passenger,45,61,106,65169,65275,0.16
2049,August,2019,Lake,IL,Passenger,1,0,1,165,166,0.6
2050,August,2019,Goochland,VA,Passenger,1,1,2,259,261,0.77
2051,August,2019,Kitsap,WA,Truck,1,0,1,54161,54162,0.0
2052,August,2019,Santa Cruz,CA,Passenger,1,0,1,38,39,2.56
2053,August,2019,Spokane,WA,Truck,1,0,1,95528,95529,0.0
2054,August,2019,Oklahoma,OK,Passenger,0,1,1,125,126,0.79
2055,August,2019,Skamania,WA,Passenger,25,18,43,8755,8798,0.49
2056,August,2019,El Paso,TX,Passenger,3,0,3,480,483,0.62
2057,August,2019,Virginia Beach,VA,Passenger,1,0,1,701,702,0.14
2058,August,2019,Anne Arundel,MD,Passenger,1,2,3,438,441,0.68
2059,August,2019,El Paso,CO,Passenger,2,1,3,737,740,0.41
2060,August,2019,District of Columbia,DC,Passenger,1,1,2,210,212,0.94
2061,August,2019,Franklin,WA,Passenger,51,72,123,60233,60356,0.2
2062,August,2019,Prince George's,MD,Passenger,1,1,2,179,181,1.1
2063,August,2019,Harris,TX,Passenger,1,1,2,249,251,0.8
2064,August,2019,Spokane,WA,Passenger,575,439,1014,313142,314156,0.32
2065,August,2019,Bergen,NJ,Passenger,1,0,1,26,27,3.7
2066,August,2019,Walla Walla,WA,Truck,0,0,0,13652,13652,0.0
2067,August,2019,Cochise,AZ,Passenger,0,1,1,107,108,0.93
2068,August,2019,Grant,WA,Truck,0,0,0,26739,26739,0.0
2069,August,2019,Kittitas,WA,Truck,0,0,0,14523,14523,0.0
2070,August,2019,Osceola,FL,Passenger,1,0,1,41,42,2.38
2071,August,2019,Prince William,VA,Passenger,1,3,4,251,255,1.57
2072,August,2019,St. Mary's,MD,Passenger,1,0,1,217,218,0.46
2073,August,2019,Asotin,WA,Passenger,12,7,19,12642,12661,0.15
2074,August,2019,Sumter,FL,Passenger,0,1,1,9,10,10.0
2075,August,2019,Saratoga,NY,Passenger,1,0,1,52,53,1.89
2076,August,2019,Stafford,VA,Passenger,1,1,2,98,100,2.0
2077,August,2019,Sedgwick,KS,Passenger,1,1,2,98,100,2.0
2078,August,2019,Vigo,IN,Passenger,1,0,1,6,7,14.29
2079,August,2019,Nantucket,MA,Passenger,1,0,1,2,3,33.33
2080,August,2019,Yakima,WA,Passenger,112,108,220,165635,165855,0.13
2081,August,2019,Santa Rosa,FL,Passenger,1,0,1,87,88,1.14
2082,August,2019,Pinal,AZ,Passenger,2,0,2,192,194,1.03
2083,August,2019,Kern,CA,Passenger,0,1,1,223,224,0.45
2084,August,2019,Franklin,MA,Passenger,0,1,1,1,2,50.0
2085,August,2019,Caddo,LA,Passenger,0,1,1,19,20,5.0
2086,August,2019,Maui,HI,Passenger,1,0,1,43,44,2.27
2087,August,2019,Tarrant,TX,Passenger,2,0,2,201,203,0.99
2088,August,2019,Cowlitz,WA,Passenger,107,108,215,73286,73501,0.29
2089,August,2019,Albemarle,VA,Passenger,1,0,1,21,22,4.55
2090,August,2019,Camden,NJ,Passenger,0,1,1,24,25,4.0
2091,August,2019,San Joaquin,CA,Passenger,1,0,1,131,132,0.76
2092,August,2019,Snohomish,WA,Passenger,3641,1640,5281,533107,538388,0.98
2093,August,2019,Suffolk,MA,Passenger,0,1,1,37,38,2.63
2094,August,2019,Douglas,WA,Passenger,61,36,97,28181,28278,0.34
2095,August,2019,Garfield,WA,Truck,0,0,0,959,959,0.0
2096,August,2019,Fairbanks North Star,AK,Passenger,0,1,1,98,99,1.01
2097,August,2019,Shelby,OH,Passenger,0,1,1,1,2,50.0
2098,August,2019,DuPage,IL,Passenger,3,0,3,59,62,4.84
2099,August,2019,Kittitas,WA,Passenger,79,44,123,29744,29867,0.41
2100,August,2019,Penobscot,ME,Passenger,0,1,1,13,14,7.14
2101,August,2019,Alameda,CA,Passenger,4,1,5,294,299,1.67
2102,August,2019,Pacific,WA,Truck,0,0,0,7681,7681,0.0
2103,August,2019,Montgomery,TX,Passenger,1,0,1,60,61,1.64
2104,August,2019,Boone,MO,Passenger,0,1,1,10,11,9.09
2105,August,2019,Clallam,WA,Truck,1,0,1,21824,21825,0.0
2106,August,2019,Island,WA,Truck,0,0,0,21275,21275,0.0
2107,August,2019,Jefferson,CO,Passenger,0,2,2,59,61,3.28
2108,August,2019,Sarasota,FL,Passenger,1,0,1,27,28,3.57
2109,August,2019,Norfolk,VA,Passenger,2,2,4,347,351,1.14
2110,August,2019,Middlesex,MA,Passenger,1,1,2,113,115,1.74
2111,August,2019,San Mateo,CA,Passenger,2,1,3,115,118,2.54
2112,August,2019,Duval,FL,Passenger,1,2,3,374,377,0.8
2113,August,2019,Clackamas,OR,Passenger,1,1,2,215,217,0.92
2114,August,2019,DeKalb,IN,Passenger,1,0,1,1,2,50.0
2115,August,2019,New London,CT,Passenger,0,2,2,241,243,0.82
2116,August,2019,Frederick,MD,Passenger,1,1,2,80,82,2.44
2117,August,2019,Ramsey,MN,Passenger,1,0,1,38,39,2.56
2118,August,2019,Island,WA,Passenger,335,244,579,63461,64040,0.9
2119,August,2019,Ada,ID,Passenger,0,2,2,305,307,0.65
2120,August,2019,Cape May,NJ,Passenger,0,1,1,14,15,6.67
2121,August,2019,Shasta,CA,Passenger,1,0,1,40,41,2.44
2122,August,2019,Clallam,WA,Passenger,184,148,332,50729,51061,0.65
2123,August,2019,Pinellas,FL,Passenger,1,1,2,115,117,1.71
2124,August,2019,Wayne,MI,Passenger,0,1,1,64,65,1.54
2125,August,2019,Tulsa,OK,Passenger,1,1,2,47,49,4.08
2126,August,2019,Walla Walla,WA,Passenger,56,63,119,36230,36349,0.33
2127,August,2019,Columbia,WA,Passenger,2,2,4,2455,2459,0.16
2128,August,2019,Kitsap,WA,Passenger,1114,633,1747,181513,183260,0.95
2129,August,2019,Stevens,WA,Truck,0,0,0,18717,18717,0.0
2130,August,2019,DeKalb,GA,Passenger,1,0,1,78,79,1.27
2131,August,2019,Santa Fe,NM,Passenger,0,1,1,39,40,2.5
2132,August,2019,Honolulu,HI,Passenger,4,2,6,487,493,1.22
2133,August,2019,Flathead,MT,Passenger,1,0,1,65,66,1.52
2134,August,2019,Skagit,WA,Passenger,310,209,519,92306,92825,0.56
2135,August,2019,Santa Clara,CA,Passenger,4,2,6,365,371,1.62
2136,August,2019,Lincoln,WA,Passenger,2,10,12,7786,7798,0.15
2137,August,2019,Cowlitz,WA,Truck,0,0,0,28900,28900,0.0
2138,August,2019,Richmond,GA,Passenger,0,1,1,93,94,1.06
2139,August,2019,Manatee,FL,Passenger,1,0,1,34,35,2.86
2140,August,2019,Bucks,PA,Passenger,1,0,1,23,24,4.17
2141,August,2019,Dallas,TX,Passenger,1,0,1,207,208,0.48
2142,August,2019,Whitman,WA,Passenger,34,44,78,22711,22789,0.34
2143,August,2019,Wahkiakum,WA,Truck,0,0,0,1763,1763,0.0
2144,August,2019,Pierce,WA,Truck,0,0,0,140335,140335,0.0
2145,August,2019,Skagit,WA,Truck,1,0,1,32553,32554,0.0
2146,August,2019,Ventura,CA,Passenger,0,2,2,309,311,0.64
2147,August,2019,Okanogan,WA,Passenger,25,26,51,26190,26241,0.19
2148,August,2019,Guadalupe,TX,Passenger,1,0,1,70,71,1.41
2149,August,2019,Maricopa,AZ,Passenger,7,4,11,1531,1542,0.71
2150,August,2019,San Juan,WA,Truck,0,0,0,5891,5891,0.0
2151,August,2019,Klickitat,WA,Passenger,37,35,72,15624,15696,0.46
2152,August,2019,Contra Costa,CA,Passenger,2,2,4,368,372,1.08
2153,August,2019,Chelan,WA,Truck,0,0,0,22366,22366,0.0
2154,August,2019,Harrison,MS,Passenger,1,0,1,62,63,1.59
2155,August,2019,Howard,MD,Passenger,0,1,1,74,75,1.33
2156,August,2019,King,WA,Passenger,20005,7202,27207,1393126,1420333,1.92
2157,August,2019,Douglas,NE,Passenger,0,1,1,59,60,1.67
2158,August,2019,Calvert,MD,Passenger,0,2,2,89,91,2.2
2159,August,2019,Clark,WA,Truck,0,0,0,80861,80861,0.0
2160,August,2019,Pend Oreille,WA,Truck,0,0,0,5721,5721,0.0
2161,August,2019,Whatcom,WA,Truck,2,0,2,42997,42999,0.0
2162,August,2019,Putnam,TN,Passenger,0,1,1,3,4,25.0
2163,August,2019,Grays Harbor,WA,Passenger,88,85,173,48116,48289,0.36
2164,August,2019,Wahkiakum,WA,Passenger,2,2,4,3026,3030,0.13
2165,August,2019,Oldham,KY,Passenger,0,1,1,5,6,16.67
2166,August,2019,Larimer,CO,Passenger,1,0,1,58,59,1.69
2167,August,2019,Hennepin,MN,Passenger,3,1,4,105,109,3.67
2168,August,2019,Clay,FL,Passenger,0,1,1,84,85,1.18
2169,August,2019,Manassas,VA,Passenger,0,1,1,8,9,11.11
2170,August,2019,Saginaw,MI,Passenger,1,0,1,12,13,7.69
2171,August,2019,Nueces,TX,Passenger,1,1,2,92,94,2.13
2172,August,2019,Arlington,VA,Passenger,0,2,2,155,157,1.27
2173,August,2019,Columbia,WA,Truck,0,0,0,1531,1531,0.0
2174,August,2019,Fairfax,VA,Passenger,3,2,5,761,766,0.65
2175,August,2019,Denver,CO,Passenger,1,0,1,128,129,0.78
2176,August,2019,Kootenai,ID,Passenger,1,1,2,220,222,0.9
2177,August,2019,King,WA,Truck,6,1,7,182265,182272,0.0
2178,August,2019,Polk,FL,Passenger,1,0,1,68,69,1.45
2179,August,2019,Thurston,WA,Truck,0,0,0,55440,55440,0.0
2180,August,2019,Washoe,NV,Passenger,2,0,2,109,111,1.8
2181,August,2019,Skamania,WA,Truck,0,0,0,4075,4075,0.0
2182,August,2019,Berkshire,MA,Passenger,0,1,1,4,5,20.0
2183,August,2019,San Francisco,CA,Passenger,2,1,3,106,109,2.75
2184,August,2019,Ferry,WA,Passenger,5,2,7,4414,4421,0.16
2185,August,2019,Jefferson,WA,Truck,0,0,0,9675,9675,0.0
2186,August,2019,Pierce,WA,Passenger,1930,1584,3514,544791,548305,0.64
2187,August,2019,Los Angeles,CA,Passenger,8,6,14,1104,1118,1.25
2188,August,2019,Lewis,WA,Passenger,105,96,201,59363,59564,0.34
2189,August,2019,Mason,WA,Truck,0,0,0,20413,20413,0.0
2190,August,2019,Richland,SC,Passenger,0,1,1,159,160,0.62
2191,August,2019,Loudoun,VA,Passenger,1,0,1,94,95,1.05
2192,August,2019,Montgomery,AL,Passenger,0,1,1,41,42,2.38
2193,August,2019,Douglas,WA,Truck,0,0,0,12264,12264,0.0
2194,August,2019,Jefferson,WA,Passenger,205,122,327,25074,25401,1.29
2195,August,2019,Wilson,TX,Passenger,0,1,1,6,7,14.29
2196,August,2019,Cook,IL,Passenger,1,0,1,240,241,0.41
2197,August,2019,Shelby,TN,Passenger,0,1,1,92,93,1.08
2198,August,2019,Benton,WA,Truck,0,0,0,42177,42177,0.0
2199,August,2019,Orange,CA,Passenger,6,3,9,523,532,1.69
2200,August,2019,Klickitat,WA,Truck,0,0,0,8292,8292,0.0
2201,August,2019,Owyhee,ID,Passenger,1,0,1,4,5,20.0
2202,August,2019,Nassau,NY,Passenger,4,0,4,38,42,9.52
2203,August,2019,Clark,WA,Passenger,1647,959,2606,315547,318153,0.82
2204,August,2019,Twin Falls,ID,Passenger,0,1,1,26,27,3.7
2205,August,2019,RÃ­o Grande,PR,Passenger,1,0,1,1,2,50.0
2206,August,2019,Klamath,OR,Passenger,1,0,1,39,40,2.5
2207,August,2019,Tuolumne,CA,Passenger,0,1,1,11,12,8.33
2208,August,2019,Harnett,NC,Passenger,1,1,2,210,212,0.94
2209,August,2019,Washtenaw,MI,Passenger,1,0,1,41,42,2.38
2210,August,2019,Placer,CA,Passenger,1,0,1,98,99,1.01
2211,August,2020,Kauai,HI,Passenger,1,0,1,13,14,7.14
2212,August,2020,Klickitat,WA,Truck,0,0,0,8105,8105,0.0
2213,August,2020,Alameda,CA,Passenger,2,0,2,266,268,0.75
2214,August,2020,Bucks,PA,Passenger,1,0,1,20,21,4.76
2215,August,2020,Pacific,WA,Truck,0,0,0,7724,7724,0.0
2216,August,2020,Howard,MD,Passenger,0,1,1,68,69,1.45
2217,August,2020,St. Louis,MO,Passenger,1,0,1,96,97,1.03
2218,August,2020,King,WA,Truck,5,1,6,183316,183322,0.0
2219,August,2020,Okaloosa,FL,Passenger,0,1,1,139,140,0.71
2220,August,2020,Yakima,WA,Passenger,146,122,268,166128,166396,0.16
2221,August,2020,Hudson,NJ,Passenger,1,0,1,38,39,2.56
2222,August,2020,Maui,HI,Passenger,1,0,1,30,31,3.23
2223,August,2020,Fairfax,VA,Passenger,4,3,7,741,748,0.94
2224,August,2020,Collin,TX,Passenger,1,1,2,119,121,1.65
2225,August,2020,Richland,SC,Passenger,0,1,1,146,147,0.68
2226,August,2020,Allegheny,PA,Passenger,1,0,1,71,72,1.39
2227,August,2020,Charleston,SC,Passenger,2,0,2,97,99,2.02
2228,August,2020,Harrison,MS,Passenger,1,0,1,52,53,1.89
2229,August,2020,Boone,MO,Passenger,0,1,1,10,11,9.09
2230,August,2020,Lake,IL,Passenger,1,0,1,161,162,0.62
2231,August,2020,Washoe,NV,Passenger,1,0,1,100,101,0.99
2232,August,2020,Penobscot,ME,Passenger,0,1,1,14,15,6.67
2234,August,2020,Utah,UT,Passenger,0,1,1,128,129,0.78
2235,August,2020,DeKalb,IN,Passenger,1,0,1,1,2,50.0
2236,August,2020,Klamath,OR,Passenger,1,0,1,32,33,3.03
2237,August,2020,Skamania,WA,Passenger,31,22,53,8376,8429,0.63
2238,August,2020,Rogers,OK,Passenger,1,0,1,4,5,20.0
2239,August,2020,Multnomah,OR,Passenger,4,6,10,702,712,1.4
2240,August,2020,Grant,WA,Passenger,66,75,141,65404,65545,0.22
2241,August,2020,Williams,ND,Passenger,0,1,1,11,12,8.33
2242,August,2020,Spokane,WA,Truck,1,0,1,99446,99447,0.0
2243,August,2020,Frederick,MD,Passenger,1,1,2,74,76,2.63
2244,August,2020,Harris,TX,Passenger,1,0,1,217,218,0.46
2245,August,2020,Vigo,IN,Passenger,1,0,1,5,6,16.67
2246,August,2020,RÃ­o Grande,PR,Passenger,1,0,1,1,2,50.0
2247,August,2020,Richmond,GA,Passenger,0,1,1,82,83,1.2
2248,August,2020,Erie,NY,Passenger,1,0,1,45,46,2.17
2249,August,2020,Columbia,WA,Truck,0,0,0,1526,1526,0.0
2250,August,2020,Albemarle,VA,Passenger,1,0,1,20,21,4.76
2251,August,2020,Travis,TX,Passenger,2,1,3,171,174,1.72
2252,August,2020,New Haven,CT,Passenger,0,2,2,35,37,5.41
2253,August,2020,Lincoln,WA,Passenger,5,11,16,7625,7641,0.21
2254,August,2020,Hamilton,IN,Passenger,1,0,1,39,40,2.5
2255,August,2020,San Diego,CA,Passenger,15,5,20,2745,2765,0.72
2256,August,2020,Prince William,VA,Passenger,2,2,4,222,226,1.77
2257,August,2020,Santa Clara,CA,Passenger,8,2,10,274,284,3.52
2258,August,2020,Cowlitz,WA,Passenger,152,120,272,72131,72403,0.38
2259,August,2020,Lincoln,WA,Truck,0,0,0,4652,4652,0.0
2260,August,2020,Calvert,MD,Passenger,0,2,2,87,89,2.25
2261,August,2020,Whatcom,WA,Passenger,1111,512,1623,149201,150824,1.08
2262,August,2020,Whatcom,WA,Truck,3,0,3,43278,43281,0.01
2263,August,2020,Adams,WA,Truck,0,0,0,5303,5303,0.0
2264,August,2020,Ulster,NY,Passenger,1,0,1,8,9,11.11
2265,August,2020,Stafford,VA,Passenger,1,1,2,91,93,2.15
2266,August,2020,Pierce,WA,Truck,0,0,0,143398,143398,0.0
2267,August,2020,San Juan,WA,Passenger,320,100,420,13928,14348,2.93
2268,August,2020,Prince George's,MD,Passenger,2,1,3,154,157,1.91
2269,August,2020,El Paso,CO,Passenger,2,0,2,706,708,0.28
2270,August,2020,Owyhee,ID,Passenger,1,0,1,3,4,25.0
2271,August,2020,Franklin,WA,Truck,0,0,0,20187,20187,0.0
2272,August,2020,Columbia,WA,Passenger,3,3,6,2423,2429,0.25
2273,August,2020,Clark,NV,Passenger,2,2,4,665,669,0.6
2274,August,2020,San Joaquin,CA,Passenger,1,0,1,121,122,0.82
2275,August,2020,Grays Harbor,WA,Passenger,111,116,227,48357,48584,0.47
2276,August,2020,Jefferson,WA,Truck,0,0,0,9539,9539,0.0
2277,August,2020,Kittitas,WA,Passenger,110,47,157,29764,29921,0.52
2278,August,2020,Portsmouth,VA,Passenger,0,1,1,75,76,1.32
2279,August,2020,Sedgwick,KS,Passenger,1,1,2,89,91,2.2
2280,August,2020,Brevard,FL,Passenger,0,1,1,81,82,1.22
2281,August,2020,Palm Beach,FL,Passenger,0,1,1,79,80,1.25
2282,August,2020,Pima,AZ,Passenger,3,1,4,328,332,1.2
2283,August,2020,Douglas,NE,Passenger,0,1,1,49,50,2.0
2284,August,2020,Carroll,MD,Passenger,0,1,1,20,21,4.76
2285,August,2020,Spartanburg,SC,Passenger,0,1,1,48,49,2.04
2286,August,2020,Manassas,VA,Passenger,0,1,1,5,6,16.67
2287,August,2020,Okanogan,WA,Passenger,40,34,74,25977,26051,0.28
2288,August,2020,Shelby,TN,Passenger,0,1,1,84,85,1.18
2289,August,2020,Monroe,IL,Passenger,1,0,1,4,5,20.0
2290,August,2020,Montgomery,PA,Passenger,1,0,1,27,28,3.57
2291,August,2020,Twin Falls,ID,Passenger,0,1,1,22,23,4.35
2292,August,2020,Orange,CA,Passenger,6,2,8,474,482,1.66
2293,August,2020,Greene,MO,Passenger,0,1,1,33,34,2.94
2294,August,2020,Denver,CO,Passenger,1,0,1,114,115,0.87
2295,August,2020,Morris,NJ,Passenger,1,0,1,18,19,5.26
2296,August,2020,Pinal,AZ,Passenger,1,0,1,177,178,0.56
2297,August,2020,Garfield,WA,Truck,0,0,0,994,994,0.0
2298,August,2020,Monterey,CA,Passenger,0,1,1,161,162,0.62
2299,August,2020,Mason,WA,Passenger,162,133,295,47407,47702,0.62
2300,August,2020,Boulder,CO,Passenger,0,1,1,41,42,2.38
2301,August,2020,Houston,GA,Passenger,1,0,1,53,54,1.85
2302,August,2020,Gwinnett,GA,Passenger,1,0,1,72,73,1.37
2303,August,2020,Adams,WA,Passenger,9,7,16,12868,12884,0.12
2304,August,2020,Jones,GA,Passenger,1,0,1,1,2,50.0
2305,August,2020,Solano,CA,Passenger,1,0,1,207,208,0.48
2306,August,2020,Rockingham,NH,Passenger,1,0,1,21,22,4.55
2307,August,2020,Powhatan,VA,Passenger,1,0,1,0,1,100.0
2308,August,2020,Duval,FL,Passenger,0,2,2,356,358,0.56
2309,August,2020,Polk,FL,Passenger,1,0,1,61,62,1.61
2310,August,2020,Asotin,WA,Truck,0,0,0,6667,6667,0.0
2311,August,2020,San Francisco,CA,Passenger,2,1,3,90,93,3.23
2312,August,2020,Cascade,MT,Passenger,0,1,1,53,54,1.85
2313,August,2020,Kern,CA,Passenger,0,1,1,221,222,0.45
2314,August,2020,Thurston,WA,Passenger,1194,752,1946,197105,199051,0.98
2315,August,2020,Bartow,GA,Passenger,0,1,1,4,5,20.0
2316,August,2020,Clackamas,OR,Passenger,2,0,2,184,186,1.08
2317,August,2020,Grays Harbor,WA,Truck,0,0,0,21033,21033,0.0
2318,August,2020,Chelan,WA,Truck,0,0,0,22677,22677,0.0
2319,August,2020,Kings,NY,Passenger,1,0,1,63,64,1.56
2320,August,2020,Charles,MD,Passenger,1,1,2,74,76,2.63
2321,August,2020,Anne Arundel,MD,Passenger,0,1,1,400,401,0.25
2322,August,2020,Hawaii,HI,Passenger,1,0,1,54,55,1.82
2323,August,2020,Carson City,NV,Passenger,1,0,1,10,11,9.09
2324,August,2020,King,WA,Passenger,25173,7814,32987,1370893,1403880,2.35
2325,August,2020,Honolulu,HI,Passenger,4,2,6,433,439,1.37
2326,August,2020,Randolph,NC,Passenger,1,0,1,7,8,12.5
2327,August,2020,Alexandria,VA,Passenger,2,0,2,134,136,1.47
2328,August,2020,Pinellas,FL,Passenger,1,1,2,104,106,1.89
2329,August,2020,Benton,WA,Truck,0,0,0,43024,43024,0.0
2330,August,2020,Fresno,CA,Passenger,1,0,1,172,173,0.58
2331,August,2020,Pend Oreille,WA,Truck,0,0,0,5746,5746,0.0
2332,August,2020,Lake,FL,Passenger,1,0,1,22,23,4.35
2333,August,2020,Norfolk,VA,Passenger,2,2,4,343,347,1.15
2334,August,2020,Okanogan,WA,Truck,0,0,0,16543,16543,0.0
2335,August,2020,Lewis,WA,Truck,0,0,0,26362,26362,0.0
2336,August,2020,District of Columbia,DC,Passenger,2,1,3,200,203,1.48
2337,August,2020,Montgomery,AL,Passenger,0,1,1,39,40,2.5
2338,August,2020,San Juan,WA,Truck,0,0,0,5838,5838,0.0
2339,August,2020,Bradley,TN,Passenger,1,0,1,1,2,50.0
2340,August,2020,Ada,ID,Passenger,0,1,1,256,257,0.39
2341,August,2020,St. Mary's,MD,Passenger,1,0,1,217,218,0.46
2342,August,2020,Harnett,NC,Passenger,1,0,1,196,197,0.51
2343,August,2020,Franklin,WA,Passenger,66,77,143,60794,60937,0.23
2344,August,2020,Deschutes,OR,Passenger,1,0,1,128,129,0.78
2345,August,2020,Nassau,NY,Passenger,4,0,4,29,33,12.12
2346,August,2020,Spokane,WA,Passenger,781,505,1286,317481,318767,0.4
2347,August,2020,Riverside,CA,Passenger,3,0,3,609,612,0.49
2348,August,2020,Middlesex,MA,Passenger,1,1,2,91,93,2.15
2349,August,2020,Snohomish,WA,Truck,0,0,0,124595,124595,0.0
2350,August,2020,Sumter,FL,Passenger,0,1,1,10,11,9.09
2351,August,2020,Grant,WA,Truck,0,0,0,27237,27237,0.0
2352,August,2020,Montgomery,OH,Passenger,0,1,1,47,48,2.08
2353,August,2020,Ramsey,MN,Passenger,1,0,1,37,38,2.63
2354,August,2020,Asotin,WA,Passenger,17,14,31,12356,12387,0.25
2355,August,2020,Los Angeles,CA,Passenger,8,11,19,981,1000,1.9
2356,August,2020,Nueces,TX,Passenger,1,0,1,83,84,1.19
2357,August,2020,Pacific,WA,Passenger,32,33,65,15709,15774,0.41
2358,August,2020,Shelby,OH,Passenger,0,1,1,1,2,50.0
2359,August,2020,Benton,WA,Passenger,380,322,702,134321,135023,0.52
2360,August,2020,Arapahoe,CO,Passenger,1,0,1,129,130,0.77
2361,August,2020,Dakota,MN,Passenger,0,1,1,34,35,2.86
2362,August,2020,New London,CT,Passenger,1,2,3,239,242,1.24
2363,August,2020,Washington,OR,Passenger,1,0,1,432,433,0.23
2364,August,2020,Stevens,WA,Truck,0,0,0,18653,18653,0.0
2365,August,2020,Shasta,CA,Passenger,1,0,1,36,37,2.7
2366,August,2020,Thurston,WA,Truck,0,0,0,55974,55974,0.0
2367,August,2020,Contra Costa,CA,Passenger,4,3,7,302,309,2.27
2368,August,2020,Sarasota,FL,Passenger,2,0,2,22,24,8.33
2369,August,2020,Klickitat,WA,Passenger,57,42,99,15043,15142,0.65
2370,August,2020,Kitsap,WA,Truck,0,0,0,54174,54174,0.0
2371,August,2020,Kittitas,WA,Truck,0,0,0,14559,14559,0.0
2372,August,2020,Whitman,WA,Truck,0,0,0,8480,8480,0.0
2373,August,2020,San Mateo,CA,Passenger,0,1,1,105,106,0.94
2374,August,2020,Skagit,WA,Truck,1,0,1,32634,32635,0.0
2375,August,2020,Clark,WA,Passenger,2135,1076,3211,318235,321446,1.0
2376,August,2020,Clallam,WA,Passenger,239,171,410,49948,50358,0.81
2377,August,2020,Juneau,AK,Passenger,0,1,1,27,28,3.57
2378,August,2020,Howard,IN,Passenger,0,1,1,3,4,25.0
2379,August,2020,Lewis,WA,Passenger,112,117,229,58206,58435,0.39
2380,August,2020,Lee,FL,Passenger,1,0,1,48,49,2.04
2381,August,2020,Skamania,WA,Truck,0,0,0,4023,4023,0.0
2382,August,2020,Douglas,WA,Truck,0,0,0,12339,12339,0.0
2383,August,2020,Fort Bend,TX,Passenger,1,0,1,45,46,2.17
2384,August,2020,Ventura,CA,Passenger,1,2,3,278,281,1.07
2385,August,2020,Kootenai,ID,Passenger,1,0,1,216,217,0.46
2386,August,2020,Jefferson,WA,Passenger,249,144,393,24652,25045,1.57
2387,August,2020,Camden,NJ,Passenger,0,1,1,22,23,4.35
2388,August,2020,St. Clair,IL,Passenger,1,0,1,140,141,0.71
2389,August,2020,Carroll,NH,Passenger,0,1,1,5,6,16.67
2390,August,2020,Chelan,WA,Passenger,248,80,328,54176,54504,0.6
2391,August,2020,Maricopa,AZ,Passenger,5,7,12,1363,1375,0.87
2392,August,2020,Stevens,WA,Passenger,35,36,71,30494,30565,0.23
2393,August,2020,Pierce,WA,Passenger,2519,1704,4223,552476,556699,0.76
2394,August,2020,Saginaw,MI,Passenger,1,0,1,9,10,10.0
2395,August,2020,DuPage,IL,Passenger,3,0,3,57,60,5.0
2396,August,2020,Jefferson,NY,Passenger,0,1,1,210,211,0.47
2397,August,2020,Loudoun,VA,Passenger,1,0,1,82,83,1.2
2398,August,2020,Fulton,GA,Passenger,1,2,3,100,103,2.91
2399,August,2020,Dallas,TX,Passenger,1,0,1,186,187,0.53
2400,August,2020,Island,WA,Passenger,434,273,707,62809,63516,1.11
2401,August,2020,Putnam,TN,Passenger,0,1,1,3,4,25.0
2402,August,2020,Kitsap,WA,Passenger,1400,699,2099,179638,181737,1.15
2403,August,2020,Mason,WA,Truck,0,0,0,20779,20779,0.0
2404,August,2020,Suffolk,VA,Passenger,1,0,1,125,126,0.79
2405,August,2020,Walla Walla,WA,Truck,0,0,0,13750,13750,0.0
2406,August,2020,Douglas,CO,Passenger,0,1,1,79,80,1.25
2407,August,2020,Santa Cruz,CA,Passenger,1,0,1,32,33,3.03
2408,August,2020,Arlington,VA,Passenger,0,2,2,148,150,1.33
2409,August,2020,DeKalb,GA,Passenger,1,0,1,77,78,1.28
2410,August,2020,Cape May,NJ,Passenger,0,1,1,13,14,7.14
2411,August,2020,Garfield,WA,Passenger,0,1,1,1350,1351,0.07
2412,August,2020,Whitman,WA,Passenger,46,48,94,22021,22115,0.43
2413,August,2020,Kent,MI,Passenger,0,1,1,24,25,4.0
2414,August,2020,Williamson,TX,Passenger,0,2,2,129,131,1.53
2415,August,2020,Ferry,WA,Passenger,7,3,10,4309,4319,0.23
2416,August,2020,Island,WA,Truck,1,0,1,21228,21229,0.0
2417,August,2020,Pend Oreille,WA,Passenger,8,5,13,9230,9243,0.14
2418,August,2020,Yakima,WA,Truck,0,0,0,60420,60420,0.0
2419,August,2020,Skagit,WA,Passenger,432,222,654,91256,91910,0.71
2420,August,2020,Placer,CA,Passenger,2,0,2,84,86,2.33
2421,August,2020,Clark,WA,Truck,0,0,0,82716,82716,0.0
2422,August,2020,Montgomery,TX,Passenger,1,0,1,49,50,2.0
2423,August,2020,Wahkiakum,WA,Passenger,6,6,12,3028,3040,0.39
2424,August,2020,Ferry,WA,Truck,0,0,0,3582,3582,0.0
2425,August,2020,Hennepin,MN,Passenger,3,0,3,88,91,3.3
2426,August,2020,Sacramento,CA,Passenger,1,0,1,255,256,0.39
2427,August,2020,Snohomish,WA,Passenger,4645,1782,6427,536082,542509,1.18
2428,August,2020,Larimer,CO,Passenger,1,0,1,51,52,1.92
2429,August,2020,Clallam,WA,Truck,1,0,1,21704,21705,0.0
2430,August,2020,Denton,TX,Passenger,1,0,1,89,90,1.11
2431,August,2020,El Paso,TX,Passenger,3,0,3,414,417,0.72
2432,August,2020,Queens,NY,Passenger,1,0,1,50,51,1.96
2433,August,2020,Fairbanks North Star,AK,Passenger,0,1,1,95,96,1.04
2434,August,2020,Chesapeake,VA,Passenger,0,2,2,415,417,0.48
2435,August,2020,Moore,NC,Passenger,0,2,2,154,156,1.28
2436,August,2020,Valencia,NM,Passenger,1,0,1,6,7,14.29
2437,August,2020,Bexar,TX,Passenger,4,5,9,589,598,1.51
2438,August,2020,Wilson,TX,Passenger,0,1,1,5,6,16.67
2439,August,2020,Tulsa,OK,Passenger,1,1,2,42,44,4.55
2440,August,2020,Suffolk,MA,Passenger,0,2,2,35,37,5.41
2441,August,2020,Cowlitz,WA,Truck,0,0,0,28911,28911,0.0
2442,August,2020,Flathead,MT,Passenger,1,0,1,55,56,1.79
2443,August,2020,Broward,FL,Passenger,2,1,3,108,111,2.7
2444,August,2020,Douglas,WA,Passenger,77,41,118,28010,28128,0.42
2445,August,2020,Walla Walla,WA,Passenger,81,65,146,35891,36037,0.41
2446,August,2020,Virginia Beach,VA,Passenger,1,0,1,659,660,0.15
2447,August,2020,Goochland,VA,Passenger,3,2,5,250,255,1.96
2448,August,2020,Washtenaw,MI,Passenger,1,0,1,36,37,2.7
2449,August,2020,Cumberland,NC,Passenger,0,3,3,454,457,0.66
2450,August,2020,Clay,FL,Passenger,0,1,1,81,82,1.22
2451,August,2020,Wahkiakum,WA,Truck,0,0,0,1745,1745,0.0
2452,August,2020,Jefferson,CO,Passenger,0,1,1,56,57,1.75
2453,August,2020,Oldham,KY,Passenger,0,1,1,4,5,20.0
2454,August,2020,Nassau,FL,Passenger,1,0,1,36,37,2.7
2455,August,2020,Guadalupe,TX,Passenger,1,0,1,60,61,1.64
2456,August,2020,Salt Lake,UT,Passenger,0,1,1,183,184,0.54
2457,August,2020,New York,NY,Passenger,1,0,1,56,57,1.75
2458,August,2021,Richmond,NY,Passenger,1,0,1,8,9,11.11
2459,August,2021,Fort Bend,TX,Passenger,1,0,1,35,36,2.78
2460,August,2021,Lake,IL,Passenger,2,0,2,156,158,1.27
2461,August,2021,San Diego,CA,Passenger,17,7,24,2518,2542,0.94
2462,August,2021,Owyhee,ID,Passenger,1,0,1,2,3,33.33
2463,August,2021,Island,WA,Truck,0,0,0,21590,21590,0.0
2464,August,2021,Columbia,WA,Truck,0,0,0,1539,1539,0.0
2465,August,2021,Pennington,SD,Passenger,1,0,1,31,32,3.12
2466,August,2021,Norfolk,VA,Passenger,3,3,6,310,316,1.9
2467,August,2021,Geary,KS,Passenger,1,0,1,95,96,1.04
2468,August,2021,San Francisco,CA,Passenger,0,1,1,84,85,1.18
2469,August,2021,Snohomish,WA,Passenger,6310,2137,8447,539419,547866,1.54
2470,August,2021,Hidalgo,TX,Passenger,0,1,1,52,53,1.89
2471,August,2021,Kings,NY,Passenger,1,0,1,67,68,1.47
2472,August,2021,Hampshire,MA,Passenger,1,0,1,6,7,14.29
2473,August,2021,Portsmouth,VA,Passenger,0,1,1,76,77,1.3
2474,August,2021,Miami-Dade,FL,Passenger,1,0,1,95,96,1.04
2475,August,2021,Chelan,WA,Passenger,364,102,466,54718,55184,0.84
2476,August,2021,Houston,GA,Passenger,1,0,1,46,47,2.13
2477,August,2021,Lewis,WA,Passenger,181,151,332,59647,59979,0.55
2478,August,2021,Sonoma,CA,Passenger,0,1,1,82,83,1.2
2479,August,2021,Suffolk,MA,Passenger,0,2,2,28,30,6.67
2480,August,2021,Santa Clara,CA,Passenger,8,2,10,243,253,3.95
2481,August,2021,Sevier,AR,Passenger,0,1,1,0,1,100.0
2482,August,2021,Thurston,WA,Truck,0,0,0,56421,56421,0.0
2483,August,2021,Queens,NY,Passenger,2,0,2,48,50,4.0
2484,August,2021,Carroll,NH,Passenger,0,1,1,5,6,16.67
2485,August,2021,New Haven,CT,Passenger,0,2,2,28,30,6.67
2486,August,2021,Skamania,WA,Passenger,52,38,90,8389,8479,1.06
2487,August,2021,Albemarle,VA,Passenger,1,0,1,20,21,4.76
2488,August,2021,Wichita,TX,Passenger,1,0,1,41,42,2.38
2489,August,2021,Sacramento,CA,Passenger,2,0,2,212,214,0.93
2490,August,2021,Moore,NC,Passenger,0,1,1,123,124,0.81
2491,August,2021,Greene,MO,Passenger,0,1,1,28,29,3.45
2492,August,2021,Boulder,CO,Passenger,0,1,1,39,40,2.5
2493,August,2021,Wahkiakum,WA,Passenger,16,8,24,3079,3103,0.77
2494,August,2021,Garfield,WA,Truck,0,0,0,1003,1003,0.0
2495,August,2021,Kern,CA,Passenger,0,1,1,203,204,0.49
2496,August,2021,Pierce,WA,Truck,0,0,0,145668,145668,0.0
2497,August,2021,Walla Walla,WA,Truck,0,0,0,14079,14079,0.0
2498,August,2021,Philadelphia,PA,Passenger,1,0,1,44,45,2.22
2499,August,2021,Arlington,VA,Passenger,0,1,1,133,134,0.75
2500,August,2021,Calvert,MD,Passenger,0,2,2,86,88,2.27
2501,August,2021,Prince William,VA,Passenger,1,1,2,203,205,0.98
2502,August,2021,Anne Arundel,MD,Passenger,4,3,7,374,381,1.84
2503,August,2021,Grant,WA,Truck,0,0,0,27997,27997,0.0
2504,August,2021,Wilson,NC,Passenger,1,0,1,0,1,100.0
2505,August,2021,Missoula,MT,Passenger,1,0,1,52,53,1.89
2506,August,2021,Wahkiakum,WA,Truck,0,0,0,1801,1801,0.0
2507,August,2021,Baltimore,MD,Passenger,1,0,1,93,94,1.06
2508,August,2021,Cowlitz,WA,Passenger,237,152,389,72118,72507,0.54
2509,August,2021,Klickitat,WA,Truck,0,0,0,8331,8331,0.0
2510,August,2021,Montgomery,PA,Passenger,2,0,2,22,24,8.33
2511,August,2021,Randolph,NC,Passenger,1,0,1,5,6,16.67
2512,August,2021,Stafford,VA,Passenger,2,1,3,98,101,2.97
2513,August,2021,Whatcom,WA,Truck,4,0,4,43867,43871,0.01
2514,August,2021,King,WA,Truck,5,1,6,184053,184059,0.0
2515,August,2021,Juneau,AK,Passenger,0,1,1,26,27,3.7
2516,August,2021,Whitman,WA,Passenger,63,52,115,21930,22045,0.52
2517,August,2021,Santa Cruz,CA,Passenger,1,0,1,25,26,3.85
2518,August,2021,Hudson,NJ,Passenger,1,0,1,41,42,2.38
2519,August,2021,Wilson,TX,Passenger,0,1,1,3,4,25.0
2520,August,2021,San Juan,WA,Truck,0,0,0,5976,5976,0.0
2521,August,2021,Polk,FL,Passenger,1,0,1,56,57,1.75
2522,August,2021,Virginia Beach,VA,Passenger,2,0,2,602,604,0.33
2523,August,2021,Garfield,WA,Passenger,0,3,3,1369,1372,0.22
2524,August,2021,Snohomish,WA,Truck,1,0,1,126015,126016,0.0
2525,August,2021,Clackamas,OR,Passenger,2,0,2,167,169,1.18
2526,August,2021,Onslow,NC,Passenger,0,1,1,178,179,0.56
2527,August,2021,Erie,NY,Passenger,1,0,1,36,37,2.7
2528,August,2021,New London,CT,Passenger,1,3,4,214,218,1.83
2529,August,2021,Champaign,IL,Passenger,1,0,1,10,11,9.09
2530,August,2021,Clallam,WA,Truck,1,0,1,22024,22025,0.0
2531,August,2021,Flathead,MT,Passenger,1,0,1,42,43,2.33
2532,August,2021,Whatcom,WA,Passenger,1520,628,2148,150496,152644,1.41
2533,August,2021,Carroll,MD,Passenger,0,1,1,17,18,5.56
2534,August,2021,Burlington,NJ,Passenger,0,1,1,124,125,0.8
2535,August,2021,Spokane,WA,Truck,0,0,0,102463,102463,0.0
2536,August,2021,Montgomery,OH,Passenger,0,1,1,55,56,1.79
2537,August,2021,Skagit,WA,Passenger,620,287,907,91723,92630,0.98
2538,August,2021,Howard,IN,Passenger,0,1,1,5,6,16.67
2539,August,2021,Howard,MD,Passenger,0,1,1,58,59,1.69
2540,August,2021,Collin,TX,Passenger,1,1,2,105,107,1.87
2541,August,2021,Spokane,WA,Passenger,1158,684,1842,326045,327887,0.56
2542,August,2021,Franklin,WA,Truck,0,0,0,20720,20720,0.0
2543,August,2021,Larimer,CO,Passenger,1,0,1,48,49,2.04
2544,August,2021,Pacific,WA,Truck,0,0,0,7973,7973,0.0
2545,August,2021,Yakima,WA,Truck,0,0,0,61772,61772,0.0
2546,August,2021,Jefferson,NY,Passenger,0,1,1,210,211,0.47
2547,August,2021,Montgomery,MD,Passenger,3,1,4,207,211,1.9
2548,August,2021,Fairbanks North Star,AK,Passenger,0,1,1,79,80,1.25
2549,August,2021,El Paso,TX,Passenger,3,0,3,358,361,0.83
2550,August,2021,Kittitas,WA,Truck,0,0,0,14782,14782,0.0
2551,August,2021,Walla Walla,WA,Passenger,121,82,203,36479,36682,0.55
2552,August,2021,San Luis Obispo,CA,Passenger,1,0,1,58,59,1.69
2553,August,2021,Mason,WA,Passenger,227,147,374,48071,48445,0.77
2554,August,2021,Dallas,TX,Passenger,1,0,1,144,145,0.69
2555,August,2021,Sarasota,FL,Passenger,2,0,2,28,30,6.67
2556,August,2021,Clallam,WA,Passenger,350,220,570,50504,51074,1.12
2557,August,2021,Anchorage,AK,Passenger,1,0,1,132,133,0.75
2558,August,2021,Fresno,CA,Passenger,1,0,1,161,162,0.62
2559,August,2021,New York,NY,Passenger,1,0,1,39,40,2.5
2560,August,2021,Okaloosa,FL,Passenger,0,1,1,111,112,0.89
2561,August,2021,Hennepin,MN,Passenger,3,0,3,72,75,4.0
2562,August,2021,Okanogan,WA,Passenger,66,45,111,26473,26584,0.42
2563,August,2021,Travis,TX,Passenger,3,3,6,141,147,4.08
2564,August,2021,Maricopa,AZ,Passenger,6,2,8,1098,1106,0.72
2565,August,2021,Riverside,CA,Passenger,5,1,6,530,536,1.12
2566,August,2021,Gwinnett,GA,Passenger,1,0,1,58,59,1.69
2567,August,2021,Louisa,VA,Passenger,0,1,1,1,2,50.0
2569,August,2021,Los Angeles,CA,Passenger,10,9,19,849,868,2.19
2570,August,2021,Rogers,OK,Passenger,1,0,1,3,4,25.0
2571,August,2021,Klamath,OR,Passenger,1,0,1,28,29,3.45
2572,August,2021,Salt Lake,UT,Passenger,0,1,1,158,159,0.63
2573,August,2021,Las Animas,CO,Passenger,1,0,1,0,1,100.0
2574,August,2021,DuPage,IL,Passenger,1,0,1,51,52,1.92
2575,August,2021,Kitsap,WA,Passenger,1952,888,2840,180672,183512,1.55
2576,August,2021,Adams,WA,Passenger,16,14,30,13041,13071,0.23
2577,August,2021,Skamania,WA,Truck,0,0,0,4036,4036,0.0
2578,August,2021,Alexandria,VA,Passenger,2,0,2,122,124,1.61
2579,August,2021,Grays Harbor,WA,Passenger,177,147,324,49506,49830,0.65
2580,August,2021,Stevens,WA,Passenger,48,44,92,30285,30377,0.3
2581,August,2021,San Mateo,CA,Passenger,1,0,1,93,94,1.06
2582,August,2021,Rockdale,GA,Passenger,1,0,1,8,9,11.11
2583,August,2021,Williamson,TX,Passenger,0,2,2,100,102,1.96
2584,August,2021,Pend Oreille,WA,Truck,0,0,0,5726,5726,0.0
2585,August,2021,Honolulu,HI,Passenger,5,3,8,365,373,2.14
2586,August,2021,Klickitat,WA,Passenger,82,51,133,15361,15494,0.86
2587,August,2021,Multnomah,OR,Passenger,2,7,9,626,635,1.42
2588,August,2021,Chelan,WA,Truck,0,0,0,23088,23088,0.0
2589,August,2021,Denver,CO,Passenger,1,0,1,116,117,0.85
2590,August,2021,Leavenworth,KS,Passenger,0,1,1,114,115,0.87
2591,August,2021,Broward,FL,Passenger,2,0,2,104,106,1.89
2592,August,2021,Plaquemines,LA,Passenger,0,1,1,16,17,5.88
2593,August,2021,DeKalb,GA,Passenger,1,0,1,59,60,1.67
2594,August,2021,Penobscot,ME,Passenger,0,1,1,8,9,11.11
2595,August,2021,Camden,NJ,Passenger,0,1,1,14,15,6.67
2596,August,2021,Milwaukee,WI,Passenger,1,0,1,38,39,2.56
2597,August,2021,King,WA,Passenger,32289,9551,41840,1365924,1407764,2.97
2598,August,2021,Yakima,WA,Passenger,248,163,411,168910,169321,0.24
2599,August,2021,Frederick,MD,Passenger,1,1,2,68,70,2.86
2600,August,2021,Powhatan,VA,Passenger,1,0,1,1,2,50.0
2601,August,2021,Williams,ND,Passenger,0,1,1,7,8,12.5
2602,August,2021,Skagit,WA,Truck,1,0,1,32973,32974,0.0
2603,August,2021,San Joaquin,CA,Passenger,1,0,1,100,101,0.99
2604,August,2021,Lake,FL,Passenger,1,0,1,22,23,4.35
2605,August,2021,Harnett,NC,Passenger,1,1,2,162,164,1.22
2606,August,2021,Monterey,CA,Passenger,0,1,1,144,145,0.69
2607,August,2021,Goochland,VA,Passenger,4,2,6,210,216,2.78
2608,August,2021,Ferry,WA,Passenger,9,3,12,4389,4401,0.27
2609,August,2021,Thurston,WA,Passenger,1715,906,2621,197780,200401,1.31
2610,August,2021,Yamhill,OR,Passenger,1,0,1,33,34,2.94
2611,August,2021,Grant,WA,Passenger,123,96,219,66857,67076,0.33
2612,August,2021,San Juan,WA,Passenger,452,141,593,14207,14800,4.01
2613,August,2021,Alameda,CA,Passenger,4,0,4,227,231,1.73
2614,August,2021,Sumter,SC,Passenger,0,1,1,36,37,2.7
2615,August,2021,Clark,WA,Truck,0,0,0,84180,84180,0.0
2616,August,2021,Hamilton,IN,Passenger,2,0,2,29,31,6.45
2617,August,2021,Clark,NV,Passenger,4,2,6,593,599,1.0
2618,August,2021,Lewis,WA,Truck,0,0,0,26748,26748,0.0
2619,August,2021,El Paso,CO,Passenger,3,0,3,660,663,0.45
2620,August,2021,Suffolk,VA,Passenger,1,0,1,124,125,0.8
2621,August,2021,Island,WA,Passenger,645,318,963,63236,64199,1.5
2622,August,2021,Pierce,WA,Passenger,3774,2031,5805,559092,564897,1.03
2623,August,2021,Harris,TX,Passenger,1,1,2,179,181,1.1
2624,August,2021,Ulster,NY,Passenger,1,0,1,8,9,11.11
2625,August,2021,Placer,CA,Passenger,2,0,2,70,72,2.78
2626,August,2021,Rockingham,NH,Passenger,1,0,1,19,20,5.0
2627,August,2021,Denton,TX,Passenger,1,0,1,77,78,1.28
2628,August,2021,Saratoga,NY,Passenger,1,0,1,42,43,2.33
2629,August,2021,Orange,CA,Passenger,5,2,7,402,409,1.71
2630,August,2021,Charles,MD,Passenger,1,1,2,69,71,2.82
2631,August,2021,Columbia,WA,Passenger,7,2,9,2458,2467,0.36
2632,August,2021,St. Louis,MO,Passenger,1,0,1,78,79,1.27
2633,August,2021,Cumberland,NC,Passenger,0,2,2,414,416,0.48
2634,August,2021,Stevens,WA,Truck,0,0,0,18913,18913,0.0
2635,August,2021,Jefferson,WA,Truck,0,0,0,9611,9611,0.0
2636,August,2021,Nassau,NY,Passenger,2,0,2,26,28,7.14
2637,August,2021,Clark,WA,Passenger,3072,1473,4545,322091,326636,1.39
2638,August,2021,District of Columbia,DC,Passenger,5,1,6,198,204,2.94
2639,August,2021,Whitman,WA,Truck,0,0,0,8572,8572,0.0
2640,August,2021,Asotin,WA,Passenger,21,17,38,12728,12766,0.3
2641,August,2021,Douglas,WA,Truck,0,0,0,12682,12682,0.0
2642,August,2021,Kittitas,WA,Passenger,173,72,245,29872,30117,0.81
2643,August,2021,Carson City,NV,Passenger,1,0,1,10,11,9.09
2644,August,2021,Cook,IL,Passenger,1,0,1,201,202,0.5
2645,August,2021,Danville,VA,Passenger,1,0,1,0,1,100.0
2646,August,2021,Washington,MD,Passenger,2,0,2,13,15,13.33
2647,August,2021,Essex,NJ,Passenger,2,0,2,10,12,16.67
2648,August,2021,Harrison,MS,Passenger,2,0,2,51,53,3.77
2649,August,2021,Loudoun,VA,Passenger,1,0,1,72,73,1.37
2650,August,2021,Richmond,GA,Passenger,0,1,1,73,74,1.35
2651,August,2021,Lincoln,WA,Truck,0,0,0,4773,4773,0.0
2652,August,2021,Shelby,OH,Passenger,0,1,1,2,3,33.33
2653,August,2021,Richland,SC,Passenger,0,1,1,132,133,0.75
2654,August,2021,Cowlitz,WA,Truck,0,1,1,29085,29086,0.0
2655,August,2021,Lincoln,WA,Passenger,7,15,22,7695,7717,0.29
2656,August,2021,Spartanburg,SC,Passenger,0,1,1,49,50,2.0
2657,August,2021,Chesapeake,VA,Passenger,0,4,4,384,388,1.03
2658,August,2021,Nueces,TX,Passenger,1,0,1,67,68,1.47
2659,August,2021,Ferry,WA,Truck,0,0,0,3632,3632,0.0
2660,August,2021,Sedgwick,KS,Passenger,1,1,2,79,81,2.47
2661,August,2021,Washington,OR,Passenger,1,0,1,368,369,0.27
2662,August,2021,Fairfax,VA,Passenger,5,4,9,676,685,1.31
2663,August,2021,Contra Costa,CA,Passenger,2,4,6,260,266,2.26
2664,August,2021,Middlesex,MA,Passenger,1,1,2,91,93,2.15
2665,August,2021,Bartow,GA,Passenger,0,1,1,3,4,25.0
2666,August,2021,Pend Oreille,WA,Passenger,16,7,23,9243,9266,0.25
2667,August,2021,Oldham,KY,Passenger,0,1,1,4,5,20.0
2668,August,2021,Hillsborough,FL,Passenger,0,1,1,143,144,0.69
2669,August,2021,Kings,CA,Passenger,1,0,1,321,322,0.31
2670,August,2021,Douglas,NE,Passenger,1,1,2,50,52,3.85
2671,August,2021,Vigo,IN,Passenger,1,0,1,5,6,16.67
2672,August,2021,Orange,FL,Passenger,1,0,1,109,110,0.91
2673,August,2021,St. Clair,IL,Passenger,2,0,2,131,133,1.5
2674,August,2021,Hawaii,HI,Passenger,1,0,1,44,45,2.22
2675,August,2021,Lee,FL,Passenger,1,0,1,34,35,2.86
2676,August,2021,Boone,MO,Passenger,0,1,1,10,11,9.09
2677,August,2021,Kauai,HI,Passenger,1,0,1,18,19,5.26
2678,August,2021,Ray,MO,Passenger,0,1,1,1,2,50.0
2679,August,2021,Cape May,NJ,Passenger,0,1,1,8,9,11.11
2680,August,2021,Manassas,VA,Passenger,0,1,1,7,8,12.5
2681,August,2021,Platte,MO,Passenger,1,0,1,16,17,5.88
2682,August,2021,Franklin,WA,Passenger,139,99,238,61954,62192,0.38
2683,August,2021,Adams,WA,Truck,0,0,0,5413,5413,0.0
2684,August,2021,Pima,AZ,Passenger,1,1,2,259,261,0.77
2685,August,2021,Saginaw,MI,Passenger,1,0,1,6,7,14.29
2686,August,2021,Allen,IN,Passenger,1,0,1,15,16,6.25
2687,August,2021,Asotin,WA,Truck,0,0,0,6755,6755,0.0
2688,August,2021,Charleston,SC,Passenger,1,1,2,80,82,2.44
2689,August,2021,Kitsap,WA,Truck,0,0,0,54394,54394,0.0
2690,August,2021,Duval,FL,Passenger,0,2,2,329,331,0.6
2691,August,2021,Ventura,CA,Passenger,1,2,3,251,254,1.18
2692,August,2021,Escambia,FL,Passenger,0,1,1,143,144,0.69
2693,August,2021,Douglas,WA,Passenger,103,51,154,28575,28729,0.54
2694,August,2021,Grays Harbor,WA,Truck,0,0,0,21395,21395,0.0
2695,August,2021,Bucks,PA,Passenger,1,0,1,14,15,6.67
2696,August,2021,Arapahoe,CO,Passenger,1,0,1,104,105,0.95
2697,August,2021,RÃ­o Grande,PR,Passenger,1,0,1,0,1,100.0
2698,August,2021,Jefferson,WA,Passenger,350,183,533,24858,25391,2.1
2699,August,2021,Allegheny,PA,Passenger,1,1,2,61,63,3.17
2700,August,2021,Wake,NC,Passenger,1,0,1,119,120,0.83
2701,August,2021,Montgomery,TX,Passenger,1,1,2,38,40,5.0
2702,August,2021,Mason,WA,Truck,0,0,0,21324,21324,0.0
2703,August,2021,Lane,OR,Passenger,0,1,1,119,120,0.83
2704,August,2021,Benton,WA,Passenger,567,409,976,136208,137184,0.71
2705,August,2021,Okanogan,WA,Truck,0,0,0,16752,16752,0.0
2706,August,2021,St. Mary's,MD,Passenger,1,0,1,203,204,0.49
2707,August,2021,Prince George's,MD,Passenger,2,1,3,137,140,2.14
2708,August,2021,Pacific,WA,Passenger,48,54,102,16069,16171,0.63
2709,August,2021,Douglas,CO,Passenger,0,1,1,75,76,1.32
2710,August,2021,Pinellas,FL,Passenger,0,1,1,90,91,1.1
2711,August,2021,Benton,WA,Truck,0,0,0,43605,43605,0.0
2712,August,2021,Bexar,TX,Passenger,3,4,7,506,513,1.36
2713,August,2022,Hudson,NJ,Passenger,2,0,2,31,33,6.06
2714,August,2022,Pierce,WA,Truck,34,0,34,140861,140895,0.02
2715,August,2022,Jefferson,NY,Passenger,0,1,1,196,197,0.51
2716,August,2022,Virginia Beach,VA,Passenger,2,0,2,490,492,0.41
2717,August,2022,Cook,IL,Passenger,2,0,2,175,177,1.13
2718,August,2022,Arapahoe,CO,Passenger,0,1,1,72,73,1.37
2719,August,2022,Thurston,WA,Truck,17,0,17,55162,55179,0.03
2720,August,2022,Douglas,NE,Passenger,1,2,3,35,38,7.89
2721,August,2022,Coryell,TX,Passenger,1,0,1,89,90,1.11
2722,August,2022,Philadelphia,PA,Passenger,1,0,1,35,36,2.78
2723,August,2022,Wilson,TX,Passenger,0,1,1,2,3,33.33
2724,August,2022,Lake,IL,Passenger,2,0,2,123,125,1.6
2725,August,2022,Oldham,KY,Passenger,0,1,1,4,5,20.0
2726,August,2022,Orange,FL,Passenger,1,0,1,79,80,1.25
2727,August,2022,Yakima,WA,Truck,1,0,1,61393,61394,0.0
2728,August,2022,Bartow,GA,Passenger,0,1,1,3,4,25.0
2729,August,2022,Montgomery,PA,Passenger,1,0,1,20,21,4.76
2730,August,2022,Honolulu,HI,Passenger,3,3,6,309,315,1.9
2731,August,2022,Sumter,SC,Passenger,0,1,1,32,33,3.03
2732,August,2022,Penobscot,ME,Passenger,0,1,1,8,9,11.11
2733,August,2022,Santa Clara,CA,Passenger,10,2,12,203,215,5.58
2734,August,2022,Ferry,WA,Truck,0,0,0,3585,3585,0.0
2735,August,2022,Juneau,AK,Passenger,0,1,1,28,29,3.45
2736,August,2022,Bexar,TX,Passenger,5,3,8,412,420,1.9
2737,August,2022,Williamson,TX,Passenger,0,2,2,76,78,2.56
2738,August,2022,Marin,CA,Passenger,0,1,1,27,28,3.57
2739,August,2022,Spokane,WA,Truck,10,0,10,102018,102028,0.01
2740,August,2022,Richmond,NY,Passenger,1,0,1,6,7,14.29
2741,August,2022,Lewis,WA,Truck,0,0,0,26330,26330,0.0
2742,August,2022,Snohomish,WA,Passenger,8928,2595,11523,531276,542799,2.12
2743,August,2022,Okanogan,WA,Passenger,88,48,136,26317,26453,0.51
2744,August,2022,District of Columbia,DC,Passenger,4,0,4,162,166,2.41
2745,August,2022,Douglas,WA,Passenger,141,60,201,28384,28585,0.7
2746,August,2022,Pend Oreille,WA,Truck,0,0,0,5635,5635,0.0
2747,August,2022,Anne Arundel,MD,Passenger,4,4,8,324,332,2.41
2748,August,2022,Lincoln,OR,Passenger,0,1,1,22,23,4.35
2749,August,2022,Garfield,WA,Passenger,1,3,4,1322,1326,0.3
2750,August,2022,Tarrant,TX,Passenger,1,0,1,99,100,1.0
2751,August,2022,Yellowstone,MT,Passenger,0,1,1,20,21,4.76
2752,August,2022,Garfield,WA,Truck,0,0,0,977,977,0.0
2753,August,2022,Jackson,OK,Passenger,0,1,1,32,33,3.03
2754,August,2022,Sonoma,CA,Passenger,0,1,1,69,70,1.43
2755,August,2022,Cumberland,PA,Passenger,1,0,1,35,36,2.78
2756,August,2022,Walla Walla,WA,Passenger,179,104,283,35818,36101,0.78
2757,August,2022,Charles,MD,Passenger,1,1,2,53,55,3.64
2758,August,2022,Placer,CA,Passenger,2,0,2,63,65,3.08
2759,August,2022,Goochland,VA,Passenger,1,1,2,95,97,2.06
2760,August,2022,Island,WA,Truck,9,0,9,21330,21339,0.04
2761,August,2022,Pacific,WA,Passenger,70,72,142,15797,15939,0.89
2762,August,2022,Albemarle,VA,Passenger,1,0,1,16,17,5.88
2763,August,2022,Prince George's,MD,Passenger,3,1,4,113,117,3.42
2764,August,2022,Loudoun,VA,Passenger,2,1,3,62,65,4.62
2765,August,2022,Ferry,WA,Passenger,20,4,24,4399,4423,0.54
2766,August,2022,Hawaii,HI,Passenger,1,0,1,31,32,3.12
2767,August,2022,Moore,NC,Passenger,0,1,1,107,108,0.93
2768,August,2022,Kings,CA,Passenger,2,1,3,290,293,1.02
2769,August,2022,Asotin,WA,Truck,0,0,0,6695,6695,0.0
2770,August,2022,Bell,TX,Passenger,1,0,1,295,296,0.34
2771,August,2022,Washington,MD,Passenger,2,0,2,15,17,11.76
2772,August,2022,Kittitas,WA,Passenger,284,88,372,29610,29982,1.24
2773,August,2022,Norfolk,VA,Passenger,2,3,5,274,279,1.79
2774,August,2022,Montgomery,AL,Passenger,0,1,1,32,33,3.03
2775,August,2022,El Paso,TX,Passenger,2,0,2,309,311,0.64
2776,August,2022,Columbia,WA,Truck,0,0,0,1574,1574,0.0
2777,August,2022,Sarpy,NE,Passenger,1,0,1,49,50,2.0
2778,August,2022,Pennington,SD,Passenger,2,0,2,23,25,8.0
2779,August,2022,Harnett,NC,Passenger,2,0,2,140,142,1.41
2780,August,2022,Multnomah,OR,Passenger,0,3,3,495,498,0.6
2781,August,2022,Denton,TX,Passenger,1,0,1,57,58,1.72
2782,August,2022,Benton,WA,Passenger,815,471,1286,135382,136668,0.94
2783,August,2022,Kitsap,WA,Passenger,2523,1093,3616,177977,181593,1.99
2784,August,2022,Elmore,ID,Passenger,1,0,1,12,13,7.69
2785,August,2022,Gwinnett,GA,Passenger,1,0,1,50,51,1.96
2786,August,2022,Douglas,WA,Truck,1,0,1,12758,12759,0.01
2787,August,2022,Rockdale,GA,Passenger,1,0,1,6,7,14.29
2788,August,2022,Jefferson,WA,Passenger,453,223,676,24508,25184,2.68
2789,August,2022,Spokane,WA,Passenger,1743,881,2624,324740,327364,0.8
2790,August,2022,Jefferson,WA,Truck,3,0,3,9424,9427,0.03
2791,August,2022,Solano,CA,Passenger,2,0,2,151,153,1.31
2792,August,2022,Adams,WA,Truck,1,0,1,5434,5435,0.02
2793,August,2022,San Joaquin,CA,Passenger,1,1,2,80,82,2.44
2794,August,2022,Platte,MO,Passenger,1,0,1,21,22,4.55
2795,August,2022,Island,WA,Passenger,858,380,1238,61876,63114,1.96
2796,August,2022,Columbia,WA,Passenger,8,0,8,2437,2445,0.33
2797,August,2022,Hoke,NC,Passenger,1,0,1,62,63,1.59
2798,August,2022,Lincoln,WA,Truck,0,0,0,4846,4846,0.0
2799,August,2022,King,WA,Passenger,42950,11640,54590,1346237,1400827,3.9
2800,August,2022,Pulaski,AR,Passenger,1,0,1,27,28,3.57
2801,August,2022,Hennepin,MN,Passenger,1,0,1,45,46,2.17
2802,August,2022,Harris,TX,Passenger,1,0,1,125,126,0.79
2803,August,2022,New London,CT,Passenger,2,5,7,186,193,3.63
2804,August,2022,Burlington,NJ,Passenger,0,2,2,101,103,1.94
2805,August,2022,Lake,FL,Passenger,1,0,1,16,17,5.88
2806,August,2022,Montgomery,MD,Passenger,4,2,6,184,190,3.16
2807,August,2022,Allen,IN,Passenger,1,0,1,12,13,7.69
2808,August,2022,Douglas,CO,Passenger,0,1,1,63,64,1.56
2809,August,2022,Klickitat,WA,Passenger,106,54,160,15196,15356,1.04
2810,August,2022,San Juan,WA,Passenger,530,162,692,13993,14685,4.71
2811,August,2022,Frederick,MD,Passenger,1,0,1,57,58,1.72
2812,August,2022,Grays Harbor,WA,Passenger,218,163,381,48843,49224,0.77
2813,August,2022,Sheridan,WY,Passenger,1,0,1,6,7,14.29
2814,August,2022,Cumberland,NC,Passenger,1,2,3,334,337,0.89
2815,August,2022,Travis,TX,Passenger,1,0,1,93,94,1.06
2816,August,2022,Hidalgo,TX,Passenger,0,1,1,53,54,1.85
2817,August,2022,Suffolk,VA,Passenger,1,0,1,118,119,0.84
2818,August,2022,Carroll,MD,Passenger,0,1,1,16,17,5.88
2819,August,2022,Sevier,AR,Passenger,0,1,1,0,1,100.0
2820,August,2022,Cape May,NJ,Passenger,0,1,1,7,8,12.5
2821,August,2022,Kittitas,WA,Truck,3,0,3,14621,14624,0.02
2822,August,2022,Pierce,WA,Passenger,5429,2399,7828,542983,550811,1.42
2823,August,2022,St. Mary's,MD,Passenger,1,0,1,180,181,0.55
2824,August,2022,Adams,WA,Passenger,21,9,30,12974,13004,0.23
2825,August,2022,Grant,WA,Passenger,198,106,304,66772,67076,0.45
2826,August,2022,Fort Bend,TX,Passenger,1,0,1,24,25,4.0
2827,August,2022,Riverside,CA,Passenger,7,1,8,426,434,1.84
2828,August,2022,Alexandria,VA,Passenger,3,0,3,102,105,2.86
2829,August,2022,San Bernardino,CA,Passenger,1,1,2,302,304,0.66
2830,August,2022,Escambia,FL,Passenger,0,1,1,124,125,0.8
2831,August,2022,Rogers,OK,Passenger,1,0,1,1,2,50.0
2832,August,2022,Sedgwick,KS,Passenger,1,1,2,65,67,2.99
2833,August,2022,Wahkiakum,WA,Truck,1,0,1,1802,1803,0.06
2834,August,2022,Miami-Dade,FL,Passenger,1,0,1,72,73,1.37
2835,August,2022,Contra Costa,CA,Passenger,0,4,4,227,231,1.73
2836,August,2022,Sacramento,CA,Passenger,3,0,3,184,187,1.6
2837,August,2022,Klickitat,WA,Truck,2,0,2,8267,8269,0.02
2838,August,2022,Okanogan,WA,Truck,1,0,1,16543,16544,0.01
2839,August,2022,Boulder,CO,Passenger,1,0,1,31,32,3.12
2840,August,2022,Adams,CO,Passenger,1,0,1,38,39,2.56
2841,August,2022,Clark,WA,Truck,17,0,17,82407,82424,0.02
2842,August,2022,Franklin,WA,Passenger,224,113,337,61955,62292,0.54
2843,August,2022,Lewis,WA,Passenger,243,177,420,59723,60143,0.7
2844,August,2022,Wood,OH,Passenger,0,1,1,3,4,25.0
2845,August,2022,Clackamas,OR,Passenger,2,0,2,128,130,1.54
2846,August,2022,Kauai,HI,Passenger,1,0,1,14,15,6.67
2847,August,2022,Stevens,WA,Passenger,76,56,132,30060,30192,0.44
2848,August,2022,San Juan,WA,Truck,5,0,5,5953,5958,0.08
2849,August,2022,King,WA,Truck,204,2,206,180057,180263,0.11
2850,August,2022,Randolph,NC,Passenger,1,0,1,5,6,16.67
2851,August,2022,Las Animas,CO,Passenger,1,0,1,1,2,50.0
2852,August,2022,Wahkiakum,WA,Passenger,24,12,36,3080,3116,1.16
2853,August,2022,Camden,NJ,Passenger,0,1,1,12,13,7.69
2854,August,2022,Skagit,WA,Passenger,855,348,1203,89814,91017,1.32
2855,August,2022,Middlesex,MA,Passenger,2,1,3,66,69,4.35
2856,August,2022,St. Louis,MO,Passenger,1,0,1,57,58,1.72
2857,August,2022,Kootenai,ID,Truck,1,0,1,33,34,2.94
2858,August,2022,Ray,MO,Passenger,0,1,1,1,2,50.0
2859,August,2022,Asotin,WA,Passenger,24,18,42,12617,12659,0.33
2860,August,2022,Essex,NJ,Passenger,2,0,2,8,10,20.0
2861,August,2022,Carroll,NH,Passenger,0,1,1,5,6,16.67
2862,August,2022,El Paso,CO,Passenger,3,1,4,561,565,0.71
2863,August,2022,Rockingham,NH,Passenger,1,0,1,14,15,6.67
2864,August,2022,Clallam,WA,Truck,4,0,4,21879,21883,0.02
2865,August,2022,Alameda,CA,Passenger,4,0,4,174,178,2.25
2866,August,2022,Franklin,WA,Truck,2,0,2,20905,20907,0.01
2867,August,2022,San Mateo,CA,Passenger,1,0,1,70,71,1.41
2868,August,2022,Skamania,WA,Truck,0,0,0,3906,3906,0.0
2869,August,2022,Nueces,TX,Passenger,1,1,2,50,52,3.85
2870,August,2022,Orange,CA,Passenger,6,2,8,321,329,2.43
2871,August,2022,Cowlitz,WA,Passenger,353,172,525,70460,70985,0.74
2872,August,2022,Mason,WA,Passenger,330,177,507,47021,47528,1.07
2873,August,2022,Thurston,WA,Passenger,2326,1086,3412,193178,196590,1.74
2874,August,2022,Dorchester,SC,Passenger,1,0,1,48,49,2.04
2875,August,2022,Bryan,GA,Passenger,0,1,1,36,37,2.7
2876,August,2022,Broward,FL,Passenger,1,0,1,68,69,1.45
2877,August,2022,Grays Harbor,WA,Truck,2,0,2,21214,21216,0.01
2878,August,2022,Berkeley,SC,Passenger,0,1,1,112,113,0.88
2879,August,2022,Pacific,WA,Truck,0,0,0,7860,7860,0.0
2880,August,2022,Hillsborough,FL,Passenger,0,1,1,113,114,0.88
2881,August,2022,Fairbanks North Star,AK,Passenger,0,1,1,67,68,1.47
2882,August,2022,Spartanburg,SC,Passenger,0,1,1,35,36,2.78
2883,August,2022,St. Tammany,LA,Passenger,1,0,1,33,34,2.94
2884,August,2022,Stevens,WA,Truck,1,0,1,18926,18927,0.01
2885,August,2022,Saratoga,NY,Passenger,1,0,1,39,40,2.5
2886,August,2022,Whatcom,WA,Truck,13,0,13,43149,43162,0.03
2887,August,2022,Houston,GA,Passenger,1,0,1,31,32,3.12
2888,August,2022,Owyhee,ID,Passenger,1,0,1,2,3,33.33
2889,August,2022,Leavenworth,KS,Passenger,0,1,1,93,94,1.06
2890,August,2022,Chelan,WA,Truck,5,0,5,23065,23070,0.02
2891,August,2022,St. Clair,IL,Passenger,2,0,2,113,115,1.74
2892,August,2022,Pend Oreille,WA,Passenger,18,12,30,9031,9061,0.33
2893,August,2022,Portsmouth,VA,Passenger,0,1,1,73,74,1.35
2894,August,2022,Anchorage,AK,Passenger,1,0,1,111,112,0.89
2895,August,2022,New Haven,CT,Passenger,0,2,2,25,27,7.41
2896,August,2022,Queens,NY,Passenger,1,0,1,37,38,2.63
2897,August,2022,Geary,KS,Passenger,1,0,1,81,82,1.22
2898,August,2022,Whitman,WA,Truck,2,0,2,8568,8570,0.02
2899,August,2022,Stafford,VA,Passenger,2,1,3,83,86,3.49
2900,August,2022,Chesapeake,VA,Passenger,3,3,6,312,318,1.89
2901,August,2022,Collin,TX,Passenger,2,0,2,72,74,2.7
2902,August,2022,Plaquemines,LA,Passenger,1,1,2,16,18,11.11
2903,August,2022,Cowlitz,WA,Truck,2,0,2,28458,28460,0.01
2904,August,2022,Fairfax,VA,Passenger,6,3,9,585,594,1.52
2905,August,2022,Lee,FL,Passenger,1,0,1,25,26,3.85
2906,August,2022,Howard,MD,Passenger,0,1,1,51,52,1.92
2907,August,2022,Galveston,TX,Passenger,0,1,1,18,19,5.26
2908,August,2022,Snohomish,WA,Truck,45,0,45,123227,123272,0.04
2909,August,2022,Los Angeles,CA,Passenger,7,7,14,717,731,1.92
2910,August,2022,Clark,NV,Passenger,4,2,6,464,470,1.28
2911,August,2022,Arlington,VA,Passenger,1,0,1,120,121,0.83
2912,August,2022,Whitman,WA,Passenger,94,62,156,22009,22165,0.7
2913,August,2022,Manassas,VA,Passenger,0,1,1,8,9,11.11
2914,August,2022,Harrison,MS,Passenger,1,0,1,36,37,2.7
2915,August,2022,Onslow,NC,Passenger,0,1,1,157,158,0.63
2916,August,2022,Kern,CA,Passenger,0,1,1,187,188,0.53
2917,August,2022,Danville,VA,Passenger,1,0,1,0,1,100.0
2918,August,2022,Santa Cruz,CA,Passenger,1,0,1,20,21,4.76
2919,August,2022,Lincoln,WA,Passenger,9,16,25,7697,7722,0.32
2920,August,2022,San Diego,CA,Passenger,18,10,28,2167,2195,1.28
2921,August,2022,Monterey,CA,Passenger,1,1,2,125,127,1.57
2922,August,2022,Rock Island,IL,Passenger,0,1,1,15,16,6.25
2923,August,2022,Calvert,MD,Passenger,0,2,2,74,76,2.63
2924,August,2022,Whatcom,WA,Passenger,1915,766,2681,148907,151588,1.77
2926,August,2022,Fairfax,VA,Truck,1,0,1,109,110,0.91
2927,August,2022,Allegheny,PA,Passenger,1,1,2,50,52,3.85
2928,August,2022,Salt Lake,UT,Passenger,1,1,2,115,117,1.71
2929,August,2022,Louisa,VA,Passenger,0,1,1,1,2,50.0
2930,August,2022,Maricopa,AZ,Passenger,7,1,8,808,816,0.98
2931,August,2022,Okaloosa,FL,Passenger,0,1,1,94,95,1.05
2932,August,2022,Wichita,TX,Passenger,2,0,2,37,39,5.13
2933,August,2022,Hamilton,IN,Passenger,1,0,1,16,17,5.88
2934,August,2022,Walla Walla,WA,Truck,2,0,2,13914,13916,0.01
2935,August,2022,Clark,WA,Passenger,4348,1852,6200,315595,321795,1.93
2936,August,2022,Charleston,SC,Passenger,2,2,4,59,63,6.35
2937,August,2022,Ventura,CA,Passenger,2,1,3,221,224,1.34
2938,August,2022,Chelan,WA,Passenger,487,134,621,54190,54811,1.13
2939,August,2022,Hamilton,OH,Passenger,1,0,1,27,28,3.57
2940,August,2022,Nassau,NY,Passenger,2,0,2,23,25,8.0
2941,August,2022,Skagit,WA,Truck,5,0,5,32237,32242,0.02
2942,August,2022,Skamania,WA,Passenger,82,50,132,8155,8287,1.59
2943,August,2022,Sarasota,FL,Passenger,2,0,2,22,24,8.33
2944,August,2022,Grant,WA,Truck,1,0,1,27998,27999,0.0
2945,August,2022,DeKalb,GA,Passenger,1,0,1,44,45,2.22
2946,August,2022,Yakima,WA,Passenger,364,204,568,166544,167112,0.34
2947,August,2022,Kitsap,WA,Truck,19,0,19,53291,53310,0.04
2948,August,2022,Richmond,GA,Passenger,0,1,1,59,60,1.67
2949,August,2022,Ulster,NY,Passenger,1,0,1,7,8,12.5
2950,August,2022,Mason,WA,Truck,4,0,4,20986,20990,0.02
2951,August,2022,Lane,OR,Passenger,0,1,1,84,85,1.18
2952,August,2022,Clallam,WA,Passenger,435,247,682,49540,50222,1.36
2953,August,2022,Duval,FL,Passenger,1,2,3,258,261,1.15
2954,August,2022,Williams,ND,Passenger,0,1,1,5,6,16.67
2955,August,2022,Benton,WA,Truck,5,0,5,43422,43427,0.01
2956,December,2017,Wahkiakum,WA,Passenger,0,2,2,2860,2862,0.07
2957,December,2017,Sangamon,IL,Passenger,1,0,1,10,11,9.09
2958,December,2017,Franklin,WA,Truck,0,0,0,18492,18492,0.0
2959,December,2017,San Juan,WA,Passenger,132,43,175,13853,14028,1.25
2960,December,2017,Jefferson,WA,Truck,0,0,0,9475,9475,0.0
2961,December,2017,DuPage,IL,Passenger,1,0,1,61,62,1.61
2962,December,2017,Lincoln,WA,Passenger,2,5,7,7569,7576,0.09
2963,December,2017,Montgomery,TN,Passenger,1,0,1,269,270,0.37
2964,December,2017,Okanogan,WA,Passenger,7,18,25,25740,25765,0.1
2965,December,2017,Marin,CA,Passenger,1,0,1,58,59,1.69
2966,December,2017,Tarrant,TX,Passenger,1,0,1,228,229,0.44
2967,December,2017,Orange,CA,Passenger,3,1,4,576,580,0.69
2968,December,2017,Richmond,GA,Passenger,0,1,1,93,94,1.06
2969,December,2017,Whitman,WA,Passenger,17,20,37,22426,22463,0.16
2970,December,2017,Kittitas,WA,Passenger,35,26,61,28449,28510,0.21
2971,December,2017,Duval,FL,Passenger,1,2,3,370,373,0.8
2972,December,2017,Alameda,CA,Passenger,0,1,1,352,353,0.28
2973,December,2017,Stevens,WA,Truck,0,0,0,18379,18379,0.0
2974,December,2017,Santa Rosa,FL,Passenger,1,0,1,103,104,0.96
2975,December,2017,Palm Beach,FL,Passenger,0,1,1,90,91,1.1
2976,December,2017,Multnomah,OR,Passenger,3,3,6,879,885,0.68
2977,December,2017,Hamilton,IN,Passenger,1,0,1,54,55,1.82
2978,December,2017,Lewis,WA,Passenger,54,40,94,56571,56665,0.17
2979,December,2017,Yakima,WA,Passenger,59,75,134,162075,162209,0.08
2980,December,2017,Stevens,WA,Passenger,10,21,31,31533,31564,0.1
2981,December,2017,Deschutes,OR,Passenger,1,0,1,178,179,0.56
2982,December,2017,Columbia,WA,Truck,0,0,0,1540,1540,0.0
2983,December,2017,King,WA,Truck,8,1,9,185056,185065,0.0
2984,December,2017,Polk,FL,Passenger,1,0,1,61,62,1.61
2985,December,2017,Pend Oreille,WA,Truck,0,0,0,5618,5618,0.0
2986,December,2017,Twin Falls,ID,Passenger,0,1,1,24,25,4.0
2987,December,2017,Canyon,ID,Passenger,0,1,1,92,93,1.08
2988,December,2017,Asotin,WA,Truck,0,0,0,6543,6543,0.0
2989,December,2017,Fulton,GA,Passenger,1,0,1,106,107,0.93
2990,December,2017,Moore,NC,Passenger,0,1,1,199,200,0.5
2991,December,2017,Manatee,FL,Passenger,1,0,1,39,40,2.5
2992,December,2017,Clallam,WA,Passenger,99,91,190,49056,49246,0.39
2993,December,2017,Columbia,WA,Passenger,2,1,3,2403,2406,0.12
2994,December,2017,Garfield,WA,Truck,0,0,0,943,943,0.0
2995,December,2017,Kitsap,WA,Truck,1,0,1,52687,52688,0.0
2996,December,2017,Klickitat,WA,Truck,0,0,0,8003,8003,0.0
2997,December,2017,Hardin,KY,Passenger,0,1,1,119,120,0.83
2998,December,2017,Snohomish,WA,Passenger,2016,1051,3067,516915,519982,0.59
2999,December,2017,Sacramento,CA,Passenger,1,0,1,311,312,0.32
3000,December,2017,Pacific,WA,Truck,0,0,0,7545,7545,0.0
3001,December,2017,Whatcom,WA,Passenger,532,227,759,145194,145953,0.52
3002,December,2017,Clark,WA,Truck,0,0,0,78388,78388,0.0
3003,December,2017,Gwinnett,GA,Passenger,0,1,1,83,84,1.19
3004,December,2017,Prince William,VA,Passenger,0,3,3,271,274,1.09
3005,December,2017,Howard,MD,Passenger,0,2,2,87,89,2.25
3006,December,2017,Okaloosa,FL,Passenger,1,0,1,184,185,0.54
3007,December,2017,Norfolk,MA,Passenger,1,0,1,38,39,2.56
3008,December,2017,Grays Harbor,WA,Truck,0,0,0,20064,20064,0.0
3009,December,2017,Lee,AL,Passenger,1,0,1,37,38,2.63
3010,December,2017,Contra Costa,CA,Passenger,0,1,1,467,468,0.21
3011,December,2017,Monterey,CA,Passenger,0,2,2,191,193,1.04
3012,December,2017,Albemarle,VA,Passenger,0,1,1,32,33,3.03
3013,December,2017,Santa Clara,CA,Passenger,7,1,8,383,391,2.05
3014,December,2017,Ramsey,MN,Passenger,1,0,1,38,39,2.56
3015,December,2017,Benton,WA,Passenger,172,168,340,130229,130569,0.26
3016,December,2017,Travis,TX,Passenger,0,1,1,188,189,0.53
3017,December,2017,Douglas,WA,Truck,0,0,0,11757,11757,0.0
3018,December,2017,Douglas,WA,Passenger,38,33,71,27171,27242,0.26
3019,December,2017,Maui,HI,Passenger,1,0,1,67,68,1.47
3020,December,2017,DeKalb,IN,Passenger,1,0,1,1,2,50.0
3021,December,2017,Jefferson,WA,Passenger,121,74,195,24283,24478,0.8
3022,December,2017,Spokane,WA,Truck,1,0,1,91580,91581,0.0
3023,December,2017,Grant,WA,Passenger,26,35,61,62097,62158,0.1
3024,December,2017,Madison,ID,Passenger,1,0,1,39,40,2.5
3025,December,2017,Pima,AZ,Passenger,1,1,2,409,411,0.49
3027,December,2017,Pierce,WA,Truck,0,0,0,137028,137028,0.0
3028,December,2017,Ada,ID,Passenger,0,1,1,349,350,0.29
3029,December,2017,Whatcom,WA,Truck,1,0,1,42016,42017,0.0
3030,December,2017,DeKalb,GA,Passenger,1,0,1,87,88,1.14
3031,December,2017,Nassau,NY,Passenger,1,1,2,38,40,5.0
3032,December,2017,Prince George's,MD,Passenger,0,1,1,177,178,0.56
3033,December,2017,Thurston,WA,Passenger,470,391,861,190046,190907,0.45
3034,December,2017,Cowlitz,WA,Truck,0,0,0,28150,28150,0.0
3035,December,2017,Bexar,TX,Passenger,1,2,3,822,825,0.36
3036,December,2017,Skagit,WA,Passenger,167,138,305,89553,89858,0.34
3037,December,2017,Pierce,WA,Passenger,1071,963,2034,526446,528480,0.38
3038,December,2017,Mason,WA,Truck,0,0,0,19593,19593,0.0
3039,December,2017,Portsmouth,VA,Passenger,0,1,1,67,68,1.47
3040,December,2017,Dakota,MN,Passenger,0,2,2,38,40,5.0
3041,December,2017,Norfolk,VA,Passenger,1,1,2,308,310,0.65
3042,December,2017,Island,WA,Truck,0,0,0,20753,20753,0.0
3043,December,2017,Okanogan,WA,Truck,0,0,0,16269,16269,0.0
3044,December,2017,Shelby,TN,Passenger,0,1,1,104,105,0.95
3045,December,2017,Skamania,WA,Passenger,10,7,17,8589,8606,0.2
3046,December,2017,Orange,FL,Passenger,1,1,2,139,141,1.42
3047,December,2017,Kittitas,WA,Truck,0,0,0,13805,13805,0.0
3048,December,2017,Montgomery,PA,Passenger,1,0,1,39,40,2.5
3049,December,2017,El Paso,TX,Passenger,1,0,1,522,523,0.19
3050,December,2017,Walla Walla,WA,Truck,0,0,0,13292,13292,0.0
3051,December,2017,Yakima,WA,Truck,0,0,0,58011,58011,0.0
3052,December,2017,Virginia Beach,VA,Passenger,2,1,3,669,672,0.45
3053,December,2017,Garfield,WA,Passenger,1,0,1,1321,1322,0.08
3054,December,2017,Clark,NV,Passenger,1,2,3,752,755,0.4
3055,December,2017,Dale,AL,Passenger,0,1,1,64,65,1.54
3056,December,2017,Los Angeles,CA,Passenger,5,2,7,1209,1216,0.58
3057,December,2017,Sumter,FL,Passenger,0,1,1,10,11,9.09
3058,December,2017,Manassas,VA,Passenger,0,1,1,9,10,10.0
3059,December,2017,Northampton,PA,Passenger,0,1,1,67,68,1.47
3060,December,2017,Wahkiakum,WA,Truck,0,0,0,1670,1670,0.0
3061,December,2017,Spokane,WA,Passenger,297,240,537,300106,300643,0.18
3062,December,2017,Richland,SC,Passenger,0,1,1,171,172,0.58
3063,December,2017,Island,WA,Passenger,155,165,320,61576,61896,0.52
3064,December,2017,Fairfax,VA,Passenger,2,2,4,828,832,0.48
3065,December,2017,Snohomish,WA,Truck,1,0,1,121405,121406,0.0
3066,December,2017,Cowlitz,WA,Passenger,54,67,121,70747,70868,0.17
3067,December,2017,Kitsap,WA,Passenger,693,377,1070,175868,176938,0.6
3068,December,2017,Lane,OR,Passenger,0,1,1,208,209,0.48
3069,December,2017,Clay,FL,Passenger,0,1,1,106,107,0.93
3070,December,2017,Utah,UT,Passenger,0,1,1,134,135,0.74
3071,December,2017,Hamilton,TN,Passenger,1,0,1,21,22,4.55
3072,December,2017,Asotin,WA,Passenger,8,5,13,12519,12532,0.1
3073,December,2017,Queens,NY,Passenger,1,0,1,61,62,1.61
3074,December,2017,Dallas,TX,Passenger,0,1,1,182,183,0.55
3075,December,2017,Adams,WA,Passenger,4,5,9,12408,12417,0.07
3076,December,2017,Benton,WA,Truck,0,0,0,40573,40573,0.0
3077,December,2017,Nantucket,MA,Passenger,1,0,1,3,4,25.0
3078,December,2017,Flathead,MT,Passenger,1,0,1,55,56,1.79
3079,December,2017,Montgomery,TX,Passenger,1,0,1,62,63,1.59
3080,December,2017,Clark,WA,Passenger,851,573,1424,304270,305694,0.47
3081,December,2017,Honolulu,HI,Passenger,2,2,4,556,560,0.71
3082,December,2017,Adams,WA,Truck,0,0,0,5128,5128,0.0
3083,December,2017,Nueces,TX,Passenger,1,1,2,92,94,2.13
3084,December,2017,Arlington,VA,Passenger,1,2,3,172,175,1.71
3085,December,2017,Latah,ID,Passenger,0,1,1,77,78,1.28
3086,December,2017,New Haven,CT,Passenger,0,1,1,54,55,1.82
3087,December,2017,Ferry,WA,Truck,0,0,0,3523,3523,0.0
3088,December,2017,San Juan,WA,Truck,0,0,0,5604,5604,0.0
3089,December,2017,Thurston,WA,Truck,0,0,0,53761,53761,0.0
3090,December,2017,Allegheny,PA,Passenger,1,0,1,84,85,1.18
3091,December,2017,Morris,NJ,Passenger,1,0,1,21,22,4.55
3092,December,2017,Tuolumne,CA,Passenger,0,1,1,14,15,6.67
3093,December,2017,Carroll,NH,Passenger,0,1,1,1,2,50.0
3094,December,2017,King,WA,Passenger,11277,4684,15961,1370800,1386761,1.15
3095,December,2017,District of Columbia,DC,Passenger,0,3,3,201,204,1.47
3096,December,2017,Prince George,VA,Passenger,0,1,1,74,75,1.33
3097,December,2017,Franklin,OH,Passenger,0,1,1,108,109,0.92
3098,December,2017,Missoula,MT,Passenger,1,0,1,69,70,1.43
3099,December,2017,San Mateo,CA,Passenger,0,1,1,147,148,0.68
3100,December,2017,New London,CT,Passenger,1,1,2,249,251,0.8
3101,December,2017,Pend Oreille,WA,Passenger,3,4,7,9440,9447,0.07
3102,December,2017,Juneau,AK,Passenger,0,1,1,46,47,2.13
3103,December,2017,Ferry,WA,Passenger,1,3,4,4402,4406,0.09
3104,December,2017,Ventura,CA,Passenger,0,1,1,328,329,0.3
3105,December,2017,Grant,WA,Truck,0,0,0,25587,25587,0.0
3106,December,2017,Chelan,WA,Truck,0,0,0,21619,21619,0.0
3107,December,2017,Anne Arundel,MD,Passenger,0,1,1,474,475,0.21
3108,December,2017,St. Clair,IL,Passenger,0,1,1,159,160,0.62
3109,December,2017,Pacific,WA,Passenger,15,13,28,15404,15432,0.18
3110,December,2017,Santa Fe,NM,Passenger,0,1,1,43,44,2.27
3111,December,2017,Skamania,WA,Truck,0,0,0,3896,3896,0.0
3112,December,2017,Lewis,WA,Truck,0,0,0,25311,25311,0.0
3113,December,2017,Kent,MI,Passenger,0,1,1,34,35,2.86
3114,December,2017,St. Lucie,FL,Passenger,1,0,1,26,27,3.7
3115,December,2017,Riverside,CA,Passenger,1,2,3,739,742,0.4
3116,December,2017,Whitman,WA,Truck,0,0,0,8450,8450,0.0
3117,December,2017,Lumpkin,GA,Passenger,1,0,1,9,10,10.0
3118,December,2017,Klickitat,WA,Passenger,23,26,49,14902,14951,0.33
3119,December,2017,Franklin,MA,Passenger,0,1,1,4,5,20.0
3120,December,2017,San Diego,CA,Passenger,6,1,7,2563,2570,0.27
3121,December,2017,Walla Walla,WA,Passenger,29,32,61,35287,35348,0.17
3122,December,2017,Mason,WA,Passenger,66,75,141,44844,44985,0.31
3123,December,2017,Maricopa,AZ,Passenger,2,0,2,1621,1623,0.12
3124,December,2017,Hawaii,HI,Passenger,1,0,1,78,79,1.27
3125,December,2017,Grays Harbor,WA,Passenger,42,41,83,45821,45904,0.18
3126,December,2017,Brevard,FL,Passenger,0,1,1,101,102,0.98
3127,December,2017,Lincoln,WA,Truck,0,0,0,4493,4493,0.0
3128,December,2017,Chelan,WA,Passenger,86,38,124,53028,53152,0.23
3129,December,2017,Clallam,WA,Truck,0,0,0,21218,21218,0.0
3130,December,2017,Jefferson,NY,Passenger,1,0,1,232,233,0.43
3131,December,2017,Charles,MD,Passenger,0,1,1,85,86,1.16
3132,December,2017,Sedgwick,KS,Passenger,0,1,1,106,107,0.93
3133,December,2017,Saratoga,NY,Passenger,1,1,2,69,71,2.82
3134,December,2017,Montgomery,MD,Passenger,1,0,1,300,301,0.33
3135,December,2017,Essex,NJ,Passenger,1,0,1,10,11,9.09
3136,December,2017,El Paso,CO,Passenger,2,0,2,764,766,0.26
3137,December,2017,Franklin,WA,Passenger,30,50,80,56860,56940,0.14
3138,December,2017,Orleans,LA,Passenger,0,1,1,47,48,2.08
3139,December,2017,Frederick,MD,Passenger,0,1,1,88,89,1.12
3140,December,2017,Volusia,FL,Passenger,0,1,1,37,38,2.63
3141,December,2017,Pinal,AZ,Passenger,2,0,2,213,215,0.93
3142,December,2017,Skagit,WA,Truck,1,0,1,31731,31732,0.0
3143,December,2017,Cape May,NJ,Passenger,0,1,1,22,23,4.35
3144,December,2018,Franklin,WA,Truck,0,0,0,19057,19057,0.0
3145,December,2018,Arlington,VA,Passenger,1,1,2,165,167,1.2
3146,December,2018,Franklin,MA,Passenger,0,1,1,1,2,50.0
3147,December,2018,Carroll,NH,Passenger,0,1,1,1,2,50.0
3148,December,2018,Snohomish,WA,Truck,1,0,1,121967,121968,0.0
3149,December,2018,Skamania,WA,Passenger,16,13,29,8731,8760,0.33
3150,December,2018,Wahkiakum,WA,Passenger,1,1,2,2979,2981,0.07
3151,December,2018,Kitsap,WA,Passenger,946,544,1490,179830,181320,0.82
3152,December,2018,Pacific,WA,Passenger,21,25,46,15834,15880,0.29
3153,December,2018,Grays Harbor,WA,Passenger,62,72,134,47465,47599,0.28
3154,December,2018,Tuolumne,CA,Passenger,0,1,1,13,14,7.14
3155,December,2018,Asotin,WA,Passenger,12,9,21,12724,12745,0.16
3156,December,2018,Caddo,LA,Passenger,0,1,1,21,22,4.55
3157,December,2018,Chelan,WA,Passenger,140,61,201,54138,54339,0.37
3158,December,2018,Fulton,GA,Passenger,1,2,3,108,111,2.7
3159,December,2018,Cowlitz,WA,Passenger,72,94,166,72436,72602,0.23
3160,December,2018,Walla Walla,WA,Passenger,41,52,93,36097,36190,0.26
3161,December,2018,Pacific,WA,Truck,0,0,0,7614,7614,0.0
3162,December,2018,Twin Falls,ID,Passenger,0,1,1,23,24,4.17
3163,December,2018,Monroe,IL,Passenger,1,0,1,4,5,20.0
3164,December,2018,Lane,OR,Passenger,0,1,1,169,170,0.59
3165,December,2018,District of Columbia,DC,Passenger,1,3,4,197,201,1.99
3166,December,2018,New London,CT,Passenger,0,2,2,252,254,0.79
3167,December,2018,Cumberland,NC,Passenger,0,1,1,522,523,0.19
3169,December,2018,El Paso,CO,Passenger,3,1,4,763,767,0.52
3170,December,2018,Nantucket,MA,Passenger,1,0,1,4,5,20.0
3171,December,2018,Jefferson,WA,Passenger,168,106,274,24838,25112,1.09
3172,December,2018,Fairfax,VA,Passenger,3,2,5,808,813,0.62
3173,December,2018,DeKalb,GA,Passenger,1,0,1,77,78,1.28
3174,December,2018,Pend Oreille,WA,Truck,0,0,0,5738,5738,0.0
3175,December,2018,Jefferson,WA,Truck,0,0,0,9606,9606,0.0
3176,December,2018,Bexar,TX,Passenger,3,4,7,711,718,0.97
3177,December,2018,Prince William,VA,Passenger,0,4,4,254,258,1.55
3178,December,2018,Snohomish,WA,Passenger,2915,1437,4352,527237,531589,0.82
3179,December,2018,Chelan,WA,Truck,0,0,0,22052,22052,0.0
3180,December,2018,Richland,SC,Passenger,0,1,1,162,163,0.61
3181,December,2018,Tarrant,TX,Passenger,1,0,1,204,205,0.49
3182,December,2018,Harnett,NC,Passenger,1,0,1,228,229,0.44
3183,December,2018,El Paso,TX,Passenger,1,0,1,495,496,0.2
3184,December,2018,Jefferson,NY,Passenger,0,1,1,228,229,0.44
3185,December,2018,Fresno,CA,Passenger,1,0,1,190,191,0.52
3186,December,2018,Clay,FL,Passenger,0,1,1,87,88,1.14
3187,December,2018,Grant,WA,Passenger,32,52,84,64196,64280,0.13
3188,December,2018,Nueces,TX,Passenger,1,1,2,93,95,2.11
3189,December,2018,Multnomah,OR,Passenger,3,5,8,764,772,1.04
3190,December,2018,Marion,IN,Passenger,1,0,1,119,120,0.83
3191,December,2018,Cowlitz,WA,Truck,0,0,0,28739,28739,0.0
3192,December,2018,Cochise,AZ,Passenger,0,1,1,119,120,0.83
3193,December,2018,Richmond,GA,Passenger,0,1,1,90,91,1.1
3194,December,2018,Klickitat,WA,Passenger,28,32,60,15431,15491,0.39
3195,December,2018,Franklin,WA,Passenger,45,66,111,59124,59235,0.19
3196,December,2018,Grays Harbor,WA,Truck,0,0,0,20356,20356,0.0
3197,December,2018,Kittitas,WA,Passenger,66,37,103,29339,29442,0.35
3198,December,2018,Skagit,WA,Truck,1,0,1,32318,32319,0.0
3199,December,2018,Middlesex,MA,Passenger,1,1,2,128,130,1.54
3200,December,2018,Maui,HI,Passenger,1,0,1,51,52,1.92
3201,December,2018,Beaufort,SC,Passenger,1,0,1,34,35,2.86
3202,December,2018,Lincoln,WA,Truck,0,0,0,4639,4639,0.0
3203,December,2018,Sedgwick,KS,Passenger,0,1,1,98,99,1.01
3204,December,2018,Santa Rosa,FL,Passenger,1,0,1,88,89,1.12
3205,December,2018,Ferry,WA,Truck,0,0,0,3585,3585,0.0
3206,December,2018,Skamania,WA,Truck,0,0,0,4008,4008,0.0
3207,December,2018,Garfield,WA,Passenger,1,1,2,1329,1331,0.15
3208,December,2018,Manassas,VA,Passenger,0,1,1,9,10,10.0
3209,December,2018,Kent,MI,Passenger,0,1,1,23,24,4.17
3210,December,2018,St. Lucie,FL,Passenger,1,0,1,30,31,3.23
3211,December,2018,Clallam,WA,Passenger,150,124,274,50353,50627,0.54
3212,December,2018,Flathead,MT,Passenger,1,0,1,56,57,1.75
3213,December,2018,Yakima,WA,Truck,0,0,0,58848,58848,0.0
3214,December,2018,Clallam,WA,Truck,0,0,0,21642,21642,0.0
3215,December,2018,Douglas,WA,Truck,0,0,0,12160,12160,0.0
3216,December,2018,Sumter,FL,Passenger,0,1,1,10,11,9.09
3217,December,2018,St. Clair,IL,Passenger,0,1,1,165,166,0.6
3218,December,2018,Nassau,NY,Passenger,3,0,3,35,38,7.89
3219,December,2018,Columbia,WA,Truck,0,0,0,1517,1517,0.0
3220,December,2018,Howard,MD,Passenger,0,1,1,84,85,1.18
3221,December,2018,Montgomery,TX,Passenger,2,0,2,61,63,3.17
3222,December,2018,Benton,WA,Passenger,227,235,462,132930,133392,0.35
3223,December,2018,Washtenaw,MI,Passenger,1,0,1,40,41,2.44
3224,December,2018,San Juan,WA,Truck,0,0,0,5818,5818,0.0
3225,December,2018,Thurston,WA,Passenger,739,572,1311,195602,196913,0.67
3226,December,2018,Maricopa,AZ,Passenger,3,2,5,1544,1549,0.32
3227,December,2018,Los Angeles,CA,Passenger,7,5,12,1105,1117,1.07
3228,December,2018,Duval,FL,Passenger,1,2,3,381,384,0.78
3229,December,2018,Bucks,PA,Passenger,1,0,1,16,17,5.88
3230,December,2018,Hawaii,HI,Passenger,1,0,1,62,63,1.59
3231,December,2018,Santa Cruz,CA,Passenger,1,0,1,41,42,2.38
3232,December,2018,Cape May,NJ,Passenger,0,1,1,21,22,4.55
3233,December,2018,Guadalupe,TX,Passenger,1,0,1,79,80,1.25
3234,December,2018,Kittitas,WA,Truck,0,0,0,14196,14196,0.0
3235,December,2018,Riverside,CA,Passenger,2,2,4,677,681,0.59
3236,December,2018,Houston,GA,Passenger,1,0,1,51,52,1.92
3237,December,2018,Dakota,MN,Passenger,0,2,2,34,36,5.56
3238,December,2018,San Juan,WA,Passenger,183,69,252,14224,14476,1.74
3239,December,2018,Tulsa,OK,Passenger,1,1,2,47,49,4.08
3240,December,2018,Albemarle,VA,Passenger,1,0,1,25,26,3.85
3241,December,2018,Adams,WA,Truck,0,0,0,5149,5149,0.0
3242,December,2018,Charles,MD,Passenger,0,1,1,76,77,1.3
3243,December,2018,Suffolk,MA,Passenger,0,1,1,42,43,2.33
3244,December,2018,Orange,FL,Passenger,2,0,2,166,168,1.19
3245,December,2018,Whatcom,WA,Truck,2,0,2,42664,42666,0.0
3246,December,2018,Polk,FL,Passenger,1,0,1,64,65,1.54
3247,December,2018,Pima,AZ,Passenger,1,1,2,399,401,0.5
3248,December,2018,Douglas,NE,Passenger,0,1,1,67,68,1.47
3249,December,2018,Deschutes,OR,Passenger,2,0,2,165,167,1.2
3250,December,2018,Lewis,WA,Passenger,93,77,170,58326,58496,0.29
3251,December,2018,Clackamas,OR,Passenger,1,1,2,214,216,0.93
3252,December,2018,Whatcom,WA,Passenger,757,371,1128,149448,150576,0.75
3253,December,2018,Washoe,NV,Passenger,2,0,2,110,112,1.79
3254,December,2018,Bergen,NJ,Passenger,1,0,1,27,28,3.57
3255,December,2018,Mason,WA,Passenger,107,110,217,46462,46679,0.46
3256,December,2018,Mason,WA,Truck,0,0,0,20192,20192,0.0
3257,December,2018,San Francisco,CA,Passenger,2,1,3,115,118,2.54
3258,December,2018,Cook,IL,Passenger,1,0,1,247,248,0.4
3259,December,2018,Larimer,CO,Passenger,1,0,1,60,61,1.64
3260,December,2018,Virginia Beach,VA,Passenger,2,1,3,695,698,0.43
3261,December,2018,Goochland,VA,Passenger,0,1,1,243,244,0.41
3262,December,2018,Thurston,WA,Truck,0,0,0,54873,54873,0.0
3263,December,2018,Jefferson,CO,Passenger,0,2,2,61,63,3.17
3264,December,2018,Island,WA,Truck,0,0,0,21185,21185,0.0
3265,December,2018,Garfield,WA,Truck,0,0,0,965,965,0.0
3266,December,2018,Rogers,OK,Passenger,1,0,1,5,6,16.67
3267,December,2018,Lewis,WA,Truck,0,0,0,25634,25634,0.0
3268,December,2018,Yakima,WA,Passenger,82,99,181,164762,164943,0.11
3269,December,2018,Sangamon,IL,Passenger,1,0,1,9,10,10.0
3270,December,2018,Frederick,MD,Passenger,0,1,1,79,80,1.25
3271,December,2018,Benton,WA,Truck,0,0,0,41561,41561,0.0
3272,December,2018,Manatee,FL,Passenger,1,0,1,37,38,2.63
3273,December,2018,Marion,OR,Passenger,1,0,1,117,118,0.85
3274,December,2018,St. Mary's,MD,Passenger,1,0,1,214,215,0.47
3275,December,2018,Ventura,CA,Passenger,0,2,2,319,321,0.62
3276,December,2018,Pierce,WA,Truck,0,0,0,139122,139122,0.0
3277,December,2018,Pinal,AZ,Passenger,2,0,2,200,202,0.99
3278,December,2018,Clark,NV,Passenger,2,2,4,719,723,0.55
3279,December,2018,Kootenai,ID,Passenger,1,1,2,218,220,0.91
3280,December,2018,Dale,AL,Passenger,0,1,1,56,57,1.75
3281,December,2018,Travis,TX,Passenger,1,1,2,197,199,1.01
3282,December,2018,Hennepin,MN,Passenger,2,0,2,105,107,1.87
3283,December,2018,Grant,WA,Truck,0,0,0,26258,26258,0.0
3284,December,2018,Honolulu,HI,Passenger,1,3,4,516,520,0.77
3285,December,2018,Denver,CO,Passenger,1,0,1,128,129,0.78
3286,December,2018,Ferry,WA,Passenger,3,2,5,4383,4388,0.11
3287,December,2018,Norfolk,VA,Passenger,2,2,4,341,345,1.16
3288,December,2018,Garfield,OK,Passenger,1,0,1,13,14,7.14
3289,December,2018,Norfolk,MA,Passenger,1,0,1,36,37,2.7
3290,December,2018,Camden,NJ,Passenger,0,1,1,28,29,3.45
3291,December,2018,Ada,ID,Passenger,0,2,2,312,314,0.64
3292,December,2018,Spokane,WA,Truck,1,0,1,93762,93763,0.0
3293,December,2018,Hardin,KY,Passenger,0,1,1,107,108,0.93
3294,December,2018,Asotin,WA,Truck,0,0,0,6635,6635,0.0
3295,December,2018,Madison,ID,Passenger,1,0,1,35,36,2.78
3296,December,2018,Valencia,NM,Passenger,1,0,1,10,11,9.09
3297,December,2018,Carson City,NV,Passenger,1,0,1,15,16,6.25
3298,December,2018,Montgomery,PA,Passenger,2,0,2,35,37,5.41
3299,December,2018,Adams,WA,Passenger,5,6,11,12744,12755,0.09
3300,December,2018,San Juan,PR,Passenger,0,1,1,5,6,16.67
3301,December,2018,DuPage,IL,Passenger,1,0,1,59,60,1.67
3302,December,2018,King,WA,Truck,6,1,7,182653,182660,0.0
3303,December,2018,Santa Fe,NM,Passenger,0,1,1,41,42,2.38
3304,December,2018,New Haven,CT,Passenger,0,1,1,49,50,2.0
3305,December,2018,DeKalb,IN,Passenger,1,0,1,1,2,50.0
3306,December,2018,Clark,WA,Passenger,1246,841,2087,311394,313481,0.67
3307,December,2018,Washington,OR,Passenger,0,1,1,471,472,0.21
3308,December,2018,Kitsap,WA,Truck,1,0,1,53636,53637,0.0
3309,December,2018,Douglas,WA,Passenger,50,34,84,28009,28093,0.3
3310,December,2018,San Mateo,CA,Passenger,2,1,3,128,131,2.29
3311,December,2018,Collin,TX,Passenger,1,1,2,145,147,1.36
3312,December,2018,Shasta,CA,Passenger,1,0,1,42,43,2.33
3313,December,2018,Island,WA,Passenger,276,225,501,63178,63679,0.79
3314,December,2018,Saratoga,NY,Passenger,1,0,1,62,63,1.59
3315,December,2018,Lee,AL,Passenger,1,0,1,36,37,2.7
3316,December,2018,Williamson,TX,Passenger,0,1,1,147,148,0.68
3317,December,2018,Ramsey,MN,Passenger,1,0,1,39,40,2.5
3318,December,2018,Brevard,FL,Passenger,0,1,1,94,95,1.05
3319,December,2018,Skagit,WA,Passenger,259,187,446,91196,91642,0.49
3320,December,2018,Portsmouth,VA,Passenger,0,1,1,81,82,1.22
3321,December,2018,Lumpkin,GA,Passenger,1,0,1,7,8,12.5
3322,December,2018,Charleston,SC,Passenger,1,0,1,123,124,0.81
3323,December,2018,Gwinnett,GA,Passenger,0,1,1,78,79,1.27
3324,December,2018,Randolph,NC,Passenger,1,0,1,6,7,14.29
3325,December,2018,Santa Clara,CA,Passenger,8,1,9,372,381,2.36
3326,December,2018,Klickitat,WA,Truck,0,0,0,8209,8209,0.0
3327,December,2018,Lincoln,WA,Passenger,2,5,7,7780,7787,0.09
3328,December,2018,Volusia,FL,Passenger,0,1,1,37,38,2.63
3329,December,2018,Pierce,WA,Passenger,1509,1373,2882,538890,541772,0.53
3330,December,2018,Walla Walla,WA,Truck,0,0,0,13523,13523,0.0
3331,December,2018,Juneau,AK,Passenger,0,1,1,43,44,2.27
3332,December,2018,Prince George's,MD,Passenger,1,1,2,183,185,1.08
3333,December,2018,Oldham,KY,Passenger,0,1,1,5,6,16.67
3334,December,2018,Spokane,WA,Passenger,439,373,812,307178,307990,0.26
3335,December,2018,Allegheny,PA,Passenger,1,0,1,81,82,1.22
3336,December,2018,Stevens,WA,Truck,0,0,0,18764,18764,0.0
3337,December,2018,Moore,NC,Passenger,0,1,1,191,192,0.52
3338,December,2018,Montgomery,AL,Passenger,0,1,1,46,47,2.13
3339,December,2018,Palm Beach,FL,Passenger,0,1,1,94,95,1.05
3340,December,2018,Clark,WA,Truck,0,0,0,79840,79840,0.0
3341,December,2018,Orange,CA,Passenger,6,2,8,539,547,1.46
3342,December,2018,Montgomery,MD,Passenger,1,0,1,275,276,0.36
3343,December,2018,Okanogan,WA,Truck,0,0,0,16487,16487,0.0
3344,December,2018,King,WA,Passenger,16280,6530,22810,1378186,1400996,1.63
3345,December,2018,Mecklenburg,NC,Passenger,1,0,1,79,80,1.25
3346,December,2018,Okanogan,WA,Passenger,16,22,38,26070,26108,0.15
3347,December,2018,Contra Costa,CA,Passenger,0,2,2,408,410,0.49
3348,December,2018,Pend Oreille,WA,Passenger,5,5,10,9533,9543,0.1
3349,December,2018,Columbia,WA,Passenger,2,2,4,2421,2425,0.16
3350,December,2018,Alameda,CA,Passenger,0,2,2,323,325,0.62
3351,December,2018,San Diego,CA,Passenger,8,2,10,2569,2579,0.39
3352,December,2018,Shelby,TN,Passenger,0,1,1,98,99,1.01
3353,December,2018,Broward,FL,Passenger,2,1,3,128,131,2.29
3354,December,2018,Klamath,OR,Passenger,1,0,1,37,38,2.63
3355,December,2018,Whitman,WA,Passenger,24,38,62,22811,22873,0.27
3356,December,2018,Lee,FL,Passenger,1,0,1,52,53,1.89
3357,December,2018,Stevens,WA,Passenger,16,27,43,31786,31829,0.14
3358,December,2018,Wahkiakum,WA,Truck,0,0,0,1722,1722,0.0
3359,December,2018,Anne Arundel,MD,Passenger,0,2,2,452,454,0.44
3360,December,2018,Whitman,WA,Truck,0,0,0,8542,8542,0.0
3361,December,2018,Dallas,TX,Passenger,0,1,1,203,204,0.49
3362,December,2019,Charleston,SC,Passenger,1,0,1,109,110,0.91
3363,December,2019,Asotin,WA,Passenger,14,9,23,12679,12702,0.18
3364,December,2019,Hennepin,MN,Passenger,3,1,4,101,105,3.81
3365,December,2019,Jefferson,WA,Truck,0,0,0,9647,9647,0.0
3366,December,2019,Howard,MD,Passenger,0,1,1,74,75,1.33
3367,December,2019,Clallam,WA,Passenger,196,157,353,50869,51222,0.69
3368,December,2019,Lee,FL,Passenger,1,0,1,53,54,1.85
3369,December,2019,Grant,WA,Truck,0,0,0,27002,27002,0.0
3370,December,2019,Washtenaw,MI,Passenger,1,0,1,42,43,2.33
3371,December,2019,Montgomery,TX,Passenger,1,0,1,55,56,1.79
3372,December,2019,Douglas,WA,Passenger,67,38,105,28299,28404,0.37
3373,December,2019,Houston,GA,Passenger,1,0,1,60,61,1.64
3374,December,2019,Fulton,GA,Passenger,0,2,2,104,106,1.89
3375,December,2019,Whitman,WA,Truck,0,0,0,8579,8579,0.0
3376,December,2019,Honolulu,HI,Passenger,4,2,6,479,485,1.24
3377,December,2019,Columbia,WA,Passenger,3,3,6,2449,2455,0.24
3378,December,2019,Boone,MO,Passenger,0,1,1,11,12,8.33
3379,December,2019,Bexar,TX,Passenger,1,5,6,646,652,0.92
3380,December,2019,Calvert,MD,Passenger,0,2,2,91,93,2.15
3381,December,2019,Dakota,MN,Passenger,0,1,1,33,34,2.94
3382,December,2019,Clark,WA,Passenger,1843,1043,2886,317733,320619,0.9
3383,December,2019,Cowlitz,WA,Passenger,118,107,225,73644,73869,0.3
3384,December,2019,Kent,MI,Passenger,0,1,1,24,25,4.0
3385,December,2019,Ada,ID,Passenger,0,1,1,290,291,0.34
3386,December,2019,Carson City,NV,Passenger,1,0,1,10,11,9.09
3387,December,2019,Wahkiakum,WA,Passenger,4,3,7,3041,3048,0.23
3388,December,2019,Klickitat,WA,Passenger,46,38,84,15674,15758,0.53
3389,December,2019,Wahkiakum,WA,Truck,0,0,0,1754,1754,0.0
3390,December,2019,San Juan,WA,Truck,0,0,0,5935,5935,0.0
3391,December,2019,Solano,CA,Passenger,1,0,1,207,208,0.48
3392,December,2019,Clark,NV,Passenger,3,2,5,680,685,0.73
3393,December,2019,Valencia,NM,Passenger,1,0,1,5,6,16.67
3394,December,2019,DeKalb,GA,Passenger,1,0,1,81,82,1.22
3395,December,2019,Columbia,WA,Truck,0,0,0,1537,1537,0.0
3396,December,2019,Berkshire,MA,Passenger,0,1,1,5,6,16.67
3397,December,2019,Juneau,AK,Passenger,0,2,2,29,31,6.45
3398,December,2019,Wayne,MI,Passenger,0,1,1,59,60,1.67
3399,December,2019,Oldham,KY,Passenger,0,1,1,4,5,20.0
3400,December,2019,Pend Oreille,WA,Truck,0,0,0,5771,5771,0.0
3401,December,2019,Cape May,NJ,Passenger,0,1,1,13,14,7.14
3402,December,2019,Cowlitz,WA,Truck,0,0,0,29035,29035,0.0
3403,December,2019,Skagit,WA,Passenger,363,213,576,92637,93213,0.62
3404,December,2019,San Diego,CA,Passenger,9,3,12,2797,2809,0.43
3405,December,2019,Lewis,WA,Passenger,106,102,208,59556,59764,0.35
3406,December,2019,Allegheny,PA,Passenger,1,0,1,74,75,1.33
3407,December,2019,Prince George's,MD,Passenger,1,1,2,172,174,1.15
3408,December,2019,Montgomery,OH,Passenger,0,1,1,47,48,2.08
3409,December,2019,Clark,WA,Truck,0,0,0,81316,81316,0.0
3410,December,2019,Anne Arundel,MD,Passenger,1,2,3,434,437,0.69
3411,December,2019,Oklahoma,OK,Passenger,0,1,1,128,129,0.78
3412,December,2019,Garfield,WA,Passenger,0,1,1,1306,1307,0.08
3413,December,2019,Thurston,WA,Passenger,1052,701,1753,199236,200989,0.87
3414,December,2019,El Paso,CO,Passenger,2,1,3,742,745,0.4
3415,December,2019,Okanogan,WA,Truck,0,0,0,16550,16550,0.0
3416,December,2019,Chelan,WA,Passenger,201,78,279,54622,54901,0.51
3417,December,2019,Whatcom,WA,Truck,2,0,2,43188,43190,0.0
3418,December,2019,Montgomery,AL,Passenger,0,1,1,39,40,2.5
3419,December,2019,Ferry,WA,Passenger,5,2,7,4398,4405,0.16
3420,December,2019,Greene,MO,Passenger,0,1,1,31,32,3.12
3421,December,2019,Richland,SC,Passenger,0,1,1,157,158,0.63
3422,December,2019,Tulsa,OK,Passenger,1,1,2,48,50,4.0
3423,December,2019,Santa Cruz,CA,Passenger,1,0,1,36,37,2.7
3424,December,2019,Frederick,MD,Passenger,1,1,2,81,83,2.41
3425,December,2019,King,WA,Truck,6,1,7,182216,182223,0.0
3426,December,2019,Placer,CA,Passenger,1,0,1,95,96,1.04
3427,December,2019,Maricopa,AZ,Passenger,7,5,12,1498,1510,0.79
3428,December,2019,Duval,FL,Passenger,1,2,3,362,365,0.82
3429,December,2019,Lewis,WA,Truck,0,0,0,26087,26087,0.0
3430,December,2019,Middlesex,MA,Passenger,1,1,2,107,109,1.83
3431,December,2019,Williamson,TX,Passenger,0,2,2,144,146,1.37
3432,December,2019,Sedgwick,KS,Passenger,1,1,2,96,98,2.04
3433,December,2019,Santa Clara,CA,Passenger,7,2,9,351,360,2.5
3434,December,2019,Sarasota,FL,Passenger,2,0,2,25,27,7.41
3435,December,2019,Kitsap,WA,Passenger,1199,652,1851,182349,184200,1.0
3436,December,2019,San Joaquin,CA,Passenger,1,0,1,137,138,0.72
3437,December,2019,Virginia Beach,VA,Passenger,1,0,1,695,696,0.14
3438,December,2019,Asotin,WA,Truck,0,0,0,6709,6709,0.0
3439,December,2019,Putnam,TN,Passenger,0,1,1,3,4,25.0
3440,December,2019,Walla Walla,WA,Truck,0,0,0,13663,13663,0.0
3441,December,2019,Contra Costa,CA,Passenger,3,2,5,343,348,1.44
3442,December,2019,Island,WA,Truck,1,0,1,21356,21357,0.0
3443,December,2019,Harnett,NC,Passenger,1,1,2,206,208,0.96
3444,December,2019,Clallam,WA,Truck,1,0,1,21871,21872,0.0
3445,December,2019,Pacific,WA,Truck,0,0,0,7721,7721,0.0
3446,December,2019,Guadalupe,TX,Passenger,1,0,1,66,67,1.49
3447,December,2019,Multnomah,OR,Passenger,4,6,10,726,736,1.36
3448,December,2019,Spokane,WA,Passenger,643,471,1114,315064,316178,0.35
3449,December,2019,Chesapeake,VA,Passenger,0,2,2,431,433,0.46
3450,December,2019,Pierce,WA,Passenger,2127,1651,3778,547907,551685,0.68
3451,December,2019,San Mateo,CA,Passenger,1,1,2,119,121,1.65
3452,December,2019,Pacific,WA,Passenger,30,30,60,16120,16180,0.37
3453,December,2019,Pinal,AZ,Passenger,1,0,1,190,191,0.52
3454,December,2019,Pierce,WA,Truck,0,0,0,140864,140864,0.0
3455,December,2019,Harrison,MS,Passenger,1,0,1,57,58,1.72
3456,December,2019,Albemarle,VA,Passenger,1,0,1,25,26,3.85
3457,December,2019,Stevens,WA,Passenger,31,31,62,31609,31671,0.2
3458,December,2019,Yakima,WA,Truck,0,0,0,59618,59618,0.0
3459,December,2019,Fairbanks North Star,AK,Passenger,0,1,1,99,100,1.0
3460,December,2019,Jones,GA,Passenger,1,0,1,1,2,50.0
3461,December,2019,Saginaw,MI,Passenger,1,0,1,11,12,8.33
3462,December,2019,District of Columbia,DC,Passenger,1,1,2,213,215,0.93
3463,December,2019,Montgomery,PA,Passenger,2,0,2,35,37,5.41
3464,December,2019,Skagit,WA,Truck,1,0,1,32566,32567,0.0
3465,December,2019,DeKalb,IN,Passenger,1,0,1,1,2,50.0
3466,December,2019,Snohomish,WA,Passenger,4021,1709,5730,536109,541839,1.06
3467,December,2019,Goochland,VA,Passenger,2,1,3,263,266,1.13
3468,December,2019,Bucks,PA,Passenger,1,0,1,21,22,4.55
3469,December,2019,Los Angeles,CA,Passenger,7,9,16,1062,1078,1.48
3470,December,2019,Island,WA,Passenger,375,253,628,63608,64236,0.98
3471,December,2019,Carroll,NH,Passenger,0,1,1,4,5,20.0
3472,December,2019,Polk,FL,Passenger,1,0,1,65,66,1.52
3473,December,2019,Ventura,CA,Passenger,0,3,3,299,302,0.99
3474,December,2019,Manassas,VA,Passenger,0,1,1,6,7,14.29
3475,December,2019,Norfolk,VA,Passenger,1,2,3,348,351,0.85
3476,December,2019,Broward,FL,Passenger,2,1,3,125,128,2.34
3477,December,2019,Prince William,VA,Passenger,1,3,4,234,238,1.68
3478,December,2019,Nueces,TX,Passenger,1,1,2,85,87,2.3
3479,December,2019,Deschutes,OR,Passenger,3,0,3,149,152,1.97
3480,December,2019,Shelby,TN,Passenger,0,1,1,95,96,1.04
3481,December,2019,Arapahoe,CO,Passenger,1,0,1,141,142,0.7
3482,December,2019,Fresno,CA,Passenger,1,0,1,188,189,0.53
3483,December,2019,Jefferson,WA,Passenger,217,134,351,25187,25538,1.37
3484,December,2019,Adams,WA,Passenger,6,7,13,12936,12949,0.1
3485,December,2019,Hudson,NJ,Passenger,1,0,1,38,39,2.56
3486,December,2019,Douglas,WA,Truck,0,0,0,12308,12308,0.0
3487,December,2019,Rogers,OK,Passenger,1,0,1,5,6,16.67
3488,December,2019,Okanogan,WA,Passenger,30,30,60,26236,26296,0.23
3489,December,2019,Vigo,IN,Passenger,1,0,1,6,7,14.29
3490,December,2019,Osceola,FL,Passenger,1,0,1,42,43,2.33
3491,December,2019,Clay,FL,Passenger,0,1,1,86,87,1.15
3492,December,2019,Skamania,WA,Truck,0,0,0,4099,4099,0.0
3493,December,2019,Suffolk,VA,Passenger,1,0,1,124,125,0.8
3494,December,2019,Collin,TX,Passenger,1,1,2,131,133,1.5
3495,December,2019,Travis,TX,Passenger,2,1,3,198,201,1.49
3496,December,2019,Alameda,CA,Passenger,5,1,6,292,298,2.01
3497,December,2019,Randolph,NC,Passenger,1,0,1,7,8,12.5
3498,December,2019,Grays Harbor,WA,Passenger,105,100,205,48394,48599,0.42
3499,December,2019,Boulder,CO,Passenger,0,1,1,50,51,1.96
3500,December,2019,Yakima,WA,Passenger,116,114,230,166298,166528,0.14
3501,December,2019,Washoe,NV,Passenger,1,0,1,108,109,0.92
3502,December,2019,Klickitat,WA,Truck,0,0,0,8318,8318,0.0
3503,December,2019,Norfolk,MA,Passenger,1,0,1,36,37,2.7
3504,December,2019,Denver,CO,Passenger,1,0,1,127,128,0.78
3505,December,2019,Snohomish,WA,Truck,0,0,0,123277,123277,0.0
3506,December,2019,Jefferson,CO,Passenger,0,2,2,58,60,3.33
3507,December,2019,Thurston,WA,Truck,0,0,0,55729,55729,0.0
3508,December,2019,Lake,IL,Passenger,1,0,1,162,163,0.61
3509,December,2019,Camden,NJ,Passenger,0,2,2,21,23,8.7
3510,December,2019,Riverside,CA,Passenger,4,1,5,637,642,0.78
3511,December,2019,Penobscot,ME,Passenger,0,1,1,13,14,7.14
3512,December,2019,Twin Falls,ID,Passenger,0,1,1,28,29,3.45
3513,December,2019,Benton,WA,Truck,0,0,0,42486,42486,0.0
3514,December,2019,Ferry,WA,Truck,0,0,0,3580,3580,0.0
3516,December,2019,Lincoln,WA,Truck,0,0,0,4683,4683,0.0
3517,December,2019,Kittitas,WA,Passenger,90,46,136,30054,30190,0.45
3518,December,2019,El Paso,TX,Passenger,3,0,3,455,458,0.66
3519,December,2019,Santa Rosa,FL,Passenger,1,0,1,86,87,1.15
3520,December,2019,Loudoun,VA,Passenger,1,0,1,93,94,1.06
3521,December,2019,Jefferson,NY,Passenger,0,2,2,218,220,0.91
3522,December,2019,Nassau,NY,Passenger,4,0,4,39,43,9.3
3523,December,2019,Cumberland,NC,Passenger,0,2,2,487,489,0.41
3524,December,2019,Garfield,WA,Truck,0,0,0,969,969,0.0
3525,December,2019,Hawaii,HI,Passenger,1,0,1,60,61,1.64
3526,December,2019,Flathead,MT,Passenger,1,0,1,63,64,1.56
3527,December,2019,Adams,WA,Truck,0,0,0,5198,5198,0.0
3528,December,2019,Shasta,CA,Passenger,1,0,1,37,38,2.63
3529,December,2019,Queens,NY,Passenger,1,0,1,52,53,1.89
3530,December,2019,RÃ­o Grande,PR,Passenger,1,0,1,1,2,50.0
3531,December,2019,Larimer,CO,Passenger,1,0,1,55,56,1.79
3532,December,2019,Spokane,WA,Truck,1,0,1,96378,96379,0.0
3533,December,2019,Spartanburg,SC,Passenger,0,1,1,43,44,2.27
3534,December,2019,Grant,WA,Passenger,55,68,123,65625,65748,0.19
3535,December,2019,King,WA,Passenger,21951,7543,29494,1394823,1424317,2.07
3536,December,2019,Mason,WA,Truck,0,0,0,20527,20527,0.0
3537,December,2019,Sumter,FL,Passenger,0,1,1,9,10,10.0
3538,December,2019,Franklin,WA,Passenger,54,76,130,60982,61112,0.21
3539,December,2019,Kootenai,ID,Passenger,1,1,2,226,228,0.88
3540,December,2019,Washington,OR,Passenger,1,0,1,454,455,0.22
3541,December,2019,Maui,HI,Passenger,1,0,1,38,39,2.56
3542,December,2019,Tarrant,TX,Passenger,2,0,2,192,194,1.03
3543,December,2019,Kittitas,WA,Truck,0,0,0,14624,14624,0.0
3544,December,2019,San Francisco,CA,Passenger,2,1,3,100,103,2.91
3545,December,2019,Harris,TX,Passenger,1,0,1,240,241,0.41
3546,December,2019,Wilson,TX,Passenger,0,1,1,8,9,11.11
3547,December,2019,Moore,NC,Passenger,0,1,1,164,165,0.61
3548,December,2019,Stafford,VA,Passenger,1,1,2,94,96,2.08
3549,December,2019,Mason,WA,Passenger,142,135,277,47637,47914,0.58
3550,December,2019,San Juan,WA,Passenger,253,79,332,14407,14739,2.25
3551,December,2019,Cochise,AZ,Passenger,0,1,1,105,106,0.94
3552,December,2019,DuPage,IL,Passenger,3,0,3,63,66,4.55
3553,December,2019,Benton,WA,Passenger,315,308,623,135242,135865,0.46
3554,December,2019,New Haven,CT,Passenger,0,2,2,46,48,4.17
3555,December,2019,Walla Walla,WA,Passenger,63,60,123,36306,36429,0.34
3556,December,2019,Arlington,VA,Passenger,0,2,2,152,154,1.3
3557,December,2019,Owyhee,ID,Passenger,1,0,1,3,4,25.0
3558,December,2019,Fairfax,VA,Passenger,4,2,6,753,759,0.79
3559,December,2019,Shelby,OH,Passenger,0,1,1,1,2,50.0
3560,December,2019,Richmond,GA,Passenger,0,1,1,91,92,1.09
3561,December,2019,Brevard,FL,Passenger,0,1,1,88,89,1.12
3562,December,2019,Fort Bend,TX,Passenger,1,0,1,47,48,2.08
3563,December,2019,Cascade,MT,Passenger,0,1,1,55,56,1.79
3564,December,2019,Orange,CA,Passenger,7,2,9,504,513,1.75
3565,December,2019,Monroe,IL,Passenger,1,0,1,4,5,20.0
3566,December,2019,Lincoln,WA,Passenger,1,11,12,7804,7816,0.15
3567,December,2019,Dallas,TX,Passenger,1,0,1,207,208,0.48
3568,December,2019,Klamath,OR,Passenger,1,0,1,37,38,2.63
3569,December,2019,Douglas,NE,Passenger,0,1,1,57,58,1.72
3570,December,2019,Whatcom,WA,Passenger,987,477,1464,151703,153167,0.96
3571,December,2019,Kern,CA,Passenger,0,1,1,222,223,0.45
3572,December,2019,New London,CT,Passenger,0,2,2,246,248,0.81
3573,December,2019,Whitman,WA,Passenger,42,46,88,22678,22766,0.39
3574,December,2019,Palm Beach,FL,Passenger,0,1,1,83,84,1.19
3575,December,2019,Pend Oreille,WA,Passenger,7,7,14,9514,9528,0.15
3576,December,2019,Charles,MD,Passenger,0,1,1,83,84,1.19
3577,December,2019,Lake,FL,Passenger,1,0,1,21,22,4.55
3578,December,2019,Tuolumne,CA,Passenger,0,1,1,11,12,8.33
3579,December,2019,Clackamas,OR,Passenger,2,1,3,210,213,1.41
3580,December,2019,Portsmouth,VA,Passenger,0,1,1,81,82,1.22
3581,December,2019,Kitsap,WA,Truck,1,0,1,54446,54447,0.0
3582,December,2019,Stevens,WA,Truck,0,0,0,18761,18761,0.0
3583,December,2019,Skamania,WA,Passenger,26,19,45,8767,8812,0.51
3584,December,2019,Ramsey,MN,Passenger,1,0,1,39,40,2.5
3585,December,2019,Alexandria,VA,Passenger,1,0,1,147,148,0.68
3586,December,2019,Pinellas,FL,Passenger,1,1,2,108,110,1.82
3587,December,2019,Powhatan,VA,Passenger,1,0,1,0,1,100.0
3588,December,2019,St. Mary's,MD,Passenger,1,0,1,217,218,0.46
3589,December,2019,Suffolk,MA,Passenger,0,1,1,34,35,2.86
3590,December,2019,Franklin,WA,Truck,0,0,0,19779,19779,0.0
3591,December,2019,Grays Harbor,WA,Truck,0,0,0,20770,20770,0.0
3592,December,2019,Chelan,WA,Truck,0,0,0,22549,22549,0.0
3593,December,2019,Pima,AZ,Passenger,3,1,4,369,373,1.07
3594,December,2020,DeKalb,IN,Passenger,1,0,1,0,1,100.0
3595,December,2020,Lincoln,WA,Truck,0,0,0,4673,4673,0.0
3596,December,2020,Clallam,WA,Truck,1,0,1,21831,21832,0.0
3597,December,2020,Columbia,WA,Truck,0,0,0,1543,1543,0.0
3598,December,2020,Broward,FL,Passenger,2,1,3,107,110,2.73
3599,December,2020,Benton,WA,Truck,0,0,0,43207,43207,0.0
3600,December,2020,Chelan,WA,Passenger,278,88,366,54504,54870,0.67
3601,December,2020,Montgomery,MD,Passenger,1,0,1,227,228,0.44
3602,December,2020,Cascade,MT,Passenger,0,1,1,54,55,1.82
3603,December,2020,Charleston,SC,Passenger,2,0,2,89,91,2.2
3604,December,2020,Hudson,NJ,Passenger,1,0,1,39,40,2.5
3605,December,2020,Whitman,WA,Truck,0,0,0,8508,8508,0.0
3606,December,2020,Hampshire,MA,Passenger,1,0,1,6,7,14.29
3607,December,2020,Harrison,MS,Passenger,2,0,2,52,54,3.7
3608,December,2020,Cumberland,NC,Passenger,0,3,3,442,445,0.67
3609,December,2020,Collin,TX,Passenger,1,1,2,116,118,1.69
3610,December,2020,Nassau,NY,Passenger,4,0,4,28,32,12.5
3611,December,2020,Whitman,WA,Passenger,51,44,95,21905,22000,0.43
3612,December,2020,Pierce,WA,Truck,0,0,0,144789,144789,0.0
3613,December,2020,Larimer,CO,Passenger,1,0,1,54,55,1.82
3614,December,2020,Duval,FL,Passenger,0,2,2,353,355,0.56
3615,December,2020,Douglas,WA,Truck,0,0,0,12494,12494,0.0
3616,December,2020,Vigo,IN,Passenger,1,0,1,6,7,14.29
3617,December,2020,Kitsap,WA,Passenger,1556,756,2312,179832,182144,1.27
3618,December,2020,Honolulu,HI,Passenger,5,2,7,416,423,1.65
3619,December,2020,Franklin,WA,Passenger,85,83,168,61368,61536,0.27
3620,December,2020,Kauai,HI,Passenger,1,0,1,15,16,6.25
3621,December,2020,Boulder,CO,Passenger,0,1,1,44,45,2.22
3622,December,2020,St. Clair,IL,Passenger,1,0,1,137,138,0.72
3623,December,2020,Klickitat,WA,Truck,0,0,0,8088,8088,0.0
3624,December,2020,Stevens,WA,Truck,0,0,0,18716,18716,0.0
3625,December,2020,DuPage,IL,Passenger,2,0,2,53,55,3.64
3626,December,2020,Denton,TX,Passenger,1,0,1,85,86,1.16
3627,December,2020,San Francisco,CA,Passenger,1,1,2,90,92,2.17
3628,December,2020,Bradley,TN,Passenger,1,0,1,0,1,100.0
3629,December,2020,Skagit,WA,Passenger,497,238,735,91428,92163,0.8
3630,December,2020,Douglas,NE,Passenger,0,1,1,51,52,1.92
3631,December,2020,Dallas,TX,Passenger,1,0,1,171,172,0.58
3632,December,2020,Kitsap,WA,Truck,0,0,0,54371,54371,0.0
3633,December,2020,Santa Clara,CA,Passenger,7,2,9,267,276,3.26
3634,December,2020,Lewis,WA,Passenger,123,122,245,58843,59088,0.41
3635,December,2020,Portsmouth,VA,Passenger,0,1,1,77,78,1.28
3636,December,2020,Los Angeles,CA,Passenger,10,11,21,939,960,2.19
3637,December,2020,Columbia,WA,Passenger,5,3,8,2441,2449,0.33
3638,December,2020,Grant,WA,Truck,0,0,0,27505,27505,0.0
3639,December,2020,Maui,HI,Passenger,1,0,1,27,28,3.57
3640,December,2020,Lewis,WA,Truck,0,0,0,26622,26622,0.0
3641,December,2020,Dakota,MN,Passenger,0,1,1,26,27,3.7
3642,December,2020,Lake,FL,Passenger,1,0,1,22,23,4.35
3643,December,2020,Sacramento,CA,Passenger,2,0,2,234,236,0.85
3644,December,2020,Lincoln,WA,Passenger,5,12,17,7644,7661,0.22
3645,December,2020,San Mateo,CA,Passenger,1,1,2,107,109,1.83
3646,December,2020,Carson City,NV,Passenger,1,0,1,12,13,7.69
3647,December,2020,Shelby,OH,Passenger,0,1,1,1,2,50.0
3648,December,2020,Plaquemines,LA,Passenger,0,1,1,13,14,7.14
3649,December,2020,Mason,WA,Truck,0,0,0,20948,20948,0.0
3650,December,2020,Clark,WA,Passenger,2356,1180,3536,319513,323049,1.09
3651,December,2020,Anne Arundel,MD,Passenger,1,1,2,399,401,0.5
3652,December,2020,Williams,ND,Passenger,0,1,1,10,11,9.09
3653,December,2020,Bartow,GA,Passenger,0,1,1,4,5,20.0
3654,December,2020,Wahkiakum,WA,Passenger,6,7,13,3036,3049,0.43
3655,December,2020,Harris,TX,Passenger,1,1,2,214,216,0.93
3656,December,2020,Flathead,MT,Passenger,1,0,1,50,51,1.96
3657,December,2020,Garfield,WA,Passenger,0,2,2,1367,1369,0.15
3658,December,2020,Yakima,WA,Passenger,170,128,298,167294,167592,0.18
3659,December,2020,Sarasota,FL,Passenger,2,0,2,26,28,7.14
3660,December,2020,Santa Cruz,CA,Passenger,1,0,1,27,28,3.57
3661,December,2020,Kittitas,WA,Truck,0,0,0,14646,14646,0.0
3662,December,2020,Charles,MD,Passenger,1,1,2,70,72,2.78
3663,December,2020,Powhatan,VA,Passenger,1,0,1,1,2,50.0
3664,December,2020,Thurston,WA,Truck,0,0,0,56389,56389,0.0
3665,December,2020,Erie,NY,Passenger,1,0,1,42,43,2.33
3666,December,2020,San Juan,WA,Passenger,365,111,476,14021,14497,3.28
3667,December,2020,Richland,SC,Passenger,0,1,1,139,140,0.71
3668,December,2020,Ada,ID,Passenger,0,1,1,243,244,0.41
3669,December,2020,Walla Walla,WA,Truck,0,0,0,13871,13871,0.0
3670,December,2020,Albemarle,VA,Passenger,1,0,1,21,22,4.55
3671,December,2020,Anchorage,AK,Passenger,1,0,1,144,145,0.69
3672,December,2020,Bexar,TX,Passenger,3,5,8,567,575,1.39
3674,December,2020,Juneau,AK,Passenger,0,1,1,25,26,3.85
3675,December,2020,Houston,GA,Passenger,1,0,1,51,52,1.92
3676,December,2020,Deschutes,OR,Passenger,1,0,1,117,118,0.85
3677,December,2020,Ferry,WA,Passenger,9,3,12,4361,4373,0.27
3678,December,2020,Moore,NC,Passenger,0,1,1,147,148,0.68
3679,December,2020,Jefferson,WA,Passenger,285,155,440,24813,25253,1.74
3680,December,2020,Sumter,FL,Passenger,0,1,1,10,11,9.09
3681,December,2020,Norfolk,VA,Passenger,2,3,5,338,343,1.46
3682,December,2020,Kittitas,WA,Passenger,127,51,178,29824,30002,0.59
3683,December,2020,Manassas,VA,Passenger,0,1,1,5,6,16.67
3684,December,2020,Okanogan,WA,Passenger,55,36,91,26069,26160,0.35
3685,December,2020,Rockingham,NH,Passenger,1,0,1,21,22,4.55
3686,December,2020,Harnett,NC,Passenger,1,0,1,185,186,0.54
3687,December,2020,Asotin,WA,Passenger,16,13,29,12413,12442,0.23
3688,December,2020,Skamania,WA,Passenger,33,22,55,8352,8407,0.65
3689,December,2020,Grays Harbor,WA,Truck,0,0,0,21205,21205,0.0
3690,December,2020,King,WA,Passenger,26917,8171,35088,1370135,1405223,2.5
3691,December,2020,Leavenworth,KS,Passenger,0,1,1,124,125,0.8
3692,December,2020,San Diego,CA,Passenger,13,4,17,2708,2725,0.62
3693,December,2020,Thurston,WA,Passenger,1321,780,2101,197406,199507,1.05
3694,December,2020,Riverside,CA,Passenger,4,1,5,592,597,0.84
3695,December,2020,Allegheny,PA,Passenger,1,1,2,66,68,2.94
3696,December,2020,Cowlitz,WA,Passenger,177,127,304,72118,72422,0.42
3697,December,2020,Sedgwick,KS,Passenger,1,1,2,89,91,2.2
3698,December,2020,Okanogan,WA,Truck,0,0,0,16607,16607,0.0
3699,December,2020,New London,CT,Passenger,1,2,3,232,235,1.28
3700,December,2020,Maricopa,AZ,Passenger,6,6,12,1306,1318,0.91
3701,December,2020,Okaloosa,FL,Passenger,0,1,1,132,133,0.75
3702,December,2020,Placer,CA,Passenger,2,0,2,83,85,2.35
3703,December,2020,Twin Falls,ID,Passenger,0,1,1,24,25,4.0
3704,December,2020,Hawaii,HI,Passenger,1,0,1,53,54,1.85
3705,December,2020,Rogers,OK,Passenger,1,0,1,3,4,25.0
3706,December,2020,Oldham,KY,Passenger,0,1,1,4,5,20.0
3707,December,2020,Jefferson,WA,Truck,0,0,0,9588,9588,0.0
3708,December,2020,Miami-Dade,FL,Passenger,1,0,1,97,98,1.02
3709,December,2020,Ventura,CA,Passenger,1,1,2,272,274,0.73
3710,December,2020,Wichita,TX,Passenger,1,0,1,41,42,2.38
3711,December,2020,Clark,WA,Truck,0,0,0,83498,83498,0.0
3712,December,2020,Penobscot,ME,Passenger,0,1,1,9,10,10.0
3713,December,2020,Kern,CA,Passenger,0,1,1,216,217,0.46
3714,December,2020,Contra Costa,CA,Passenger,3,3,6,278,284,2.11
3715,December,2020,Snohomish,WA,Truck,0,0,0,125700,125700,0.0
3716,December,2020,San Joaquin,CA,Passenger,1,0,1,108,109,0.92
3717,December,2020,Denver,CO,Passenger,1,0,1,115,116,0.86
3718,December,2020,Kings,NY,Passenger,1,0,1,62,63,1.59
3719,December,2020,Stevens,WA,Passenger,36,40,76,30234,30310,0.25
3720,December,2020,Pennington,SD,Passenger,1,0,1,34,35,2.86
3721,December,2020,Spartanburg,SC,Passenger,0,1,1,49,50,2.0
3722,December,2020,Grays Harbor,WA,Passenger,127,122,249,48651,48900,0.51
3723,December,2020,Douglas,CO,Passenger,0,1,1,78,79,1.27
3724,December,2020,Pacific,WA,Truck,0,0,0,7792,7792,0.0
3725,December,2020,Spokane,WA,Truck,0,0,0,100712,100712,0.0
3726,December,2020,Fresno,CA,Passenger,1,0,1,169,170,0.59
3727,December,2020,Queens,NY,Passenger,1,0,1,52,53,1.89
3728,December,2020,Whatcom,WA,Passenger,1218,550,1768,150033,151801,1.16
3729,December,2020,Adams,WA,Truck,0,0,0,5337,5337,0.0
3730,December,2020,Prince George's,MD,Passenger,2,1,3,145,148,2.03
3731,December,2020,Orange,CA,Passenger,4,3,7,446,453,1.55
3732,December,2020,El Dorado,CA,Passenger,1,0,1,33,34,2.94
3733,December,2020,Camden,NJ,Passenger,0,1,1,19,20,5.0
3734,December,2020,Morris,NJ,Passenger,1,0,1,16,17,5.88
3735,December,2020,Yakima,WA,Truck,0,0,0,60982,60982,0.0
3736,December,2020,Pierce,WA,Passenger,2825,1771,4596,555647,560243,0.82
3737,December,2020,Frederick,MD,Passenger,1,1,2,72,74,2.7
3738,December,2020,Monroe,IL,Passenger,1,0,1,3,4,25.0
3739,December,2020,Lee,FL,Passenger,1,0,1,43,44,2.27
3740,December,2020,Howard,MD,Passenger,0,1,1,64,65,1.54
3741,December,2020,Gwinnett,GA,Passenger,1,0,1,67,68,1.47
3742,December,2020,Lake,IL,Passenger,2,0,2,158,160,1.25
3743,December,2020,Ulster,NY,Passenger,1,0,1,8,9,11.11
3744,December,2020,New Haven,CT,Passenger,0,2,2,36,38,5.26
3745,December,2020,Garfield,WA,Truck,0,0,0,996,996,0.0
3746,December,2020,Skagit,WA,Truck,1,0,1,32781,32782,0.0
3747,December,2020,Suffolk,MA,Passenger,0,2,2,33,35,5.71
3748,December,2020,Pinellas,FL,Passenger,1,1,2,97,99,2.02
3749,December,2020,Ramsey,MN,Passenger,1,0,1,34,35,2.86
3750,December,2020,Snohomish,WA,Passenger,5036,1848,6884,538610,545494,1.26
3751,December,2020,Klamath,OR,Passenger,1,0,1,30,31,3.23
3752,December,2020,Saginaw,MI,Passenger,2,0,2,9,11,18.18
3753,December,2020,Fairbanks North Star,AK,Passenger,0,1,1,90,91,1.1
3754,December,2020,Middlesex,MA,Passenger,1,1,2,94,96,2.08
3755,December,2020,Kent,MI,Passenger,0,1,1,23,24,4.17
3756,December,2020,Randolph,NC,Passenger,1,0,1,6,7,14.29
3757,December,2020,Owyhee,ID,Passenger,1,0,1,3,4,25.0
3758,December,2020,Island,WA,Truck,0,0,0,21369,21369,0.0
3759,December,2020,Cowlitz,WA,Truck,0,0,0,28933,28933,0.0
3760,December,2020,Pacific,WA,Passenger,34,35,69,15727,15796,0.44
3761,December,2020,Salt Lake,UT,Passenger,0,1,1,172,173,0.58
3762,December,2020,Montgomery,PA,Passenger,1,0,1,25,26,3.85
3763,December,2020,Williamson,TX,Passenger,0,2,2,122,124,1.61
3764,December,2020,El Paso,CO,Passenger,2,0,2,698,700,0.29
3765,December,2020,San Juan,WA,Truck,0,0,0,5874,5874,0.0
3766,December,2020,Orange,FL,Passenger,1,0,1,114,115,0.87
3767,December,2020,Klickitat,WA,Passenger,62,43,105,14980,15085,0.7
3768,December,2020,Palm Beach,FL,Passenger,0,1,1,73,74,1.35
3769,December,2020,Virginia Beach,VA,Passenger,2,0,2,637,639,0.31
3770,December,2020,Stafford,VA,Passenger,2,1,3,92,95,3.16
3771,December,2020,District of Columbia,DC,Passenger,3,1,4,201,205,1.95
3772,December,2020,St. Louis,MO,Passenger,1,0,1,96,97,1.03
3773,December,2020,Calvert,MD,Passenger,0,2,2,85,87,2.3
3774,December,2020,Arapahoe,CO,Passenger,1,0,1,120,121,0.83
3775,December,2020,El Paso,TX,Passenger,3,0,3,396,399,0.75
3776,December,2020,Solano,CA,Passenger,1,0,1,205,206,0.49
3777,December,2020,Missoula,MT,Passenger,1,0,1,64,65,1.54
3778,December,2020,Prince William,VA,Passenger,1,2,3,217,220,1.36
3779,December,2020,Nueces,TX,Passenger,1,0,1,82,83,1.2
3780,December,2020,Carroll,NH,Passenger,0,1,1,5,6,16.67
3781,December,2020,Washtenaw,MI,Passenger,1,0,1,31,32,3.12
3782,December,2020,Island,WA,Passenger,507,289,796,63011,63807,1.25
3783,December,2020,Asotin,WA,Truck,0,0,0,6675,6675,0.0
3784,December,2020,Bucks,PA,Passenger,1,0,1,18,19,5.26
3785,December,2020,Montgomery,OH,Passenger,0,1,1,52,53,1.89
3786,December,2020,Ferry,WA,Truck,0,0,0,3607,3607,0.0
3787,December,2020,Philadelphia,PA,Passenger,1,0,1,60,61,1.64
3788,December,2020,Washington,OR,Passenger,1,0,1,410,411,0.24
3789,December,2020,Whatcom,WA,Truck,3,0,3,43545,43548,0.01
3790,December,2020,Boone,MO,Passenger,0,1,1,10,11,9.09
3791,December,2020,Chesapeake,VA,Passenger,0,3,3,404,407,0.74
3792,December,2020,Fulton,GA,Passenger,1,2,3,89,92,3.26
3793,December,2020,Jefferson,NY,Passenger,0,1,1,208,209,0.48
3794,December,2020,St. Mary's,MD,Passenger,1,0,1,210,211,0.47
3795,December,2020,Hamilton,IN,Passenger,2,0,2,34,36,5.56
3796,December,2020,Fort Bend,TX,Passenger,1,0,1,42,43,2.33
3797,December,2020,Utah,UT,Passenger,0,1,1,126,127,0.79
3798,December,2020,Mason,WA,Passenger,173,133,306,47648,47954,0.64
3799,December,2020,Hennepin,MN,Passenger,2,0,2,82,84,2.38
3800,December,2020,Clark,NV,Passenger,3,2,5,649,654,0.76
3801,December,2020,Grant,WA,Passenger,80,81,161,65927,66088,0.24
3802,December,2020,Douglas,WA,Passenger,86,44,130,28191,28321,0.46
3803,December,2020,Nassau,FL,Passenger,1,0,1,35,36,2.78
3804,December,2020,Clallam,WA,Passenger,273,185,458,49921,50379,0.91
3805,December,2020,Wilson,TX,Passenger,0,1,1,5,6,16.67
3806,December,2020,Walla Walla,WA,Passenger,98,67,165,36134,36299,0.45
3807,December,2020,Pend Oreille,WA,Truck,0,0,0,5715,5715,0.0
3808,December,2020,Benton,WA,Passenger,440,355,795,134989,135784,0.59
3809,December,2020,Skamania,WA,Truck,0,0,0,4004,4004,0.0
3810,December,2020,RÃ­o Grande,PR,Passenger,1,0,1,1,2,50.0
3811,December,2020,Chelan,WA,Truck,0,0,0,22804,22804,0.0
3812,December,2020,Platte,MO,Passenger,1,0,1,17,18,5.56
3813,December,2020,Cape May,NJ,Passenger,0,1,1,10,11,9.09
3814,December,2020,Putnam,TN,Passenger,0,1,1,2,3,33.33
3815,December,2020,Clackamas,OR,Passenger,3,0,3,180,183,1.64
3816,December,2020,Pend Oreille,WA,Passenger,12,4,16,9171,9187,0.17
3817,December,2020,Loudoun,VA,Passenger,1,0,1,75,76,1.32
3818,December,2020,Travis,TX,Passenger,2,1,3,168,171,1.75
3819,December,2020,Howard,IN,Passenger,0,1,1,3,4,25.0
3820,December,2020,Goochland,VA,Passenger,4,3,7,245,252,2.78
3821,December,2020,Montgomery,TX,Passenger,1,0,1,46,47,2.13
3822,December,2020,Wahkiakum,WA,Truck,0,0,0,1770,1770,0.0
3823,December,2020,Monterey,CA,Passenger,0,1,1,156,157,0.64
3824,December,2020,New York,NY,Passenger,1,0,1,54,55,1.82
3825,December,2020,Tulsa,OK,Passenger,1,1,2,39,41,4.88
3826,December,2020,Pima,AZ,Passenger,2,1,3,320,323,0.93
3827,December,2020,Franklin,WA,Truck,0,0,0,20434,20434,0.0
3828,December,2020,Adams,WA,Passenger,10,7,17,12960,12977,0.13
3829,December,2020,Alexandria,VA,Passenger,2,0,2,134,136,1.47
3830,December,2020,King,WA,Truck,6,1,7,184370,184377,0.0
3831,December,2020,Multnomah,OR,Passenger,3,6,9,685,694,1.3
3832,December,2020,Fairfax,VA,Passenger,4,3,7,704,711,0.98
3833,December,2020,Alameda,CA,Passenger,3,0,3,260,263,1.14
3834,December,2020,Jones,GA,Passenger,1,0,1,1,2,50.0
3835,December,2020,Washoe,NV,Passenger,1,0,1,101,102,0.98
3836,December,2020,Arlington,VA,Passenger,0,2,2,140,142,1.41
3837,December,2020,Richmond,GA,Passenger,0,1,1,77,78,1.28
3838,December,2020,Carroll,MD,Passenger,0,1,1,21,22,4.55
3839,December,2020,Polk,FL,Passenger,1,0,1,56,57,1.75
3840,December,2020,DeKalb,GA,Passenger,1,0,1,69,70,1.43
3841,December,2020,Spokane,WA,Passenger,886,547,1433,321109,322542,0.44
3842,December,2020,Suffolk,VA,Passenger,1,0,1,124,125,0.8
3843,December,2020,Greene,MO,Passenger,0,1,1,32,33,3.03
3844,December,2021,Benton,WA,Truck,0,0,0,43707,43707,0.0
3845,December,2021,Bartow,GA,Passenger,0,1,1,3,4,25.0
3846,December,2021,Lewis,WA,Passenger,206,164,370,59615,59985,0.62
3847,December,2021,Geary,KS,Passenger,1,0,1,94,95,1.05
3848,December,2021,Pend Oreille,WA,Truck,0,0,0,5703,5703,0.0
3849,December,2021,Denton,TX,Passenger,1,0,1,74,75,1.33
3850,December,2021,Wilson,NC,Passenger,1,0,1,0,1,100.0
3851,December,2021,Hamilton,OH,Passenger,1,0,1,32,33,3.03
3852,December,2021,El Paso,TX,Passenger,2,0,2,344,346,0.58
3853,December,2021,Moore,NC,Passenger,0,1,1,120,121,0.83
3854,December,2021,Elmore,ID,Passenger,1,0,1,16,17,5.88
3855,December,2021,Williamson,TX,Passenger,1,2,3,90,93,3.23
3856,December,2021,Lincoln,WA,Truck,0,0,0,4823,4823,0.0
3857,December,2021,Williams,ND,Passenger,0,1,1,8,9,11.11
3858,December,2021,Benton,WA,Passenger,639,445,1084,136113,137197,0.79
3859,December,2021,Grant,WA,Truck,0,0,0,27999,27999,0.0
3860,December,2021,Alexandria,VA,Passenger,2,0,2,115,117,1.71
3861,December,2021,Erie,NY,Passenger,1,0,1,31,32,3.12
3862,December,2021,Coryell,TX,Passenger,1,0,1,106,107,0.93
3863,December,2021,Fresno,CA,Passenger,1,0,1,155,156,0.64
3864,December,2021,Clallam,WA,Truck,1,0,1,22124,22125,0.0
3865,December,2021,Wahkiakum,WA,Passenger,17,10,27,3082,3109,0.87
3866,December,2021,Spokane,WA,Truck,0,0,0,102792,102792,0.0
3867,December,2021,Asotin,WA,Truck,0,0,0,6755,6755,0.0
3868,December,2021,Penobscot,ME,Passenger,0,1,1,8,9,11.11
3869,December,2021,Grant,WA,Passenger,137,98,235,66973,67208,0.35
3870,December,2021,Greene,MO,Passenger,0,1,1,24,25,4.0
3871,December,2021,Adams,WA,Truck,0,0,0,5419,5419,0.0
3872,December,2021,Fairfax,VA,Passenger,3,4,7,645,652,1.07
3873,December,2021,Howard,IN,Passenger,0,1,1,6,7,14.29
3874,December,2021,Larimer,CO,Passenger,1,0,1,50,51,1.96
3875,December,2021,Monterey,CA,Passenger,0,1,1,136,137,0.73
3876,December,2021,Stevens,WA,Truck,0,0,0,18940,18940,0.0
3877,December,2021,Asotin,WA,Passenger,22,17,39,12718,12757,0.31
3878,December,2021,Boulder,CO,Passenger,1,1,2,38,40,5.0
3879,December,2021,Island,WA,Passenger,714,340,1054,62768,63822,1.65
3881,December,2021,Charleston,SC,Passenger,2,1,3,75,78,3.85
3882,December,2021,Santa Cruz,CA,Passenger,1,0,1,23,24,4.17
3883,December,2021,Adams,WA,Passenger,17,14,31,13083,13114,0.24
3884,December,2021,Whatcom,WA,Truck,4,0,4,43696,43700,0.01
3885,December,2021,St. Clair,IL,Passenger,2,0,2,120,122,1.64
3886,December,2021,Solano,CA,Passenger,1,0,1,173,174,0.57
3887,December,2021,Pend Oreille,WA,Passenger,18,9,27,9129,9156,0.29
3888,December,2021,Jefferson,WA,Truck,0,0,0,9599,9599,0.0
3889,December,2021,Santa Clara,CA,Passenger,7,1,8,227,235,3.4
3890,December,2021,Rogers,OK,Passenger,1,0,1,3,4,25.0
3891,December,2021,Jefferson,WA,Passenger,382,194,576,24756,25332,2.27
3892,December,2021,Ferry,WA,Passenger,14,3,17,4442,4459,0.38
3893,December,2021,Thurston,WA,Truck,0,0,0,56065,56065,0.0
3894,December,2021,Powhatan,VA,Passenger,1,0,1,1,2,50.0
3895,December,2021,Honolulu,HI,Passenger,4,4,8,346,354,2.26
3896,December,2021,Alameda,CA,Passenger,4,0,4,210,214,1.87
3897,December,2021,Kittitas,WA,Truck,0,0,0,14794,14794,0.0
3898,December,2021,Ulster,NY,Passenger,1,0,1,9,10,10.0
3899,December,2021,Whitman,WA,Passenger,67,59,126,21978,22104,0.57
3900,December,2021,Suffolk,VA,Passenger,1,0,1,124,125,0.8
3901,December,2021,Juneau,AK,Passenger,0,1,1,27,28,3.57
3902,December,2021,Houston,GA,Passenger,1,0,1,43,44,2.27
3903,December,2021,Clallam,WA,Passenger,383,239,622,50384,51006,1.22
3904,December,2021,Klickitat,WA,Passenger,89,53,142,15347,15489,0.92
3905,December,2021,Sarpy,NE,Passenger,1,0,1,58,59,1.69
3906,December,2021,Wahkiakum,WA,Truck,0,0,0,1824,1824,0.0
3907,December,2021,Carroll,MD,Passenger,0,1,1,16,17,5.88
3908,December,2021,Franklin,WA,Passenger,162,104,266,62306,62572,0.43
3909,December,2021,Pacific,WA,Passenger,51,64,115,16068,16183,0.71
3910,December,2021,Clark,WA,Truck,1,0,1,83996,83997,0.0
3911,December,2021,Plaquemines,LA,Passenger,0,1,1,17,18,5.56
3912,December,2021,Flathead,MT,Passenger,1,0,1,38,39,2.56
3913,December,2021,Okaloosa,FL,Passenger,0,1,1,108,109,0.92
3914,December,2021,Carroll,NH,Passenger,0,1,1,5,6,16.67
3915,December,2021,Manassas,VA,Passenger,0,1,1,7,8,12.5
3916,December,2021,King,WA,Passenger,35480,10222,45702,1359266,1404968,3.25
3917,December,2021,Grays Harbor,WA,Truck,0,0,0,21388,21388,0.0
3918,December,2021,Collin,TX,Passenger,1,0,1,102,103,0.97
3919,December,2021,Richmond,NY,Passenger,1,0,1,6,7,14.29
3920,December,2021,Nueces,TX,Passenger,1,1,2,64,66,3.03
3921,December,2021,Yakima,WA,Truck,0,0,0,61785,61785,0.0
3922,December,2021,Salt Lake,UT,Passenger,1,1,2,150,152,1.32
3923,December,2021,Platte,MO,Passenger,1,0,1,17,18,5.56
3924,December,2021,Boone,MO,Passenger,0,1,1,9,10,10.0
3925,December,2021,Lincoln,WA,Passenger,7,16,23,7719,7742,0.3
3926,December,2021,Klickitat,WA,Truck,0,0,0,8333,8333,0.0
3927,December,2021,Island,WA,Truck,0,0,0,21524,21524,0.0
3928,December,2021,DeKalb,GA,Passenger,1,0,1,56,57,1.75
3929,December,2021,Shelby,OH,Passenger,0,1,1,2,3,33.33
3930,December,2021,Allegheny,PA,Passenger,1,1,2,55,57,3.51
3931,December,2021,Ventura,CA,Passenger,2,1,3,242,245,1.22
3932,December,2021,San Juan,WA,Passenger,478,149,627,14189,14816,4.23
3933,December,2021,Essex,NJ,Passenger,2,0,2,10,12,16.67
3934,December,2021,Gwinnett,GA,Passenger,1,0,1,57,58,1.72
3935,December,2021,Kings,NY,Passenger,1,0,1,66,67,1.49
3936,December,2021,Baltimore,MD,Passenger,1,0,1,80,81,1.23
3937,December,2021,Snohomish,WA,Passenger,7024,2235,9259,537474,546733,1.69
3938,December,2021,Cowlitz,WA,Truck,0,1,1,28998,28999,0.0
3939,December,2021,Placer,CA,Passenger,2,0,2,71,73,2.74
3940,December,2021,Douglas,WA,Truck,0,0,0,12700,12700,0.0
3941,December,2021,Bexar,TX,Passenger,3,4,7,481,488,1.43
3942,December,2021,Onslow,NC,Passenger,0,1,1,167,168,0.6
3943,December,2021,Carson City,NV,Passenger,1,0,1,8,9,11.11
3944,December,2021,Queens,NY,Passenger,1,0,1,49,50,2.0
3945,December,2021,Montgomery,MD,Passenger,3,2,5,203,208,2.4
3946,December,2021,Mason,WA,Passenger,266,158,424,47764,48188,0.88
3947,December,2021,Wichita,TX,Passenger,1,0,1,42,43,2.33
3948,December,2021,Charles,MD,Passenger,1,1,2,67,69,2.9
3949,December,2021,Owyhee,ID,Passenger,1,0,1,2,3,33.33
3950,December,2021,Orange,FL,Passenger,1,0,1,103,104,0.96
3951,December,2021,Ray,MO,Passenger,0,1,1,1,2,50.0
3952,December,2021,Burlington,NJ,Passenger,0,1,1,118,119,0.84
3953,December,2021,Lewis,WA,Truck,0,0,0,26677,26677,0.0
3954,December,2021,Riverside,CA,Passenger,5,1,6,494,500,1.2
3955,December,2021,Multnomah,OR,Passenger,2,5,7,599,606,1.16
3956,December,2021,Columbia,WA,Passenger,6,2,8,2452,2460,0.33
3957,December,2021,Oldham,KY,Passenger,0,1,1,4,5,20.0
3958,December,2021,Lake,IL,Passenger,3,0,3,149,152,1.97
3959,December,2021,Virginia Beach,VA,Passenger,2,0,2,558,560,0.36
3960,December,2021,Kern,CA,Passenger,0,1,1,198,199,0.5
3961,December,2021,Clark,WA,Passenger,3474,1562,5036,320347,325383,1.55
3962,December,2021,Harris,TX,Passenger,1,0,1,160,161,0.62
3963,December,2021,Calvert,MD,Passenger,0,2,2,80,82,2.44
3964,December,2021,St. Mary's,MD,Passenger,1,0,1,202,203,0.49
3965,December,2021,Travis,TX,Passenger,2,0,2,130,132,1.52
3966,December,2021,Clackamas,OR,Passenger,2,0,2,159,161,1.24
3967,December,2021,Nassau,NY,Passenger,2,0,2,25,27,7.41
3968,December,2021,Jefferson,NY,Passenger,0,1,1,205,206,0.49
3969,December,2021,Yamhill,OR,Passenger,1,0,1,31,32,3.12
3970,December,2021,Frederick,MD,Passenger,1,1,2,68,70,2.86
3971,December,2021,Rockdale,GA,Passenger,1,0,1,7,8,12.5
3972,December,2021,Okanogan,WA,Truck,0,0,0,16688,16688,0.0
3973,December,2021,Whitman,WA,Truck,0,0,0,8559,8559,0.0
3974,December,2021,San Bernardino,CA,Passenger,0,1,1,357,358,0.28
3975,December,2021,Escambia,FL,Passenger,0,1,1,136,137,0.73
3976,December,2021,Cowlitz,WA,Passenger,274,163,437,71563,72000,0.61
3977,December,2021,Rockingham,NH,Passenger,1,0,1,17,18,5.56
3978,December,2021,Pinellas,FL,Passenger,0,1,1,85,86,1.16
3979,December,2021,Randolph,NC,Passenger,1,0,1,5,6,16.67
3980,December,2021,Whatcom,WA,Passenger,1643,673,2316,149995,152311,1.52
3981,December,2021,Loudoun,VA,Passenger,1,0,1,66,67,1.49
3982,December,2021,Yakima,WA,Passenger,286,173,459,168770,169229,0.27
3983,December,2021,Los Angeles,CA,Passenger,8,7,15,825,840,1.79
3984,December,2021,Sonoma,CA,Passenger,0,1,1,80,81,1.23
3985,December,2021,Lee,FL,Passenger,1,0,1,29,30,3.33
3986,December,2021,Prince William,VA,Passenger,1,1,2,199,201,1.0
3987,December,2021,Hillsborough,FL,Passenger,0,1,1,134,135,0.74
3988,December,2021,Columbia,WA,Truck,0,0,0,1555,1555,0.0
3989,December,2021,Wake,NC,Passenger,1,0,1,106,107,0.93
3990,December,2021,Montgomery,PA,Passenger,2,0,2,21,23,8.7
3991,December,2021,Cumberland,NC,Passenger,1,2,3,393,396,0.76
3992,December,2021,El Paso,CO,Passenger,3,0,3,644,647,0.46
3993,December,2021,Skamania,WA,Passenger,60,42,102,8323,8425,1.21
3994,December,2021,Kauai,HI,Passenger,1,0,1,17,18,5.56
3995,December,2021,Fairbanks North Star,AK,Passenger,0,1,1,77,78,1.28
3996,December,2021,Stafford,VA,Passenger,2,1,3,92,95,3.16
3997,December,2021,Contra Costa,CA,Passenger,1,4,5,260,265,1.89
3998,December,2021,Kitsap,WA,Truck,0,0,0,54199,54199,0.0
3999,December,2021,Wood,OH,Passenger,0,1,1,5,6,16.67
4000,December,2021,Arlington,VA,Passenger,1,0,1,127,128,0.78
4001,December,2021,Cook,IL,Passenger,2,0,2,191,193,1.04
4002,December,2021,Hennepin,MN,Passenger,3,0,3,63,66,4.55
4003,December,2021,San Joaquin,CA,Passenger,1,1,2,94,96,2.08
4004,December,2021,Albemarle,VA,Passenger,1,0,1,18,19,5.26
4005,December,2021,Cape May,NJ,Passenger,0,1,1,8,9,11.11
4006,December,2021,Grays Harbor,WA,Passenger,192,157,349,49447,49796,0.7
4007,December,2021,Lake,FL,Passenger,1,0,1,22,23,4.35
4008,December,2021,Garfield,WA,Truck,0,0,0,1001,1001,0.0
4009,December,2021,Harnett,NC,Passenger,1,1,2,150,152,1.32
4010,December,2021,Tarrant,TX,Passenger,1,0,1,127,128,0.78
4011,December,2021,Danville,VA,Passenger,1,0,1,0,1,100.0
4012,December,2021,Prince George's,MD,Passenger,2,1,3,140,143,2.1
4013,December,2021,Miami-Dade,FL,Passenger,1,0,1,90,91,1.1
4014,December,2021,Snohomish,WA,Truck,2,0,2,125446,125448,0.0
4015,December,2021,Middlesex,MA,Passenger,0,1,1,85,86,1.16
4016,December,2021,Sedgwick,KS,Passenger,1,1,2,81,83,2.41
4017,December,2021,San Juan,WA,Truck,0,0,0,6002,6002,0.0
4018,December,2021,Fort Bend,TX,Passenger,1,0,1,31,32,3.12
4019,December,2021,Douglas,NE,Passenger,1,2,3,46,49,6.12
4020,December,2021,Norfolk,VA,Passenger,3,3,6,304,310,1.94
4021,December,2021,Hudson,NJ,Passenger,2,0,2,38,40,5.0
4022,December,2021,Chesapeake,VA,Passenger,2,3,5,372,377,1.33
4023,December,2021,DuPage,IL,Passenger,1,0,1,48,49,2.04
4024,December,2021,Garfield,WA,Passenger,0,3,3,1350,1353,0.22
4025,December,2021,Sacramento,CA,Passenger,2,0,2,207,209,0.96
4026,December,2021,Maricopa,AZ,Passenger,8,2,10,1035,1045,0.96
4027,December,2021,Walla Walla,WA,Truck,0,0,0,14090,14090,0.0
4028,December,2021,Dallas,TX,Passenger,1,0,1,136,137,0.73
4029,December,2021,Mason,WA,Truck,0,0,0,21219,21219,0.0
4030,December,2021,San Luis Obispo,CA,Passenger,1,0,1,56,57,1.75
4031,December,2021,Saratoga,NY,Passenger,1,0,1,39,40,2.5
4032,December,2021,Broward,FL,Passenger,2,0,2,93,95,2.11
4033,December,2021,Douglas,CO,Passenger,0,1,1,75,76,1.32
4034,December,2021,Camden,NJ,Passenger,0,1,1,14,15,6.67
4035,December,2021,Hawaii,HI,Passenger,1,0,1,40,41,2.44
4036,December,2021,Pierce,WA,Passenger,4236,2127,6363,555764,562127,1.13
4037,December,2021,Goochland,VA,Passenger,3,2,5,179,184,2.72
4038,December,2021,Marin,CA,Passenger,0,1,1,32,33,3.03
4039,December,2021,Duval,FL,Passenger,0,2,2,314,316,0.63
4040,December,2021,Clark,NV,Passenger,4,2,6,557,563,1.07
4041,December,2021,Chelan,WA,Truck,0,0,0,23108,23108,0.0
4042,December,2021,Douglas,WA,Passenger,116,56,172,28610,28782,0.6
4043,December,2021,Walla Walla,WA,Passenger,143,87,230,36378,36608,0.63
4044,December,2021,Richmond,GA,Passenger,0,1,1,70,71,1.41
4045,December,2021,Washington,MD,Passenger,2,0,2,14,16,12.5
4046,December,2021,Hamilton,IN,Passenger,2,0,2,24,26,7.69
4047,December,2021,Okanogan,WA,Passenger,69,45,114,26600,26714,0.43
4048,December,2021,Skagit,WA,Passenger,695,302,997,91135,92132,1.08
4049,December,2021,Wilson,TX,Passenger,0,1,1,2,3,33.33
4050,December,2021,Orange,CA,Passenger,5,2,7,376,383,1.83
4051,December,2021,Ferry,WA,Truck,0,0,0,3596,3596,0.0
4052,December,2021,Skamania,WA,Truck,0,0,0,4002,4002,0.0
4053,December,2021,San Francisco,CA,Passenger,0,1,1,81,82,1.22
4054,December,2021,Stevens,WA,Passenger,55,44,99,30290,30389,0.33
4055,December,2021,Pennington,SD,Passenger,1,0,1,31,32,3.12
4056,December,2021,New London,CT,Passenger,1,4,5,210,215,2.33
4057,December,2021,Pacific,WA,Truck,0,0,0,8019,8019,0.0
4058,December,2021,District of Columbia,DC,Passenger,5,0,5,188,193,2.59
4059,December,2021,Anchorage,AK,Passenger,1,0,1,122,123,0.81
4060,December,2021,Lane,OR,Passenger,0,1,1,108,109,0.92
4061,December,2021,Kittitas,WA,Passenger,207,75,282,29844,30126,0.94
4062,December,2021,Sevier,AR,Passenger,0,1,1,0,1,100.0
4063,December,2021,Champaign,IL,Passenger,1,0,1,9,10,10.0
4064,December,2021,Louisa,VA,Passenger,0,1,1,1,2,50.0
4065,December,2021,King,WA,Truck,6,1,7,183027,183034,0.0
4066,December,2021,Harrison,MS,Passenger,2,0,2,44,46,4.35
4067,December,2021,Sumter,SC,Passenger,0,1,1,34,35,2.86
4068,December,2021,Suffolk,MA,Passenger,0,2,2,25,27,7.41
4069,December,2021,Hidalgo,TX,Passenger,0,1,1,53,54,1.85
4070,December,2021,Lincoln,OR,Passenger,0,1,1,32,33,3.03
4071,December,2021,Franklin,WA,Truck,0,0,0,20851,20851,0.0
4072,December,2021,Philadelphia,PA,Passenger,1,0,1,36,37,2.7
4073,December,2021,San Mateo,CA,Passenger,2,0,2,78,80,2.5
4074,December,2021,Sarasota,FL,Passenger,2,0,2,30,32,6.25
4075,December,2021,Thurston,WA,Passenger,1867,964,2831,196824,199655,1.42
4076,December,2021,Kings,CA,Passenger,2,1,3,321,324,0.93
4077,December,2021,San Diego,CA,Passenger,15,8,23,2410,2433,0.95
4078,December,2021,Dorchester,SC,Passenger,1,0,1,62,63,1.59
4079,December,2021,Klamath,OR,Passenger,1,0,1,28,29,3.45
4080,December,2021,Howard,MD,Passenger,0,1,1,54,55,1.82
4081,December,2021,Spokane,WA,Passenger,1310,758,2068,327386,329454,0.63
4082,December,2021,Pierce,WA,Truck,0,0,0,144818,144818,0.0
4083,December,2021,Pima,AZ,Passenger,1,1,2,247,249,0.8
4084,December,2021,Kitsap,WA,Passenger,2129,958,3087,180142,183229,1.68
4085,December,2021,Leavenworth,KS,Passenger,0,1,1,107,108,0.93
4086,December,2021,Las Animas,CO,Passenger,1,0,1,0,1,100.0
4087,December,2021,Allen,IN,Passenger,1,0,1,14,15,6.67
4088,December,2021,Anne Arundel,MD,Passenger,4,3,7,354,361,1.94
4089,December,2021,Spartanburg,SC,Passenger,0,1,1,47,48,2.08
4090,December,2021,New York,NY,Passenger,1,0,1,36,37,2.7
4091,December,2021,Portsmouth,VA,Passenger,0,1,1,76,77,1.3
4092,December,2021,New Haven,CT,Passenger,0,2,2,27,29,6.9
4093,December,2021,RÃ­o Grande,PR,Passenger,1,0,1,0,1,100.0
4094,December,2021,Montgomery,TX,Passenger,1,1,2,35,37,5.41
4095,December,2021,Vigo,IN,Passenger,1,0,1,5,6,16.67
4096,December,2021,Richland,SC,Passenger,0,1,1,130,131,0.76
4097,December,2021,St. Louis,MO,Passenger,1,0,1,73,74,1.35
4098,December,2021,Chelan,WA,Passenger,408,114,522,54685,55207,0.95
4099,December,2021,Skagit,WA,Truck,1,0,1,32702,32703,0.0
4100,December,2022,San Joaquin,CA,Passenger,1,0,1,75,76,1.32
4101,December,2022,Stevens,WA,Truck,2,0,2,18846,18848,0.01
4102,December,2022,Snohomish,WA,Passenger,10174,2763,12937,530310,543247,2.38
4103,December,2022,Lewis,WA,Truck,1,0,1,26311,26312,0.0
4104,December,2022,Stevens,WA,Passenger,90,56,146,30021,30167,0.48
4105,December,2022,Napa,CA,Passenger,0,1,1,9,10,10.0
4106,December,2022,Danville,VA,Passenger,1,0,1,0,1,100.0
4107,December,2022,Pacific,WA,Passenger,74,80,154,15740,15894,0.97
4108,December,2022,Duval,FL,Passenger,1,0,1,240,241,0.41
4109,December,2022,Beaufort,SC,Passenger,1,0,1,20,21,4.76
4110,December,2022,Wahkiakum,WA,Passenger,26,13,39,3037,3076,1.27
4111,December,2022,Middlesex,MA,Passenger,2,1,3,60,63,4.76
4112,December,2022,Ferry,WA,Passenger,24,4,28,4344,4372,0.64
4113,December,2022,St. Clair,IL,Passenger,2,0,2,108,110,1.82
4114,December,2022,St. Tammany,LA,Passenger,1,0,1,31,32,3.12
4115,December,2022,Moore,NC,Passenger,0,1,1,103,104,0.96
4116,December,2022,Cumberland,NC,Passenger,1,2,3,313,316,0.95
4117,December,2022,Fairfax,VA,Passenger,5,3,8,569,577,1.39
4118,December,2022,Sumter,SC,Passenger,0,1,1,31,32,3.12
4119,December,2022,Harnett,NC,Passenger,2,0,2,131,133,1.5
4120,December,2022,Columbia,WA,Truck,0,0,0,1587,1587,0.0
4121,December,2022,Garfield,WA,Passenger,1,3,4,1313,1317,0.3
4122,December,2022,Nueces,TX,Passenger,0,1,1,49,50,2.0
4123,December,2022,Sarpy,NE,Passenger,1,0,1,46,47,2.13
4124,December,2022,Dallas,TX,Passenger,1,0,1,83,84,1.19
4125,December,2022,Skamania,WA,Passenger,89,52,141,8114,8255,1.71
4126,December,2022,Lee,FL,Passenger,1,0,1,24,25,4.0
4127,December,2022,El Paso,TX,Passenger,2,0,2,287,289,0.69
4128,December,2022,Lake,FL,Passenger,1,0,1,16,17,5.88
4129,December,2022,Hoke,NC,Passenger,1,0,1,58,59,1.69
4130,December,2022,Cowlitz,WA,Passenger,405,190,595,70330,70925,0.84
4131,December,2022,Frederick,MD,Passenger,1,0,1,57,58,1.72
4132,December,2022,Hennepin,MN,Passenger,1,0,1,37,38,2.63
4133,December,2022,Columbia,WA,Passenger,7,1,8,2441,2449,0.33
4134,December,2022,Douglas,CO,Passenger,0,1,1,58,59,1.69
4135,December,2022,San Juan,WA,Passenger,561,170,731,13907,14638,4.99
4136,December,2022,Allen,IN,Passenger,1,0,1,11,12,8.33
4137,December,2022,Skamania,WA,Truck,0,0,0,3884,3884,0.0
4138,December,2022,Island,WA,Passenger,930,398,1328,61576,62904,2.11
4139,December,2022,Portsmouth,VA,Passenger,0,1,1,64,65,1.54
4140,December,2022,Mason,WA,Truck,6,0,6,20861,20867,0.03
4141,December,2022,Jackson,OK,Passenger,0,1,1,32,33,3.03
4142,December,2022,Adams,WA,Passenger,23,11,34,13019,13053,0.26
4143,December,2022,Walla Walla,WA,Passenger,201,106,307,35691,35998,0.85
4144,December,2022,San Bernardino,CA,Passenger,1,1,2,282,284,0.7
4145,December,2022,Harris,TX,Passenger,1,0,1,123,124,0.81
4146,December,2022,Collin,TX,Passenger,2,0,2,48,50,4.0
4147,December,2022,Santa Cruz,CA,Passenger,1,0,1,15,16,6.25
4148,December,2022,Sarasota,FL,Passenger,1,0,1,17,18,5.56
4149,December,2022,Pierce,WA,Truck,82,0,82,139604,139686,0.06
4150,December,2022,Rock Island,IL,Passenger,0,1,1,15,16,6.25
4151,December,2022,New Haven,CT,Passenger,0,2,2,22,24,8.33
4152,December,2022,Sheridan,WY,Passenger,1,0,1,5,6,16.67
4153,December,2022,Broward,FL,Passenger,1,0,1,63,64,1.56
4154,December,2022,Okaloosa,FL,Passenger,0,1,1,90,91,1.1
4155,December,2022,Spokane,WA,Truck,20,0,20,101929,101949,0.02
4156,December,2022,Bartow,GA,Passenger,0,1,1,3,4,25.0
4157,December,2022,Spokane,WA,Passenger,1943,932,2875,324633,327508,0.88
4158,December,2022,Wilson,TX,Passenger,0,1,1,2,3,33.33
4159,December,2022,St. Louis,MO,Passenger,1,0,1,53,54,1.85
4160,December,2022,Hamilton,OH,Truck,1,0,1,2,3,33.33
4161,December,2022,Pend Oreille,WA,Passenger,21,13,34,8969,9003,0.38
4162,December,2022,Whatcom,WA,Passenger,2110,809,2919,148844,151763,1.92
4163,December,2022,Orange,CA,Passenger,7,2,9,301,310,2.9
4164,December,2022,Fairfax,VA,Truck,1,0,1,99,100,1.0
4165,December,2022,Whatcom,WA,Truck,26,0,26,43084,43110,0.06
4166,December,2022,Stafford,VA,Passenger,3,1,4,80,84,4.76
4167,December,2022,Williamson,TX,Passenger,0,2,2,61,63,3.17
4168,December,2022,Yellowstone,MT,Passenger,0,1,1,17,18,5.56
4169,December,2022,Ventura,CA,Passenger,2,1,3,205,208,1.44
4170,December,2022,Garfield,WA,Truck,0,0,0,976,976,0.0
4171,December,2022,Larimer,CO,Passenger,1,0,1,40,41,2.44
4172,December,2022,Salt Lake,UT,Passenger,0,1,1,105,106,0.94
4173,December,2022,Montgomery,MD,Passenger,3,2,5,173,178,2.81
4174,December,2022,Placer,CA,Passenger,2,0,2,57,59,3.39
4175,December,2022,Norfolk,VA,Passenger,3,3,6,271,277,2.17
4176,December,2022,Escambia,FL,Passenger,0,1,1,113,114,0.88
4177,December,2022,Kittitas,WA,Truck,5,0,5,14570,14575,0.03
4178,December,2022,Walla Walla,WA,Truck,3,0,3,13871,13874,0.02
4179,December,2022,Virginia Beach,VA,Passenger,2,0,2,454,456,0.44
4180,December,2022,Calvert,MD,Passenger,0,2,2,77,79,2.53
4181,December,2022,Gwinnett,GA,Passenger,1,0,1,41,42,2.38
4182,December,2022,Grays Harbor,WA,Truck,2,0,2,21093,21095,0.01
4183,December,2022,Essex,NJ,Passenger,2,0,2,8,10,20.0
4184,December,2022,Jefferson,WA,Passenger,480,230,710,24301,25011,2.84
4185,December,2022,Klickitat,WA,Truck,4,0,4,8233,8237,0.05
4186,December,2022,Douglas,WA,Truck,3,0,3,12825,12828,0.02
4187,December,2022,Clark,NV,Passenger,4,2,6,414,420,1.43
4188,December,2022,Clark,WA,Passenger,4917,2031,6948,314946,321894,2.16
4189,December,2022,Okanogan,WA,Truck,2,0,2,16442,16444,0.01
4190,December,2022,Cook,IL,Passenger,2,0,2,156,158,1.27
4191,December,2022,Cumberland,PA,Passenger,1,0,1,31,32,3.12
4192,December,2022,Sacramento,CA,Passenger,4,0,4,165,169,2.37
4193,December,2022,Bryan,GA,Passenger,0,1,1,38,39,2.56
4194,December,2022,Dorchester,SC,Passenger,1,0,1,42,43,2.33
4195,December,2022,Charleston,SC,Passenger,2,2,4,54,58,6.9
4196,December,2022,Yavapai,AZ,Passenger,1,0,1,22,23,4.35
4197,December,2022,Solano,CA,Passenger,2,0,2,142,144,1.39
4198,December,2022,St. Mary's,MD,Passenger,1,0,1,170,171,0.58
4199,December,2022,King,WA,Truck,386,2,388,178383,178771,0.22
4200,December,2022,Prince George's,MD,Passenger,3,1,4,111,115,3.48
4201,December,2022,Burlington,NJ,Passenger,0,2,2,97,99,2.02
4202,December,2022,Clark,WA,Truck,51,0,51,81917,81968,0.06
4203,December,2022,Lincoln,WA,Truck,0,0,0,4848,4848,0.0
4204,December,2022,DeKalb,GA,Passenger,1,0,1,39,40,2.5
4205,December,2022,Boulder,CO,Passenger,1,0,1,28,29,3.45
4206,December,2022,Skagit,WA,Passenger,924,355,1279,89464,90743,1.41
4207,December,2022,Champaign,IL,Passenger,1,0,1,7,8,12.5
4208,December,2022,Clallam,WA,Truck,8,0,8,21879,21887,0.04
4209,December,2022,Benton,WA,Passenger,933,500,1433,135784,137217,1.04
4210,December,2022,Lincoln,WA,Passenger,12,18,30,7769,7799,0.38
4211,December,2022,Ferry,WA,Truck,0,0,0,3548,3548,0.0
4212,December,2022,Maricopa,AZ,Passenger,6,3,9,690,699,1.29
4213,December,2022,Lane,OR,Passenger,0,1,1,73,74,1.35
4214,December,2022,Goochland,VA,Passenger,0,1,1,64,65,1.54
4215,December,2022,Hudson,NJ,Passenger,1,0,1,28,29,3.45
4216,December,2022,Adams,CO,Passenger,1,0,1,33,34,2.94
4217,December,2022,Owyhee,ID,Passenger,1,0,1,3,4,25.0
4218,December,2022,Pend Oreille,WA,Truck,0,0,0,5582,5582,0.0
4219,December,2022,Santa Barbara,CA,Passenger,1,0,1,65,66,1.52
4220,December,2022,Skagit,WA,Truck,11,0,11,32151,32162,0.03
4221,December,2022,Wahkiakum,WA,Truck,1,0,1,1790,1791,0.06
4222,December,2022,Okanogan,WA,Passenger,97,52,149,26171,26320,0.57
4223,December,2022,Marin,CA,Passenger,0,1,1,29,30,3.33
4224,December,2022,Lee,AL,Passenger,1,0,1,11,12,8.33
4225,December,2022,Thurston,WA,Truck,38,0,38,54686,54724,0.07
4226,December,2022,Lincoln,OR,Passenger,0,1,1,15,16,6.25
4227,December,2022,Plaquemines,LA,Passenger,1,1,2,16,18,11.11
4228,December,2022,El Paso,CO,Passenger,3,1,4,517,521,0.77
4229,December,2022,Alexandria,VA,Passenger,3,1,4,93,97,4.12
4230,December,2022,Asotin,WA,Passenger,29,20,49,12492,12541,0.39
4231,December,2022,Hawaii,HI,Passenger,1,0,1,25,26,3.85
4232,December,2022,King,WA,Passenger,48110,12252,60362,1337864,1398226,4.32
4233,December,2022,District of Columbia,DC,Passenger,4,0,4,152,156,2.56
4234,December,2022,Hamilton,OH,Passenger,1,0,1,25,26,3.85
4235,December,2022,Sedgwick,KS,Passenger,1,1,2,65,67,2.99
4236,December,2022,Rockingham,NH,Passenger,1,0,1,12,13,7.69
4237,December,2022,Benton,WA,Truck,10,0,10,43344,43354,0.02
4238,December,2022,Adams,WA,Truck,1,0,1,5387,5388,0.02
4239,December,2022,Vernon,LA,Passenger,1,0,1,74,75,1.33
4240,December,2022,Rockdale,GA,Passenger,1,0,1,6,7,14.29
4241,December,2022,Nassau,NY,Passenger,1,0,1,21,22,4.55
4242,December,2022,San Juan,WA,Truck,8,0,8,5913,5921,0.14
4243,December,2022,Hillsborough,FL,Passenger,0,1,1,104,105,0.95
4244,December,2022,Houston,GA,Passenger,1,0,1,24,25,4.0
4245,December,2022,Carroll,NH,Passenger,0,1,1,5,6,16.67
4246,December,2022,Galveston,TX,Passenger,0,1,1,16,17,5.88
4247,December,2022,Lewis,WA,Passenger,268,182,450,59910,60360,0.75
4248,December,2022,Charles,MD,Passenger,1,1,2,48,50,4.0
4249,December,2022,Yakima,WA,Truck,6,0,6,61209,61215,0.01
4250,December,2022,Lake,IL,Passenger,1,0,1,118,119,0.84
4251,December,2022,Fairbanks North Star,AK,Passenger,0,1,1,58,59,1.69
4252,December,2022,Kent,DE,Passenger,1,0,1,49,50,2.0
4253,December,2022,Arapahoe,CO,Passenger,0,1,1,67,68,1.47
4254,December,2022,Jefferson,WA,Truck,6,0,6,9367,9373,0.06
4255,December,2022,Saratoga,NY,Passenger,1,0,1,36,37,2.7
4256,December,2022,Grays Harbor,WA,Passenger,246,160,406,48674,49080,0.83
4257,December,2022,Newport News,VA,Passenger,1,0,1,94,95,1.05
4258,December,2022,Snohomish,WA,Truck,92,0,92,122549,122641,0.08
4260,December,2022,Grant,WA,Truck,4,0,4,28064,28068,0.01
4261,December,2022,San Diego,CA,Passenger,17,9,26,2033,2059,1.26
4262,December,2022,Miami-Dade,FL,Passenger,1,0,1,63,64,1.56
4263,December,2022,Jefferson,NY,Passenger,1,1,2,186,188,1.06
4264,December,2022,Las Animas,CO,Passenger,1,0,1,1,2,50.0
4265,December,2022,Louisa,VA,Passenger,0,1,1,1,2,50.0
4266,December,2022,Kootenai,ID,Truck,1,0,1,29,30,3.33
4267,December,2022,Anne Arundel,MD,Passenger,4,4,8,300,308,2.6
4268,December,2022,Travis,TX,Passenger,1,0,1,78,79,1.27
4269,December,2022,Cowlitz,WA,Truck,4,0,4,28376,28380,0.01
4270,December,2022,Whitman,WA,Passenger,110,67,177,21969,22146,0.8
4271,December,2022,Allegheny,PA,Passenger,1,0,1,48,49,2.04
4272,December,2022,Island,WA,Truck,17,0,17,21235,21252,0.08
4273,December,2022,Douglas,WA,Passenger,169,59,228,28513,28741,0.79
4274,December,2022,Whitman,WA,Truck,3,0,3,8661,8664,0.03
4275,December,2022,Penobscot,ME,Passenger,0,1,1,8,9,11.11
4276,December,2022,Bell,TX,Passenger,1,0,1,269,270,0.37
4277,December,2022,Harrison,MS,Passenger,1,0,1,33,34,2.94
4278,December,2022,Franklin,WA,Truck,4,0,4,20986,20990,0.02
4279,December,2022,Alameda,CA,Passenger,3,0,3,158,161,1.86
4280,December,2022,Polk,OR,Passenger,0,1,1,19,20,5.0
4281,December,2022,Montgomery,PA,Passenger,1,0,1,17,18,5.56
4282,December,2022,Kittitas,WA,Passenger,301,93,394,29550,29944,1.32
4283,December,2022,Washington,MD,Passenger,2,0,2,14,16,12.5
4284,December,2022,Chelan,WA,Passenger,536,143,679,54270,54949,1.24
4285,December,2022,Thurston,WA,Passenger,2627,1134,3761,192301,196062,1.92
4286,December,2022,Asotin,WA,Truck,0,0,0,6686,6686,0.0
4287,December,2022,Mason,WA,Passenger,370,191,561,46879,47440,1.18
4288,December,2022,Contra Costa,CA,Passenger,0,3,3,209,212,1.42
4289,December,2022,Franklin,WA,Passenger,252,120,372,61769,62141,0.6
4290,December,2022,Kern,CA,Passenger,1,1,2,187,189,1.06
4291,December,2022,Ray,MO,Passenger,0,1,1,1,2,50.0
4292,December,2022,Klickitat,WA,Passenger,123,51,174,15155,15329,1.14
4293,December,2022,Los Angeles,CA,Passenger,5,6,11,655,666,1.65
4294,December,2022,Platte,MO,Passenger,1,0,1,19,20,5.0
4295,December,2022,Suffolk,VA,Passenger,1,0,1,113,114,0.88
4296,December,2022,Ulster,NY,Passenger,1,0,1,4,5,20.0
4297,December,2022,Richmond,NY,Passenger,1,0,1,6,7,14.29
4298,December,2022,Kitsap,WA,Passenger,2765,1146,3911,177328,181239,2.16
4299,December,2022,Yakima,WA,Passenger,425,218,643,166458,167101,0.38
4300,December,2022,Cape May,NJ,Passenger,0,1,1,7,8,12.5
4301,December,2022,Riverside,CA,Passenger,7,0,7,390,397,1.76
4302,December,2022,Grant,WA,Passenger,230,112,342,66890,67232,0.51
4303,December,2022,Kings,CA,Passenger,2,1,3,276,279,1.08
4304,December,2022,Denton,TX,Passenger,1,0,1,50,51,1.96
4305,December,2022,Pacific,WA,Truck,2,0,2,7838,7840,0.03
4306,December,2022,Howard,MD,Passenger,0,1,1,43,44,2.27
4307,December,2022,Carroll,MD,Passenger,0,1,1,17,18,5.56
4308,December,2022,Camden,NJ,Passenger,0,1,1,12,13,7.69
4309,December,2022,Monterey,CA,Passenger,1,1,2,117,119,1.68
4310,December,2022,Berkeley,SC,Passenger,0,1,1,110,111,0.9
4311,December,2022,Clallam,WA,Passenger,482,262,744,49422,50166,1.48
4312,December,2022,Chesapeake,VA,Passenger,2,3,5,291,296,1.69
4313,December,2022,Honolulu,HI,Passenger,3,3,6,283,289,2.08
4314,December,2022,Richmond,GA,Passenger,0,1,1,59,60,1.67
4315,December,2022,Loudoun,VA,Passenger,3,1,4,60,64,6.25
4316,December,2022,Kauai,HI,Passenger,1,1,2,13,15,13.33
4317,December,2022,New London,CT,Passenger,2,4,6,179,185,3.24
4318,December,2022,Emmet,MI,Passenger,0,1,1,0,1,100.0
4319,December,2022,Pierce,WA,Passenger,6159,2513,8672,539032,547704,1.58
4320,December,2022,Queens,NY,Passenger,1,0,1,29,30,3.33
4321,December,2022,Bexar,TX,Passenger,4,3,7,374,381,1.84
4322,December,2022,Douglas,NE,Passenger,2,1,3,29,32,9.38
4323,December,2022,Onslow,NC,Passenger,0,1,1,145,146,0.68
4324,December,2022,Pulaski,AR,Passenger,3,0,3,24,27,11.11
4325,December,2022,Arlington,VA,Passenger,1,0,1,104,105,0.95
4326,December,2022,Multnomah,OR,Passenger,0,2,2,443,445,0.45
4327,December,2022,Montgomery,AL,Passenger,0,1,1,29,30,3.33
4328,December,2022,Hidalgo,TX,Passenger,0,1,1,47,48,2.08
4329,December,2022,Chelan,WA,Truck,13,0,13,23093,23106,0.06
4330,December,2022,Randolph,NC,Passenger,1,0,1,4,5,20.0
4331,December,2022,Sonoma,CA,Passenger,1,1,2,61,63,3.17
4332,December,2022,Kitsap,WA,Truck,34,0,34,52973,53007,0.06
4333,December,2022,Oldham,KY,Passenger,0,1,1,4,5,20.0
4334,December,2022,Wichita,TX,Passenger,2,0,2,37,39,5.13
4335,December,2022,Elmore,ID,Passenger,1,0,1,12,13,7.69
4336,December,2022,Leavenworth,KS,Passenger,0,1,1,92,93,1.08
4337,December,2022,Geary,KS,Passenger,1,0,1,75,76,1.32
4338,December,2022,Santa Clara,CA,Passenger,9,2,11,170,181,6.08
4339,February,2017,Columbia,WA,Passenger,0,1,1,2337,2338,0.04
4340,February,2017,New London,CT,Passenger,2,1,3,265,268,1.12
4341,February,2017,Pacific,WA,Passenger,5,6,11,14997,15008,0.07
4342,February,2017,Island,WA,Passenger,100,122,222,59448,59670,0.37
4343,February,2017,Harnett,NC,Passenger,1,0,1,263,264,0.38
4344,February,2017,Allegheny,PA,Passenger,1,0,1,92,93,1.08
4345,February,2017,Prince William,VA,Passenger,0,3,3,277,280,1.07
4346,February,2017,Clark,WA,Truck,0,0,0,77521,77521,0.0
4347,February,2017,Durham,NC,Passenger,0,1,1,37,38,2.63
4348,February,2017,Cowlitz,WA,Passenger,50,46,96,69052,69148,0.14
4349,February,2017,DeKalb,IN,Passenger,1,0,1,1,2,50.0
4350,February,2017,San Mateo,CA,Passenger,0,1,1,165,166,0.6
4351,February,2017,Santa Clara,CA,Passenger,5,3,8,424,432,1.85
4352,February,2017,Salt Lake,UT,Passenger,0,1,1,332,333,0.3
4353,February,2017,Lane,OR,Passenger,0,1,1,258,259,0.39
4354,February,2017,Jefferson,NY,Passenger,1,1,2,255,257,0.78
4355,February,2017,Virginia Beach,VA,Passenger,2,1,3,651,654,0.46
4356,February,2017,Skagit,WA,Truck,1,0,1,31404,31405,0.0
4357,February,2017,Clark,WA,Passenger,695,434,1129,297935,299064,0.38
4358,February,2017,Utah,UT,Passenger,0,1,1,169,170,0.59
4359,February,2017,Dane,WI,Passenger,1,0,1,168,169,0.59
4360,February,2017,Manassas,VA,Passenger,0,1,1,8,9,11.11
4361,February,2017,Essex,NJ,Passenger,1,0,1,16,17,5.88
4362,February,2017,Adams,WA,Truck,0,0,0,5071,5071,0.0
4363,February,2017,Benton,WA,Passenger,134,133,267,127653,127920,0.21
4364,February,2017,Mason,WA,Truck,0,0,0,19196,19196,0.0
4365,February,2017,Wayne,MI,Passenger,0,2,2,69,71,2.82
4366,February,2017,Lee,AL,Passenger,1,0,1,36,37,2.7
4367,February,2017,Douglas,WA,Passenger,30,19,49,26547,26596,0.18
4368,February,2017,Morris,NJ,Passenger,1,0,1,22,23,4.35
4369,February,2017,Franklin,WA,Truck,0,0,0,17907,17907,0.0
4370,February,2017,Richmond,GA,Passenger,0,1,1,99,100,1.0
4371,February,2017,Dakota,MN,Passenger,0,1,1,41,42,2.38
4372,February,2017,Ferry,WA,Truck,0,0,0,3562,3562,0.0
4373,February,2017,Guilford,NC,Passenger,1,0,1,32,33,3.03
4374,February,2017,Kittitas,WA,Truck,0,0,0,13383,13383,0.0
4375,February,2017,Prince George's,MD,Passenger,0,1,1,186,187,0.53
4376,February,2017,Franklin,WA,Passenger,26,42,68,55221,55289,0.12
4377,February,2017,Orange,FL,Passenger,1,1,2,153,155,1.29
4378,February,2017,Jackson,MO,Passenger,1,0,1,71,72,1.39
4379,February,2017,Latah,ID,Passenger,0,1,1,131,132,0.76
4380,February,2017,Hidalgo,TX,Passenger,0,1,1,95,96,1.04
4381,February,2017,Middlesex,MA,Passenger,1,0,1,158,159,0.63
4382,February,2017,Dallas,TX,Passenger,1,0,1,210,211,0.47
4383,February,2017,Lincoln,WA,Passenger,2,4,6,7509,7515,0.08
4384,February,2017,Island,WA,Truck,0,0,0,20499,20499,0.0
4385,February,2017,Montgomery,TN,Passenger,1,0,1,294,295,0.34
4386,February,2017,Cowlitz,WA,Truck,0,0,0,27871,27871,0.0
4387,February,2017,Spokane,WA,Passenger,226,196,422,295023,295445,0.14
4388,February,2017,Maui,HI,Passenger,1,0,1,71,72,1.39
4389,February,2017,Fairfax,VA,Passenger,2,2,4,877,881,0.45
4390,February,2017,Jefferson,WA,Passenger,89,55,144,23601,23745,0.61
4391,February,2017,Manatee,FL,Passenger,1,0,1,55,56,1.79
4392,February,2017,Clallam,WA,Passenger,75,64,139,47981,48120,0.29
4393,February,2017,Okanogan,WA,Truck,0,0,0,16300,16300,0.0
4394,February,2017,Wahkiakum,WA,Passenger,0,1,1,2843,2844,0.04
4395,February,2017,Monterey,CA,Passenger,0,1,1,224,225,0.44
4396,February,2017,Honolulu,HI,Passenger,4,2,6,628,634,0.95
4397,February,2017,Grant,WA,Truck,0,0,0,24996,24996,0.0
4398,February,2017,Charles,MD,Passenger,0,1,1,91,92,1.09
4399,February,2017,Benton,WA,Truck,0,0,0,39743,39743,0.0
4400,February,2017,Franklin,MA,Passenger,0,1,1,4,5,20.0
4401,February,2017,Lewis,WA,Passenger,45,31,76,54970,55046,0.14
4402,February,2017,Grant,WA,Passenger,16,21,37,60193,60230,0.06
4403,February,2017,Cascade,MT,Passenger,0,1,1,59,60,1.67
4404,February,2017,King,WA,Passenger,9098,3713,12811,1385263,1398074,0.92
4405,February,2017,Whatcom,WA,Passenger,401,146,547,141888,142435,0.38
4406,February,2017,Stevens,WA,Truck,0,0,0,18333,18333,0.0
4407,February,2017,Whitman,WA,Passenger,8,18,26,21938,21964,0.12
4408,February,2017,San Juan,WA,Passenger,88,31,119,13403,13522,0.88
4409,February,2017,Oklahoma,OK,Passenger,0,1,1,187,188,0.53
4410,February,2017,Nassau,NY,Passenger,0,1,1,39,40,2.5
4411,February,2017,Walla Walla,WA,Passenger,17,21,38,34781,34819,0.11
4412,February,2017,Pinal,AZ,Passenger,2,0,2,263,265,0.75
4413,February,2017,Hardin,KY,Passenger,0,1,1,128,129,0.78
4414,February,2017,Dale,AL,Passenger,0,1,1,65,66,1.52
4415,February,2017,Bergen,NJ,Passenger,0,2,2,32,34,5.88
4416,February,2017,Grays Harbor,WA,Passenger,27,24,51,44252,44303,0.12
4417,February,2017,Klickitat,WA,Truck,0,0,0,7937,7937,0.0
4418,February,2017,San Diego,CA,Passenger,4,1,5,2821,2826,0.18
4419,February,2017,Madison,ID,Passenger,1,0,1,44,45,2.22
4420,February,2017,Klickitat,WA,Passenger,20,22,42,14768,14810,0.28
4421,February,2017,Asotin,WA,Truck,0,0,0,6475,6475,0.0
4422,February,2017,King,WA,Truck,8,1,9,190501,190510,0.0
4423,February,2017,New Haven,CT,Passenger,0,1,1,62,63,1.59
4424,February,2017,Ferry,WA,Passenger,2,1,3,4391,4394,0.07
4425,February,2017,Clackamas,OR,Passenger,1,2,3,361,364,0.82
4426,February,2017,Pend Oreille,WA,Truck,0,0,0,5573,5573,0.0
4427,February,2017,Cape May,NJ,Passenger,0,1,1,19,20,5.0
4428,February,2017,Norfolk,MA,Passenger,1,0,1,37,38,2.63
4429,February,2017,Whatcom,WA,Truck,2,0,2,41327,41329,0.0
4430,February,2017,Missoula,MT,Passenger,1,0,1,81,82,1.22
4431,February,2017,Orange,CA,Passenger,2,1,3,676,679,0.44
4432,February,2017,Polk,FL,Passenger,1,0,1,65,66,1.52
4433,February,2017,Walla Walla,WA,Truck,0,0,0,13161,13161,0.0
4434,February,2017,Los Angeles,CA,Passenger,3,1,4,1376,1380,0.29
4435,February,2017,Clark,NV,Passenger,1,3,4,877,881,0.45
4436,February,2017,Pend Oreille,WA,Passenger,1,4,5,9300,9305,0.05
4437,February,2017,Douglas,WA,Truck,0,0,0,11387,11387,0.0
4438,February,2017,Moore,NC,Passenger,0,1,1,210,211,0.47
4439,February,2017,Okanogan,WA,Passenger,3,15,18,25674,25692,0.07
4440,February,2017,Nantucket,MA,Passenger,1,0,1,3,4,25.0
4441,February,2017,Juneau,AK,Passenger,0,1,1,55,56,1.79
4442,February,2017,Monroe,NY,Passenger,1,0,1,28,29,3.45
4443,February,2017,Saratoga,NY,Passenger,1,1,2,78,80,2.5
4444,February,2017,Snohomish,WA,Passenger,1604,824,2428,514072,516500,0.47
4445,February,2017,Chelan,WA,Passenger,55,29,84,51755,51839,0.16
4446,February,2017,Lewis,WA,Truck,0,0,0,24783,24783,0.0
4447,February,2017,Bexar,TX,Passenger,1,2,3,1157,1160,0.26
4448,February,2017,Marin,CA,Passenger,1,0,1,59,60,1.67
4449,February,2017,Hamilton,TN,Passenger,1,0,1,26,27,3.7
4450,February,2017,Montgomery,MD,Passenger,1,0,1,305,306,0.33
4451,February,2017,Garfield,WA,Truck,0,0,0,934,934,0.0
4452,February,2017,Columbia,WA,Truck,0,0,0,1528,1528,0.0
4453,February,2017,Volusia,FL,Passenger,0,1,1,47,48,2.08
4454,February,2017,Carroll,NH,Passenger,0,1,1,0,1,100.0
4455,February,2017,Pierce,WA,Truck,0,0,0,138554,138554,0.0
4456,February,2017,Norfolk,VA,Passenger,1,1,2,303,305,0.66
4457,February,2017,Snohomish,WA,Truck,1,0,1,122505,122506,0.0
4458,February,2017,Travis,TX,Passenger,0,1,1,198,199,0.5
4459,February,2017,Santa Fe,NM,Passenger,0,1,1,44,45,2.22
4460,February,2017,DeKalb,GA,Passenger,1,0,1,84,85,1.18
4461,February,2017,Lincoln,WA,Truck,0,0,0,4463,4463,0.0
4462,February,2017,Thurston,WA,Truck,0,0,0,53345,53345,0.0
4463,February,2017,Shoshone,ID,Passenger,0,1,1,82,83,1.2
4464,February,2017,Thurston,WA,Passenger,351,309,660,184902,185562,0.36
4465,February,2017,Howard,MD,Passenger,0,2,2,88,90,2.22
4466,February,2017,Hawaii,HI,Passenger,1,0,1,86,87,1.15
4467,February,2017,Tulare,CA,Passenger,1,0,1,200,201,0.5
4468,February,2017,Whitman,WA,Truck,0,0,0,8399,8399,0.0
4469,February,2017,Clallam,WA,Truck,0,0,0,21029,21029,0.0
4470,February,2017,Cobb,GA,Passenger,0,1,1,80,81,1.23
4471,February,2017,Northampton,PA,Passenger,2,0,2,231,233,0.86
4472,February,2017,Alameda,CA,Passenger,3,1,4,389,393,1.02
4473,February,2017,Maricopa,AZ,Passenger,3,0,3,1858,1861,0.16
4474,February,2017,Skamania,WA,Truck,0,0,0,3889,3889,0.0
4475,February,2017,Yakima,WA,Passenger,36,50,86,159126,159212,0.05
4476,February,2017,Cumberland,NC,Passenger,1,0,1,624,625,0.16
4477,February,2017,Douglas,OR,Passenger,0,1,1,79,80,1.25
4478,February,2017,Deschutes,OR,Passenger,1,0,1,203,204,0.49
4479,February,2017,Anne Arundel,MD,Passenger,0,1,1,511,512,0.2
4480,February,2017,Stevens,WA,Passenger,6,21,27,31317,31344,0.09
4481,February,2017,Lewis,NY,Passenger,0,1,1,10,11,9.09
4482,February,2017,Fulton,GA,Passenger,1,1,2,128,130,1.54
4483,February,2017,Okaloosa,FL,Passenger,1,0,1,190,191,0.52
4484,February,2017,District of Columbia,DC,Passenger,0,3,3,231,234,1.28
4485,February,2017,Pacific,WA,Truck,0,0,0,7486,7486,0.0
4486,February,2017,Skamania,WA,Passenger,7,7,14,8543,8557,0.16
4487,February,2017,Arlington,VA,Passenger,1,1,2,170,172,1.16
4488,February,2017,Shelby,TN,Passenger,0,1,1,108,109,0.92
4489,February,2017,Yakima,WA,Truck,0,0,0,57223,57223,0.0
4490,February,2017,Sumter,FL,Passenger,0,1,1,10,11,9.09
4491,February,2017,Orleans,LA,Passenger,0,1,1,51,52,1.92
4492,February,2017,Contra Costa,CA,Passenger,1,0,1,653,654,0.15
4493,February,2017,Spokane,WA,Truck,1,0,1,90241,90242,0.0
4494,February,2017,Duval,FL,Passenger,1,1,2,371,373,0.54
4495,February,2017,Marion,OR,Passenger,1,0,1,202,203,0.49
4496,February,2017,El Paso,CO,Passenger,1,1,2,844,846,0.24
4497,February,2017,Canyon,ID,Passenger,0,1,1,108,109,0.92
4498,February,2017,Gwinnett,GA,Passenger,0,1,1,87,88,1.14
4499,February,2017,Riverside,CA,Passenger,1,1,2,842,844,0.24
4500,February,2017,Garfield,WA,Passenger,0,0,0,1290,1290,0.0
4501,February,2017,Kittitas,WA,Passenger,15,15,30,27062,27092,0.11
4503,February,2017,Pima,AZ,Passenger,0,2,2,441,443,0.45
4504,February,2017,Nueces,TX,Passenger,0,1,1,98,99,1.01
4505,February,2017,Skagit,WA,Passenger,113,86,199,87262,87461,0.23
4506,February,2017,Hamilton,IN,Passenger,1,0,1,67,68,1.47
4507,February,2017,Jefferson,WA,Truck,0,0,0,9472,9472,0.0
4508,February,2017,Pierce,WA,Passenger,862,778,1640,526771,528411,0.31
4509,February,2017,Portsmouth,VA,Passenger,0,1,1,66,67,1.49
4510,February,2017,Ventura,CA,Passenger,0,2,2,376,378,0.53
4511,February,2017,Grays Harbor,WA,Truck,0,0,0,19819,19819,0.0
4512,February,2017,Adams,WA,Passenger,2,2,4,12126,12130,0.03
4513,February,2017,Kitsap,WA,Truck,1,0,1,52347,52348,0.0
4514,February,2017,Asotin,WA,Passenger,4,3,7,12324,12331,0.06
4515,February,2017,Multnomah,OR,Passenger,0,3,3,1150,1153,0.26
4516,February,2017,Muscogee,GA,Passenger,0,1,1,256,257,0.39
4517,February,2017,San Juan,WA,Truck,0,0,0,5573,5573,0.0
4518,February,2017,Tarrant,TX,Passenger,0,2,2,304,306,0.65
4519,February,2017,St. Lucie,FL,Passenger,1,0,1,31,32,3.12
4520,February,2017,Franklin,OH,Passenger,0,1,1,116,117,0.85
4521,February,2017,Mason,WA,Passenger,47,63,110,42778,42888,0.26
4522,February,2017,Kitsap,WA,Passenger,561,280,841,172111,172952,0.49
4523,February,2017,Chelan,WA,Truck,0,0,0,21250,21250,0.0
4524,February,2017,Wahkiakum,WA,Truck,0,0,0,1625,1625,0.0
4525,February,2018,Cape May,NJ,Passenger,0,1,1,22,23,4.35
4526,February,2018,Mason,WA,Truck,0,0,0,19725,19725,0.0
4527,February,2018,Grant,WA,Passenger,31,38,69,62313,62382,0.11
4528,February,2018,Pacific,WA,Passenger,15,17,32,15463,15495,0.21
4529,February,2018,Wahkiakum,WA,Truck,0,0,0,1673,1673,0.0
4530,February,2018,Island,WA,Truck,0,0,0,20828,20828,0.0
4531,February,2018,San Mateo,CA,Passenger,0,1,1,138,139,0.72
4532,February,2018,Skagit,WA,Truck,1,0,1,31814,31815,0.0
4533,February,2018,Asotin,WA,Passenger,8,5,13,12588,12601,0.1
4534,February,2018,Franklin,MA,Passenger,0,1,1,3,4,25.0
4535,February,2018,Garfield,WA,Truck,0,0,0,942,942,0.0
4536,February,2018,Walla Walla,WA,Passenger,31,35,66,35386,35452,0.19
4537,February,2018,Queens,NY,Passenger,1,0,1,61,62,1.61
4538,February,2018,Gwinnett,GA,Passenger,0,1,1,78,79,1.27
4539,February,2018,Duval,FL,Passenger,1,2,3,368,371,0.81
4540,February,2018,Manatee,FL,Passenger,1,0,1,38,39,2.56
4541,February,2018,Whitman,WA,Passenger,18,21,39,22530,22569,0.17
4542,February,2018,Yakima,WA,Truck,0,0,0,58125,58125,0.0
4543,February,2018,Los Angeles,CA,Passenger,5,3,8,1192,1200,0.67
4544,February,2018,Grays Harbor,WA,Truck,0,0,0,20115,20115,0.0
4545,February,2018,Jefferson,WA,Truck,0,0,0,9511,9511,0.0
4546,February,2018,Garfield,WA,Passenger,1,0,1,1323,1324,0.08
4547,February,2018,Adams,WA,Truck,0,0,0,5139,5139,0.0
4548,February,2018,Fairfax,VA,Passenger,2,2,4,825,829,0.48
4549,February,2018,Contra Costa,CA,Passenger,0,1,1,469,470,0.21
4550,February,2018,Adams,WA,Passenger,5,4,9,12458,12467,0.07
4551,February,2018,Maricopa,AZ,Passenger,2,0,2,1598,1600,0.12
4552,February,2018,Frederick,MD,Passenger,0,1,1,90,91,1.1
4553,February,2018,Portsmouth,VA,Passenger,0,1,1,72,73,1.37
4554,February,2018,Multnomah,OR,Passenger,3,4,7,835,842,0.83
4555,February,2018,Dallas,TX,Passenger,0,1,1,185,186,0.54
4556,February,2018,Clallam,WA,Passenger,109,101,210,49356,49566,0.42
4557,February,2018,Sumter,FL,Passenger,0,1,1,10,11,9.09
4558,February,2018,Norfolk,MA,Passenger,1,0,1,39,40,2.5
4559,February,2018,Columbia,WA,Truck,0,0,0,1535,1535,0.0
4560,February,2018,Latah,ID,Passenger,0,1,1,76,77,1.3
4561,February,2018,Garfield,OK,Passenger,1,0,1,21,22,4.55
4562,February,2018,Cowlitz,WA,Truck,0,0,0,28183,28183,0.0
4563,February,2018,Northampton,PA,Passenger,0,1,1,61,62,1.61
4564,February,2018,Yakima,WA,Passenger,61,79,140,162333,162473,0.09
4565,February,2018,Fulton,GA,Passenger,1,0,1,106,107,0.93
4566,February,2018,Deschutes,OR,Passenger,1,0,1,177,178,0.56
4567,February,2018,Ferry,WA,Truck,0,0,0,3527,3527,0.0
4568,February,2018,Whatcom,WA,Truck,1,0,1,42039,42040,0.0
4569,February,2018,Missoula,MT,Passenger,1,0,1,67,68,1.47
4570,February,2018,Franklin,WA,Passenger,32,51,83,57008,57091,0.15
4571,February,2018,District of Columbia,DC,Passenger,0,3,3,194,197,1.52
4572,February,2018,Pend Oreille,WA,Truck,0,0,0,5631,5631,0.0
4573,February,2018,Cook,IL,Passenger,1,0,1,286,287,0.35
4574,February,2018,Hardin,KY,Passenger,0,1,1,116,117,0.85
4575,February,2018,Montgomery,TN,Passenger,1,0,1,264,265,0.38
4576,February,2018,Polk,FL,Passenger,1,0,1,63,64,1.56
4577,February,2018,Lincoln,WA,Passenger,2,5,7,7594,7601,0.09
4578,February,2018,Sacramento,CA,Passenger,1,0,1,297,298,0.34
4579,February,2018,Santa Clara,CA,Passenger,7,1,8,380,388,2.06
4580,February,2018,Marin,CA,Passenger,1,0,1,56,57,1.75
4581,February,2018,Bexar,TX,Passenger,2,2,4,798,802,0.5
4582,February,2018,Lane,OR,Passenger,0,1,1,199,200,0.5
4583,February,2018,Arlington,VA,Passenger,1,2,3,171,174,1.72
4584,February,2018,Caddo,LA,Passenger,0,1,1,22,23,4.35
4585,February,2018,Skagit,WA,Passenger,172,145,317,89751,90068,0.35
4586,February,2018,Thurston,WA,Passenger,492,414,906,190758,191664,0.47
4587,February,2018,Benton,WA,Passenger,175,179,354,130454,130808,0.27
4588,February,2018,Broward,FL,Passenger,0,1,1,139,140,0.71
4589,February,2018,Santa Rosa,FL,Passenger,1,0,1,99,100,1.0
4590,February,2018,Orange,FL,Passenger,2,1,3,169,172,1.74
4591,February,2018,Nantucket,MA,Passenger,1,0,1,4,5,20.0
4592,February,2018,Kitsap,WA,Passenger,716,418,1134,176380,177514,0.64
4593,February,2018,Utah,UT,Passenger,0,1,1,133,134,0.75
4594,February,2018,Clark,WA,Passenger,888,616,1504,305306,306810,0.49
4595,February,2018,Travis,TX,Passenger,0,1,1,186,187,0.53
4596,February,2018,Flathead,MT,Passenger,1,0,1,53,54,1.85
4597,February,2018,Kent,MI,Passenger,0,1,1,35,36,2.78
4598,February,2018,Madison,ID,Passenger,1,0,1,39,40,2.5
4599,February,2018,Jefferson,WA,Passenger,127,80,207,24312,24519,0.84
4600,February,2018,Chelan,WA,Passenger,94,39,133,53238,53371,0.25
4601,February,2018,Palm Beach,FL,Passenger,0,1,1,86,87,1.15
4602,February,2018,DuPage,IL,Passenger,1,0,1,65,66,1.52
4603,February,2018,Dale,AL,Passenger,0,1,1,64,65,1.54
4604,February,2018,Okaloosa,FL,Passenger,1,0,1,178,179,0.56
4605,February,2018,Franklin,WA,Truck,0,0,0,18577,18577,0.0
4606,February,2018,Clay,FL,Passenger,0,1,1,103,104,0.96
4607,February,2018,Pierce,WA,Truck,0,0,0,137016,137016,0.0
4608,February,2018,Alameda,CA,Passenger,0,1,1,357,358,0.28
4609,February,2018,Richmond,GA,Passenger,0,1,1,92,93,1.08
4610,February,2018,Nueces,TX,Passenger,1,1,2,96,98,2.04
4611,February,2018,St. Lucie,FL,Passenger,1,0,1,26,27,3.7
4612,February,2018,Spokane,WA,Passenger,306,263,569,300527,301096,0.19
4613,February,2018,Columbia,WA,Passenger,2,1,3,2407,2410,0.12
4614,February,2018,Prince George's,MD,Passenger,0,1,1,180,181,0.55
4615,February,2018,Howard,MD,Passenger,0,1,1,87,88,1.14
4616,February,2018,Riverside,CA,Passenger,2,2,4,723,727,0.55
4617,February,2018,Clark,NV,Passenger,1,2,3,739,742,0.4
4618,February,2018,Lewis,WA,Truck,0,0,0,25269,25269,0.0
4619,February,2018,Snohomish,WA,Passenger,2088,1119,3207,517277,520484,0.62
4620,February,2018,Anne Arundel,MD,Passenger,0,1,1,473,474,0.21
4621,February,2018,Allegheny,PA,Passenger,1,0,1,81,82,1.22
4622,February,2018,Spokane,WA,Truck,1,0,1,91721,91722,0.0
4623,February,2018,Whitman,WA,Truck,0,0,0,8453,8453,0.0
4624,February,2018,Tuolumne,CA,Passenger,0,1,1,14,15,6.67
4625,February,2018,Montgomery,MD,Passenger,1,0,1,298,299,0.33
4626,February,2018,Manassas,VA,Passenger,0,1,1,9,10,10.0
4627,February,2018,Hamilton,TN,Passenger,1,0,1,22,23,4.35
4628,February,2018,New Haven,CT,Passenger,0,1,1,52,53,1.89
4629,February,2018,Dakota,MN,Passenger,0,2,2,36,38,5.26
4630,February,2018,Chelan,WA,Truck,0,0,0,21668,21668,0.0
4631,February,2018,Sangamon,IL,Passenger,1,0,1,11,12,8.33
4632,February,2018,Moore,NC,Passenger,0,1,1,199,200,0.5
4633,February,2018,Maui,HI,Passenger,1,0,1,65,66,1.52
4634,February,2018,Orange,CA,Passenger,3,1,4,572,576,0.69
4635,February,2018,Santa Fe,NM,Passenger,0,1,1,43,44,2.27
4636,February,2018,Grant,WA,Truck,0,0,0,25680,25680,0.0
4637,February,2018,Pacific,WA,Truck,0,0,0,7561,7561,0.0
4638,February,2018,Jefferson,NY,Passenger,1,0,1,227,228,0.44
4639,February,2018,Cowlitz,WA,Passenger,54,70,124,70938,71062,0.17
4641,February,2018,Juneau,AK,Passenger,0,1,1,43,44,2.27
4642,February,2018,Clark,WA,Truck,0,0,0,78570,78570,0.0
4643,February,2018,Klickitat,WA,Passenger,24,27,51,14944,14995,0.34
4644,February,2018,Douglas,WA,Passenger,43,33,76,27316,27392,0.28
4645,February,2018,Mason,WA,Passenger,64,80,144,45049,45193,0.32
4646,February,2018,Canyon,ID,Passenger,0,1,1,95,96,1.04
4647,February,2018,Hawaii,HI,Passenger,1,0,1,81,82,1.22
4648,February,2018,DeKalb,IN,Passenger,1,0,1,1,2,50.0
4649,February,2018,Benton,WA,Truck,0,0,0,40752,40752,0.0
4650,February,2018,DeKalb,GA,Passenger,1,0,1,84,85,1.18
4651,February,2018,Ramsey,MN,Passenger,1,0,1,37,38,2.63
4652,February,2018,Orleans,LA,Passenger,0,1,1,47,48,2.08
4653,February,2018,Prince William,VA,Passenger,0,4,4,268,272,1.47
4654,February,2018,Okanogan,WA,Truck,0,0,0,16305,16305,0.0
4655,February,2018,Monterey,CA,Passenger,0,2,2,194,196,1.02
4656,February,2018,Thurston,WA,Truck,0,0,0,53921,53921,0.0
4657,February,2018,Honolulu,HI,Passenger,2,2,4,555,559,0.72
4658,February,2018,Whatcom,WA,Passenger,556,249,805,145579,146384,0.55
4659,February,2018,Pend Oreille,WA,Passenger,4,3,7,9418,9425,0.07
4660,February,2018,Prince George,VA,Passenger,0,1,1,74,75,1.33
4661,February,2018,Wahkiakum,WA,Passenger,0,2,2,2860,2862,0.07
4662,February,2018,Ferry,WA,Passenger,1,3,4,4396,4400,0.09
4663,February,2018,Brevard,FL,Passenger,0,1,1,102,103,0.97
4664,February,2018,Carroll,NH,Passenger,0,1,1,1,2,50.0
4665,February,2018,Montgomery,PA,Passenger,1,0,1,35,36,2.78
4666,February,2018,Lincoln,WA,Truck,0,0,0,4511,4511,0.0
4667,February,2018,Douglas,WA,Truck,0,0,0,11812,11812,0.0
4668,February,2018,Twin Falls,ID,Passenger,0,1,1,23,24,4.17
4669,February,2018,Island,WA,Passenger,165,171,336,61877,62213,0.54
4670,February,2018,Stevens,WA,Truck,0,0,0,18404,18404,0.0
4671,February,2018,Shelby,TN,Passenger,0,1,1,105,106,0.94
4672,February,2018,Jefferson,CO,Passenger,0,1,1,75,76,1.32
4673,February,2018,Essex,NJ,Passenger,1,0,1,10,11,9.09
4674,February,2018,El Paso,CO,Passenger,2,0,2,763,765,0.26
4675,February,2018,Montgomery,TX,Passenger,1,0,1,62,63,1.59
4676,February,2018,Pierce,WA,Passenger,1116,1028,2144,526413,528557,0.41
4677,February,2018,Okanogan,WA,Passenger,7,19,26,25665,25691,0.1
4678,February,2018,Virginia Beach,VA,Passenger,2,1,3,680,683,0.44
4679,February,2018,San Juan,WA,Truck,0,0,0,5641,5641,0.0
4680,February,2018,Ventura,CA,Passenger,0,1,1,333,334,0.3
4681,February,2018,Kitsap,WA,Truck,1,0,1,52833,52834,0.0
4682,February,2018,St. Clair,IL,Passenger,0,1,1,157,158,0.63
4683,February,2018,Richland,SC,Passenger,0,1,1,172,173,0.58
4684,February,2018,Lewis,WA,Passenger,52,45,97,56859,56956,0.17
4685,February,2018,Ada,ID,Passenger,0,2,2,344,346,0.58
4686,February,2018,Lee,AL,Passenger,1,0,1,34,35,2.86
4687,February,2018,Sedgwick,KS,Passenger,0,1,1,103,104,0.96
4688,February,2018,Morris,NJ,Passenger,1,0,1,19,20,5.0
4689,February,2018,Snohomish,WA,Truck,1,0,1,121335,121336,0.0
4690,February,2018,King,WA,Truck,8,1,9,184086,184095,0.0
4691,February,2018,Walla Walla,WA,Truck,0,0,0,13323,13323,0.0
4692,February,2018,San Juan,WA,Passenger,140,48,188,13922,14110,1.33
4693,February,2018,Saratoga,NY,Passenger,1,1,2,67,69,2.9
4694,February,2018,Pinal,AZ,Passenger,2,0,2,210,212,0.94
4695,February,2018,Stevens,WA,Passenger,10,21,31,31515,31546,0.1
4696,February,2018,Tarrant,TX,Passenger,1,0,1,224,225,0.44
4697,February,2018,Volusia,FL,Passenger,0,1,1,34,35,2.86
4698,February,2018,Pima,AZ,Passenger,1,1,2,412,414,0.48
4699,February,2018,Charles,MD,Passenger,0,1,1,81,82,1.22
4700,February,2018,King,WA,Passenger,11758,5019,16777,1368249,1385026,1.21
4701,February,2018,Skamania,WA,Truck,0,0,0,3920,3920,0.0
4702,February,2018,Asotin,WA,Truck,0,0,0,6580,6580,0.0
4703,February,2018,Skamania,WA,Passenger,11,8,19,8624,8643,0.22
4704,February,2018,Kittitas,WA,Truck,0,0,0,13948,13948,0.0
4705,February,2018,Grays Harbor,WA,Passenger,42,44,86,45889,45975,0.19
4706,February,2018,El Paso,TX,Passenger,1,0,1,522,523,0.19
4707,February,2018,Norfolk,VA,Passenger,1,1,2,319,321,0.62
4708,February,2018,Clallam,WA,Truck,0,0,0,21289,21289,0.0
4709,February,2018,New London,CT,Passenger,1,1,2,252,254,0.79
4710,February,2018,Lumpkin,GA,Passenger,1,0,1,7,8,12.5
4711,February,2018,Hamilton,IN,Passenger,1,0,1,51,52,1.92
4712,February,2018,Nassau,NY,Passenger,1,0,1,37,38,2.63
4713,February,2018,San Diego,CA,Passenger,6,1,7,2566,2573,0.27
4714,February,2018,Klickitat,WA,Truck,0,0,0,8038,8038,0.0
4715,February,2018,Kittitas,WA,Passenger,36,27,63,28690,28753,0.22
4716,February,2019,Grays Harbor,WA,Truck,0,0,0,20318,20318,0.0
4717,February,2019,Garfield,WA,Truck,0,0,0,961,961,0.0
4718,February,2019,Larimer,CO,Passenger,1,0,1,57,58,1.72
4719,February,2019,Benton,WA,Passenger,233,245,478,132999,133477,0.36
4720,February,2019,Whatcom,WA,Passenger,785,380,1165,149641,150806,0.77
4721,February,2019,Richmond,GA,Passenger,0,1,1,89,90,1.11
4722,February,2019,Jefferson,NY,Passenger,0,2,2,222,224,0.89
4723,February,2019,Juneau,AK,Passenger,0,1,1,38,39,2.56
4724,February,2019,Montgomery,AL,Passenger,0,1,1,44,45,2.22
4725,February,2019,Calvert,MD,Passenger,0,1,1,87,88,1.14
4726,February,2019,Douglas,NE,Passenger,0,1,1,66,67,1.49
4727,February,2019,New Haven,CT,Passenger,0,1,1,49,50,2.0
4728,February,2019,Benton,WA,Truck,0,0,0,41547,41547,0.0
4729,February,2019,Howard,MD,Passenger,0,1,1,82,83,1.2
4730,February,2019,Cumberland,NC,Passenger,0,2,2,511,513,0.39
4731,February,2019,Island,WA,Truck,0,0,0,21171,21171,0.0
4732,February,2019,Douglas,WA,Truck,0,0,0,12166,12166,0.0
4733,February,2019,Clackamas,OR,Passenger,1,1,2,211,213,0.94
4734,February,2019,Bergen,NJ,Passenger,1,0,1,25,26,3.85
4735,February,2019,Okanogan,WA,Truck,0,0,0,16468,16468,0.0
4736,February,2019,Cape May,NJ,Passenger,0,1,1,19,20,5.0
4737,February,2019,Grant,WA,Truck,0,0,0,26315,26315,0.0
4738,February,2019,Whitman,WA,Passenger,25,40,65,22756,22821,0.28
4739,February,2019,San Diego,CA,Passenger,9,3,12,2628,2640,0.45
4740,February,2019,Manatee,FL,Passenger,1,0,1,35,36,2.78
4741,February,2019,Owyhee,ID,Passenger,1,0,1,5,6,16.67
4742,February,2019,Tuolumne,CA,Passenger,0,1,1,12,13,7.69
4743,February,2019,Brevard,FL,Passenger,0,1,1,89,90,1.11
4744,February,2019,Pierce,WA,Truck,0,0,0,138931,138931,0.0
4745,February,2019,Ada,ID,Passenger,0,2,2,307,309,0.65
4746,February,2019,Clay,FL,Passenger,0,1,1,84,85,1.18
4747,February,2019,Tarrant,TX,Passenger,1,0,1,206,207,0.48
4748,February,2019,Monroe,IL,Passenger,1,0,1,4,5,20.0
4749,February,2019,District of Columbia,DC,Passenger,1,1,2,207,209,0.96
4750,February,2019,Fresno,CA,Passenger,1,0,1,187,188,0.53
4751,February,2019,Yakima,WA,Truck,0,0,0,58797,58797,0.0
4752,February,2019,Tulsa,OK,Passenger,1,1,2,48,50,4.0
4753,February,2019,Island,WA,Passenger,294,231,525,63179,63704,0.82
4754,February,2019,Spartanburg,SC,Passenger,0,1,1,33,34,2.94
4755,February,2019,Kittitas,WA,Passenger,73,37,110,29446,29556,0.37
4756,February,2019,DeKalb,GA,Passenger,1,0,1,77,78,1.28
4757,February,2019,Lewis,WA,Truck,0,0,0,25698,25698,0.0
4758,February,2019,Montgomery,PA,Passenger,2,0,2,36,38,5.26
4759,February,2019,Denver,CO,Passenger,1,0,1,129,130,0.77
4760,February,2019,Honolulu,HI,Passenger,2,3,5,502,507,0.99
4761,February,2019,Pend Oreille,WA,Passenger,5,5,10,9483,9493,0.11
4762,February,2019,Asotin,WA,Passenger,12,9,21,12682,12703,0.17
4764,February,2019,Kootenai,ID,Passenger,1,1,2,210,212,0.94
4765,February,2019,DeKalb,IN,Passenger,1,0,1,1,2,50.0
4766,February,2019,Lincoln,WA,Truck,0,0,0,4667,4667,0.0
4767,February,2019,Jefferson,WA,Passenger,179,113,292,24863,25155,1.16
4768,February,2019,Dale,AL,Passenger,0,1,1,57,58,1.72
4769,February,2019,Allegheny,PA,Passenger,1,0,1,84,85,1.18
4770,February,2019,San Francisco,CA,Passenger,2,1,3,114,117,2.56
4771,February,2019,Jefferson,CO,Passenger,0,2,2,60,62,3.23
4772,February,2019,Skamania,WA,Passenger,20,15,35,8715,8750,0.4
4773,February,2019,San Juan,PR,Passenger,0,1,1,3,4,25.0
4774,February,2019,Charles,MD,Passenger,0,1,1,77,78,1.28
4775,February,2019,Wahkiakum,WA,Passenger,1,1,2,3020,3022,0.07
4776,February,2019,El Paso,TX,Passenger,2,0,2,497,499,0.4
4777,February,2019,Saratoga,NY,Passenger,1,0,1,62,63,1.59
4778,February,2019,Sumter,FL,Passenger,0,1,1,10,11,9.09
4779,February,2019,Cowlitz,WA,Truck,0,0,0,28726,28726,0.0
4780,February,2019,Skagit,WA,Passenger,278,187,465,91208,91673,0.51
4781,February,2019,Collin,TX,Passenger,1,1,2,137,139,1.44
4782,February,2019,Washoe,NV,Passenger,2,0,2,106,108,1.85
4783,February,2019,Shasta,CA,Passenger,1,0,1,45,46,2.17
4784,February,2019,Harnett,NC,Passenger,1,0,1,217,218,0.46
4785,February,2019,Beaufort,SC,Passenger,1,0,1,36,37,2.7
4786,February,2019,Clark,NV,Passenger,3,2,5,709,714,0.7
4787,February,2019,Broward,FL,Passenger,2,1,3,126,129,2.33
4788,February,2019,Yakima,WA,Passenger,86,101,187,164464,164651,0.11
4789,February,2019,Dakota,MN,Passenger,0,2,2,34,36,5.56
4790,February,2019,Snohomish,WA,Passenger,3146,1498,4644,527664,532308,0.87
4791,February,2019,Stevens,WA,Passenger,18,28,46,31733,31779,0.14
4792,February,2019,Nassau,NY,Passenger,3,0,3,37,40,7.5
4793,February,2019,Montgomery,MD,Passenger,1,0,1,277,278,0.36
4794,February,2019,Randolph,NC,Passenger,1,0,1,6,7,14.29
4795,February,2019,Franklin,WA,Truck,0,0,0,19115,19115,0.0
4796,February,2019,Ferry,WA,Truck,0,0,0,3592,3592,0.0
4797,February,2019,Charleston,SC,Passenger,1,0,1,120,121,0.83
4798,February,2019,Sangamon,IL,Passenger,2,0,2,7,9,22.22
4799,February,2019,Lee,FL,Passenger,1,0,1,52,53,1.89
4800,February,2019,Houston,GA,Passenger,1,0,1,54,55,1.82
4801,February,2019,Garfield,WA,Passenger,1,1,2,1324,1326,0.15
4802,February,2019,Mason,WA,Passenger,109,117,226,46675,46901,0.48
4803,February,2019,Cochise,AZ,Passenger,0,1,1,117,118,0.85
4804,February,2019,Santa Fe,NM,Passenger,0,1,1,41,42,2.38
4805,February,2019,Maricopa,AZ,Passenger,6,2,8,1545,1553,0.52
4806,February,2019,Fairfax,VA,Passenger,3,2,5,798,803,0.62
4807,February,2019,King,WA,Passenger,17528,6762,24290,1379846,1404136,1.73
4808,February,2019,Ferry,WA,Passenger,3,2,5,4377,4382,0.11
4809,February,2019,Deschutes,OR,Passenger,2,0,2,163,165,1.21
4810,February,2019,Duval,FL,Passenger,1,2,3,381,384,0.78
4811,February,2019,DuPage,IL,Passenger,1,0,1,61,62,1.61
4812,February,2019,Thurston,WA,Truck,0,0,0,54906,54906,0.0
4813,February,2019,Clallam,WA,Truck,0,0,0,21577,21577,0.0
4814,February,2019,Anne Arundel,MD,Passenger,0,2,2,446,448,0.45
4815,February,2019,Valencia,NM,Passenger,1,0,1,9,10,10.0
4816,February,2019,Harris,TX,Passenger,0,1,1,252,253,0.4
4817,February,2019,Skamania,WA,Truck,0,0,0,3990,3990,0.0
4818,February,2019,St. Mary's,MD,Passenger,1,0,1,210,211,0.47
4819,February,2019,Flathead,MT,Passenger,1,0,1,58,59,1.69
4820,February,2019,Twin Falls,ID,Passenger,0,1,1,20,21,4.76
4821,February,2019,Carroll,NH,Passenger,0,1,1,2,3,33.33
4822,February,2019,Pima,AZ,Passenger,1,1,2,401,403,0.5
4823,February,2019,Arlington,VA,Passenger,1,2,3,161,164,1.83
4824,February,2019,Franklin,WA,Passenger,50,70,120,59299,59419,0.2
4825,February,2019,Spokane,WA,Truck,1,0,1,93888,93889,0.0
4826,February,2019,Snohomish,WA,Truck,1,0,1,121877,121878,0.0
4827,February,2019,Contra Costa,CA,Passenger,1,2,3,393,396,0.76
4828,February,2019,Lee,AL,Passenger,1,0,1,34,35,2.86
4829,February,2019,Nueces,TX,Passenger,1,1,2,90,92,2.17
4830,February,2019,Wahkiakum,WA,Truck,0,0,0,1720,1720,0.0
4831,February,2019,Klickitat,WA,Passenger,30,32,62,15450,15512,0.4
4832,February,2019,Frederick,MD,Passenger,1,1,2,80,82,2.44
4833,February,2019,Kern,CA,Passenger,0,1,1,233,234,0.43
4834,February,2019,Ventura,CA,Passenger,0,2,2,312,314,0.64
4835,February,2019,Carson City,NV,Passenger,1,0,1,14,15,6.67
4836,February,2019,Richland,SC,Passenger,0,1,1,163,164,0.61
4837,February,2019,Suffolk,MA,Passenger,0,1,1,41,42,2.38
4838,February,2019,Gwinnett,GA,Passenger,0,1,1,76,77,1.3
4839,February,2019,Columbia,WA,Truck,0,0,0,1525,1525,0.0
4840,February,2019,Clallam,WA,Passenger,153,127,280,50344,50624,0.55
4841,February,2019,Riverside,CA,Passenger,2,2,4,657,661,0.61
4842,February,2019,Klickitat,WA,Truck,0,0,0,8221,8221,0.0
4843,February,2019,Cascade,MT,Passenger,0,1,1,55,56,1.79
4844,February,2019,Los Angeles,CA,Passenger,6,5,11,1086,1097,1.0
4845,February,2019,Fulton,GA,Passenger,1,2,3,108,111,2.7
4846,February,2019,Klamath,OR,Passenger,1,0,1,37,38,2.63
4847,February,2019,Thurston,WA,Passenger,782,594,1376,195890,197266,0.7
4848,February,2019,Penobscot,ME,Passenger,0,1,1,12,13,7.69
4849,February,2019,Lumpkin,GA,Passenger,1,0,1,6,7,14.29
4850,February,2019,Prince George's,MD,Passenger,1,1,2,184,186,1.08
4851,February,2019,Walla Walla,WA,Truck,0,0,0,13543,13543,0.0
4852,February,2019,Multnomah,OR,Passenger,4,5,9,759,768,1.17
4853,February,2019,Marion,IN,Passenger,1,0,1,112,113,0.88
4854,February,2019,Clark,WA,Truck,0,0,0,79977,79977,0.0
4855,February,2019,Walla Walla,WA,Passenger,43,54,97,36066,36163,0.27
4856,February,2019,Santa Cruz,CA,Passenger,1,0,1,41,42,2.38
4857,February,2019,Mecklenburg,NC,Passenger,1,0,1,79,80,1.25
4858,February,2019,San Juan,WA,Truck,0,0,0,5799,5799,0.0
4859,February,2019,Pacific,WA,Truck,0,0,0,7634,7634,0.0
4860,February,2019,Rogers,OK,Passenger,1,0,1,4,5,20.0
4861,February,2019,Kitsap,WA,Truck,1,0,1,53701,53702,0.0
4862,February,2019,Jefferson,WA,Truck,0,0,0,9623,9623,0.0
4863,February,2019,Volusia,FL,Passenger,0,1,1,37,38,2.63
4864,February,2019,Nantucket,MA,Passenger,1,0,1,4,5,20.0
4865,February,2019,San Mateo,CA,Passenger,2,1,3,125,128,2.34
4866,February,2019,Pend Oreille,WA,Truck,0,0,0,5738,5738,0.0
4867,February,2019,Caddo,LA,Passenger,0,1,1,22,23,4.35
4868,February,2019,King,WA,Truck,6,1,7,182021,182028,0.0
4869,February,2019,Bexar,TX,Passenger,3,4,7,694,701,1.0
4870,February,2019,Washington,OR,Passenger,0,1,1,467,468,0.21
4871,February,2019,Guadalupe,TX,Passenger,1,0,1,78,79,1.27
4872,February,2019,San Juan,WA,Passenger,193,69,262,14274,14536,1.8
4873,February,2019,Whitman,WA,Truck,0,0,0,8490,8490,0.0
4874,February,2019,Portsmouth,VA,Passenger,0,1,1,80,81,1.23
4875,February,2019,Kittitas,WA,Truck,0,0,0,14260,14260,0.0
4876,February,2019,Pierce,WA,Passenger,1611,1428,3039,538910,541949,0.56
4877,February,2019,Adams,WA,Passenger,4,6,10,12671,12681,0.08
4878,February,2019,Skagit,WA,Truck,1,0,1,32291,32292,0.0
4879,February,2019,Alameda,CA,Passenger,1,2,3,318,321,0.93
4880,February,2019,Cowlitz,WA,Passenger,82,100,182,72440,72622,0.25
4881,February,2019,Clark,WA,Passenger,1337,866,2203,311844,314047,0.7
4882,February,2019,Santa Clara,CA,Passenger,8,1,9,367,376,2.39
4883,February,2019,Kent,MI,Passenger,0,1,1,22,23,4.35
4884,February,2019,Kitsap,WA,Passenger,988,571,1559,179782,181341,0.86
4885,February,2019,Sedgwick,KS,Passenger,0,1,1,101,102,0.98
4886,February,2019,St. Lucie,FL,Passenger,1,0,1,30,31,3.23
4887,February,2019,Asotin,WA,Truck,0,0,0,6644,6644,0.0
4888,February,2019,Washtenaw,MI,Passenger,1,0,1,38,39,2.56
4889,February,2019,Lincoln,WA,Passenger,3,5,8,7735,7743,0.1
4890,February,2019,Pacific,WA,Passenger,22,26,48,15864,15912,0.3
4891,February,2019,Bucks,PA,Passenger,1,0,1,17,18,5.56
4892,February,2019,Albemarle,VA,Passenger,1,0,1,24,25,4.0
4893,February,2019,Mason,WA,Truck,0,0,0,20229,20229,0.0
4894,February,2019,Goochland,VA,Passenger,1,1,2,244,246,0.81
4895,February,2019,Hennepin,MN,Passenger,2,0,2,105,107,1.87
4896,February,2019,Camden,NJ,Passenger,0,1,1,27,28,3.57
4897,February,2019,Montgomery,TX,Passenger,2,0,2,61,63,3.17
4898,February,2019,Norfolk,VA,Passenger,2,2,4,346,350,1.14
4899,February,2019,Prince William,VA,Passenger,0,4,4,255,259,1.54
4900,February,2019,Oldham,KY,Passenger,0,1,1,5,6,16.67
4901,February,2019,Norfolk,MA,Passenger,1,0,1,35,36,2.78
4902,February,2019,Chelan,WA,Passenger,145,66,211,54157,54368,0.39
4903,February,2019,Grant,WA,Passenger,33,55,88,64279,64367,0.14
4904,February,2019,Stevens,WA,Truck,0,0,0,18757,18757,0.0
4905,February,2019,Manassas,VA,Passenger,0,1,1,9,10,10.0
4906,February,2019,Marion,OR,Passenger,1,0,1,115,116,0.86
4907,February,2019,Polk,FL,Passenger,1,0,1,65,66,1.52
4908,February,2019,Orange,CA,Passenger,5,2,7,533,540,1.3
4909,February,2019,New London,CT,Passenger,0,2,2,246,248,0.81
4910,February,2019,Virginia Beach,VA,Passenger,2,1,3,698,701,0.43
4911,February,2019,Moore,NC,Passenger,0,1,1,183,184,0.54
4912,February,2019,Douglas,WA,Passenger,52,35,87,27939,28026,0.31
4913,February,2019,Ramsey,MN,Passenger,1,0,1,39,40,2.5
4914,February,2019,Lewis,WA,Passenger,96,84,180,58309,58489,0.31
4915,February,2019,Franklin,MA,Passenger,0,1,1,1,2,50.0
4916,February,2019,Okanogan,WA,Passenger,19,21,40,25964,26004,0.15
4917,February,2019,Spokane,WA,Passenger,481,386,867,307236,308103,0.28
4918,February,2019,Williamson,TX,Passenger,0,1,1,150,151,0.66
4919,February,2019,Hawaii,HI,Passenger,1,0,1,62,63,1.59
4920,February,2019,St. Clair,IL,Passenger,0,1,1,166,167,0.6
4921,February,2019,Hardin,KY,Passenger,0,1,1,105,106,0.94
4922,February,2019,Adams,WA,Truck,0,0,0,5109,5109,0.0
4923,February,2019,Pinal,AZ,Passenger,2,0,2,203,205,0.98
4924,February,2019,Shelby,TN,Passenger,0,1,1,96,97,1.03
4925,February,2019,Travis,TX,Passenger,2,1,3,200,203,1.48
4926,February,2019,Cook,IL,Passenger,1,0,1,240,241,0.41
4927,February,2019,Columbia,WA,Passenger,2,2,4,2430,2434,0.16
4928,February,2019,El Paso,CO,Passenger,3,2,5,757,762,0.66
4929,February,2019,Whatcom,WA,Truck,2,0,2,42708,42710,0.0
4930,February,2019,Santa Rosa,FL,Passenger,1,0,1,89,90,1.11
4931,February,2019,Alexandria,VA,Passenger,1,0,1,159,160,0.62
4932,February,2019,Palm Beach,FL,Passenger,0,1,1,92,93,1.08
4933,February,2019,Middlesex,MA,Passenger,1,1,2,120,122,1.64
4934,February,2019,Chelan,WA,Truck,0,0,0,22097,22097,0.0
4935,February,2019,Grays Harbor,WA,Passenger,66,79,145,47455,47600,0.3
4936,February,2019,Maui,HI,Passenger,1,0,1,50,51,1.96
4937,February,2021,Sedgwick,KS,Passenger,1,1,2,89,91,2.2
4938,February,2021,Portsmouth,VA,Passenger,0,1,1,76,77,1.3
4939,February,2021,Miami-Dade,FL,Passenger,1,0,1,97,98,1.02
4940,February,2021,Hennepin,MN,Passenger,2,0,2,78,80,2.5
4941,February,2021,Spartanburg,SC,Passenger,0,1,1,49,50,2.0
4942,February,2021,Washtenaw,MI,Passenger,1,0,1,30,31,3.23
4943,February,2021,Sumter,FL,Passenger,0,1,1,10,11,9.09
4944,February,2021,San Joaquin,CA,Passenger,1,0,1,108,109,0.92
4945,February,2021,Saginaw,MI,Passenger,2,0,2,9,11,18.18
4946,February,2021,Island,WA,Passenger,546,296,842,62878,63720,1.32
4947,February,2021,Jefferson,NY,Passenger,0,1,1,212,213,0.47
4948,February,2021,Prince George's,MD,Passenger,2,1,3,139,142,2.11
4949,February,2021,Spokane,WA,Passenger,923,560,1483,321417,322900,0.46
4950,February,2021,Juneau,AK,Passenger,0,1,1,25,26,3.85
4951,February,2021,Missoula,MT,Passenger,1,0,1,65,66,1.52
4952,February,2021,Washoe,NV,Passenger,1,0,1,97,98,1.02
4953,February,2021,Williamson,TX,Passenger,0,2,2,115,117,1.71
4954,February,2021,Wahkiakum,WA,Passenger,8,6,14,3045,3059,0.46
4955,February,2021,Kings,NY,Passenger,1,0,1,64,65,1.54
4956,February,2021,Montgomery,OH,Passenger,0,1,1,54,55,1.82
4957,February,2021,Wichita,TX,Passenger,1,0,1,41,42,2.38
4958,February,2021,Wahkiakum,WA,Truck,0,0,0,1782,1782,0.0
4959,February,2021,Hudson,NJ,Passenger,1,0,1,39,40,2.5
4960,February,2021,Manassas,VA,Passenger,0,1,1,6,7,14.29
4961,February,2021,Rogers,OK,Passenger,1,0,1,4,5,20.0
4962,February,2021,District of Columbia,DC,Passenger,3,1,4,201,205,1.95
4963,February,2021,Hampshire,MA,Passenger,1,0,1,6,7,14.29
4964,February,2021,El Paso,TX,Passenger,3,0,3,384,387,0.78
4965,February,2021,Ramsey,MN,Passenger,1,0,1,34,35,2.86
4966,February,2021,Thurston,WA,Truck,0,0,0,56448,56448,0.0
4967,February,2021,Norfolk,VA,Passenger,2,3,5,330,335,1.49
4968,February,2021,Franklin,WA,Truck,0,0,0,20510,20510,0.0
4969,February,2021,King,WA,Truck,6,1,7,184321,184328,0.0
4970,February,2021,Erie,NY,Passenger,1,0,1,43,44,2.27
4971,February,2021,Dakota,MN,Passenger,0,1,1,25,26,3.85
4972,February,2021,Grant,WA,Passenger,90,86,176,66076,66252,0.27
4973,February,2021,Hamilton,IN,Passenger,2,0,2,34,36,5.56
4974,February,2021,San Francisco,CA,Passenger,1,1,2,91,93,2.15
4975,February,2021,Palm Beach,FL,Passenger,0,1,1,72,73,1.37
4976,February,2021,Moore,NC,Passenger,0,1,1,138,139,0.72
4977,February,2021,Carroll,NH,Passenger,0,1,1,5,6,16.67
4978,February,2021,Columbia,WA,Truck,0,0,0,1543,1543,0.0
4979,February,2021,Boulder,CO,Passenger,0,1,1,44,45,2.22
4980,February,2021,Kittitas,WA,Passenger,142,53,195,29825,30020,0.65
4981,February,2021,Charles,MD,Passenger,1,1,2,72,74,2.7
4982,February,2021,Suffolk,MA,Passenger,0,2,2,32,34,5.88
4983,February,2021,Tulsa,OK,Passenger,1,1,2,40,42,4.76
4984,February,2021,Lewis,WA,Truck,0,0,0,26704,26704,0.0
4985,February,2021,Bradley,TN,Passenger,1,0,1,0,1,100.0
4986,February,2021,Pacific,WA,Passenger,37,38,75,15822,15897,0.47
4987,February,2021,Shelby,OH,Passenger,0,1,1,1,2,50.0
4988,February,2021,Okanogan,WA,Passenger,56,35,91,26131,26222,0.35
4989,February,2021,Okaloosa,FL,Passenger,0,1,1,130,131,0.76
4990,February,2021,Duval,FL,Passenger,0,2,2,346,348,0.57
4991,February,2021,Walla Walla,WA,Truck,0,0,0,13907,13907,0.0
4992,February,2021,Grays Harbor,WA,Passenger,142,130,272,48797,49069,0.55
4993,February,2021,DeKalb,IN,Passenger,1,0,1,0,1,100.0
4994,February,2021,Suffolk,VA,Passenger,1,0,1,124,125,0.8
4995,February,2021,Gwinnett,GA,Passenger,1,0,1,68,69,1.45
4996,February,2021,Howard,MD,Passenger,0,1,1,62,63,1.59
4997,February,2021,Douglas,WA,Passenger,86,46,132,28249,28381,0.47
4998,February,2021,Riverside,CA,Passenger,4,1,5,581,586,0.85
4999,February,2021,Sacramento,CA,Passenger,2,0,2,232,234,0.85
5000,February,2021,Okanogan,WA,Truck,0,0,0,16631,16631,0.0
5001,February,2021,Stevens,WA,Truck,0,0,0,18720,18720,0.0
5002,February,2021,El Dorado,CA,Passenger,1,0,1,32,33,3.03
5003,February,2021,Harris,TX,Passenger,1,1,2,204,206,0.97
5004,February,2021,Plaquemines,LA,Passenger,0,1,1,14,15,6.67
5005,February,2021,Flathead,MT,Passenger,1,0,1,46,47,2.13
5006,February,2021,Nueces,TX,Passenger,1,0,1,79,80,1.25
5007,February,2021,Kitsap,WA,Passenger,1642,777,2419,179346,181765,1.33
5008,February,2021,Howard,IN,Passenger,0,1,1,3,4,25.0
5009,February,2021,Fort Bend,TX,Passenger,1,0,1,40,41,2.44
5010,February,2021,Powhatan,VA,Passenger,1,0,1,1,2,50.0
5011,February,2021,Bexar,TX,Passenger,4,5,9,554,563,1.6
5012,February,2021,Orange,CA,Passenger,4,3,7,436,443,1.58
5013,February,2021,Whatcom,WA,Passenger,1277,572,1849,150039,151888,1.22
5014,February,2021,Houston,GA,Passenger,1,0,1,50,51,1.96
5015,February,2021,Fairfax,VA,Passenger,4,4,8,694,702,1.14
5016,February,2021,Ventura,CA,Passenger,1,1,2,266,268,0.75
5017,February,2021,Island,WA,Truck,0,0,0,21432,21432,0.0
5018,February,2021,Nassau,NY,Passenger,4,0,4,27,31,12.9
5019,February,2021,Morris,NJ,Passenger,1,0,1,16,17,5.88
5020,February,2021,Klickitat,WA,Passenger,65,45,110,14999,15109,0.73
5021,February,2021,Yakima,WA,Truck,0,0,0,61147,61147,0.0
5022,February,2021,Jefferson,WA,Truck,0,0,0,9576,9576,0.0
5023,February,2021,San Mateo,CA,Passenger,1,1,2,103,105,1.9
5024,February,2021,San Juan,WA,Passenger,383,118,501,14058,14559,3.44
5025,February,2021,Travis,TX,Passenger,2,3,5,160,165,3.03
5026,February,2021,Multnomah,OR,Passenger,3,5,8,665,673,1.19
5027,February,2021,Skamania,WA,Passenger,37,24,61,8292,8353,0.73
5028,February,2021,Queens,NY,Passenger,2,0,2,49,51,3.92
5029,February,2021,Chelan,WA,Truck,0,0,0,22878,22878,0.0
5031,February,2021,Honolulu,HI,Passenger,5,2,7,409,416,1.68
5032,February,2021,Walla Walla,WA,Passenger,105,69,174,36134,36308,0.48
5033,February,2021,Whitman,WA,Passenger,53,46,99,21854,21953,0.45
5034,February,2021,Washington,OR,Passenger,1,0,1,399,400,0.25
5035,February,2021,Bartow,GA,Passenger,0,1,1,4,5,20.0
5036,February,2021,Thurston,WA,Passenger,1383,811,2194,197237,199431,1.1
5037,February,2021,Rockingham,NH,Passenger,1,0,1,22,23,4.35
5038,February,2021,Anchorage,AK,Passenger,1,0,1,140,141,0.71
5039,February,2021,Owyhee,ID,Passenger,1,0,1,3,4,25.0
5040,February,2021,Anne Arundel,MD,Passenger,3,1,4,395,399,1.0
5041,February,2021,Denver,CO,Passenger,1,0,1,114,115,0.87
5042,February,2021,Larimer,CO,Passenger,1,0,1,53,54,1.85
5043,February,2021,Charleston,SC,Passenger,2,0,2,83,85,2.35
5044,February,2021,St. Clair,IL,Passenger,1,0,1,137,138,0.72
5045,February,2021,Placer,CA,Passenger,2,0,2,79,81,2.47
5046,February,2021,Randolph,NC,Passenger,1,0,1,6,7,14.29
5047,February,2021,Vigo,IN,Passenger,1,0,1,5,6,16.67
5048,February,2021,Jones,GA,Passenger,1,0,1,1,2,50.0
5049,February,2021,Nassau,FL,Passenger,1,0,1,33,34,2.94
5050,February,2021,Fairbanks North Star,AK,Passenger,0,1,1,86,87,1.15
5051,February,2021,Prince William,VA,Passenger,1,1,2,212,214,0.93
5052,February,2021,Clallam,WA,Truck,1,0,1,21901,21902,0.0
5053,February,2021,Skagit,WA,Passenger,535,247,782,91350,92132,0.85
5054,February,2021,Klamath,OR,Passenger,1,0,1,29,30,3.33
5055,February,2021,Maui,HI,Passenger,1,0,1,27,28,3.57
5056,February,2021,Kauai,HI,Passenger,1,0,1,15,16,6.25
5057,February,2021,Yakima,WA,Passenger,184,135,319,167503,167822,0.19
5058,February,2021,Ulster,NY,Passenger,1,0,1,7,8,12.5
5059,February,2021,Goochland,VA,Passenger,4,3,7,237,244,2.87
5060,February,2021,Santa Clara,CA,Passenger,7,2,9,263,272,3.31
5061,February,2021,Sarasota,FL,Passenger,2,0,2,25,27,7.41
5062,February,2021,Whatcom,WA,Truck,3,0,3,43636,43639,0.01
5063,February,2021,Alexandria,VA,Passenger,2,0,2,133,135,1.48
5064,February,2021,Whitman,WA,Truck,0,0,0,8514,8514,0.0
5065,February,2021,Fresno,CA,Passenger,1,0,1,169,170,0.59
5066,February,2021,Lake,IL,Passenger,2,0,2,152,154,1.3
5067,February,2021,Clark,NV,Passenger,4,2,6,646,652,0.92
5068,February,2021,Los Angeles,CA,Passenger,10,10,20,917,937,2.13
5069,February,2021,Philadelphia,PA,Passenger,1,0,1,56,57,1.75
5070,February,2021,Salt Lake,UT,Passenger,0,1,1,171,172,0.58
5071,February,2021,Snohomish,WA,Truck,1,0,1,125733,125734,0.0
5072,February,2021,Kern,CA,Passenger,0,1,1,217,218,0.46
5073,February,2021,Adams,WA,Truck,0,0,0,5344,5344,0.0
5074,February,2021,Kitsap,WA,Truck,0,0,0,54278,54278,0.0
5075,February,2021,Fulton,GA,Passenger,0,2,2,85,87,2.3
5076,February,2021,Douglas,CO,Passenger,0,1,1,76,77,1.3
5077,February,2021,Arlington,VA,Passenger,0,1,1,138,139,0.72
5078,February,2021,Dallas,TX,Passenger,1,0,1,166,167,0.6
5079,February,2021,Kittitas,WA,Truck,0,0,0,14694,14694,0.0
5080,February,2021,Stevens,WA,Passenger,38,42,80,30228,30308,0.26
5081,February,2021,New London,CT,Passenger,1,2,3,225,228,1.32
5082,February,2021,Pacific,WA,Truck,0,0,0,7828,7828,0.0
5083,February,2021,Skagit,WA,Truck,1,0,1,32853,32854,0.0
5084,February,2021,Deschutes,OR,Passenger,1,0,1,119,120,0.83
5085,February,2021,Richland,SC,Passenger,0,1,1,139,140,0.71
5086,February,2021,Stafford,VA,Passenger,2,1,3,95,98,3.06
5087,February,2021,Cumberland,NC,Passenger,0,2,2,440,442,0.45
5088,February,2021,Collin,TX,Passenger,1,1,2,115,117,1.71
5089,February,2021,New Haven,CT,Passenger,0,2,2,33,35,5.71
5090,February,2021,Bucks,PA,Passenger,1,0,1,18,19,5.26
5091,February,2021,Clallam,WA,Passenger,282,195,477,49992,50469,0.95
5092,February,2021,Oldham,KY,Passenger,0,1,1,4,5,20.0
5093,February,2021,Frederick,MD,Passenger,1,1,2,68,70,2.86
5094,February,2021,St. Mary's,MD,Passenger,1,0,1,212,213,0.47
5095,February,2021,Spokane,WA,Truck,0,0,0,101004,101004,0.0
5096,February,2021,Asotin,WA,Passenger,17,14,31,12486,12517,0.25
5097,February,2021,Ray,MO,Passenger,0,1,1,1,2,50.0
5098,February,2021,Lincoln,WA,Passenger,6,13,19,7648,7667,0.25
5099,February,2021,Virginia Beach,VA,Passenger,3,0,3,624,627,0.48
5100,February,2021,St. Louis,MO,Passenger,1,0,1,91,92,1.09
5101,February,2021,Pend Oreille,WA,Truck,0,0,0,5722,5722,0.0
5102,February,2021,Contra Costa,CA,Passenger,3,3,6,279,285,2.11
5103,February,2021,El Paso,CO,Passenger,2,0,2,686,688,0.29
5104,February,2021,Clackamas,OR,Passenger,3,0,3,175,178,1.69
5105,February,2021,Orange,FL,Passenger,1,0,1,111,112,0.89
5106,February,2021,Columbia,WA,Passenger,5,4,9,2453,2462,0.37
5107,February,2021,Santa Cruz,CA,Passenger,1,0,1,30,31,3.23
5108,February,2021,Putnam,TN,Passenger,0,1,1,2,3,33.33
5109,February,2021,Carroll,MD,Passenger,0,1,1,20,21,4.76
5110,February,2021,Boone,MO,Passenger,0,1,1,10,11,9.09
5111,February,2021,Clark,WA,Truck,0,0,0,83537,83537,0.0
5112,February,2021,Chelan,WA,Passenger,301,88,389,54492,54881,0.71
5113,February,2021,Adams,WA,Passenger,10,6,16,12975,12991,0.12
5114,February,2021,Pima,AZ,Passenger,2,1,3,306,309,0.97
5115,February,2021,Kent,MI,Passenger,0,1,1,25,26,3.85
5116,February,2021,Klickitat,WA,Truck,0,0,0,8118,8118,0.0
5117,February,2021,Montgomery,PA,Passenger,1,0,1,25,26,3.85
5118,February,2021,Asotin,WA,Truck,0,0,0,6696,6696,0.0
5119,February,2021,RÃ­o Grande,PR,Passenger,1,0,1,1,2,50.0
5120,February,2021,Williams,ND,Passenger,0,1,1,10,11,9.09
5121,February,2021,Skamania,WA,Truck,0,0,0,4030,4030,0.0
5122,February,2021,Hawaii,HI,Passenger,1,0,1,49,50,2.0
5123,February,2021,Snohomish,WA,Passenger,5270,1894,7164,538252,545416,1.31
5124,February,2021,Carson City,NV,Passenger,1,0,1,12,13,7.69
5125,February,2021,Alameda,CA,Passenger,3,0,3,253,256,1.17
5126,February,2021,Mason,WA,Passenger,177,135,312,47649,47961,0.65
5127,February,2021,Pend Oreille,WA,Passenger,12,4,16,9194,9210,0.17
5128,February,2021,Greene,MO,Passenger,0,1,1,31,32,3.12
5129,February,2021,Twin Falls,ID,Passenger,0,1,1,22,23,4.35
5130,February,2021,Ferry,WA,Truck,0,0,0,3625,3625,0.0
5131,February,2021,Cowlitz,WA,Passenger,194,130,324,71935,72259,0.45
5132,February,2021,Albemarle,VA,Passenger,1,0,1,21,22,4.55
5133,February,2021,Milwaukee,WI,Passenger,1,0,1,40,41,2.44
5134,February,2021,Sevier,AR,Passenger,0,1,1,0,1,100.0
5135,February,2021,Grays Harbor,WA,Truck,0,0,0,21251,21251,0.0
5136,February,2021,Leavenworth,KS,Passenger,0,1,1,120,121,0.83
5137,February,2021,San Juan,WA,Truck,0,0,0,5867,5867,0.0
5138,February,2021,Pierce,WA,Truck,0,0,0,145031,145031,0.0
5139,February,2021,Middlesex,MA,Passenger,1,1,2,94,96,2.08
5140,February,2021,DeKalb,GA,Passenger,1,0,1,65,66,1.52
5141,February,2021,San Diego,CA,Passenger,13,5,18,2662,2680,0.67
5142,February,2021,Douglas,NE,Passenger,1,1,2,50,52,3.85
5143,February,2021,Pennington,SD,Passenger,1,0,1,34,35,2.86
5144,February,2021,Washington,MD,Passenger,1,0,1,11,12,8.33
5145,February,2021,Allegheny,PA,Passenger,1,1,2,65,67,2.99
5146,February,2021,Cape May,NJ,Passenger,0,1,1,9,10,10.0
5147,February,2021,Broward,FL,Passenger,2,0,2,107,109,1.83
5148,February,2021,Penobscot,ME,Passenger,0,1,1,10,11,9.09
5149,February,2021,Cowlitz,WA,Truck,0,0,0,28976,28976,0.0
5150,February,2021,Harnett,NC,Passenger,1,0,1,180,181,0.55
5151,February,2021,DuPage,IL,Passenger,2,0,2,54,56,3.57
5152,February,2021,Douglas,WA,Truck,0,0,0,12517,12517,0.0
5153,February,2021,Lee,FL,Passenger,1,0,1,39,40,2.5
5154,February,2021,Garfield,WA,Passenger,0,2,2,1356,1358,0.15
5155,February,2021,Maricopa,AZ,Passenger,5,5,10,1265,1275,0.78
5156,February,2021,Monterey,CA,Passenger,0,1,1,149,150,0.67
5157,February,2021,Mason,WA,Truck,0,0,0,21053,21053,0.0
5158,February,2021,Solano,CA,Passenger,1,0,1,195,196,0.51
5159,February,2021,Loudoun,VA,Passenger,1,0,1,72,73,1.37
5160,February,2021,Harrison,MS,Passenger,2,0,2,54,56,3.57
5161,February,2021,Montgomery,TX,Passenger,1,0,1,45,46,2.17
5162,February,2021,Garfield,WA,Truck,0,0,0,1006,1006,0.0
5163,February,2021,New York,NY,Passenger,1,0,1,51,52,1.92
5164,February,2021,Pierce,WA,Passenger,3029,1810,4839,555482,560321,0.86
5165,February,2021,Benton,WA,Passenger,460,362,822,135084,135906,0.6
5166,February,2021,Pinellas,FL,Passenger,1,1,2,97,99,2.02
5167,February,2021,Franklin,WA,Passenger,92,87,179,61606,61785,0.29
5168,February,2021,Richmond,GA,Passenger,0,1,1,78,79,1.27
5169,February,2021,Utah,UT,Passenger,0,1,1,123,124,0.81
5170,February,2021,Camden,NJ,Passenger,0,1,1,16,17,5.88
5171,February,2021,Lincoln,WA,Truck,0,0,0,4689,4689,0.0
5172,February,2021,Arapahoe,CO,Passenger,1,0,1,118,119,0.84
5173,February,2021,Platte,MO,Passenger,1,0,1,18,19,5.26
5174,February,2021,Calvert,MD,Passenger,0,2,2,85,87,2.3
5175,February,2021,Clark,WA,Passenger,2505,1245,3750,318957,322707,1.16
5176,February,2021,Monroe,IL,Passenger,1,0,1,3,4,25.0
5177,February,2021,Polk,FL,Passenger,1,0,1,53,54,1.85
5178,February,2021,Benton,WA,Truck,0,0,0,43381,43381,0.0
5179,February,2021,Jefferson,WA,Passenger,295,168,463,24790,25253,1.83
5180,February,2021,Lake,FL,Passenger,1,0,1,21,22,4.55
5181,February,2021,King,WA,Passenger,28230,8448,36678,1364916,1401594,2.62
5182,February,2021,Wilson,TX,Passenger,0,1,1,5,6,16.67
5183,February,2021,Montgomery,MD,Passenger,1,0,1,228,229,0.44
5184,February,2021,Chesapeake,VA,Passenger,0,3,3,399,402,0.75
5185,February,2021,Lewis,WA,Passenger,127,132,259,58860,59119,0.44
5186,February,2021,Grant,WA,Truck,0,0,0,27662,27662,0.0
5187,February,2021,Ferry,WA,Passenger,10,3,13,4332,4345,0.3
5188,February,2022,Suffolk,MA,Passenger,0,2,2,23,25,8.0
5189,February,2022,Pacific,WA,Passenger,58,65,123,16024,16147,0.76
5190,February,2022,Sevier,AR,Passenger,0,1,1,0,1,100.0
5191,February,2022,Whatcom,WA,Passenger,1690,685,2375,149351,151726,1.57
5192,February,2022,Jefferson,NY,Passenger,0,1,1,201,202,0.5
5193,February,2022,Lane,OR,Passenger,0,1,1,103,104,0.96
5194,February,2022,El Paso,TX,Passenger,2,0,2,342,344,0.58
5195,February,2022,St. Mary's,MD,Passenger,1,0,1,199,200,0.5
5196,February,2022,Clark,NV,Passenger,4,2,6,541,547,1.1
5197,February,2022,Clallam,WA,Passenger,393,243,636,50137,50773,1.25
5198,February,2022,Mason,WA,Truck,0,0,0,21184,21184,0.0
5199,February,2022,Cook,IL,Passenger,2,0,2,192,194,1.03
5200,February,2022,Travis,TX,Passenger,1,0,1,118,119,0.84
5201,February,2022,Stevens,WA,Truck,0,0,0,18976,18976,0.0
5202,February,2022,Kings,CA,Passenger,2,1,3,311,314,0.96
5203,February,2022,Multnomah,OR,Passenger,1,4,5,576,581,0.86
5204,February,2022,Loudoun,VA,Passenger,1,0,1,65,66,1.52
5205,February,2022,San Joaquin,CA,Passenger,1,1,2,89,91,2.2
5206,February,2022,Williams,ND,Passenger,0,1,1,7,8,12.5
5207,February,2022,Nueces,TX,Passenger,1,1,2,59,61,3.28
5208,February,2022,San Juan,WA,Truck,1,0,1,6017,6018,0.02
5209,February,2022,Moore,NC,Passenger,0,1,1,121,122,0.82
5210,February,2022,Arlington,VA,Passenger,1,0,1,128,129,0.78
5211,February,2022,Howard,IN,Passenger,0,1,1,6,7,14.29
5212,February,2022,Coryell,TX,Passenger,1,0,1,102,103,0.97
5213,February,2022,Benton,WA,Passenger,664,451,1115,135846,136961,0.81
5214,February,2022,Spartanburg,SC,Passenger,0,1,1,44,45,2.22
5215,February,2022,Essex,NJ,Passenger,2,0,2,10,12,16.67
5216,February,2022,Montgomery,MD,Passenger,3,2,5,193,198,2.53
5217,February,2022,Charleston,SC,Passenger,2,1,3,69,72,4.17
5218,February,2022,Boulder,CO,Passenger,1,0,1,35,36,2.78
5219,February,2022,Skagit,WA,Passenger,716,316,1032,90675,91707,1.13
5220,February,2022,New Haven,CT,Passenger,0,2,2,29,31,6.45
5221,February,2022,Thurston,WA,Passenger,1970,990,2960,196039,198999,1.49
5222,February,2022,Contra Costa,CA,Passenger,1,4,5,259,264,1.89
5223,February,2022,El Paso,CO,Passenger,3,1,4,628,632,0.63
5224,February,2022,Monterey,CA,Passenger,0,1,1,130,131,0.76
5225,February,2022,Erie,NY,Passenger,1,0,1,29,30,3.33
5226,February,2022,Santa Clara,CA,Passenger,8,1,9,227,236,3.81
5227,February,2022,Ulster,NY,Passenger,1,0,1,9,10,10.0
5228,February,2022,Calvert,MD,Passenger,0,2,2,79,81,2.47
5229,February,2022,Grays Harbor,WA,Truck,0,0,0,21340,21340,0.0
5230,February,2022,Leavenworth,KS,Passenger,0,1,1,102,103,0.97
5231,February,2022,Harnett,NC,Passenger,1,0,1,142,143,0.7
5232,February,2022,Fort Bend,TX,Passenger,1,0,1,32,33,3.03
5234,February,2022,Lincoln,OR,Passenger,0,1,1,30,31,3.23
5235,February,2022,Ray,MO,Passenger,0,1,1,1,2,50.0
5236,February,2022,Douglas,CO,Passenger,0,1,1,76,77,1.3
5237,February,2022,Spokane,WA,Passenger,1392,784,2176,326237,328413,0.66
5238,February,2022,Los Angeles,CA,Passenger,10,7,17,809,826,2.06
5239,February,2022,Wood,OH,Passenger,0,1,1,4,5,20.0
5240,February,2022,Clark,WA,Passenger,3627,1600,5227,319148,324375,1.61
5241,February,2022,Garfield,WA,Passenger,0,3,3,1353,1356,0.22
5242,February,2022,Washington,MD,Passenger,2,0,2,14,16,12.5
5243,February,2022,Lincoln,WA,Truck,0,0,0,4845,4845,0.0
5244,February,2022,Kitsap,WA,Passenger,2230,982,3212,179653,182865,1.76
5245,February,2022,Platte,MO,Passenger,1,0,1,17,18,5.56
5246,February,2022,Benton,WA,Truck,0,0,0,43644,43644,0.0
5247,February,2022,Clallam,WA,Truck,1,0,1,22104,22105,0.0
5248,February,2022,DeKalb,GA,Passenger,1,0,1,51,52,1.92
5249,February,2022,Miami-Dade,FL,Passenger,1,0,1,87,88,1.14
5250,February,2022,Lewis,WA,Truck,0,0,0,26607,26607,0.0
5251,February,2022,Kauai,HI,Passenger,1,0,1,18,19,5.26
5252,February,2022,Geary,KS,Passenger,1,0,1,89,90,1.11
5253,February,2022,Suffolk,VA,Passenger,1,0,1,121,122,0.82
5254,February,2022,Camden,NJ,Passenger,0,1,1,13,14,7.14
5255,February,2022,San Diego,CA,Passenger,14,8,22,2347,2369,0.93
5256,February,2022,Nassau,NY,Passenger,2,0,2,24,26,7.69
5257,February,2022,San Francisco,CA,Passenger,0,1,1,76,77,1.3
5258,February,2022,Greene,MO,Passenger,0,1,1,24,25,4.0
5259,February,2022,Columbia,WA,Passenger,6,1,7,2457,2464,0.28
5260,February,2022,San Juan,WA,Passenger,485,152,637,14178,14815,4.3
5261,February,2022,Kittitas,WA,Truck,0,0,0,14753,14753,0.0
5262,February,2022,Onslow,NC,Passenger,0,1,1,165,166,0.6
5263,February,2022,Richmond,GA,Passenger,0,1,1,69,70,1.43
5264,February,2022,Owyhee,ID,Passenger,1,0,1,2,3,33.33
5265,February,2022,Jefferson,WA,Truck,0,0,0,9576,9576,0.0
5266,February,2022,St. Louis,MO,Passenger,1,0,1,71,72,1.39
5267,February,2022,Pierce,WA,Passenger,4484,2176,6660,552620,559280,1.19
5268,February,2022,Adams,WA,Passenger,17,14,31,13020,13051,0.24
5269,February,2022,Danville,VA,Passenger,1,0,1,0,1,100.0
5270,February,2022,Sarasota,FL,Passenger,2,0,2,27,29,6.9
5271,February,2022,Wahkiakum,WA,Truck,0,0,0,1815,1815,0.0
5272,February,2022,Asotin,WA,Truck,0,0,0,6741,6741,0.0
5273,February,2022,Rockdale,GA,Passenger,1,0,1,7,8,12.5
5274,February,2022,Garfield,WA,Truck,0,0,0,998,998,0.0
5275,February,2022,Escambia,FL,Passenger,0,1,1,136,137,0.73
5276,February,2022,Allen,IN,Passenger,1,0,1,14,15,6.67
5277,February,2022,Klickitat,WA,Truck,0,0,0,8332,8332,0.0
5278,February,2022,Prince George's,MD,Passenger,2,1,3,134,137,2.19
5279,February,2022,Penobscot,ME,Passenger,0,1,1,6,7,14.29
5280,February,2022,Pend Oreille,WA,Truck,0,0,0,5718,5718,0.0
5281,February,2022,Lake,FL,Passenger,1,0,1,22,23,4.35
5282,February,2022,Kern,CA,Passenger,0,1,1,196,197,0.51
5283,February,2022,New London,CT,Passenger,1,4,5,206,211,2.37
5284,February,2022,Honolulu,HI,Passenger,4,4,8,338,346,2.31
5285,February,2022,Island,WA,Passenger,745,351,1096,62408,63504,1.73
5286,February,2022,Flathead,MT,Passenger,1,0,1,37,38,2.63
5287,February,2022,Ventura,CA,Passenger,2,1,3,235,238,1.26
5288,February,2022,Thurston,WA,Truck,3,0,3,55853,55856,0.01
5289,February,2022,Grant,WA,Truck,0,0,0,28009,28009,0.0
5290,February,2022,Elmore,ID,Passenger,1,0,1,15,16,6.25
5291,February,2022,Larimer,CO,Passenger,1,0,1,49,50,2.0
5292,February,2022,Powhatan,VA,Passenger,1,0,1,1,2,50.0
5293,February,2022,Rock Island,IL,Passenger,0,1,1,16,17,5.88
5294,February,2022,Clackamas,OR,Passenger,2,0,2,157,159,1.26
5295,February,2022,Chesapeake,VA,Passenger,2,3,5,356,361,1.39
5296,February,2022,Chelan,WA,Truck,0,0,0,23075,23075,0.0
5297,February,2022,Pima,AZ,Passenger,1,1,2,241,243,0.82
5298,February,2022,Oldham,KY,Passenger,0,1,1,4,5,20.0
5299,February,2022,Snohomish,WA,Truck,3,0,3,125152,125155,0.0
5300,February,2022,Juneau,AK,Passenger,0,1,1,28,29,3.45
5301,February,2022,Orange,FL,Passenger,1,0,1,95,96,1.04
5302,February,2022,Yellowstone,MT,Passenger,0,1,1,28,29,3.45
5303,February,2022,Wilson,NC,Passenger,1,0,1,0,1,100.0
5304,February,2022,Broward,FL,Passenger,2,0,2,86,88,2.27
5305,February,2022,Howard,MD,Passenger,0,1,1,56,57,1.75
5306,February,2022,Williamson,TX,Passenger,1,2,3,87,90,3.33
5307,February,2022,Placer,CA,Passenger,2,0,2,70,72,2.78
5308,February,2022,Hennepin,MN,Passenger,3,0,3,62,65,4.62
5309,February,2022,Fairfax,VA,Passenger,3,3,6,629,635,0.94
5310,February,2022,Klamath,OR,Passenger,1,0,1,27,28,3.57
5311,February,2022,Yakima,WA,Passenger,301,178,479,168019,168498,0.28
5312,February,2022,St. Tammany,LA,Passenger,1,0,1,37,38,2.63
5313,February,2022,Grant,WA,Passenger,142,99,241,66798,67039,0.36
5314,February,2022,Pennington,SD,Passenger,2,0,2,29,31,6.45
5315,February,2022,Anne Arundel,MD,Passenger,4,3,7,357,364,1.92
5316,February,2022,Boone,MO,Passenger,0,1,1,9,10,10.0
5317,February,2022,Walla Walla,WA,Truck,0,0,0,14072,14072,0.0
5318,February,2022,New York,NY,Passenger,1,0,1,34,35,2.86
5319,February,2022,Middlesex,MA,Passenger,0,1,1,81,82,1.22
5320,February,2022,Salt Lake,UT,Passenger,1,1,2,146,148,1.35
5321,February,2022,San Bernardino,CA,Passenger,1,1,2,344,346,0.58
5322,February,2022,Richmond,NY,Passenger,1,0,1,6,7,14.29
5323,February,2022,Kittitas,WA,Passenger,218,72,290,29778,30068,0.96
5324,February,2022,Tarrant,TX,Passenger,1,0,1,125,126,0.79
5325,February,2022,Albemarle,VA,Passenger,1,0,1,18,19,5.26
5326,February,2022,Anchorage,AK,Passenger,1,0,1,121,122,0.82
5327,February,2022,Douglas,NE,Passenger,1,2,3,46,49,6.12
5328,February,2022,Sumter,SC,Passenger,0,1,1,33,34,2.94
5329,February,2022,Philadelphia,PA,Passenger,1,0,1,35,36,2.78
5330,February,2022,Lee,FL,Passenger,1,0,1,28,29,3.45
5331,February,2022,Champaign,IL,Passenger,1,0,1,11,12,8.33
5332,February,2022,Dorchester,SC,Passenger,1,0,1,62,63,1.59
5333,February,2022,Hidalgo,TX,Passenger,0,1,1,52,53,1.89
5334,February,2022,Burlington,NJ,Passenger,0,1,1,115,116,0.86
5335,February,2022,Rockingham,NH,Passenger,1,0,1,17,18,5.56
5336,February,2022,Maricopa,AZ,Passenger,7,2,9,985,994,0.91
5337,February,2022,Pierce,WA,Truck,2,0,2,144061,144063,0.0
5338,February,2022,Prince William,VA,Passenger,1,1,2,200,202,0.99
5339,February,2022,Okanogan,WA,Passenger,74,47,121,26474,26595,0.45
5340,February,2022,Queens,NY,Passenger,1,0,1,46,47,2.13
5341,February,2022,Vigo,IN,Passenger,1,0,1,5,6,16.67
5342,February,2022,Franklin,WA,Truck,0,0,0,20925,20925,0.0
5343,February,2022,Jefferson,WA,Passenger,394,202,596,24685,25281,2.36
5344,February,2022,Ferry,WA,Passenger,15,3,18,4443,4461,0.4
5345,February,2022,Whitman,WA,Truck,0,0,0,8578,8578,0.0
5346,February,2022,Whitman,WA,Passenger,70,56,126,22020,22146,0.57
5347,February,2022,Hamilton,OH,Passenger,1,0,1,30,31,3.23
5348,February,2022,Manassas,VA,Passenger,0,1,1,7,8,12.5
5349,February,2022,Randolph,NC,Passenger,1,0,1,5,6,16.67
5350,February,2022,Denton,TX,Passenger,1,0,1,70,71,1.41
5351,February,2022,Hudson,NJ,Passenger,2,0,2,35,37,5.41
5352,February,2022,Sedgwick,KS,Passenger,1,1,2,82,84,2.38
5353,February,2022,Kings,NY,Passenger,1,0,1,66,67,1.49
5354,February,2022,Galveston,TX,Passenger,0,1,1,20,21,4.76
5355,February,2022,Stevens,WA,Passenger,58,47,105,30105,30210,0.35
5356,February,2022,Frederick,MD,Passenger,1,1,2,67,69,2.9
5357,February,2022,Skagit,WA,Truck,1,0,1,32638,32639,0.0
5358,February,2022,Saratoga,NY,Passenger,1,0,1,39,40,2.5
5359,February,2022,Pinellas,FL,Passenger,0,1,1,81,82,1.22
5360,February,2022,Island,WA,Truck,1,0,1,21490,21491,0.0
5361,February,2022,Stafford,VA,Passenger,2,1,3,91,94,3.19
5362,February,2022,San Luis Obispo,CA,Passenger,1,0,1,55,56,1.79
5363,February,2022,Skamania,WA,Truck,0,0,0,4001,4001,0.0
5364,February,2022,Kitsap,WA,Truck,0,0,0,54096,54096,0.0
5365,February,2022,Rogers,OK,Passenger,1,0,1,2,3,33.33
5366,February,2022,Montgomery,TX,Passenger,1,0,1,31,32,3.12
5367,February,2022,Lincoln,WA,Passenger,7,17,24,7685,7709,0.31
5368,February,2022,Pacific,WA,Truck,0,0,0,8006,8006,0.0
5369,February,2022,Walla Walla,WA,Passenger,152,91,243,36233,36476,0.67
5370,February,2022,Whatcom,WA,Truck,4,0,4,43608,43612,0.01
5371,February,2022,Bexar,TX,Passenger,3,4,7,470,477,1.47
5372,February,2022,Cape May,NJ,Passenger,0,1,1,8,9,11.11
5373,February,2022,Gwinnett,GA,Passenger,1,0,1,56,57,1.75
5374,February,2022,Santa Cruz,CA,Passenger,1,0,1,24,25,4.0
5375,February,2022,Goochland,VA,Passenger,3,2,5,166,171,2.92
5376,February,2022,Portsmouth,VA,Passenger,0,1,1,75,76,1.32
5377,February,2022,Yamhill,OR,Passenger,1,0,1,31,32,3.12
5378,February,2022,Wahkiakum,WA,Passenger,17,11,28,3096,3124,0.9
5379,February,2022,Bell,TX,Passenger,1,0,1,330,331,0.3
5380,February,2022,Houston,GA,Passenger,1,0,1,39,40,2.5
5381,February,2022,Wilson,TX,Passenger,0,1,1,2,3,33.33
5382,February,2022,Asotin,WA,Passenger,22,18,40,12641,12681,0.32
5383,February,2022,Carroll,NH,Passenger,0,1,1,5,6,16.67
5384,February,2022,Richland,SC,Passenger,0,1,1,126,127,0.79
5385,February,2022,Lake,IL,Passenger,3,0,3,146,149,2.01
5386,February,2022,Douglas,WA,Truck,0,0,0,12686,12686,0.0
5387,February,2022,Carroll,MD,Passenger,0,1,1,15,16,6.25
5388,February,2022,Okaloosa,FL,Passenger,0,1,1,103,104,0.96
5389,February,2022,San Mateo,CA,Passenger,2,0,2,76,78,2.56
5390,February,2022,Harris,TX,Passenger,1,0,1,154,155,0.65
5391,February,2022,DuPage,IL,Passenger,1,0,1,48,49,2.04
5392,February,2022,Plaquemines,LA,Passenger,0,1,1,17,18,5.56
5393,February,2022,Norfolk,VA,Passenger,3,3,6,299,305,1.97
5394,February,2022,King,WA,Passenger,37216,10526,47742,1354857,1402599,3.4
5395,February,2022,Charles,MD,Passenger,0,1,1,61,62,1.61
5396,February,2022,Adams,WA,Truck,0,0,0,5459,5459,0.0
5397,February,2022,Alameda,CA,Passenger,4,0,4,202,206,1.94
5398,February,2022,Sonoma,CA,Passenger,0,1,1,74,75,1.33
5399,February,2022,Baltimore,MD,Passenger,1,0,1,76,77,1.3
5400,February,2022,Cowlitz,WA,Passenger,280,168,448,71262,71710,0.62
5401,February,2022,Wichita,TX,Passenger,1,0,1,41,42,2.38
5402,February,2022,Louisa,VA,Passenger,0,1,1,1,2,50.0
5403,February,2022,Snohomish,WA,Passenger,7454,2311,9765,535946,545711,1.79
5404,February,2022,Las Animas,CO,Passenger,1,0,1,1,2,50.0
5405,February,2022,Okanogan,WA,Truck,0,0,0,16714,16714,0.0
5406,February,2022,St. Clair,IL,Passenger,2,0,2,121,123,1.63
5407,February,2022,Harrison,MS,Passenger,2,0,2,45,47,4.26
5408,February,2022,Bartow,GA,Passenger,0,1,1,3,4,25.0
5409,February,2022,Chelan,WA,Passenger,429,121,550,54566,55116,1.0
5410,February,2022,Lewis,WA,Passenger,221,166,387,59453,59840,0.65
5411,February,2022,Allegheny,PA,Passenger,1,1,2,53,55,3.64
5412,February,2022,Hamilton,IN,Passenger,2,0,2,21,23,8.7
5413,February,2022,Solano,CA,Passenger,1,0,1,169,170,0.59
5414,February,2022,Shelby,OH,Passenger,0,1,1,2,3,33.33
5415,February,2022,Hillsborough,FL,Passenger,0,1,1,129,130,0.77
5416,February,2022,Collin,TX,Passenger,2,0,2,97,99,2.02
5417,February,2022,Alexandria,VA,Passenger,3,0,3,110,113,2.65
5418,February,2022,Spokane,WA,Truck,0,0,0,102602,102602,0.0
5419,February,2022,Sarpy,NE,Passenger,1,0,1,55,56,1.79
5420,February,2022,Yakima,WA,Truck,0,0,0,61654,61654,0.0
5421,February,2022,Montgomery,PA,Passenger,2,0,2,22,24,8.33
5422,February,2022,Cowlitz,WA,Truck,0,1,1,28908,28909,0.0
5423,February,2022,Riverside,CA,Passenger,5,1,6,476,482,1.24
5424,February,2022,Duval,FL,Passenger,0,2,2,296,298,0.67
5425,February,2022,Orange,CA,Passenger,4,2,6,369,375,1.6
5426,February,2022,Carson City,NV,Passenger,1,0,1,7,8,12.5
5427,February,2022,Clark,WA,Truck,2,0,2,83758,83760,0.0
5428,February,2022,King,WA,Truck,22,1,23,182492,182515,0.01
5429,February,2022,Sacramento,CA,Passenger,2,0,2,202,204,0.98
5430,February,2022,Skamania,WA,Passenger,59,45,104,8311,8415,1.24
5431,February,2022,Klickitat,WA,Passenger,92,53,145,15306,15451,0.94
5432,February,2022,Pend Oreille,WA,Passenger,17,9,26,9075,9101,0.29
5433,February,2022,Fairbanks North Star,AK,Passenger,0,1,1,76,77,1.3
5434,February,2022,Wake,NC,Passenger,1,0,1,101,102,0.98
5435,February,2022,Marin,CA,Passenger,0,1,1,30,31,3.23
5436,February,2022,Cumberland,NC,Passenger,1,2,3,377,380,0.79
5437,February,2022,Mason,WA,Passenger,280,166,446,47722,48168,0.93
5438,February,2022,Virginia Beach,VA,Passenger,2,0,2,551,553,0.36
5439,February,2022,Hawaii,HI,Passenger,1,0,1,37,38,2.63
5440,February,2022,Grays Harbor,WA,Passenger,202,157,359,49318,49677,0.72
5441,February,2022,Ferry,WA,Truck,0,0,0,3567,3567,0.0
5442,February,2022,Columbia,WA,Truck,0,0,0,1571,1571,0.0
5443,February,2022,Fresno,CA,Passenger,1,0,1,152,153,0.65
5444,February,2022,RÃ­o Grande,PR,Passenger,1,0,1,0,1,100.0
5445,February,2022,Dallas,TX,Passenger,1,0,1,125,126,0.79
5446,February,2022,Douglas,WA,Passenger,122,55,177,28558,28735,0.62
5447,February,2022,District of Columbia,DC,Passenger,5,0,5,184,189,2.65
5448,February,2022,Franklin,WA,Passenger,175,102,277,62074,62351,0.44
5449,February,2023,Santa Clara,CA,Passenger,8,2,10,163,173,5.78
5450,February,2023,Nassau,NY,Passenger,1,0,1,21,22,4.55
5451,February,2023,Santa Cruz,CA,Passenger,1,0,1,12,13,7.69
5452,February,2023,Monterey,CA,Passenger,1,1,2,113,115,1.74
5453,February,2023,Solano,CA,Passenger,4,0,4,135,139,2.88
5454,February,2023,Vernon,LA,Passenger,1,0,1,71,72,1.39
5455,February,2023,Skagit,WA,Passenger,987,377,1364,89175,90539,1.51
5456,February,2023,Platte,MO,Passenger,1,0,1,17,18,5.56
5457,February,2023,Leavenworth,KS,Passenger,0,1,1,90,91,1.1
5458,February,2023,Cowlitz,WA,Passenger,424,193,617,70210,70827,0.87
5459,February,2023,Benton,WA,Truck,15,0,15,43323,43338,0.03
5460,February,2023,Rockingham,NH,Passenger,1,0,1,10,11,9.09
5461,February,2023,Emmet,MI,Passenger,0,1,1,0,1,100.0
5462,February,2023,Gwinnett,GA,Passenger,1,0,1,42,43,2.33
5463,February,2023,El Paso,CO,Passenger,3,1,4,497,501,0.8
5464,February,2023,Ferry,WA,Truck,0,0,0,3565,3565,0.0
5465,February,2023,Galveston,TX,Passenger,0,1,1,17,18,5.56
5466,February,2023,Salt Lake,UT,Passenger,0,1,1,97,98,1.02
5467,February,2023,Lewis,WA,Truck,4,0,4,26200,26204,0.02
5468,February,2023,Pulaski,AR,Passenger,3,0,3,22,25,12.0
5469,February,2023,Collin,TX,Passenger,2,0,2,44,46,4.35
5470,February,2023,Clark,WA,Passenger,5174,2109,7283,313862,321145,2.27
5471,February,2023,Lee,AL,Passenger,1,0,1,11,12,8.33
5472,February,2023,Whitman,WA,Truck,4,0,4,8658,8662,0.05
5473,February,2023,Cook,IL,Passenger,2,0,2,148,150,1.33
5474,February,2023,New Haven,CT,Passenger,0,2,2,22,24,8.33
5475,February,2023,Honolulu,HI,Passenger,2,3,5,266,271,1.85
5476,February,2023,Hamilton,OH,Truck,1,0,1,2,3,33.33
5477,February,2023,Columbia,WA,Truck,0,0,0,1574,1574,0.0
5478,February,2023,Klickitat,WA,Truck,4,0,4,8261,8265,0.05
5479,February,2023,El Paso,TX,Passenger,2,0,2,273,275,0.73
5480,February,2023,Spokane,WA,Passenger,2041,983,3024,323909,326933,0.92
5481,February,2023,Larimer,CO,Passenger,1,0,1,37,38,2.63
5482,February,2023,Clallam,WA,Passenger,504,272,776,49281,50057,1.55
5483,February,2023,Portsmouth,VA,Passenger,0,1,1,62,63,1.59
5484,February,2023,San Juan,WA,Passenger,580,172,752,13878,14630,5.14
5485,February,2023,Douglas,CO,Passenger,0,1,1,55,56,1.79
5486,February,2023,Travis,TX,Passenger,1,0,1,77,78,1.28
5487,February,2023,Island,WA,Truck,20,0,20,21105,21125,0.09
5488,February,2023,Yakima,WA,Passenger,445,240,685,166120,166805,0.41
5489,February,2023,Kitsap,WA,Passenger,2890,1171,4061,176810,180871,2.25
5490,February,2023,Geary,KS,Passenger,1,0,1,71,72,1.39
5491,February,2023,Hennepin,MN,Passenger,1,0,1,31,32,3.12
5492,February,2023,Rock Island,IL,Passenger,0,1,1,14,15,6.67
5493,February,2023,Hillsborough,FL,Passenger,0,1,1,103,104,0.96
5494,February,2023,Onslow,NC,Passenger,0,1,1,140,141,0.71
5495,February,2023,Sarpy,NE,Passenger,1,0,1,45,46,2.17
5496,February,2023,Hoke,NC,Passenger,1,0,1,58,59,1.69
5497,February,2023,Snohomish,WA,Truck,122,0,122,122092,122214,0.1
5498,February,2023,Stevens,WA,Truck,2,0,2,18777,18779,0.01
5499,February,2023,Marin,CA,Passenger,0,1,1,27,28,3.57
5500,February,2023,Adams,WA,Passenger,21,11,32,13008,13040,0.25
5501,February,2023,Garfield,WA,Truck,0,0,0,979,979,0.0
5502,February,2023,Virginia Beach,VA,Passenger,2,0,2,438,440,0.45
5503,February,2023,Whitman,WA,Passenger,124,71,195,22018,22213,0.88
5504,February,2023,Ray,MO,Passenger,0,1,1,0,1,100.0
5505,February,2023,Kootenai,ID,Truck,1,0,1,26,27,3.7
5506,February,2023,DeKalb,GA,Passenger,1,0,1,39,40,2.5
5507,February,2023,San Juan,WA,Truck,10,0,10,5886,5896,0.17
5508,February,2023,Louisa,VA,Passenger,0,1,1,1,2,50.0
5509,February,2023,Wahkiakum,WA,Truck,1,0,1,1793,1794,0.06
5510,February,2023,Sumter,SC,Passenger,0,1,1,32,33,3.03
5511,February,2023,Douglas,WA,Truck,6,0,6,12882,12888,0.05
5512,February,2023,Lincoln,WA,Truck,0,0,0,4846,4846,0.0
5513,February,2023,Douglas,NE,Passenger,2,1,3,27,30,10.0
5514,February,2023,Broward,FL,Passenger,1,0,1,58,59,1.69
5515,February,2023,Arapahoe,CO,Passenger,1,1,2,64,66,3.03
5516,February,2023,Klickitat,WA,Passenger,127,57,184,15144,15328,1.2
5517,February,2023,Kent,DE,Passenger,1,0,1,48,49,2.04
5518,February,2023,Nueces,TX,Passenger,0,1,1,50,51,1.96
5519,February,2023,Walla Walla,WA,Passenger,206,108,314,35642,35956,0.87
5520,February,2023,Arlington,VA,Passenger,1,0,1,103,104,0.96
5521,February,2023,Madison,IL,Passenger,1,0,1,15,16,6.25
5522,February,2023,Alameda,CA,Passenger,3,0,3,152,155,1.94
5523,February,2023,Okaloosa,FL,Passenger,0,1,1,89,90,1.11
5524,February,2023,Lake,IL,Passenger,1,0,1,114,115,0.87
5525,February,2023,Chelan,WA,Truck,19,0,19,23120,23139,0.08
5526,February,2023,Newport News,VA,Passenger,1,0,1,93,94,1.06
5527,February,2023,Clark,NV,Passenger,4,2,6,398,404,1.49
5528,February,2023,Kittitas,WA,Truck,6,0,6,14560,14566,0.04
5529,February,2023,Fairfax,VA,Passenger,5,3,8,546,554,1.44
5530,February,2023,Grays Harbor,WA,Truck,2,0,2,21049,21051,0.01
5531,February,2023,Montgomery,MD,Passenger,3,3,6,173,179,3.35
5532,February,2023,Skamania,WA,Passenger,93,53,146,8095,8241,1.77
5533,February,2023,Island,WA,Passenger,977,411,1388,61460,62848,2.21
5534,February,2023,San Diego,CA,Passenger,17,9,26,1971,1997,1.3
5535,February,2023,Randolph,NC,Passenger,1,0,1,4,5,20.0
5536,February,2023,Dallas,TX,Passenger,1,0,1,75,76,1.32
5537,February,2023,Sonoma,CA,Passenger,1,1,2,58,60,3.33
5538,February,2023,Lewis,WA,Passenger,292,186,478,59690,60168,0.79
5539,February,2023,District of Columbia,DC,Passenger,4,0,4,150,154,2.6
5540,February,2023,Carroll,MD,Passenger,0,1,1,17,18,5.56
5541,February,2023,Stafford,VA,Passenger,3,1,4,77,81,4.94
5542,February,2023,Frederick,MD,Passenger,1,0,1,54,55,1.82
5543,February,2023,Hawaii,HI,Passenger,1,0,1,24,25,4.0
5544,February,2023,Allegheny,PA,Passenger,1,0,1,46,47,2.13
5545,February,2023,Yavapai,AZ,Passenger,1,0,1,22,23,4.35
5546,February,2023,Pierce,WA,Passenger,6593,2579,9172,535692,544864,1.68
5547,February,2023,King,WA,Truck,495,2,497,177291,177788,0.28
5548,February,2023,Whatcom,WA,Truck,44,0,44,42882,42926,0.1
5549,February,2023,Sheridan,WY,Passenger,1,0,1,5,6,16.67
5550,February,2023,Danville,VA,Passenger,1,0,1,0,1,100.0
5551,February,2023,Spokane,WA,Truck,26,0,26,101868,101894,0.03
5552,February,2023,Ferry,WA,Passenger,21,4,25,4341,4366,0.57
5553,February,2023,Los Angeles,CA,Passenger,4,5,9,618,627,1.44
5554,February,2023,Yellowstone,MT,Passenger,0,1,1,15,16,6.25
5555,February,2023,Suffolk,VA,Passenger,1,0,1,110,111,0.9
5556,February,2023,Oldham,KY,Passenger,0,1,1,4,5,20.0
5557,February,2023,Calvert,MD,Passenger,0,2,2,75,77,2.6
5558,February,2023,Washington,MD,Passenger,2,0,2,14,16,12.5
5559,February,2023,Coryell,TX,Passenger,1,0,1,78,79,1.27
5560,February,2023,Grays Harbor,WA,Passenger,272,171,443,48597,49040,0.9
5561,February,2023,Hudson,NJ,Passenger,1,0,1,24,25,4.0
5562,February,2023,Elmore,ID,Passenger,1,0,1,10,11,9.09
5563,February,2023,Douglas,WA,Passenger,180,59,239,28618,28857,0.83
5564,February,2023,San Joaquin,CA,Passenger,1,0,1,73,74,1.35
5565,February,2023,Thurston,WA,Truck,49,0,49,54485,54534,0.09
5566,February,2023,Skagit,WA,Truck,13,0,13,32041,32054,0.04
5567,February,2023,Rockdale,GA,Passenger,1,0,1,5,6,16.67
5568,February,2023,Jefferson,NY,Passenger,1,1,2,178,180,1.11
5569,February,2023,Santa Barbara,CA,Passenger,1,0,1,63,64,1.56
5570,February,2023,Asotin,WA,Passenger,30,20,50,12475,12525,0.4
5571,February,2023,Essex,NJ,Passenger,2,0,2,6,8,25.0
5572,February,2023,Charles,MD,Passenger,1,1,2,49,51,3.92
5573,February,2023,Placer,CA,Passenger,1,0,1,53,54,1.85
5574,February,2023,Norfolk,VA,Passenger,3,3,6,263,269,2.23
5575,February,2023,Lane,OR,Passenger,0,1,1,70,71,1.41
5576,February,2023,King,WA,Passenger,50928,12806,63734,1330234,1393968,4.57
5577,February,2023,St. Louis,MO,Passenger,1,0,1,50,51,1.96
5578,February,2023,Lincoln,OR,Passenger,0,1,1,13,14,7.14
5579,February,2023,Orange,CA,Passenger,7,2,9,286,295,3.05
5580,February,2023,Miami-Dade,FL,Passenger,1,0,1,60,61,1.64
5581,February,2023,Okanogan,WA,Truck,2,0,2,16449,16451,0.01
5582,February,2023,Adams,CO,Passenger,1,0,1,30,31,3.23
5583,February,2023,Champaign,IL,Passenger,1,0,1,8,9,11.11
5584,February,2023,Loudoun,VA,Passenger,3,0,3,57,60,5.0
5585,February,2023,Harris,TX,Passenger,1,0,1,116,117,0.85
5586,February,2023,Montgomery,AL,Passenger,0,1,1,29,30,3.33
5587,February,2023,Jefferson,WA,Truck,9,0,9,9332,9341,0.1
5588,February,2023,Sedgwick,KS,Passenger,1,1,2,61,63,3.17
5589,February,2023,Middlesex,MA,Passenger,2,1,3,59,62,4.84
5590,February,2023,Montgomery,PA,Passenger,1,0,1,16,17,5.88
5591,February,2023,Alexandria,VA,Passenger,3,1,4,89,93,4.3
5592,February,2023,Jackson,OK,Passenger,0,1,1,31,32,3.12
5593,February,2023,St. Mary's,MD,Passenger,1,0,1,167,168,0.6
5594,February,2023,Ventura,CA,Passenger,2,1,3,200,203,1.48
5595,February,2023,Jefferson,WA,Passenger,508,242,750,24237,24987,3.0
5596,February,2023,Moore,NC,Passenger,0,1,1,101,102,0.98
5597,February,2023,Allen,IN,Passenger,1,0,1,11,12,8.33
5598,February,2023,Pend Oreille,WA,Truck,0,0,0,5573,5573,0.0
5599,February,2023,Walla Walla,WA,Truck,3,0,3,13814,13817,0.02
5600,February,2023,Harrison,MS,Passenger,1,0,1,31,32,3.12
5601,February,2023,Mason,WA,Truck,9,0,9,20863,20872,0.04
5602,February,2023,Sarasota,FL,Passenger,1,0,1,16,17,5.88
5603,February,2023,Clallam,WA,Truck,12,0,12,21812,21824,0.05
5604,February,2023,Benton,WA,Passenger,989,517,1506,135708,137214,1.1
5605,February,2023,Lake,FL,Passenger,1,0,1,14,15,6.67
5606,February,2023,Cape May,NJ,Passenger,0,1,1,7,8,12.5
5607,February,2023,Grant,WA,Truck,7,0,7,28056,28063,0.02
5608,February,2023,Lincoln,WA,Passenger,16,17,33,7744,7777,0.42
5609,February,2023,Bartow,GA,Passenger,0,1,1,3,4,25.0
5610,February,2023,Cumberland,NC,Passenger,1,2,3,302,305,0.98
5611,February,2023,Bell,TX,Passenger,1,0,1,259,260,0.38
5612,February,2023,Burlington,NJ,Passenger,0,2,2,92,94,2.13
5613,February,2023,Riverside,CA,Passenger,7,0,7,380,387,1.81
5614,February,2023,Snohomish,WA,Passenger,10921,2841,13762,529463,543225,2.53
5615,February,2023,Stevens,WA,Passenger,99,58,157,29968,30125,0.52
5617,February,2023,Dorchester,SC,Passenger,1,0,1,41,42,2.38
5618,February,2023,Berkeley,SC,Passenger,0,1,1,104,105,0.95
5619,February,2023,Hidalgo,TX,Passenger,0,1,1,46,47,2.13
5620,February,2023,Clark,WA,Truck,70,0,70,81540,81610,0.09
5621,February,2023,Chelan,WA,Passenger,566,151,717,54278,54995,1.3
5622,February,2023,Bexar,TX,Passenger,4,3,7,356,363,1.93
5623,February,2023,Pacific,WA,Passenger,71,82,153,15680,15833,0.97
5624,February,2023,New London,CT,Passenger,2,4,6,174,180,3.33
5625,February,2023,Fairfax,VA,Truck,1,0,1,94,95,1.05
5626,February,2023,Fairbanks North Star,AK,Passenger,0,1,1,56,57,1.75
5627,February,2023,Wilson,TX,Passenger,0,1,1,2,3,33.33
5628,February,2023,Howard,MD,Passenger,0,1,1,43,44,2.27
5629,February,2023,Adams,WA,Truck,2,0,2,5362,5364,0.04
5630,February,2023,Multnomah,OR,Passenger,0,2,2,423,425,0.47
5631,February,2023,Richmond,NY,Passenger,1,0,1,6,7,14.29
5632,February,2023,Goochland,VA,Passenger,0,1,1,53,54,1.85
5633,February,2023,Wahkiakum,WA,Passenger,26,15,41,3046,3087,1.33
5634,February,2023,Hamilton,OH,Passenger,1,0,1,24,25,4.0
5635,February,2023,Charleston,SC,Passenger,2,2,4,54,58,6.9
5636,February,2023,Yakima,WA,Truck,9,0,9,61121,61130,0.01
5637,February,2023,Kitsap,WA,Truck,49,0,49,52804,52853,0.09
5638,February,2023,Okanogan,WA,Passenger,107,56,163,26100,26263,0.62
5639,February,2023,Garfield,WA,Passenger,1,3,4,1315,1319,0.3
5640,February,2023,Camden,NJ,Passenger,0,1,1,12,13,7.69
5641,February,2023,Houston,GA,Passenger,1,0,1,24,25,4.0
5642,February,2023,Harnett,NC,Passenger,2,0,2,124,126,1.59
5643,February,2023,Chesapeake,VA,Passenger,2,3,5,282,287,1.74
5644,February,2023,Wichita,TX,Passenger,2,0,2,34,36,5.56
5645,February,2023,Richmond,GA,Passenger,0,1,1,56,57,1.75
5646,February,2023,Ulster,NY,Passenger,1,0,1,4,5,20.0
5647,February,2023,Kings,CA,Passenger,2,1,3,273,276,1.09
5648,February,2023,Thurston,WA,Passenger,2773,1153,3926,191440,195366,2.01
5649,February,2023,St. Clair,IL,Passenger,2,0,2,106,108,1.85
5650,February,2023,Denton,TX,Passenger,1,0,1,46,47,2.13
5651,February,2023,Columbia,WA,Passenger,8,1,9,2424,2433,0.37
5652,February,2023,Franklin,WA,Passenger,275,128,403,61808,62211,0.65
5653,February,2023,Kern,CA,Passenger,1,1,2,182,184,1.09
5654,February,2023,Franklin,WA,Truck,4,0,4,20960,20964,0.02
5655,February,2023,Lee,FL,Passenger,1,0,1,24,25,4.0
5656,February,2023,Pierce,WA,Truck,111,0,111,138554,138665,0.08
5657,February,2023,St. Tammany,LA,Passenger,1,0,1,30,31,3.23
5658,February,2023,Pacific,WA,Truck,2,0,2,7825,7827,0.03
5659,February,2023,Prince George's,MD,Passenger,3,1,4,113,117,3.42
5660,February,2023,Saratoga,NY,Passenger,1,1,2,32,34,5.88
5661,February,2023,Asotin,WA,Truck,0,0,0,6661,6661,0.0
5662,February,2023,Williamson,TX,Passenger,0,2,2,57,59,3.39
5663,February,2023,Maricopa,AZ,Passenger,7,3,10,643,653,1.53
5664,February,2023,Cowlitz,WA,Truck,7,0,7,28319,28326,0.02
5665,February,2023,Sacramento,CA,Passenger,4,0,4,152,156,2.56
5666,February,2023,Duval,FL,Passenger,1,0,1,232,233,0.43
5667,February,2023,Anne Arundel,MD,Passenger,4,4,8,297,305,2.62
5668,February,2023,Contra Costa,CA,Passenger,0,3,3,199,202,1.49
5669,February,2023,Grant,WA,Passenger,241,114,355,66906,67261,0.53
5670,February,2023,Boulder,CO,Passenger,1,0,1,26,27,3.7
5671,February,2023,Beaufort,SC,Passenger,1,0,1,19,20,5.0
5672,February,2023,Mason,WA,Passenger,394,199,593,46628,47221,1.26
5673,February,2023,Whatcom,WA,Passenger,2212,826,3038,148577,151615,2.0
5674,February,2023,Kauai,HI,Passenger,1,1,2,13,15,13.33
5675,February,2023,Pend Oreille,WA,Passenger,26,13,39,8936,8975,0.43
5676,February,2023,Napa,CA,Passenger,0,1,1,9,10,10.0
5677,February,2023,Polk,OR,Passenger,0,1,1,17,18,5.56
5678,February,2023,Kittitas,WA,Passenger,322,92,414,29510,29924,1.38
5679,February,2023,Skamania,WA,Truck,1,0,1,3860,3861,0.03
5680,February,2023,San Bernardino,CA,Passenger,2,1,3,272,275,1.09
5681,February,2023,Plaquemines,LA,Passenger,1,1,2,16,18,11.11
5682,February,2023,Cumberland,PA,Passenger,1,0,1,32,33,3.03
5683,February,2023,Escambia,FL,Passenger,0,1,1,110,111,0.9
5684,February,2023,Las Animas,CO,Passenger,1,0,1,0,1,100.0
5685,February,2020,Spartanburg,SC,Passenger,0,1,1,45,46,2.17
5686,February,2020,Camden,NJ,Passenger,0,2,2,21,23,8.7
5687,February,2020,Randolph,NC,Passenger,1,0,1,7,8,12.5
5688,February,2020,Santa Cruz,CA,Passenger,1,0,1,36,37,2.7
5689,February,2020,Williams,ND,Passenger,0,1,1,13,14,7.14
5690,February,2020,Jones,GA,Passenger,1,0,1,1,2,50.0
5691,February,2020,Prince George's,MD,Passenger,1,1,2,171,173,1.16
5692,February,2020,San Diego,CA,Passenger,11,5,16,2780,2796,0.57
5693,February,2020,Osceola,FL,Passenger,1,0,1,41,42,2.38
5694,February,2020,Jefferson,CO,Passenger,0,1,1,60,61,1.64
5695,February,2020,Alexandria,VA,Passenger,1,0,1,144,145,0.69
5696,February,2020,Manassas,VA,Passenger,0,1,1,6,7,14.29
5697,February,2020,Goochland,VA,Passenger,2,1,3,261,264,1.14
5698,February,2020,Broward,FL,Passenger,2,1,3,119,122,2.46
5699,February,2020,Fulton,GA,Passenger,1,2,3,104,107,2.8
5700,February,2020,Dakota,MN,Passenger,0,1,1,32,33,3.03
5701,February,2020,San Joaquin,CA,Passenger,1,0,1,135,136,0.74
5702,February,2020,Saginaw,MI,Passenger,1,0,1,11,12,8.33
5703,February,2020,Bucks,PA,Passenger,1,0,1,19,20,5.0
5704,February,2020,Franklin,WA,Truck,0,0,0,19897,19897,0.0
5705,February,2020,Skamania,WA,Truck,0,0,0,4102,4102,0.0
5706,February,2020,Garfield,WA,Passenger,0,1,1,1349,1350,0.07
5707,February,2020,RÃ­o Grande,PR,Passenger,1,0,1,1,2,50.0
5708,February,2020,Queens,NY,Passenger,1,0,1,53,54,1.85
5709,February,2020,Lake,IL,Passenger,1,0,1,164,165,0.61
5710,February,2020,Portsmouth,VA,Passenger,0,1,1,78,79,1.27
5711,February,2020,Jefferson,WA,Passenger,230,139,369,25171,25540,1.44
5712,February,2020,Whitman,WA,Truck,0,0,0,8555,8555,0.0
5713,February,2020,Denver,CO,Passenger,1,0,1,126,127,0.79
5714,February,2020,Skagit,WA,Truck,1,0,1,32559,32560,0.0
5715,February,2020,Riverside,CA,Passenger,3,1,4,643,647,0.62
5716,February,2020,Okanogan,WA,Passenger,34,31,65,26121,26186,0.25
5717,February,2020,Okanogan,WA,Truck,0,0,0,16498,16498,0.0
5718,February,2020,Charles,MD,Passenger,0,1,1,76,77,1.3
5719,February,2020,Honolulu,HI,Passenger,4,2,6,467,473,1.27
5720,February,2020,El Paso,TX,Passenger,3,0,3,443,446,0.67
5721,February,2020,Lee,FL,Passenger,1,0,1,52,53,1.89
5722,February,2020,Pierce,WA,Passenger,2253,1684,3937,551186,555123,0.71
5723,February,2020,Harrison,MS,Passenger,1,0,1,60,61,1.64
5724,February,2020,Fort Bend,TX,Passenger,1,0,1,48,49,2.04
5725,February,2020,Vigo,IN,Passenger,1,0,1,5,6,16.67
5726,February,2020,San Mateo,CA,Passenger,0,1,1,116,117,0.85
5727,February,2020,DeKalb,GA,Passenger,1,0,1,83,84,1.19
5728,February,2020,Sedgwick,KS,Passenger,1,1,2,95,97,2.06
5729,February,2020,Guadalupe,TX,Passenger,1,0,1,66,67,1.49
5730,February,2020,Hennepin,MN,Passenger,3,1,4,98,102,3.92
5731,February,2020,Orange,CA,Passenger,7,2,9,502,511,1.76
5732,February,2020,District of Columbia,DC,Passenger,1,1,2,205,207,0.97
5733,February,2020,Clark,WA,Passenger,1970,1058,3028,320541,323569,0.94
5734,February,2020,Douglas,NE,Passenger,0,1,1,57,58,1.72
5735,February,2020,Fairfax,VA,Passenger,4,3,7,752,759,0.92
5736,February,2020,Fresno,CA,Passenger,1,0,1,188,189,0.53
5737,February,2020,Albemarle,VA,Passenger,1,0,1,25,26,3.85
5738,February,2020,Tarrant,TX,Passenger,2,0,2,186,188,1.06
5739,February,2020,Cowlitz,WA,Passenger,128,111,239,73460,73699,0.32
5740,February,2020,Juneau,AK,Passenger,0,2,2,32,34,5.88
5741,February,2020,Pinal,AZ,Passenger,1,0,1,192,193,0.52
5742,February,2020,Asotin,WA,Truck,0,0,0,6695,6695,0.0
5743,February,2020,Owyhee,ID,Passenger,1,0,1,3,4,25.0
5744,February,2020,Denton,TX,Passenger,1,0,1,89,90,1.11
5745,February,2020,Klamath,OR,Passenger,1,0,1,37,38,2.63
5746,February,2020,Lincoln,WA,Passenger,1,12,13,7781,7794,0.17
5747,February,2020,Grays Harbor,WA,Truck,0,0,0,20809,20809,0.0
5748,February,2020,Mason,WA,Passenger,150,135,285,47595,47880,0.6
5749,February,2020,Polk,FL,Passenger,1,0,1,67,68,1.47
5750,February,2020,Allegheny,PA,Passenger,1,0,1,73,74,1.35
5751,February,2020,Clay,FL,Passenger,0,1,1,85,86,1.16
5752,February,2020,Cumberland,NC,Passenger,0,2,2,478,480,0.42
5753,February,2020,Placer,CA,Passenger,2,0,2,93,95,2.11
5754,February,2020,Washtenaw,MI,Passenger,1,0,1,40,41,2.44
5755,February,2020,Garfield,WA,Truck,0,0,0,965,965,0.0
5756,February,2020,Williamson,TX,Passenger,0,2,2,142,144,1.39
5757,February,2020,Contra Costa,CA,Passenger,3,2,5,331,336,1.49
5758,February,2020,Spokane,WA,Passenger,696,469,1165,317560,318725,0.37
5759,February,2020,Greene,MO,Passenger,0,1,1,30,31,3.23
5760,February,2020,Sacramento,CA,Passenger,1,0,1,278,279,0.36
5761,February,2020,Stafford,VA,Passenger,1,1,2,91,93,2.15
5762,February,2020,Klickitat,WA,Truck,0,0,0,8301,8301,0.0
5763,February,2020,Lewis,WA,Passenger,108,105,213,59582,59795,0.36
5764,February,2020,Washington,OR,Passenger,1,0,1,459,460,0.22
5765,February,2020,Boulder,CO,Passenger,0,1,1,48,49,2.04
5766,February,2020,Kitsap,WA,Truck,1,0,1,54392,54393,0.0
5767,February,2020,Arapahoe,CO,Passenger,1,0,1,141,142,0.7
5768,February,2020,Clark,WA,Truck,0,0,0,81980,81980,0.0
5769,February,2020,Ventura,CA,Passenger,0,3,3,294,297,1.01
5770,February,2020,Moore,NC,Passenger,0,1,1,164,165,0.61
5771,February,2020,Boone,MO,Passenger,0,1,1,11,12,8.33
5772,February,2020,Grant,WA,Truck,0,0,0,27065,27065,0.0
5773,February,2020,Cowlitz,WA,Truck,0,0,0,28994,28994,0.0
5774,February,2020,Skagit,WA,Passenger,379,215,594,92466,93060,0.64
5775,February,2020,Oklahoma,OK,Passenger,0,1,1,128,129,0.78
5776,February,2020,Shasta,CA,Passenger,1,0,1,36,37,2.7
5777,February,2020,DuPage,IL,Passenger,3,0,3,62,65,4.62
5778,February,2020,Pend Oreille,WA,Passenger,8,7,15,9454,9469,0.16
5779,February,2020,Maui,HI,Passenger,1,0,1,36,37,2.7
5780,February,2020,Cape May,NJ,Passenger,0,1,1,13,14,7.14
5781,February,2020,Hudson,NJ,Passenger,1,0,1,39,40,2.5
5782,February,2020,Douglas,WA,Passenger,69,40,109,28271,28380,0.38
5783,February,2020,Grant,WA,Passenger,58,70,128,65569,65697,0.19
5784,February,2020,Brevard,FL,Passenger,0,1,1,88,89,1.12
5785,February,2020,Maricopa,AZ,Passenger,8,6,14,1474,1488,0.94
5786,February,2020,Kern,CA,Passenger,0,1,1,223,224,0.45
5787,February,2020,Spokane,WA,Truck,1,0,1,97160,97161,0.0
5788,February,2020,Wahkiakum,WA,Truck,0,0,0,1762,1762,0.0
5789,February,2020,Montgomery,TX,Passenger,1,0,1,52,53,1.89
5790,February,2020,Tuolumne,CA,Passenger,0,1,1,10,11,9.09
5791,February,2020,Travis,TX,Passenger,2,1,3,187,190,1.58
5792,February,2020,Grays Harbor,WA,Passenger,109,108,217,48374,48591,0.45
5793,February,2020,Ada,ID,Passenger,0,1,1,287,288,0.35
5794,February,2020,Yakima,WA,Passenger,122,116,238,165956,166194,0.14
5795,February,2020,Lewis,WA,Truck,0,0,0,26101,26101,0.0
5796,February,2020,Pierce,WA,Truck,0,0,0,141517,141517,0.0
5797,February,2020,Clark,NV,Passenger,3,2,5,685,690,0.72
5798,February,2020,Rockingham,NH,Passenger,1,0,1,28,29,3.45
5799,February,2020,Suffolk,VA,Passenger,1,0,1,124,125,0.8
5800,February,2020,Ferry,WA,Truck,0,0,0,3582,3582,0.0
5801,February,2020,Duval,FL,Passenger,1,2,3,365,368,0.82
5802,February,2020,Richland,SC,Passenger,0,1,1,159,160,0.62
5803,February,2020,Walla Walla,WA,Truck,0,0,0,13701,13701,0.0
5804,February,2020,Washoe,NV,Passenger,1,0,1,109,110,0.91
5805,February,2020,Anne Arundel,MD,Passenger,1,2,3,424,427,0.7
5806,February,2020,Cascade,MT,Passenger,0,1,1,55,56,1.79
5807,February,2020,San Juan,WA,Passenger,279,82,361,14330,14691,2.46
5808,February,2020,St. Mary's,MD,Passenger,1,0,1,216,217,0.46
5809,February,2020,Harris,TX,Passenger,1,0,1,237,238,0.42
5810,February,2020,Clallam,WA,Truck,1,0,1,21839,21840,0.0
5811,February,2020,Klickitat,WA,Passenger,49,41,90,15686,15776,0.57
5812,February,2020,King,WA,Truck,6,1,7,182612,182619,0.0
5813,February,2020,Fairbanks North Star,AK,Passenger,0,1,1,99,100,1.0
5814,February,2020,Lake,FL,Passenger,1,0,1,21,22,4.55
5815,February,2020,King,WA,Passenger,23446,7675,31121,1400298,1431419,2.17
5816,February,2020,Ulster,NY,Passenger,1,0,1,8,9,11.11
5817,February,2020,Nassau,NY,Passenger,4,0,4,38,42,9.52
5818,February,2020,Houston,GA,Passenger,1,0,1,58,59,1.69
5819,February,2020,Pacific,WA,Passenger,30,32,62,16071,16133,0.38
5820,February,2020,Ramsey,MN,Passenger,1,0,1,40,41,2.44
5821,February,2020,Stevens,WA,Truck,0,0,0,18756,18756,0.0
5822,February,2020,Island,WA,Passenger,401,263,664,63475,64139,1.04
5823,February,2020,Arlington,VA,Passenger,0,2,2,154,156,1.28
5824,February,2020,Mason,WA,Truck,0,0,0,20602,20602,0.0
5825,February,2020,Carson City,NV,Passenger,1,0,1,10,11,9.09
5826,February,2020,Lincoln,WA,Truck,0,0,0,4658,4658,0.0
5827,February,2020,Whatcom,WA,Truck,3,0,3,43146,43149,0.01
5828,February,2020,Tulsa,OK,Passenger,1,1,2,48,50,4.0
5829,February,2020,Oldham,KY,Passenger,0,1,1,4,5,20.0
5830,February,2020,Solano,CA,Passenger,1,0,1,211,212,0.47
5831,February,2020,Adams,WA,Truck,0,0,0,5221,5221,0.0
5832,February,2020,New London,CT,Passenger,0,2,2,250,252,0.79
5833,February,2020,Flathead,MT,Passenger,1,0,1,63,64,1.56
5834,February,2020,Thurston,WA,Truck,0,0,0,55720,55720,0.0
5835,February,2020,Kittitas,WA,Passenger,94,49,143,30014,30157,0.47
5836,February,2020,St. Clair,IL,Passenger,1,0,1,141,142,0.7
5837,February,2020,Clackamas,OR,Passenger,2,1,3,214,217,1.38
5838,February,2020,Wahkiakum,WA,Passenger,5,5,10,3017,3027,0.33
5839,February,2020,Pend Oreille,WA,Truck,0,0,0,5763,5763,0.0
5840,February,2020,Collin,TX,Passenger,1,1,2,129,131,1.53
5841,February,2020,Ferry,WA,Passenger,5,2,7,4373,4380,0.16
5842,February,2020,Powhatan,VA,Passenger,1,0,1,0,1,100.0
5843,February,2020,Howard,MD,Passenger,0,1,1,71,72,1.39
5844,February,2020,Yakima,WA,Truck,0,0,0,59625,59625,0.0
5845,February,2020,Alameda,CA,Passenger,3,1,4,282,286,1.4
5846,February,2020,Putnam,TN,Passenger,0,1,1,3,4,25.0
5847,February,2020,Shelby,OH,Passenger,0,1,1,1,2,50.0
5848,February,2020,Palm Beach,FL,Passenger,0,1,1,84,85,1.18
5849,February,2020,Bexar,TX,Passenger,2,5,7,635,642,1.09
5850,February,2020,San Juan,WA,Truck,0,0,0,5925,5925,0.0
5851,February,2020,Whitman,WA,Passenger,42,48,90,22621,22711,0.4
5852,February,2020,Columbia,WA,Passenger,3,3,6,2433,2439,0.25
5853,February,2020,Virginia Beach,VA,Passenger,1,0,1,690,691,0.14
5854,February,2020,Adams,WA,Passenger,7,7,14,12913,12927,0.11
5855,February,2020,Island,WA,Truck,1,0,1,21333,21334,0.0
5856,February,2020,Benton,WA,Passenger,338,320,658,135315,135973,0.48
5857,February,2020,Kent,MI,Passenger,0,1,1,23,24,4.17
5858,February,2020,Penobscot,ME,Passenger,0,1,1,15,16,6.25
5859,February,2020,Stevens,WA,Passenger,33,33,66,31445,31511,0.21
5860,February,2020,Nueces,TX,Passenger,1,0,1,83,84,1.19
5861,February,2020,Douglas,WA,Truck,0,0,0,12320,12320,0.0
5862,February,2020,Charleston,SC,Passenger,1,0,1,106,107,0.93
5863,February,2020,Pima,AZ,Passenger,3,1,4,364,368,1.09
5864,February,2020,DeKalb,IN,Passenger,1,0,1,1,2,50.0
5865,February,2020,Columbia,WA,Truck,0,0,0,1535,1535,0.0
5866,February,2020,Thurston,WA,Passenger,1109,725,1834,198984,200818,0.91
5867,February,2020,Snohomish,WA,Truck,0,0,0,123728,123728,0.0
5868,February,2020,Middlesex,MA,Passenger,1,1,2,101,103,1.94
5869,February,2020,Suffolk,MA,Passenger,0,1,1,38,39,2.56
5870,February,2020,Chelan,WA,Truck,0,0,0,22573,22573,0.0
5871,February,2020,Shelby,TN,Passenger,0,1,1,93,94,1.06
5872,February,2020,Benton,WA,Truck,0,0,0,42572,42572,0.0
5873,February,2020,Valencia,NM,Passenger,1,0,1,5,6,16.67
5874,February,2020,Deschutes,OR,Passenger,3,0,3,140,143,2.1
5875,February,2020,Dallas,TX,Passenger,1,0,1,201,202,0.5
5876,February,2020,New Haven,CT,Passenger,0,2,2,43,45,4.44
5877,February,2020,Cochise,AZ,Passenger,0,1,1,102,103,0.97
5878,February,2020,Santa Clara,CA,Passenger,7,2,9,334,343,2.62
5879,February,2020,Richmond,GA,Passenger,0,1,1,89,90,1.11
5880,February,2020,Montgomery,OH,Passenger,0,1,1,48,49,2.04
5881,February,2020,Harnett,NC,Passenger,1,1,2,207,209,0.96
5882,February,2020,Walla Walla,WA,Passenger,68,62,130,36314,36444,0.36
5883,February,2020,Jefferson,NY,Passenger,0,1,1,218,219,0.46
5884,February,2020,Los Angeles,CA,Passenger,8,11,19,1039,1058,1.8
5885,February,2020,Norfolk,VA,Passenger,2,2,4,352,356,1.12
5886,February,2020,El Paso,CO,Passenger,2,0,2,734,736,0.27
5887,February,2020,Larimer,CO,Passenger,1,0,1,54,55,1.82
5888,February,2020,Pacific,WA,Truck,0,0,0,7745,7745,0.0
5889,February,2020,Chesapeake,VA,Passenger,0,2,2,432,434,0.46
5890,February,2020,Twin Falls,ID,Passenger,0,1,1,29,30,3.33
5891,February,2020,Wayne,MI,Passenger,0,1,1,58,59,1.69
5892,February,2020,Whatcom,WA,Passenger,1042,486,1528,151612,153140,1.0
5893,February,2020,Kitsap,WA,Passenger,1273,661,1934,182316,184250,1.05
5894,February,2020,Sumter,FL,Passenger,0,1,1,9,10,10.0
5895,February,2020,Monroe,IL,Passenger,1,0,1,4,5,20.0
5896,February,2020,Franklin,WA,Passenger,58,76,134,61129,61263,0.22
5897,February,2020,Rogers,OK,Passenger,1,0,1,5,6,16.67
5898,February,2020,Multnomah,OR,Passenger,4,7,11,733,744,1.48
5899,February,2020,Frederick,MD,Passenger,1,1,2,81,83,2.41
5900,February,2020,Loudoun,VA,Passenger,1,0,1,90,91,1.1
5901,February,2020,Wilson,TX,Passenger,0,1,1,7,8,12.5
5902,February,2020,Asotin,WA,Passenger,16,11,27,12671,12698,0.21
5903,February,2020,Montgomery,AL,Passenger,0,1,1,39,40,2.5
5904,February,2020,San Francisco,CA,Passenger,2,1,3,100,103,2.91
5905,February,2020,Sarasota,FL,Passenger,2,0,2,27,29,6.9
5906,February,2020,Kootenai,ID,Passenger,1,1,2,229,231,0.87
5907,February,2020,Prince William,VA,Passenger,2,3,5,232,237,2.11
5908,February,2020,Chelan,WA,Passenger,216,78,294,54606,54900,0.54
5909,February,2020,Snohomish,WA,Passenger,4302,1729,6031,538151,544182,1.11
5910,February,2020,Jefferson,WA,Truck,0,0,0,9642,9642,0.0
5911,February,2020,Calvert,MD,Passenger,0,2,2,90,92,2.17
5912,February,2020,Santa Rosa,FL,Passenger,1,0,1,85,86,1.16
5913,February,2020,Clallam,WA,Passenger,206,163,369,50804,51173,0.72
5914,February,2020,Pinellas,FL,Passenger,1,1,2,110,112,1.79
5916,February,2020,Hawaii,HI,Passenger,1,0,1,61,62,1.61
5917,February,2020,Kittitas,WA,Truck,0,0,0,14649,14649,0.0
5918,February,2020,Carroll,NH,Passenger,0,1,1,4,5,20.0
5919,February,2020,Montgomery,PA,Passenger,2,0,2,35,37,5.41
5920,February,2020,Skamania,WA,Passenger,28,19,47,8773,8820,0.53
5921,January,2017,Collier,FL,Passenger,0,1,1,22,23,4.35
5922,January,2017,Portsmouth,VA,Passenger,0,1,1,65,66,1.52
5923,January,2017,Monroe,NY,Passenger,1,0,1,30,31,3.23
5924,January,2017,Garfield,WA,Truck,0,0,0,941,941,0.0
5925,January,2017,Lane,OR,Passenger,0,1,1,291,292,0.34
5926,January,2017,Sumter,FL,Passenger,0,1,1,10,11,9.09
5927,January,2017,Skagit,WA,Truck,1,0,1,31404,31405,0.0
5928,January,2017,Anne Arundel,MD,Passenger,0,1,1,515,516,0.19
5929,January,2017,Dane,WI,Passenger,1,0,1,192,193,0.52
5930,January,2017,Saratoga,NY,Passenger,1,1,2,79,81,2.47
5931,January,2017,Adams,WA,Passenger,1,1,2,12175,12177,0.02
5932,January,2017,Skamania,WA,Truck,0,0,0,3908,3908,0.0
5933,January,2017,Kitsap,WA,Passenger,556,262,818,172401,173219,0.47
5934,January,2017,Los Angeles,CA,Passenger,3,1,4,1470,1474,0.27
5935,January,2017,Guilford,NC,Passenger,1,0,1,34,35,2.86
5936,January,2017,Cape May,NJ,Passenger,0,1,1,19,20,5.0
5937,January,2017,Thurston,WA,Truck,0,0,0,53340,53340,0.0
5938,January,2017,Yakima,WA,Passenger,36,49,85,159930,160015,0.05
5939,January,2017,Pend Oreille,WA,Truck,0,0,0,5595,5595,0.0
5940,January,2017,Brown,WI,Passenger,1,0,1,46,47,2.13
5941,January,2017,Kitsap,WA,Truck,1,0,1,52380,52381,0.0
5942,January,2017,Cowlitz,WA,Passenger,51,44,95,69109,69204,0.14
5943,January,2017,Grant,WA,Truck,0,0,0,25039,25039,0.0
5944,January,2017,Utah,UT,Passenger,0,1,1,195,196,0.51
5945,January,2017,Whitman,WA,Passenger,8,19,27,21936,21963,0.12
5946,January,2017,Santa Clara,CA,Passenger,5,3,8,460,468,1.71
5947,January,2017,Douglas,WA,Truck,0,0,0,11426,11426,0.0
5948,January,2017,Monterey,CA,Passenger,0,1,1,232,233,0.43
5949,January,2017,Durham,NC,Passenger,0,1,1,38,39,2.56
5950,January,2017,Columbia,WA,Passenger,0,1,1,2331,2332,0.04
5951,January,2017,DeKalb,GA,Passenger,1,0,1,91,92,1.09
5952,January,2017,Carroll,NH,Passenger,0,1,1,0,1,100.0
5953,January,2017,Yakima,WA,Truck,0,0,0,57337,57337,0.0
5954,January,2017,Stevens,WA,Truck,0,0,0,18341,18341,0.0
5955,January,2017,Clark,WA,Truck,0,0,0,77522,77522,0.0
5956,January,2017,El Paso,CO,Passenger,1,1,2,884,886,0.23
5957,January,2017,Clark,WA,Passenger,673,426,1099,297819,298918,0.37
5958,January,2017,Wayne,MI,Passenger,0,2,2,77,79,2.53
5959,January,2017,Maricopa,AZ,Passenger,3,0,3,1977,1980,0.15
5960,January,2017,Chelan,WA,Passenger,54,28,82,51898,51980,0.16
5961,January,2017,Pend Oreille,WA,Passenger,1,4,5,9345,9350,0.05
5962,January,2017,Hardin,KY,Passenger,0,1,1,127,128,0.78
5963,January,2017,Loudoun,VA,Passenger,0,1,1,86,87,1.15
5964,January,2017,Lincoln,WA,Truck,0,0,0,4462,4462,0.0
5965,January,2017,Skamania,WA,Passenger,7,7,14,8549,8563,0.16
5966,January,2017,Mason,WA,Passenger,48,60,108,42807,42915,0.25
5967,January,2017,Lincoln,WA,Passenger,2,4,6,7543,7549,0.08
5968,January,2017,Clallam,WA,Truck,0,0,0,21044,21044,0.0
5969,January,2017,Bexar,TX,Passenger,3,3,6,1255,1261,0.48
5970,January,2017,Ferry,WA,Passenger,2,1,3,4386,4389,0.07
5971,January,2017,Clackamas,OR,Passenger,1,2,3,426,429,0.7
5972,January,2017,Alameda,CA,Passenger,6,1,7,399,406,1.72
5973,January,2017,Cowlitz,WA,Truck,0,0,0,27949,27949,0.0
5974,January,2017,Deschutes,OR,Passenger,1,1,2,238,240,0.83
5975,January,2017,Hamilton,IN,Passenger,1,0,1,73,74,1.35
5976,January,2017,Franklin,MA,Passenger,0,1,1,5,6,16.67
5977,January,2017,Walla Walla,WA,Passenger,16,21,37,34864,34901,0.11
5978,January,2017,Benton,WA,Passenger,129,129,258,127860,128118,0.2
5979,January,2017,Lewis,NY,Passenger,0,1,1,10,11,9.09
5980,January,2017,Lewis,WA,Truck,0,0,0,24791,24791,0.0
5981,January,2017,Klickitat,WA,Truck,0,0,0,7945,7945,0.0
5982,January,2017,Fairfax,VA,Passenger,2,2,4,885,889,0.45
5983,January,2017,Clark,NV,Passenger,1,4,5,930,935,0.53
5984,January,2017,Cascade,MT,Passenger,0,1,1,62,63,1.59
5985,January,2017,Asotin,WA,Passenger,4,3,7,12319,12326,0.06
5986,January,2017,Gwinnett,GA,Passenger,0,1,1,94,95,1.05
5987,January,2017,New London,CT,Passenger,2,1,3,271,274,1.09
5988,January,2017,Douglas,WA,Passenger,29,19,48,26580,26628,0.18
5989,January,2017,Orleans,LA,Passenger,0,1,1,52,53,1.89
5990,January,2017,Middlesex,MA,Passenger,1,0,1,161,162,0.62
5991,January,2017,Shoshone,ID,Passenger,0,1,1,99,100,1.0
5992,January,2017,Polk,FL,Passenger,1,0,1,64,65,1.54
5993,January,2017,Morris,NJ,Passenger,1,0,1,23,24,4.17
5994,January,2017,Santa Fe,NM,Passenger,0,1,1,44,45,2.22
5995,January,2017,DeKalb,IN,Passenger,1,0,1,1,2,50.0
5996,January,2017,Juneau,AK,Passenger,0,1,1,58,59,1.69
5997,January,2017,Pierce,WA,Passenger,822,751,1573,528314,529887,0.3
5998,January,2017,Okanogan,WA,Passenger,3,15,18,25814,25832,0.07
5999,January,2017,Arlington,VA,Passenger,1,1,2,176,178,1.12
6000,January,2017,Thurston,WA,Passenger,336,299,635,184964,185599,0.34
6001,January,2017,Montgomery,MD,Passenger,1,0,1,312,313,0.32
6002,January,2017,Hamilton,TN,Passenger,1,0,1,28,29,3.45
6003,January,2017,Manassas,VA,Passenger,0,1,1,8,9,11.11
6004,January,2017,King,WA,Truck,8,1,9,191085,191094,0.0
6005,January,2017,Spokane,WA,Truck,1,0,1,90429,90430,0.0
6006,January,2017,Douglas,OR,Passenger,0,1,1,90,91,1.1
6007,January,2017,Walla Walla,WA,Truck,0,0,0,13168,13168,0.0
6008,January,2017,Lee,AL,Passenger,1,0,1,36,37,2.7
6009,January,2017,Jefferson,WA,Truck,0,0,0,9469,9469,0.0
6010,January,2017,Pacific,WA,Passenger,5,6,11,15034,15045,0.07
6011,January,2017,New Haven,CT,Passenger,0,1,1,66,67,1.49
6012,January,2017,Jackson,MO,Passenger,1,0,1,75,76,1.32
6013,January,2017,Cobb,GA,Passenger,0,1,1,82,83,1.2
6014,January,2017,Allegheny,PA,Passenger,1,0,1,94,95,1.05
6015,January,2017,Jefferson,NY,Passenger,1,1,2,250,252,0.79
6016,January,2017,San Mateo,CA,Passenger,0,1,1,177,178,0.56
6017,January,2017,Franklin,WA,Passenger,27,42,69,55402,55471,0.12
6018,January,2017,Adams,WA,Truck,0,0,0,5077,5077,0.0
6019,January,2017,Spokane,WA,Passenger,221,196,417,296020,296437,0.14
6020,January,2017,Grant,WA,Passenger,16,21,37,60386,60423,0.06
6021,January,2017,Marion,FL,Passenger,1,0,1,26,27,3.7
6022,January,2017,Okaloosa,FL,Passenger,1,0,1,189,190,0.53
6023,January,2017,Snohomish,WA,Truck,1,0,1,122825,122826,0.0
6024,January,2017,Stevens,WA,Passenger,6,21,27,31528,31555,0.09
6025,January,2017,Multnomah,OR,Passenger,0,3,3,1282,1285,0.23
6026,January,2017,Skagit,WA,Passenger,106,81,187,87447,87634,0.21
6027,January,2017,Ferry,WA,Truck,0,0,0,3581,3581,0.0
6028,January,2017,Orange,CA,Passenger,2,1,3,704,707,0.42
6029,January,2017,Salt Lake,UT,Passenger,0,1,1,358,359,0.28
6030,January,2017,San Juan,WA,Truck,0,0,0,5594,5594,0.0
6031,January,2017,Shelby,TN,Passenger,0,1,1,113,114,0.88
6032,January,2017,Travis,TX,Passenger,0,1,1,213,214,0.47
6033,January,2017,Norfolk,MA,Passenger,1,0,1,39,40,2.5
6034,January,2017,Kittitas,WA,Passenger,15,16,31,27158,27189,0.11
6035,January,2017,Orange,FL,Passenger,0,1,1,159,160,0.62
6036,January,2017,Pinal,AZ,Passenger,2,0,2,281,283,0.71
6037,January,2017,Asotin,WA,Truck,0,0,0,6487,6487,0.0
6038,January,2017,Northampton,PA,Passenger,2,0,2,259,261,0.77
6039,January,2017,Essex,NJ,Passenger,1,0,1,16,17,5.88
6040,January,2017,Pacific,WA,Truck,0,0,0,7509,7509,0.0
6041,January,2017,Honolulu,HI,Passenger,4,2,6,663,669,0.9
6042,January,2017,Hidalgo,TX,Passenger,0,1,1,98,99,1.01
6043,January,2017,St. Lucie,FL,Passenger,1,0,1,32,33,3.03
6044,January,2017,Prince George's,MD,Passenger,0,1,1,189,190,0.53
6045,January,2017,Richmond,GA,Passenger,0,1,1,103,104,0.96
6046,January,2017,Prince William,VA,Passenger,0,3,3,281,284,1.06
6047,January,2017,San Diego,CA,Passenger,4,2,6,2895,2901,0.21
6048,January,2017,Santa Barbara,CA,Passenger,0,1,1,133,134,0.75
6049,January,2017,Norfolk,VA,Passenger,1,1,2,305,307,0.65
6050,January,2017,Latah,ID,Passenger,0,1,1,142,143,0.7
6051,January,2017,Pierce,WA,Truck,0,0,0,138768,138768,0.0
6052,January,2017,Oklahoma,OK,Passenger,0,1,1,211,212,0.47
6053,January,2017,Muscogee,GA,Passenger,0,1,1,265,266,0.38
6054,January,2017,Klickitat,WA,Passenger,20,22,42,14793,14835,0.28
6055,January,2017,Hood River,OR,Passenger,1,0,1,43,44,2.27
6056,January,2017,King,WA,Passenger,8804,3621,12425,1387384,1399809,0.89
6057,January,2017,Clallam,WA,Passenger,73,64,137,48005,48142,0.28
6058,January,2017,Grays Harbor,WA,Passenger,27,24,51,44315,44366,0.11
6059,January,2017,Harnett,NC,Passenger,1,0,1,269,270,0.37
6060,January,2017,Columbia,WA,Truck,0,0,0,1543,1543,0.0
6061,January,2017,Dale,AL,Passenger,0,1,1,67,68,1.47
6062,January,2017,El Paso,TX,Passenger,0,1,1,593,594,0.17
6063,January,2017,Cumberland,NC,Passenger,1,0,1,636,637,0.16
6064,January,2017,Yavapai,AZ,Passenger,1,0,1,85,86,1.16
6065,January,2017,Whitman,WA,Truck,0,0,0,8403,8403,0.0
6066,January,2017,Manatee,FL,Passenger,1,0,1,59,60,1.67
6067,January,2017,Island,WA,Truck,1,0,1,20520,20521,0.0
6068,January,2017,Lake,IL,Passenger,1,0,1,187,188,0.53
6069,January,2017,Whatcom,WA,Passenger,383,141,524,141886,142410,0.37
6070,January,2017,Hawaii,HI,Passenger,1,0,1,90,91,1.1
6071,January,2017,Whatcom,WA,Truck,2,0,2,41337,41339,0.0
6072,January,2017,Island,WA,Passenger,103,119,222,59416,59638,0.37
6073,January,2017,Maui,HI,Passenger,1,0,1,82,83,1.2
6074,January,2017,Mason,WA,Truck,0,0,0,19187,19187,0.0
6075,January,2017,Charles,MD,Passenger,0,1,1,89,90,1.11
6076,January,2017,Kittitas,WA,Truck,0,0,0,13412,13412,0.0
6077,January,2017,Madison,ID,Passenger,1,0,1,48,49,2.04
6078,January,2017,Dallas,TX,Passenger,1,0,1,230,231,0.43
6079,January,2017,Garfield,WA,Passenger,0,0,0,1285,1285,0.0
6080,January,2017,Chelan,WA,Truck,0,0,0,21262,21262,0.0
6081,January,2017,District of Columbia,DC,Passenger,0,3,3,238,241,1.24
6082,January,2017,Benton,WA,Truck,0,0,0,39813,39813,0.0
6083,January,2017,Bergen,NJ,Passenger,0,2,2,33,35,5.71
6084,January,2017,Marion,OR,Passenger,1,0,1,238,239,0.42
6086,January,2017,Duval,FL,Passenger,1,1,2,379,381,0.52
6087,January,2017,Lewis,WA,Passenger,43,30,73,54960,55033,0.13
6088,January,2017,Nantucket,MA,Passenger,1,0,1,3,4,25.0
6089,January,2017,Union,OH,Passenger,1,0,1,4,5,20.0
6090,January,2017,Okanogan,WA,Truck,0,0,0,16374,16374,0.0
6091,January,2017,Riverside,CA,Passenger,1,1,2,888,890,0.22
6092,January,2017,Tulare,CA,Passenger,1,0,1,203,204,0.49
6093,January,2017,Moore,NC,Passenger,0,1,1,210,211,0.47
6094,January,2017,Pima,AZ,Passenger,0,2,2,468,470,0.43
6095,January,2017,Montgomery,TN,Passenger,1,0,1,307,308,0.32
6096,January,2017,Contra Costa,CA,Passenger,1,0,1,683,684,0.15
6097,January,2017,Canyon,ID,Passenger,0,1,1,118,119,0.84
6098,January,2017,Jefferson,WA,Passenger,87,53,140,23606,23746,0.59
6099,January,2017,Howard,MD,Passenger,0,2,2,90,92,2.17
6100,January,2017,Grays Harbor,WA,Truck,0,0,0,19862,19862,0.0
6101,January,2017,Virginia Beach,VA,Passenger,2,1,3,658,661,0.45
6102,January,2017,Ventura,CA,Passenger,0,2,2,392,394,0.51
6103,January,2017,St. Mary's,MD,Passenger,0,1,1,205,206,0.49
6104,January,2017,Fulton,GA,Passenger,1,2,3,136,139,2.16
6105,January,2017,San Juan,WA,Passenger,84,31,115,13348,13463,0.85
6106,January,2017,Franklin,WA,Truck,0,0,0,17912,17912,0.0
6107,January,2017,Marin,CA,Passenger,1,0,1,57,58,1.72
6108,January,2017,Wahkiakum,WA,Passenger,0,1,1,2861,2862,0.03
6109,January,2017,Snohomish,WA,Passenger,1549,803,2352,514965,517317,0.45
6110,January,2017,Wahkiakum,WA,Truck,0,0,0,1624,1624,0.0
6111,January,2017,Volusia,FL,Passenger,0,1,1,49,50,2.0
6112,January,2017,Tarrant,TX,Passenger,0,2,2,333,335,0.6
6113,January,2017,Dakota,MN,Passenger,0,1,1,46,47,2.13
6114,January,2018,Polk,FL,Passenger,1,0,1,62,63,1.59
6115,January,2018,Garfield,WA,Truck,0,0,0,945,945,0.0
6116,January,2018,Walla Walla,WA,Truck,0,0,0,13323,13323,0.0
6117,January,2018,Klickitat,WA,Truck,0,0,0,8000,8000,0.0
6118,January,2018,Palm Beach,FL,Passenger,0,1,1,87,88,1.14
6119,January,2018,Canyon,ID,Passenger,0,1,1,95,96,1.04
6120,January,2018,Fairfax,VA,Passenger,2,2,4,821,825,0.48
6121,January,2018,Hardin,KY,Passenger,0,1,1,118,119,0.84
6122,January,2018,Multnomah,OR,Passenger,3,4,7,845,852,0.82
6123,January,2018,Spokane,WA,Passenger,300,255,555,300795,301350,0.18
6124,January,2018,Clark,WA,Truck,0,0,0,78578,78578,0.0
6125,January,2018,Cowlitz,WA,Passenger,54,69,123,70972,71095,0.17
6126,January,2018,Franklin,WA,Passenger,31,51,82,57013,57095,0.14
6127,January,2018,Benton,WA,Passenger,175,179,354,130623,130977,0.27
6128,January,2018,Pinal,AZ,Passenger,2,0,2,210,212,0.94
6129,January,2018,Jefferson,NY,Passenger,1,0,1,228,229,0.44
6130,January,2018,Skamania,WA,Passenger,11,8,19,8608,8627,0.22
6131,January,2018,Okaloosa,FL,Passenger,1,0,1,179,180,0.56
6132,January,2018,Franklin,MA,Passenger,0,1,1,3,4,25.0
6133,January,2018,District of Columbia,DC,Passenger,0,3,3,198,201,1.49
6134,January,2018,King,WA,Passenger,11619,4878,16497,1370831,1387328,1.19
6135,January,2018,El Paso,CO,Passenger,2,0,2,762,764,0.26
6136,January,2018,Grant,WA,Truck,0,0,0,25641,25641,0.0
6137,January,2018,Pend Oreille,WA,Passenger,4,4,8,9441,9449,0.08
6138,January,2018,Mason,WA,Truck,0,0,0,19646,19646,0.0
6139,January,2018,Tuolumne,CA,Passenger,0,1,1,14,15,6.67
6140,January,2018,Shelby,TN,Passenger,0,1,1,104,105,0.95
6141,January,2018,Garfield,WA,Passenger,1,0,1,1329,1330,0.08
6142,January,2018,Snohomish,WA,Passenger,2073,1094,3167,518066,521233,0.61
6143,January,2018,Kittitas,WA,Passenger,36,27,63,28637,28700,0.22
6144,January,2018,Clark,NV,Passenger,1,2,3,746,749,0.4
6145,January,2018,Carroll,NH,Passenger,0,1,1,1,2,50.0
6146,January,2018,Pierce,WA,Passenger,1095,996,2091,527421,529512,0.39
6147,January,2018,Lewis,WA,Passenger,52,43,95,56805,56900,0.17
6148,January,2018,Volusia,FL,Passenger,0,1,1,34,35,2.86
6149,January,2018,Santa Rosa,FL,Passenger,1,0,1,102,103,0.97
6150,January,2018,Essex,NJ,Passenger,1,0,1,10,11,9.09
6151,January,2018,Richmond,GA,Passenger,0,1,1,93,94,1.06
6152,January,2018,Sumter,FL,Passenger,0,1,1,10,11,9.09
6153,January,2018,Santa Fe,NM,Passenger,0,1,1,44,45,2.22
6154,January,2018,Manassas,VA,Passenger,0,1,1,9,10,10.0
6155,January,2018,Orleans,LA,Passenger,0,1,1,46,47,2.13
6156,January,2018,Travis,TX,Passenger,0,1,1,185,186,0.54
6157,January,2018,Cook,IL,Passenger,1,0,1,284,285,0.35
6158,January,2018,Kitsap,WA,Truck,1,0,1,52751,52752,0.0
6159,January,2018,Morris,NJ,Passenger,1,0,1,20,21,4.76
6161,January,2018,Spokane,WA,Truck,1,0,1,91739,91740,0.0
6162,January,2018,Pacific,WA,Passenger,15,13,28,15453,15481,0.18
6163,January,2018,Twin Falls,ID,Passenger,0,1,1,23,24,4.17
6164,January,2018,Norfolk,VA,Passenger,1,1,2,316,318,0.63
6165,January,2018,Whatcom,WA,Truck,1,0,1,42070,42071,0.0
6166,January,2018,Bexar,TX,Passenger,1,2,3,813,816,0.37
6167,January,2018,Lumpkin,GA,Passenger,1,0,1,7,8,12.5
6168,January,2018,Wahkiakum,WA,Passenger,0,2,2,2844,2846,0.07
6169,January,2018,Dale,AL,Passenger,0,1,1,66,67,1.49
6170,January,2018,Chelan,WA,Truck,0,0,0,21676,21676,0.0
6171,January,2018,Prince George's,MD,Passenger,0,1,1,179,180,0.56
6172,January,2018,Jefferson,WA,Passenger,124,80,204,24352,24556,0.83
6173,January,2018,Monterey,CA,Passenger,0,2,2,195,197,1.02
6174,January,2018,Anne Arundel,MD,Passenger,0,1,1,471,472,0.21
6175,January,2018,Honolulu,HI,Passenger,2,2,4,555,559,0.72
6176,January,2018,Benton,WA,Truck,0,0,0,40708,40708,0.0
6177,January,2018,St. Clair,IL,Passenger,0,1,1,159,160,0.62
6178,January,2018,Skamania,WA,Truck,0,0,0,3900,3900,0.0
6179,January,2018,Queens,NY,Passenger,1,0,1,62,63,1.59
6180,January,2018,Portsmouth,VA,Passenger,0,1,1,71,72,1.39
6181,January,2018,Pima,AZ,Passenger,1,1,2,412,414,0.48
6182,January,2018,Klickitat,WA,Passenger,23,26,49,14933,14982,0.33
6183,January,2018,Norfolk,MA,Passenger,1,0,1,36,37,2.7
6184,January,2018,Asotin,WA,Passenger,8,5,13,12548,12561,0.1
6185,January,2018,Lane,OR,Passenger,0,1,1,201,202,0.5
6186,January,2018,Nantucket,MA,Passenger,1,0,1,3,4,25.0
6187,January,2018,Jefferson,WA,Truck,0,0,0,9485,9485,0.0
6188,January,2018,Missoula,MT,Passenger,1,0,1,68,69,1.45
6189,January,2018,Allegheny,PA,Passenger,1,0,1,83,84,1.19
6190,January,2018,Lincoln,WA,Truck,0,0,0,4504,4504,0.0
6191,January,2018,Stevens,WA,Truck,0,0,0,18391,18391,0.0
6192,January,2018,Stevens,WA,Passenger,10,22,32,31598,31630,0.1
6193,January,2018,Northampton,PA,Passenger,0,1,1,65,66,1.52
6194,January,2018,Frederick,MD,Passenger,0,1,1,90,91,1.1
6195,January,2018,Gwinnett,GA,Passenger,0,1,1,81,82,1.22
6196,January,2018,Arlington,VA,Passenger,1,2,3,172,175,1.71
6197,January,2018,Okanogan,WA,Passenger,7,19,26,25706,25732,0.1
6198,January,2018,Marin,CA,Passenger,1,0,1,56,57,1.75
6199,January,2018,Asotin,WA,Truck,0,0,0,6559,6559,0.0
6200,January,2018,Maricopa,AZ,Passenger,2,0,2,1621,1623,0.12
6201,January,2018,Franklin,OH,Passenger,0,1,1,110,111,0.9
6202,January,2018,Sangamon,IL,Passenger,1,0,1,11,12,8.33
6203,January,2018,Santa Clara,CA,Passenger,7,1,8,389,397,2.02
6204,January,2018,Thurston,WA,Passenger,487,407,894,190668,191562,0.47
6205,January,2018,Albemarle,VA,Passenger,0,1,1,30,31,3.23
6206,January,2018,Sedgwick,KS,Passenger,0,1,1,106,107,0.93
6207,January,2018,Adams,WA,Truck,0,0,0,5148,5148,0.0
6208,January,2018,Montgomery,TX,Passenger,1,0,1,61,62,1.61
6209,January,2018,Manatee,FL,Passenger,1,0,1,39,40,2.5
6210,January,2018,Riverside,CA,Passenger,1,2,3,731,734,0.41
6211,January,2018,Okanogan,WA,Truck,0,0,0,16333,16333,0.0
6212,January,2018,Wahkiakum,WA,Truck,0,0,0,1681,1681,0.0
6213,January,2018,Ferry,WA,Truck,0,0,0,3544,3544,0.0
6214,January,2018,Skagit,WA,Truck,1,0,1,31840,31841,0.0
6215,January,2018,Thurston,WA,Truck,0,0,0,53893,53893,0.0
6216,January,2018,Grays Harbor,WA,Truck,0,0,0,20089,20089,0.0
6217,January,2018,Richland,SC,Passenger,0,1,1,173,174,0.57
6218,January,2018,Alameda,CA,Passenger,0,1,1,358,359,0.28
6219,January,2018,New London,CT,Passenger,1,1,2,251,253,0.79
6220,January,2018,Kittitas,WA,Truck,0,0,0,13876,13876,0.0
6221,January,2018,Lewis,WA,Truck,0,0,0,25325,25325,0.0
6222,January,2018,Ferry,WA,Passenger,1,3,4,4408,4412,0.09
6223,January,2018,Howard,MD,Passenger,0,2,2,87,89,2.25
6224,January,2018,Duval,FL,Passenger,1,2,3,367,370,0.81
6225,January,2018,Hamilton,IN,Passenger,1,0,1,53,54,1.85
6226,January,2018,Moore,NC,Passenger,0,1,1,199,200,0.5
6227,January,2018,Sacramento,CA,Passenger,1,0,1,303,304,0.33
6228,January,2018,King,WA,Truck,8,1,9,184806,184815,0.0
6229,January,2018,San Diego,CA,Passenger,6,1,7,2567,2574,0.27
6230,January,2018,Brevard,FL,Passenger,0,1,1,102,103,0.97
6231,January,2018,Clark,WA,Passenger,873,599,1472,305301,306773,0.48
6232,January,2018,Contra Costa,CA,Passenger,0,1,1,469,470,0.21
6233,January,2018,Hawaii,HI,Passenger,1,0,1,79,80,1.25
6234,January,2018,Adams,WA,Passenger,4,4,8,12443,12451,0.06
6235,January,2018,New Haven,CT,Passenger,0,1,1,53,54,1.85
6236,January,2018,Pend Oreille,WA,Truck,0,0,0,5618,5618,0.0
6237,January,2018,DeKalb,GA,Passenger,1,0,1,84,85,1.18
6238,January,2018,Dakota,MN,Passenger,0,2,2,38,40,5.0
6239,January,2018,Grant,WA,Passenger,29,37,66,62283,62349,0.11
6240,January,2018,Fulton,GA,Passenger,1,0,1,106,107,0.93
6241,January,2018,Skagit,WA,Passenger,170,140,310,89781,90091,0.34
6242,January,2018,Cowlitz,WA,Truck,0,0,0,28201,28201,0.0
6243,January,2018,Whitman,WA,Passenger,18,20,38,22475,22513,0.17
6244,January,2018,Walla Walla,WA,Passenger,30,33,63,35373,35436,0.18
6245,January,2018,Dallas,TX,Passenger,0,1,1,186,187,0.53
6246,January,2018,Latah,ID,Passenger,0,1,1,76,77,1.3
6247,January,2018,Utah,UT,Passenger,0,1,1,135,136,0.74
6248,January,2018,El Paso,TX,Passenger,1,0,1,520,521,0.19
6249,January,2018,Flathead,MT,Passenger,1,0,1,52,53,1.89
6250,January,2018,Island,WA,Truck,0,0,0,20786,20786,0.0
6251,January,2018,San Mateo,CA,Passenger,0,1,1,142,143,0.7
6252,January,2018,Yakima,WA,Passenger,60,76,136,162512,162648,0.08
6253,January,2018,Cape May,NJ,Passenger,0,1,1,22,23,4.35
6254,January,2018,Mason,WA,Passenger,65,77,142,44977,45119,0.31
6255,January,2018,Hamilton,TN,Passenger,1,0,1,21,22,4.55
6256,January,2018,Douglas,WA,Truck,0,0,0,11790,11790,0.0
6257,January,2018,Charles,MD,Passenger,0,1,1,82,83,1.2
6258,January,2018,Nueces,TX,Passenger,1,1,2,95,97,2.06
6259,January,2018,Los Angeles,CA,Passenger,5,3,8,1195,1203,0.67
6260,January,2018,Yakima,WA,Truck,0,0,0,58106,58106,0.0
6261,January,2018,Ventura,CA,Passenger,0,1,1,327,328,0.3
6262,January,2018,Montgomery,TN,Passenger,1,0,1,270,271,0.37
6263,January,2018,Saratoga,NY,Passenger,1,1,2,68,70,2.86
6264,January,2018,Pierce,WA,Truck,0,0,0,137147,137147,0.0
6265,January,2018,Lincoln,WA,Passenger,2,5,7,7587,7594,0.09
6266,January,2018,Kitsap,WA,Passenger,706,402,1108,176404,177512,0.62
6267,January,2018,Snohomish,WA,Truck,1,0,1,121550,121551,0.0
6268,January,2018,Columbia,WA,Truck,0,0,0,1545,1545,0.0
6269,January,2018,Grays Harbor,WA,Passenger,42,42,84,45972,46056,0.18
6270,January,2018,San Juan,WA,Passenger,137,46,183,13927,14110,1.3
6271,January,2018,DuPage,IL,Passenger,1,0,1,64,65,1.54
6272,January,2018,Maui,HI,Passenger,1,0,1,66,67,1.49
6273,January,2018,Clay,FL,Passenger,0,1,1,106,107,0.93
6274,January,2018,Kent,MI,Passenger,0,1,1,35,36,2.78
6275,January,2018,Tarrant,TX,Passenger,1,0,1,224,225,0.44
6276,January,2018,Ada,ID,Passenger,0,1,1,348,349,0.29
6277,January,2018,Whitman,WA,Truck,0,0,0,8472,8472,0.0
6278,January,2018,Clallam,WA,Passenger,106,95,201,49281,49482,0.41
6279,January,2018,Lee,AL,Passenger,1,0,1,35,36,2.78
6280,January,2018,Whatcom,WA,Passenger,548,238,786,145510,146296,0.54
6281,January,2018,Virginia Beach,VA,Passenger,2,1,3,673,676,0.44
6282,January,2018,Chelan,WA,Passenger,94,38,132,53236,53368,0.25
6283,January,2018,Douglas,WA,Passenger,43,33,76,27223,27299,0.28
6284,January,2018,Orange,CA,Passenger,3,1,4,565,569,0.7
6285,January,2018,St. Lucie,FL,Passenger,1,0,1,27,28,3.57
6286,January,2018,Prince William,VA,Passenger,0,4,4,268,272,1.47
6287,January,2018,Ramsey,MN,Passenger,1,0,1,39,40,2.5
6288,January,2018,Clallam,WA,Truck,0,0,0,21280,21280,0.0
6289,January,2018,Juneau,AK,Passenger,0,1,1,44,45,2.22
6290,January,2018,Orange,FL,Passenger,2,1,3,166,169,1.78
6291,January,2018,Pacific,WA,Truck,0,0,0,7534,7534,0.0
6292,January,2018,Nassau,NY,Passenger,1,0,1,37,38,2.63
6293,January,2018,Montgomery,MD,Passenger,1,0,1,298,299,0.33
6294,January,2018,Island,WA,Passenger,159,167,326,61838,62164,0.52
6295,January,2018,Prince George,VA,Passenger,0,1,1,74,75,1.33
6296,January,2018,Columbia,WA,Passenger,2,1,3,2401,2404,0.12
6297,January,2018,San Juan,WA,Truck,0,0,0,5644,5644,0.0
6298,January,2018,Deschutes,OR,Passenger,1,0,1,178,179,0.56
6299,January,2018,Montgomery,PA,Passenger,1,0,1,34,35,2.86
6300,January,2018,Madison,ID,Passenger,1,0,1,39,40,2.5
6301,January,2018,Franklin,WA,Truck,0,0,0,18563,18563,0.0
6302,January,2018,DeKalb,IN,Passenger,1,0,1,1,2,50.0
6303,January,2019,Portsmouth,VA,Passenger,0,1,1,80,81,1.23
6304,January,2019,San Juan,WA,Truck,0,0,0,5802,5802,0.0
6305,January,2019,Ferry,WA,Passenger,3,2,5,4388,4393,0.11
6306,January,2019,Okanogan,WA,Truck,0,0,0,16477,16477,0.0
6307,January,2019,Ventura,CA,Passenger,0,2,2,314,316,0.63
6308,January,2019,Stevens,WA,Truck,0,0,0,18768,18768,0.0
6309,January,2019,Island,WA,Truck,0,0,0,21211,21211,0.0
6310,January,2019,Jefferson,CO,Passenger,0,2,2,61,63,3.17
6311,January,2019,Charles,MD,Passenger,0,1,1,75,76,1.32
6312,January,2019,Montgomery,AL,Passenger,0,1,1,45,46,2.17
6313,January,2019,Marion,IN,Passenger,1,0,1,117,118,0.85
6314,January,2019,San Juan,PR,Passenger,0,1,1,5,6,16.67
6315,January,2019,Adams,WA,Truck,0,0,0,5142,5142,0.0
6316,January,2019,King,WA,Truck,6,1,7,182396,182403,0.0
6317,January,2019,Cowlitz,WA,Truck,0,0,0,28728,28728,0.0
6318,January,2019,Honolulu,HI,Passenger,1,3,4,517,521,0.77
6319,January,2019,Harnett,NC,Passenger,1,0,1,221,222,0.45
6320,January,2019,Lee,FL,Passenger,1,0,1,52,53,1.89
6321,January,2019,Pacific,WA,Truck,0,0,0,7615,7615,0.0
6322,January,2019,Albemarle,VA,Passenger,1,0,1,24,25,4.0
6323,January,2019,Duval,FL,Passenger,1,2,3,382,385,0.78
6324,January,2019,Asotin,WA,Truck,0,0,0,6645,6645,0.0
6325,January,2019,Hawaii,HI,Passenger,1,0,1,60,61,1.64
6326,January,2019,DeKalb,IN,Passenger,1,0,1,1,2,50.0
6327,January,2019,Klamath,OR,Passenger,1,0,1,37,38,2.63
6328,January,2019,Grant,WA,Passenger,33,53,86,64365,64451,0.13
6329,January,2019,Cowlitz,WA,Passenger,79,96,175,72557,72732,0.24
6330,January,2019,Adams,WA,Passenger,5,6,11,12742,12753,0.09
6331,January,2019,Clark,WA,Passenger,1313,868,2181,312092,314273,0.69
6332,January,2019,Carson City,NV,Passenger,1,0,1,14,15,6.67
6333,January,2019,Franklin,WA,Passenger,49,68,117,59324,59441,0.2
6334,January,2019,Hennepin,MN,Passenger,2,0,2,106,108,1.85
6335,January,2019,Wahkiakum,WA,Passenger,1,1,2,3006,3008,0.07
6336,January,2019,Guadalupe,TX,Passenger,1,0,1,78,79,1.27
6337,January,2019,Franklin,WA,Truck,0,0,0,19128,19128,0.0
6338,January,2019,DuPage,IL,Passenger,1,0,1,60,61,1.64
6339,January,2019,Lumpkin,GA,Passenger,1,0,1,6,7,14.29
6340,January,2019,Bergen,NJ,Passenger,1,0,1,27,28,3.57
6341,January,2019,Benton,WA,Passenger,232,243,475,133224,133699,0.36
6342,January,2019,Nassau,NY,Passenger,3,0,3,36,39,7.69
6343,January,2019,Pend Oreille,WA,Passenger,5,5,10,9538,9548,0.1
6344,January,2019,Columbia,WA,Passenger,2,2,4,2423,2427,0.16
6345,January,2019,Asotin,WA,Passenger,12,9,21,12729,12750,0.16
6346,January,2019,Kootenai,ID,Passenger,1,1,2,214,216,0.93
6347,January,2019,El Paso,TX,Passenger,2,0,2,501,503,0.4
6348,January,2019,Walla Walla,WA,Passenger,42,54,96,36138,36234,0.26
6349,January,2019,Calvert,MD,Passenger,0,1,1,88,89,1.12
6350,January,2019,Kent,MI,Passenger,0,1,1,23,24,4.17
6351,January,2019,Oldham,KY,Passenger,0,1,1,5,6,16.67
6352,January,2019,Middlesex,MA,Passenger,1,1,2,121,123,1.63
6353,January,2019,Snohomish,WA,Passenger,3075,1488,4563,528288,532851,0.86
6354,January,2019,Clallam,WA,Truck,0,0,0,21632,21632,0.0
6355,January,2019,Travis,TX,Passenger,2,1,3,200,203,1.48
6356,January,2019,Allegheny,PA,Passenger,1,0,1,85,86,1.16
6357,January,2019,Kittitas,WA,Passenger,69,36,105,29465,29570,0.36
6358,January,2019,Pima,AZ,Passenger,1,1,2,403,405,0.49
6359,January,2019,Alameda,CA,Passenger,0,2,2,316,318,0.63
6360,January,2019,Clark,WA,Truck,0,0,0,79967,79967,0.0
6361,January,2019,Whitman,WA,Passenger,24,40,64,22845,22909,0.28
6362,January,2019,Pend Oreille,WA,Truck,0,0,0,5743,5743,0.0
6363,January,2019,Frederick,MD,Passenger,0,1,1,80,81,1.23
6364,January,2019,Manatee,FL,Passenger,1,0,1,36,37,2.7
6365,January,2019,Collin,TX,Passenger,1,1,2,143,145,1.38
6366,January,2019,Clallam,WA,Passenger,152,128,280,50402,50682,0.55
6367,January,2019,Klickitat,WA,Truck,0,0,0,8228,8228,0.0
6368,January,2019,Monroe,IL,Passenger,1,0,1,4,5,20.0
6369,January,2019,Nueces,TX,Passenger,1,1,2,90,92,2.17
6370,January,2019,Palm Beach,FL,Passenger,0,1,1,91,92,1.09
6371,January,2019,Maricopa,AZ,Passenger,5,2,7,1551,1558,0.45
6372,January,2019,Grays Harbor,WA,Truck,0,0,0,20319,20319,0.0
6373,January,2019,Caddo,LA,Passenger,0,1,1,21,22,4.55
6374,January,2019,Grant,WA,Truck,0,0,0,26324,26324,0.0
6375,January,2019,Pinal,AZ,Passenger,2,0,2,203,205,0.98
6376,January,2019,Benton,WA,Truck,0,0,0,41617,41617,0.0
6377,January,2019,Yakima,WA,Passenger,84,100,184,164930,165114,0.11
6378,January,2019,Klickitat,WA,Passenger,29,32,61,15485,15546,0.39
6379,January,2019,Cook,IL,Passenger,1,0,1,245,246,0.41
6380,January,2019,Chelan,WA,Truck,0,0,0,22107,22107,0.0
6381,January,2019,Fulton,GA,Passenger,1,2,3,107,110,2.73
6382,January,2019,Mason,WA,Truck,0,0,0,20224,20224,0.0
6383,January,2019,Snohomish,WA,Truck,1,0,1,122005,122006,0.0
6384,January,2019,Montgomery,PA,Passenger,2,0,2,35,37,5.41
6385,January,2019,Sangamon,IL,Passenger,1,0,1,8,9,11.11
6386,January,2019,Carroll,NH,Passenger,0,1,1,1,2,50.0
6387,January,2019,Kern,CA,Passenger,0,1,1,232,233,0.43
6388,January,2019,Penobscot,ME,Passenger,0,1,1,12,13,7.69
6389,January,2019,San Diego,CA,Passenger,9,2,11,2582,2593,0.42
6390,January,2019,Dale,AL,Passenger,0,1,1,56,57,1.75
6391,January,2019,Island,WA,Passenger,288,229,517,63253,63770,0.81
6392,January,2019,Lewis,WA,Truck,0,0,0,25661,25661,0.0
6393,January,2019,Bexar,TX,Passenger,3,4,7,706,713,0.98
6394,January,2019,Norfolk,MA,Passenger,1,0,1,36,37,2.7
6395,January,2019,Santa Rosa,FL,Passenger,1,0,1,89,90,1.11
6396,January,2019,Houston,GA,Passenger,1,0,1,51,52,1.92
6397,January,2019,El Paso,CO,Passenger,3,1,4,761,765,0.52
6398,January,2019,Clackamas,OR,Passenger,1,1,2,212,214,0.93
6399,January,2019,Walla Walla,WA,Truck,0,0,0,13535,13535,0.0
6400,January,2019,Jefferson,WA,Truck,0,0,0,9619,9619,0.0
6401,January,2019,Saratoga,NY,Passenger,1,0,1,61,62,1.61
6402,January,2019,Lee,AL,Passenger,1,0,1,35,36,2.78
6403,January,2019,Multnomah,OR,Passenger,3,5,8,768,776,1.03
6404,January,2019,Kittitas,WA,Truck,0,0,0,14237,14237,0.0
6405,January,2019,Skagit,WA,Truck,1,0,1,32319,32320,0.0
6406,January,2019,Richland,SC,Passenger,0,1,1,163,164,0.61
6407,January,2019,Okanogan,WA,Passenger,18,21,39,26053,26092,0.15
6408,January,2019,Clark,NV,Passenger,2,2,4,719,723,0.55
6409,January,2019,Santa Fe,NM,Passenger,0,1,1,41,42,2.38
6410,January,2019,Madison,ID,Passenger,1,0,1,36,37,2.7
6411,January,2019,Goochland,VA,Passenger,0,1,1,245,246,0.41
6412,January,2019,Sumter,FL,Passenger,0,1,1,10,11,9.09
6413,January,2019,Santa Clara,CA,Passenger,8,1,9,370,379,2.37
6414,January,2019,Flathead,MT,Passenger,1,0,1,59,60,1.67
6415,January,2019,Denver,CO,Passenger,1,0,1,130,131,0.76
6416,January,2019,Moore,NC,Passenger,0,1,1,187,188,0.53
6417,January,2019,Santa Cruz,CA,Passenger,1,0,1,42,43,2.33
6418,January,2019,Camden,NJ,Passenger,0,1,1,27,28,3.57
6419,January,2019,Gwinnett,GA,Passenger,0,1,1,75,76,1.32
6420,January,2019,DeKalb,GA,Passenger,1,0,1,77,78,1.28
6421,January,2019,Juneau,AK,Passenger,0,1,1,39,40,2.5
6422,January,2019,Whatcom,WA,Truck,2,0,2,42739,42741,0.0
6423,January,2019,Ramsey,MN,Passenger,1,0,1,38,39,2.56
6424,January,2019,Alexandria,VA,Passenger,1,0,1,163,164,0.61
6425,January,2019,Norfolk,VA,Passenger,2,2,4,340,344,1.16
6426,January,2019,Skamania,WA,Passenger,18,15,33,8741,8774,0.38
6427,January,2019,Larimer,CO,Passenger,1,0,1,58,59,1.69
6428,January,2019,District of Columbia,DC,Passenger,1,3,4,203,207,1.93
6429,January,2019,Jefferson,WA,Passenger,175,112,287,24852,25139,1.14
6430,January,2019,Kitsap,WA,Passenger,981,556,1537,179937,181474,0.85
6432,January,2019,Twin Falls,ID,Passenger,0,1,1,20,21,4.76
6433,January,2019,Deschutes,OR,Passenger,2,0,2,164,166,1.2
6434,January,2019,St. Mary's,MD,Passenger,1,0,1,211,212,0.47
6435,January,2019,Thurston,WA,Passenger,771,590,1361,196046,197407,0.69
6436,January,2019,Shasta,CA,Passenger,1,0,1,43,44,2.27
6437,January,2019,New Haven,CT,Passenger,0,1,1,49,50,2.0
6438,January,2019,Whatcom,WA,Passenger,778,375,1153,149711,150864,0.76
6439,January,2019,Garfield,WA,Passenger,1,1,2,1332,1334,0.15
6440,January,2019,Columbia,WA,Truck,0,0,0,1529,1529,0.0
6441,January,2019,Valencia,NM,Passenger,1,0,1,9,10,10.0
6442,January,2019,Richmond,GA,Passenger,0,1,1,90,91,1.1
6443,January,2019,Pierce,WA,Truck,0,0,0,139124,139124,0.0
6444,January,2019,Howard,MD,Passenger,0,1,1,82,83,1.2
6445,January,2019,Los Angeles,CA,Passenger,7,5,12,1096,1108,1.08
6446,January,2019,Douglas,NE,Passenger,0,1,1,67,68,1.47
6447,January,2019,Montgomery,MD,Passenger,1,0,1,276,277,0.36
6448,January,2019,Garfield,OK,Passenger,1,0,1,13,14,7.14
6449,January,2019,Maui,HI,Passenger,1,0,1,50,51,1.96
6450,January,2019,Charleston,SC,Passenger,1,0,1,122,123,0.81
6451,January,2019,Broward,FL,Passenger,2,1,3,128,131,2.29
6452,January,2019,Douglas,WA,Passenger,51,35,86,28011,28097,0.31
6453,January,2019,Skamania,WA,Truck,0,0,0,4008,4008,0.0
6454,January,2019,Thurston,WA,Truck,0,0,0,54922,54922,0.0
6455,January,2019,San Francisco,CA,Passenger,2,1,3,114,117,2.56
6456,January,2019,Mecklenburg,NC,Passenger,1,0,1,80,81,1.23
6457,January,2019,Fresno,CA,Passenger,1,0,1,187,188,0.53
6458,January,2019,Tuolumne,CA,Passenger,0,1,1,12,13,7.69
6459,January,2019,Washoe,NV,Passenger,2,0,2,107,109,1.83
6460,January,2019,Volusia,FL,Passenger,0,1,1,37,38,2.63
6461,January,2019,Beaufort,SC,Passenger,1,0,1,36,37,2.7
6462,January,2019,Cape May,NJ,Passenger,0,1,1,20,21,4.76
6463,January,2019,Williamson,TX,Passenger,0,1,1,149,150,0.67
6464,January,2019,Mason,WA,Passenger,108,115,223,46659,46882,0.48
6465,January,2019,Montgomery,TX,Passenger,2,0,2,60,62,3.23
6466,January,2019,Rogers,OK,Passenger,1,0,1,5,6,16.67
6467,January,2019,Chelan,WA,Passenger,140,64,204,54205,54409,0.37
6468,January,2019,Washington,OR,Passenger,0,1,1,471,472,0.21
6469,January,2019,Pierce,WA,Passenger,1581,1423,3004,539770,542774,0.55
6470,January,2019,Jefferson,NY,Passenger,0,1,1,229,230,0.43
6471,January,2019,Douglas,WA,Truck,0,0,0,12172,12172,0.0
6472,January,2019,Anne Arundel,MD,Passenger,0,2,2,450,452,0.44
6473,January,2019,Contra Costa,CA,Passenger,1,2,3,405,408,0.74
6474,January,2019,Sedgwick,KS,Passenger,0,1,1,99,100,1.0
6475,January,2019,Washtenaw,MI,Passenger,1,0,1,39,40,2.5
6476,January,2019,Dakota,MN,Passenger,0,2,2,33,35,5.71
6477,January,2019,Wahkiakum,WA,Truck,0,0,0,1711,1711,0.0
6478,January,2019,Tulsa,OK,Passenger,1,1,2,48,50,4.0
6479,January,2019,Stevens,WA,Passenger,18,28,46,31816,31862,0.14
6480,January,2019,Skagit,WA,Passenger,270,186,456,91360,91816,0.5
6481,January,2019,Ada,ID,Passenger,0,2,2,310,312,0.64
6482,January,2019,Lincoln,WA,Passenger,2,5,7,7755,7762,0.09
6483,January,2019,Prince George's,MD,Passenger,1,1,2,183,185,1.08
6484,January,2019,Spokane,WA,Passenger,471,380,851,307611,308462,0.28
6485,January,2019,Whitman,WA,Truck,0,0,0,8512,8512,0.0
6486,January,2019,Garfield,WA,Truck,0,0,0,962,962,0.0
6487,January,2019,Spartanburg,SC,Passenger,0,1,1,33,34,2.94
6488,January,2019,Ferry,WA,Truck,0,0,0,3590,3590,0.0
6489,January,2019,San Mateo,CA,Passenger,2,1,3,126,129,2.33
6490,January,2019,Spokane,WA,Truck,1,0,1,93943,93944,0.0
6491,January,2019,Orange,CA,Passenger,5,2,7,538,545,1.28
6492,January,2019,Kitsap,WA,Truck,1,0,1,53730,53731,0.0
6493,January,2019,Harris,TX,Passenger,0,1,1,254,255,0.39
6494,January,2019,Prince William,VA,Passenger,0,4,4,256,260,1.54
6495,January,2019,Virginia Beach,VA,Passenger,2,1,3,698,701,0.43
6496,January,2019,Tarrant,TX,Passenger,1,0,1,203,204,0.49
6497,January,2019,Marion,OR,Passenger,1,0,1,117,118,0.85
6498,January,2019,Polk,FL,Passenger,1,0,1,66,67,1.49
6499,January,2019,New London,CT,Passenger,0,2,2,248,250,0.8
6500,January,2019,Lincoln,WA,Truck,0,0,0,4666,4666,0.0
6501,January,2019,Pacific,WA,Passenger,22,26,48,15882,15930,0.3
6502,January,2019,San Juan,WA,Passenger,190,68,258,14255,14513,1.78
6503,January,2019,Lewis,WA,Passenger,95,82,177,58367,58544,0.3
6504,January,2019,King,WA,Passenger,17167,6678,23845,1381057,1404902,1.7
6505,January,2019,Fairfax,VA,Passenger,3,2,5,801,806,0.62
6506,January,2019,Yakima,WA,Truck,0,0,0,58929,58929,0.0
6507,January,2019,Franklin,MA,Passenger,0,1,1,1,2,50.0
6508,January,2019,Nantucket,MA,Passenger,1,0,1,4,5,20.0
6509,January,2019,Clay,FL,Passenger,0,1,1,86,87,1.15
6510,January,2019,Arlington,VA,Passenger,1,2,3,162,165,1.82
6511,January,2019,Grays Harbor,WA,Passenger,67,76,143,47449,47592,0.3
6512,January,2019,Manassas,VA,Passenger,0,1,1,9,10,10.0
6513,January,2019,Cumberland,NC,Passenger,0,2,2,522,524,0.38
6514,January,2019,Brevard,FL,Passenger,0,1,1,90,91,1.1
6515,January,2019,Cochise,AZ,Passenger,0,1,1,118,119,0.84
6516,January,2019,Suffolk,MA,Passenger,0,1,1,40,41,2.44
6517,January,2019,Riverside,CA,Passenger,2,2,4,669,673,0.59
6518,January,2019,Bucks,PA,Passenger,1,0,1,16,17,5.88
6519,January,2019,Shelby,TN,Passenger,0,1,1,96,97,1.03
6520,January,2019,Hardin,KY,Passenger,0,1,1,104,105,0.95
6521,January,2019,Randolph,NC,Passenger,1,0,1,6,7,14.29
6522,January,2019,St. Lucie,FL,Passenger,1,0,1,30,31,3.23
6523,January,2019,St. Clair,IL,Passenger,0,1,1,167,168,0.6
6524,January,2020,Los Angeles,CA,Passenger,8,11,19,1058,1077,1.76
6525,January,2020,Charles,MD,Passenger,0,1,1,80,81,1.23
6526,January,2020,Washington,OR,Passenger,1,0,1,457,458,0.22
6527,January,2020,Carroll,NH,Passenger,0,1,1,4,5,20.0
6528,January,2020,Rogers,OK,Passenger,1,0,1,5,6,16.67
6529,January,2020,Riverside,CA,Passenger,4,1,5,641,646,0.77
6530,January,2020,Prince George's,MD,Passenger,1,1,2,172,174,1.15
6531,January,2020,Bexar,TX,Passenger,2,5,7,639,646,1.08
6532,January,2020,San Diego,CA,Passenger,10,5,15,2781,2796,0.54
6533,January,2020,Snohomish,WA,Truck,0,0,0,123641,123641,0.0
6534,January,2020,Douglas,NE,Passenger,0,1,1,56,57,1.75
6535,January,2020,Whitman,WA,Passenger,42,48,90,22664,22754,0.4
6536,January,2020,Okanogan,WA,Passenger,32,30,62,26220,26282,0.24
6537,January,2020,Frederick,MD,Passenger,1,1,2,81,83,2.41
6538,January,2020,Fort Bend,TX,Passenger,1,0,1,49,50,2.0
6539,January,2020,Lake,FL,Passenger,1,0,1,21,22,4.55
6540,January,2020,Sedgwick,KS,Passenger,1,1,2,95,97,2.06
6541,January,2020,Maricopa,AZ,Passenger,7,6,13,1484,1497,0.87
6542,January,2020,Santa Cruz,CA,Passenger,1,0,1,34,35,2.86
6543,January,2020,Grays Harbor,WA,Passenger,105,105,210,48505,48715,0.43
6544,January,2020,Oldham,KY,Passenger,0,1,1,4,5,20.0
6545,January,2020,Greene,MO,Passenger,0,1,1,30,31,3.23
6546,January,2020,Calvert,MD,Passenger,0,2,2,91,93,2.15
6547,January,2020,Whatcom,WA,Passenger,1032,486,1518,151794,153312,0.99
6548,January,2020,Walla Walla,WA,Truck,0,0,0,13710,13710,0.0
6549,January,2020,Rockingham,NH,Passenger,1,0,1,28,29,3.45
6550,January,2020,Ada,ID,Passenger,0,1,1,288,289,0.35
6551,January,2020,Alameda,CA,Passenger,4,1,5,285,290,1.72
6552,January,2020,Montgomery,OH,Passenger,0,1,1,50,51,1.96
6553,January,2020,Chelan,WA,Truck,0,0,0,22573,22573,0.0
6554,January,2020,Clackamas,OR,Passenger,2,1,3,210,213,1.41
6555,January,2020,Williamson,TX,Passenger,0,2,2,146,148,1.35
6556,January,2020,Portsmouth,VA,Passenger,0,1,1,80,81,1.23
6557,January,2020,Monroe,IL,Passenger,1,0,1,4,5,20.0
6558,January,2020,Lee,FL,Passenger,1,0,1,52,53,1.89
6559,January,2020,Stevens,WA,Truck,0,0,0,18790,18790,0.0
6560,January,2020,Larimer,CO,Passenger,1,0,1,56,57,1.75
6561,January,2020,Garfield,WA,Passenger,0,1,1,1321,1322,0.08
6562,January,2020,Stafford,VA,Passenger,1,1,2,93,95,2.11
6563,January,2020,Brevard,FL,Passenger,0,1,1,87,88,1.14
6564,January,2020,Chelan,WA,Passenger,213,77,290,54617,54907,0.53
6565,January,2020,Wahkiakum,WA,Passenger,4,5,9,3034,3043,0.3
6566,January,2020,Benton,WA,Passenger,337,315,652,135323,135975,0.48
6567,January,2020,DeKalb,IN,Passenger,1,0,1,1,2,50.0
6568,January,2020,Pend Oreille,WA,Passenger,8,7,15,9470,9485,0.16
6569,January,2020,King,WA,Passenger,23196,7620,30816,1399178,1429994,2.15
6570,January,2020,Owyhee,ID,Passenger,1,0,1,3,4,25.0
6571,January,2020,Hennepin,MN,Passenger,3,1,4,101,105,3.81
6572,January,2020,Tarrant,TX,Passenger,2,0,2,187,189,1.06
6573,January,2020,Travis,TX,Passenger,2,1,3,191,194,1.55
6574,January,2020,Cascade,MT,Passenger,0,1,1,56,57,1.75
6575,January,2020,Island,WA,Truck,1,0,1,21354,21355,0.0
6576,January,2020,Montgomery,AL,Passenger,0,1,1,39,40,2.5
6577,January,2020,Nueces,TX,Passenger,1,0,1,84,85,1.18
6578,January,2020,Mason,WA,Passenger,150,135,285,47624,47909,0.59
6579,January,2020,Douglas,WA,Passenger,69,39,108,28367,28475,0.38
6580,January,2020,Manassas,VA,Passenger,0,1,1,6,7,14.29
6581,January,2020,Suffolk,MA,Passenger,0,1,1,36,37,2.7
6582,January,2020,Maui,HI,Passenger,1,0,1,38,39,2.56
6583,January,2020,Juneau,AK,Passenger,0,2,2,30,32,6.25
6584,January,2020,Clay,FL,Passenger,0,1,1,87,88,1.14
6585,January,2020,Harrison,MS,Passenger,1,0,1,59,60,1.67
6586,January,2020,Harnett,NC,Passenger,1,1,2,205,207,0.97
6587,January,2020,Placer,CA,Passenger,1,0,1,93,94,1.06
6588,January,2020,Klickitat,WA,Passenger,48,39,87,15683,15770,0.55
6589,January,2020,Pacific,WA,Truck,0,0,0,7748,7748,0.0
6590,January,2020,Hawaii,HI,Passenger,1,0,1,61,62,1.61
6591,January,2020,Skagit,WA,Passenger,378,215,593,92622,93215,0.64
6592,January,2020,Washtenaw,MI,Passenger,1,0,1,41,42,2.38
6593,January,2020,Pinellas,FL,Passenger,1,1,2,110,112,1.79
6594,January,2020,Charleston,SC,Passenger,1,0,1,110,111,0.9
6595,January,2020,Fairbanks North Star,AK,Passenger,0,1,1,101,102,0.98
6596,January,2020,Columbia,WA,Truck,0,0,0,1534,1534,0.0
6597,January,2020,DuPage,IL,Passenger,3,0,3,63,66,4.55
6598,January,2020,Skagit,WA,Truck,1,0,1,32593,32594,0.0
6599,January,2020,Spokane,WA,Truck,1,0,1,96899,96900,0.0
6600,January,2020,Clark,NV,Passenger,3,2,5,688,693,0.72
6601,January,2020,Washoe,NV,Passenger,1,0,1,107,108,0.93
6602,January,2020,Klamath,OR,Passenger,1,0,1,36,37,2.7
6603,January,2020,Queens,NY,Passenger,1,0,1,52,53,1.89
6604,January,2020,Loudoun,VA,Passenger,1,0,1,91,92,1.09
6605,January,2020,Bucks,PA,Passenger,1,0,1,19,20,5.0
6606,January,2020,Thurston,WA,Truck,0,0,0,55762,55762,0.0
6607,January,2020,Clark,WA,Passenger,1940,1054,2994,319981,322975,0.93
6608,January,2020,Fulton,GA,Passenger,1,2,3,105,108,2.78
6609,January,2020,Sacramento,CA,Passenger,1,0,1,284,285,0.35
6610,January,2020,Tulsa,OK,Passenger,1,1,2,48,50,4.0
6611,January,2020,Solano,CA,Passenger,1,0,1,208,209,0.48
6612,January,2020,Hudson,NJ,Passenger,1,0,1,39,40,2.5
6613,January,2020,Osceola,FL,Passenger,1,0,1,41,42,2.38
6614,January,2020,Clallam,WA,Truck,1,0,1,21855,21856,0.0
6615,January,2020,Grant,WA,Passenger,58,71,129,65624,65753,0.2
6616,January,2020,Denton,TX,Passenger,1,0,1,87,88,1.14
6617,January,2020,Lincoln,WA,Passenger,1,11,12,7787,7799,0.15
6618,January,2020,Pima,AZ,Passenger,3,1,4,367,371,1.08
6619,January,2020,King,WA,Truck,6,1,7,182654,182661,0.0
6620,January,2020,Yakima,WA,Passenger,120,115,235,166247,166482,0.14
6621,January,2020,Fairfax,VA,Passenger,4,2,6,755,761,0.79
6622,January,2020,Whatcom,WA,Truck,3,0,3,43229,43232,0.01
6623,January,2020,Pend Oreille,WA,Truck,0,0,0,5778,5778,0.0
6624,January,2020,Kittitas,WA,Passenger,93,47,140,30081,30221,0.46
6625,January,2020,Grays Harbor,WA,Truck,0,0,0,20827,20827,0.0
6626,January,2020,Palm Beach,FL,Passenger,0,1,1,85,86,1.16
6627,January,2020,Norfolk,VA,Passenger,2,2,4,353,357,1.12
6628,January,2020,Berkshire,MA,Passenger,0,1,1,5,6,16.67
6629,January,2020,Dakota,MN,Passenger,0,1,1,33,34,2.94
6630,January,2020,Jefferson,CO,Passenger,0,2,2,58,60,3.33
6631,January,2020,Virginia Beach,VA,Passenger,1,0,1,696,697,0.14
6632,January,2020,Moore,NC,Passenger,0,1,1,164,165,0.61
6633,January,2020,Ramsey,MN,Passenger,1,0,1,39,40,2.5
6634,January,2020,Anne Arundel,MD,Passenger,1,2,3,432,435,0.69
6636,January,2020,Prince William,VA,Passenger,2,3,5,233,238,2.1
6637,January,2020,Kootenai,ID,Passenger,1,1,2,232,234,0.85
6638,January,2020,Cochise,AZ,Passenger,0,1,1,103,104,0.96
6639,January,2020,Pierce,WA,Passenger,2229,1679,3908,550655,554563,0.7
6640,January,2020,Twin Falls,ID,Passenger,0,1,1,28,29,3.45
6641,January,2020,Kitsap,WA,Passenger,1258,656,1914,182446,184360,1.04
6642,January,2020,Arlington,VA,Passenger,0,2,2,152,154,1.3
6643,January,2020,Thurston,WA,Passenger,1093,719,1812,199295,201107,0.9
6644,January,2020,Columbia,WA,Passenger,3,3,6,2447,2453,0.24
6645,January,2020,Albemarle,VA,Passenger,1,0,1,25,26,3.85
6646,January,2020,Tuolumne,CA,Passenger,0,1,1,11,12,8.33
6647,January,2020,Guadalupe,TX,Passenger,1,0,1,67,68,1.47
6648,January,2020,Asotin,WA,Passenger,17,11,28,12723,12751,0.22
6649,January,2020,Garfield,WA,Truck,0,0,0,969,969,0.0
6650,January,2020,Arapahoe,CO,Passenger,1,0,1,142,143,0.7
6651,January,2020,Island,WA,Passenger,392,257,649,63598,64247,1.01
6652,January,2020,Pacific,WA,Passenger,30,31,61,16096,16157,0.38
6653,January,2020,San Mateo,CA,Passenger,1,1,2,116,118,1.69
6654,January,2020,Houston,GA,Passenger,1,0,1,60,61,1.64
6655,January,2020,Polk,FL,Passenger,1,0,1,65,66,1.52
6656,January,2020,Randolph,NC,Passenger,1,0,1,7,8,12.5
6657,January,2020,Franklin,WA,Passenger,57,76,133,61093,61226,0.22
6658,January,2020,Honolulu,HI,Passenger,4,2,6,476,482,1.24
6659,January,2020,Yakima,WA,Truck,0,0,0,59638,59638,0.0
6660,January,2020,Ferry,WA,Passenger,5,2,7,4381,4388,0.16
6661,January,2020,Clallam,WA,Passenger,203,163,366,50913,51279,0.71
6662,January,2020,DeKalb,GA,Passenger,1,0,1,83,84,1.19
6663,January,2020,San Juan,WA,Truck,0,0,0,5928,5928,0.0
6664,January,2020,Wilson,TX,Passenger,0,1,1,7,8,12.5
6665,January,2020,Penobscot,ME,Passenger,0,1,1,14,15,6.67
6666,January,2020,Alexandria,VA,Passenger,1,0,1,147,148,0.68
6667,January,2020,Skamania,WA,Truck,0,0,0,4106,4106,0.0
6668,January,2020,Shasta,CA,Passenger,1,0,1,35,36,2.78
6669,January,2020,Sarasota,FL,Passenger,2,0,2,26,28,7.14
6670,January,2020,Wayne,MI,Passenger,0,1,1,58,59,1.69
6671,January,2020,Pierce,WA,Truck,0,0,0,141347,141347,0.0
6672,January,2020,Broward,FL,Passenger,2,1,3,122,125,2.4
6673,January,2020,Benton,WA,Truck,0,0,0,42555,42555,0.0
6674,January,2020,Jones,GA,Passenger,1,0,1,1,2,50.0
6675,January,2020,Lewis,WA,Passenger,109,104,213,59601,59814,0.36
6676,January,2020,El Paso,TX,Passenger,3,0,3,451,454,0.66
6677,January,2020,Shelby,OH,Passenger,0,1,1,1,2,50.0
6678,January,2020,Chesapeake,VA,Passenger,0,2,2,431,433,0.46
6679,January,2020,New London,CT,Passenger,0,2,2,250,252,0.79
6680,January,2020,Orange,CA,Passenger,7,2,9,506,515,1.75
6681,January,2020,New Haven,CT,Passenger,0,2,2,45,47,4.26
6682,January,2020,Klickitat,WA,Truck,0,0,0,8299,8299,0.0
6683,January,2020,Kittitas,WA,Truck,0,0,0,14666,14666,0.0
6684,January,2020,Powhatan,VA,Passenger,1,0,1,0,1,100.0
6685,January,2020,Spokane,WA,Passenger,684,467,1151,316758,317909,0.36
6686,January,2020,Franklin,WA,Truck,0,0,0,19851,19851,0.0
6687,January,2020,Stevens,WA,Passenger,33,32,65,31499,31564,0.21
6688,January,2020,Lewis,WA,Truck,0,0,0,26097,26097,0.0
6689,January,2020,Boulder,CO,Passenger,0,1,1,51,52,1.92
6690,January,2020,Jefferson,WA,Truck,0,0,0,9661,9661,0.0
6691,January,2020,Shelby,TN,Passenger,0,1,1,96,97,1.03
6692,January,2020,Adams,WA,Passenger,7,7,14,12913,12927,0.11
6693,January,2020,Adams,WA,Truck,0,0,0,5211,5211,0.0
6694,January,2020,Ventura,CA,Passenger,0,3,3,299,302,0.99
6695,January,2020,Richland,SC,Passenger,0,1,1,157,158,0.63
6696,January,2020,Carson City,NV,Passenger,1,0,1,9,10,10.0
6697,January,2020,Duval,FL,Passenger,1,2,3,370,373,0.8
6698,January,2020,Skamania,WA,Passenger,29,19,48,8769,8817,0.54
6699,January,2020,Collin,TX,Passenger,1,1,2,128,130,1.54
6700,January,2020,Pinal,AZ,Passenger,1,0,1,190,191,0.52
6701,January,2020,Valencia,NM,Passenger,1,0,1,5,6,16.67
6702,January,2020,Wahkiakum,WA,Truck,0,0,0,1759,1759,0.0
6703,January,2020,Lincoln,WA,Truck,0,0,0,4671,4671,0.0
6704,January,2020,Putnam,TN,Passenger,0,1,1,3,4,25.0
6705,January,2020,Jefferson,WA,Passenger,224,139,363,25209,25572,1.42
6706,January,2020,Middlesex,MA,Passenger,1,1,2,104,106,1.89
6707,January,2020,Whitman,WA,Truck,0,0,0,8567,8567,0.0
6708,January,2020,St. Clair,IL,Passenger,1,0,1,143,144,0.69
6709,January,2020,Santa Clara,CA,Passenger,7,2,9,343,352,2.56
6710,January,2020,Walla Walla,WA,Passenger,65,61,126,36352,36478,0.35
6711,January,2020,Lake,IL,Passenger,1,0,1,161,162,0.62
6712,January,2020,San Joaquin,CA,Passenger,1,0,1,136,137,0.73
6713,January,2020,Contra Costa,CA,Passenger,3,2,5,336,341,1.47
6714,January,2020,Flathead,MT,Passenger,1,0,1,61,62,1.61
6715,January,2020,Saginaw,MI,Passenger,1,0,1,11,12,8.33
6716,January,2020,Ferry,WA,Truck,0,0,0,3586,3586,0.0
6717,January,2020,El Paso,CO,Passenger,2,1,3,735,738,0.41
6718,January,2020,Nassau,NY,Passenger,4,0,4,39,43,9.3
6719,January,2020,Jefferson,NY,Passenger,0,1,1,219,220,0.45
6720,January,2020,District of Columbia,DC,Passenger,1,1,2,209,211,0.95
6721,January,2020,Cape May,NJ,Passenger,0,1,1,13,14,7.14
6722,January,2020,Goochland,VA,Passenger,2,1,3,263,266,1.13
6723,January,2020,Fresno,CA,Passenger,1,0,1,190,191,0.52
6724,January,2020,Cowlitz,WA,Passenger,127,111,238,73602,73840,0.32
6725,January,2020,Santa Rosa,FL,Passenger,1,0,1,86,87,1.15
6726,January,2020,Clark,WA,Truck,0,0,0,81767,81767,0.0
6727,January,2020,Vigo,IN,Passenger,1,0,1,6,7,14.29
6728,January,2020,Montgomery,TX,Passenger,1,0,1,56,57,1.75
6729,January,2020,Multnomah,OR,Passenger,4,7,11,730,741,1.48
6730,January,2020,Spartanburg,SC,Passenger,0,1,1,43,44,2.27
6731,January,2020,Howard,MD,Passenger,0,1,1,74,75,1.33
6732,January,2020,Cowlitz,WA,Truck,0,0,0,29028,29028,0.0
6733,January,2020,Sumter,FL,Passenger,0,1,1,9,10,10.0
6734,January,2020,Richmond,GA,Passenger,0,1,1,90,91,1.1
6735,January,2020,Mason,WA,Truck,0,0,0,20563,20563,0.0
6736,January,2020,Grant,WA,Truck,0,0,0,27036,27036,0.0
6737,January,2020,RÃ­o Grande,PR,Passenger,1,0,1,1,2,50.0
6738,January,2020,Kitsap,WA,Truck,1,0,1,54484,54485,0.0
6739,January,2020,Montgomery,PA,Passenger,2,0,2,34,36,5.56
6740,January,2020,Denver,CO,Passenger,1,0,1,124,125,0.8
6741,January,2020,Douglas,WA,Truck,0,0,0,12312,12312,0.0
6742,January,2020,Kern,CA,Passenger,0,1,1,225,226,0.44
6743,January,2020,Dallas,TX,Passenger,1,0,1,208,209,0.48
6744,January,2020,Suffolk,VA,Passenger,1,0,1,124,125,0.8
6745,January,2020,Snohomish,WA,Passenger,4244,1718,5962,537912,543874,1.1
6746,January,2020,Oklahoma,OK,Passenger,0,1,1,127,128,0.78
6747,January,2020,Cumberland,NC,Passenger,0,2,2,488,490,0.41
6748,January,2020,Harris,TX,Passenger,1,0,1,240,241,0.41
6749,January,2020,Okanogan,WA,Truck,0,0,0,16557,16557,0.0
6750,January,2020,Allegheny,PA,Passenger,1,0,1,74,75,1.33
6751,January,2020,San Juan,WA,Passenger,265,83,348,14402,14750,2.36
6752,January,2020,Kent,MI,Passenger,0,1,1,24,25,4.0
6753,January,2020,Asotin,WA,Truck,0,0,0,6720,6720,0.0
6754,January,2020,Boone,MO,Passenger,0,1,1,11,12,8.33
6755,January,2020,San Francisco,CA,Passenger,2,1,3,101,104,2.88
6756,January,2020,Deschutes,OR,Passenger,3,0,3,145,148,2.03
6757,January,2020,St. Mary's,MD,Passenger,1,0,1,214,215,0.47
6758,January,2020,Camden,NJ,Passenger,0,2,2,21,23,8.7
6759,January,2021,Asotin,WA,Truck,0,0,0,6690,6690,0.0
6760,January,2021,Mason,WA,Passenger,179,137,316,47690,48006,0.66
6761,January,2021,Whitman,WA,Truck,0,0,0,8512,8512,0.0
6762,January,2021,Adams,WA,Truck,0,0,0,5347,5347,0.0
6763,January,2021,Fairbanks North Star,AK,Passenger,0,1,1,87,88,1.14
6764,January,2021,Virginia Beach,VA,Passenger,3,0,3,628,631,0.48
6765,January,2021,Allegheny,PA,Passenger,1,1,2,65,67,2.99
6766,January,2021,San Juan,WA,Passenger,377,113,490,14023,14513,3.38
6767,January,2021,El Paso,TX,Passenger,3,0,3,388,391,0.77
6768,January,2021,Norfolk,VA,Passenger,2,3,5,335,340,1.47
6769,January,2021,Missoula,MT,Passenger,1,0,1,64,65,1.54
6770,January,2021,Lee,FL,Passenger,1,0,1,42,43,2.33
6771,January,2021,Skamania,WA,Passenger,34,23,57,8339,8396,0.68
6772,January,2021,Los Angeles,CA,Passenger,10,11,21,927,948,2.22
6773,January,2021,Grays Harbor,WA,Passenger,133,126,259,48779,49038,0.53
6774,January,2021,Albemarle,VA,Passenger,1,0,1,21,22,4.55
6775,January,2021,Harrison,MS,Passenger,2,0,2,52,54,3.7
6776,January,2021,Pierce,WA,Passenger,2963,1790,4753,555715,560468,0.85
6777,January,2021,St. Clair,IL,Passenger,1,0,1,135,136,0.74
6778,January,2021,Wilson,TX,Passenger,0,1,1,5,6,16.67
6779,January,2021,Yakima,WA,Passenger,178,129,307,167569,167876,0.18
6780,January,2021,Anchorage,AK,Passenger,1,0,1,143,144,0.69
6781,January,2021,Bexar,TX,Passenger,3,5,8,562,570,1.4
6782,January,2021,Sedgwick,KS,Passenger,1,1,2,89,91,2.2
6783,January,2021,Jefferson,NY,Passenger,0,1,1,211,212,0.47
6784,January,2021,Contra Costa,CA,Passenger,3,3,6,278,284,2.11
6785,January,2021,Moore,NC,Passenger,0,1,1,141,142,0.7
6786,January,2021,Wahkiakum,WA,Truck,0,0,0,1769,1769,0.0
6787,January,2021,Grant,WA,Truck,0,0,0,27594,27594,0.0
6788,January,2021,Deschutes,OR,Passenger,1,0,1,119,120,0.83
6789,January,2021,Hamilton,IN,Passenger,2,0,2,34,36,5.56
6790,January,2021,Randolph,NC,Passenger,1,0,1,6,7,14.29
6791,January,2021,Snohomish,WA,Passenger,5177,1876,7053,538376,545429,1.29
6792,January,2021,Santa Clara,CA,Passenger,7,2,9,263,272,3.31
6793,January,2021,Adams,WA,Passenger,10,6,16,12971,12987,0.12
6794,January,2021,Harris,TX,Passenger,1,1,2,209,211,0.95
6795,January,2021,Orange,FL,Passenger,1,0,1,112,113,0.88
6796,January,2021,Nassau,NY,Passenger,4,0,4,27,31,12.9
6797,January,2021,Boulder,CO,Passenger,0,1,1,43,44,2.27
6798,January,2021,Grays Harbor,WA,Truck,0,0,0,21244,21244,0.0
6799,January,2021,DeKalb,GA,Passenger,1,0,1,64,65,1.54
6800,January,2021,Cowlitz,WA,Truck,0,0,0,28973,28973,0.0
6801,January,2021,Montgomery,OH,Passenger,0,1,1,53,54,1.85
6802,January,2021,Pinellas,FL,Passenger,1,1,2,96,98,2.04
6803,January,2021,Riverside,CA,Passenger,4,1,5,582,587,0.85
6804,January,2021,Wichita,TX,Passenger,1,0,1,42,43,2.33
6805,January,2021,Frederick,MD,Passenger,1,1,2,69,71,2.82
6806,January,2021,Charles,MD,Passenger,1,1,2,72,74,2.7
6807,January,2021,Loudoun,VA,Passenger,1,0,1,73,74,1.35
6808,January,2021,Cowlitz,WA,Passenger,188,129,317,72162,72479,0.44
6809,January,2021,Anne Arundel,MD,Passenger,3,1,4,400,404,0.99
6810,January,2021,Garfield,WA,Truck,0,0,0,1003,1003,0.0
6811,January,2021,Manassas,VA,Passenger,0,1,1,5,6,16.67
6812,January,2021,Hennepin,MN,Passenger,2,0,2,79,81,2.47
6813,January,2021,Montgomery,MD,Passenger,1,0,1,226,227,0.44
6814,January,2021,Okanogan,WA,Truck,0,0,0,16594,16594,0.0
6815,January,2021,Jefferson,WA,Truck,0,0,0,9597,9597,0.0
6816,January,2021,Williams,ND,Passenger,0,1,1,10,11,9.09
6817,January,2021,Placer,CA,Passenger,2,0,2,81,83,2.41
6818,January,2021,El Paso,CO,Passenger,2,0,2,689,691,0.29
6819,January,2021,Dallas,TX,Passenger,1,0,1,166,167,0.6
6820,January,2021,Oldham,KY,Passenger,0,1,1,4,5,20.0
6821,January,2021,Houston,GA,Passenger,1,0,1,52,53,1.89
6822,January,2021,Klamath,OR,Passenger,1,0,1,30,31,3.23
6823,January,2021,Juneau,AK,Passenger,0,1,1,25,26,3.85
6824,January,2021,Flathead,MT,Passenger,1,0,1,48,49,2.04
6825,January,2021,Stevens,WA,Truck,0,0,0,18751,18751,0.0
6826,January,2021,Sevier,AR,Passenger,0,1,1,0,1,100.0
6827,January,2021,King,WA,Truck,6,1,7,184346,184353,0.0
6828,January,2021,Lewis,WA,Truck,0,0,0,26714,26714,0.0
6829,January,2021,Suffolk,MA,Passenger,0,2,2,30,32,6.25
6830,January,2021,Palm Beach,FL,Passenger,0,1,1,72,73,1.37
6832,January,2021,Klickitat,WA,Passenger,63,43,106,14989,15095,0.7
6833,January,2021,Nueces,TX,Passenger,1,0,1,81,82,1.22
6834,January,2021,Greene,MO,Passenger,0,1,1,32,33,3.03
6835,January,2021,Washoe,NV,Passenger,1,0,1,99,100,1.0
6836,January,2021,Travis,TX,Passenger,2,3,5,162,167,2.99
6837,January,2021,Clallam,WA,Passenger,281,190,471,49972,50443,0.93
6838,January,2021,Thurston,WA,Truck,0,0,0,56449,56449,0.0
6839,January,2021,St. Mary's,MD,Passenger,1,0,1,213,214,0.47
6840,January,2021,Shelby,OH,Passenger,0,1,1,1,2,50.0
6841,January,2021,Alexandria,VA,Passenger,2,0,2,133,135,1.48
6842,January,2021,Bradley,TN,Passenger,1,0,1,0,1,100.0
6843,January,2021,Pima,AZ,Passenger,2,1,3,309,312,0.96
6844,January,2021,Walla Walla,WA,Truck,0,0,0,13897,13897,0.0
6845,January,2021,Arapahoe,CO,Passenger,1,0,1,120,121,0.83
6846,January,2021,Miami-Dade,FL,Passenger,1,0,1,97,98,1.02
6847,January,2021,Clallam,WA,Truck,1,0,1,21869,21870,0.0
6848,January,2021,Pacific,WA,Truck,0,0,0,7802,7802,0.0
6849,January,2021,Carroll,MD,Passenger,0,1,1,20,21,4.76
6850,January,2021,Morris,NJ,Passenger,1,0,1,16,17,5.88
6851,January,2021,Mason,WA,Truck,0,0,0,21024,21024,0.0
6852,January,2021,Camden,NJ,Passenger,0,1,1,18,19,5.26
6853,January,2021,Lewis,WA,Passenger,126,131,257,58904,59161,0.43
6854,January,2021,Hampshire,MA,Passenger,1,0,1,6,7,14.29
6855,January,2021,Prince William,VA,Passenger,1,1,2,216,218,0.92
6856,January,2021,Whatcom,WA,Truck,3,0,3,43603,43606,0.01
6857,January,2021,Whitman,WA,Passenger,51,46,97,21847,21944,0.44
6858,January,2021,Stafford,VA,Passenger,2,1,3,94,97,3.09
6859,January,2021,Ferry,WA,Truck,0,0,0,3606,3606,0.0
6860,January,2021,Ventura,CA,Passenger,1,1,2,268,270,0.74
6861,January,2021,Island,WA,Passenger,527,294,821,62983,63804,1.29
6862,January,2021,Platte,MO,Passenger,1,0,1,18,19,5.26
6863,January,2021,Pend Oreille,WA,Passenger,12,3,15,9181,9196,0.16
6864,January,2021,Powhatan,VA,Passenger,1,0,1,1,2,50.0
6865,January,2021,Asotin,WA,Passenger,16,13,29,12441,12470,0.23
6866,January,2021,Collin,TX,Passenger,1,1,2,115,117,1.71
6867,January,2021,Okanogan,WA,Passenger,56,36,92,26138,26230,0.35
6868,January,2021,Salt Lake,UT,Passenger,0,1,1,172,173,0.58
6869,January,2021,Okaloosa,FL,Passenger,0,1,1,133,134,0.75
6870,January,2021,Larimer,CO,Passenger,1,0,1,52,53,1.89
6871,January,2021,Washtenaw,MI,Passenger,1,0,1,31,32,3.12
6872,January,2021,Leavenworth,KS,Passenger,0,1,1,121,122,0.82
6873,January,2021,Richmond,GA,Passenger,0,1,1,77,78,1.28
6874,January,2021,Columbia,WA,Passenger,5,3,8,2452,2460,0.33
6875,January,2021,Vigo,IN,Passenger,1,0,1,6,7,14.29
6876,January,2021,San Francisco,CA,Passenger,1,1,2,89,91,2.2
6877,January,2021,Spokane,WA,Passenger,910,551,1461,320997,322458,0.45
6878,January,2021,Philadelphia,PA,Passenger,1,0,1,58,59,1.69
6879,January,2021,Lincoln,WA,Truck,0,0,0,4693,4693,0.0
6880,January,2021,Clark,NV,Passenger,4,2,6,644,650,0.92
6881,January,2021,Rogers,OK,Passenger,1,0,1,4,5,20.0
6882,January,2021,Monterey,CA,Passenger,0,1,1,150,151,0.66
6883,January,2021,DuPage,IL,Passenger,2,0,2,54,56,3.57
6884,January,2021,Jones,GA,Passenger,1,0,1,1,2,50.0
6885,January,2021,Garfield,WA,Passenger,0,2,2,1362,1364,0.15
6886,January,2021,Douglas,WA,Truck,0,0,0,12505,12505,0.0
6887,January,2021,Alameda,CA,Passenger,3,0,3,259,262,1.15
6888,January,2021,Fort Bend,TX,Passenger,1,0,1,42,43,2.33
6889,January,2021,Stevens,WA,Passenger,37,40,77,30273,30350,0.25
6890,January,2021,Lake,IL,Passenger,2,0,2,158,160,1.25
6891,January,2021,Grant,WA,Passenger,87,84,171,66105,66276,0.26
6892,January,2021,San Juan,WA,Truck,0,0,0,5867,5867,0.0
6893,January,2021,Skagit,WA,Passenger,517,243,760,91439,92199,0.82
6894,January,2021,Dakota,MN,Passenger,0,1,1,26,27,3.7
6895,January,2021,Utah,UT,Passenger,0,1,1,124,125,0.8
6896,January,2021,Polk,FL,Passenger,1,0,1,55,56,1.79
6897,January,2021,Clark,WA,Passenger,2459,1211,3670,319410,323080,1.14
6898,January,2021,Tulsa,OK,Passenger,1,1,2,39,41,4.88
6899,January,2021,Pend Oreille,WA,Truck,0,0,0,5717,5717,0.0
6900,January,2021,Benton,WA,Passenger,453,358,811,135157,135968,0.6
6901,January,2021,Kittitas,WA,Truck,0,0,0,14675,14675,0.0
6902,January,2021,Charleston,SC,Passenger,2,0,2,85,87,2.3
6903,January,2021,Saginaw,MI,Passenger,2,0,2,9,11,18.18
6904,January,2021,Thurston,WA,Passenger,1350,796,2146,197459,199605,1.08
6905,January,2021,New York,NY,Passenger,1,0,1,52,53,1.89
6906,January,2021,San Mateo,CA,Passenger,1,1,2,106,108,1.85
6907,January,2021,Yakima,WA,Truck,0,0,0,61081,61081,0.0
6908,January,2021,Pierce,WA,Truck,0,0,0,144891,144891,0.0
6909,January,2021,Hudson,NJ,Passenger,1,0,1,40,41,2.44
6910,January,2021,Kings,NY,Passenger,1,0,1,62,63,1.59
6911,January,2021,Howard,MD,Passenger,0,1,1,63,64,1.56
6912,January,2021,Fulton,GA,Passenger,0,2,2,86,88,2.27
6913,January,2021,Kent,MI,Passenger,0,1,1,23,24,4.17
6914,January,2021,Suffolk,VA,Passenger,1,0,1,124,125,0.8
6915,January,2021,St. Louis,MO,Passenger,1,0,1,95,96,1.04
6916,January,2021,Benton,WA,Truck,0,0,0,43331,43331,0.0
6917,January,2021,Middlesex,MA,Passenger,1,1,2,91,93,2.15
6918,January,2021,Richland,SC,Passenger,0,1,1,140,141,0.71
6919,January,2021,Franklin,WA,Truck,0,0,0,20491,20491,0.0
6920,January,2021,Fairfax,VA,Passenger,4,3,7,696,703,1.0
6921,January,2021,Twin Falls,ID,Passenger,0,1,1,25,26,3.85
6922,January,2021,Owyhee,ID,Passenger,1,0,1,3,4,25.0
6923,January,2021,Goochland,VA,Passenger,4,3,7,240,247,2.83
6924,January,2021,Milwaukee,WI,Passenger,1,0,1,39,40,2.5
6925,January,2021,Kitsap,WA,Passenger,1607,765,2372,179318,181690,1.31
6926,January,2021,Lincoln,WA,Passenger,6,12,18,7632,7650,0.24
6927,January,2021,Denver,CO,Passenger,1,0,1,116,117,0.85
6928,January,2021,Whatcom,WA,Passenger,1253,564,1817,150089,151906,1.2
6929,January,2021,Klickitat,WA,Truck,0,0,0,8117,8117,0.0
6930,January,2021,Kern,CA,Passenger,0,1,1,214,215,0.47
6931,January,2021,Lake,FL,Passenger,1,0,1,21,22,4.55
6932,January,2021,Boone,MO,Passenger,0,1,1,10,11,9.09
6933,January,2021,Chelan,WA,Truck,0,0,0,22844,22844,0.0
6934,January,2021,Sacramento,CA,Passenger,2,0,2,232,234,0.85
6935,January,2021,Sarasota,FL,Passenger,2,0,2,25,27,7.41
6936,January,2021,Orange,CA,Passenger,4,3,7,440,447,1.57
6937,January,2021,Hawaii,HI,Passenger,1,0,1,51,52,1.92
6938,January,2021,Putnam,TN,Passenger,0,1,1,2,3,33.33
6939,January,2021,Cascade,MT,Passenger,0,1,1,54,55,1.82
6940,January,2021,Skamania,WA,Truck,0,0,0,4017,4017,0.0
6941,January,2021,Fresno,CA,Passenger,1,0,1,170,171,0.58
6942,January,2021,Franklin,WA,Passenger,89,85,174,61500,61674,0.28
6943,January,2021,Walla Walla,WA,Passenger,103,68,171,36164,36335,0.47
6944,January,2021,New Haven,CT,Passenger,0,2,2,35,37,5.41
6945,January,2021,Calvert,MD,Passenger,0,2,2,85,87,2.3
6946,January,2021,Clark,WA,Truck,0,0,0,83564,83564,0.0
6947,January,2021,Douglas,NE,Passenger,1,1,2,51,53,3.77
6948,January,2021,Bucks,PA,Passenger,1,0,1,18,19,5.26
6949,January,2021,Skagit,WA,Truck,1,0,1,32861,32862,0.0
6950,January,2021,Gwinnett,GA,Passenger,1,0,1,66,67,1.49
6951,January,2021,Plaquemines,LA,Passenger,0,1,1,14,15,6.67
6952,January,2021,Snohomish,WA,Truck,1,0,1,125692,125693,0.0
6953,January,2021,Montgomery,TX,Passenger,1,0,1,46,47,2.13
6954,January,2021,Rockingham,NH,Passenger,1,0,1,22,23,4.35
6955,January,2021,Maricopa,AZ,Passenger,5,5,10,1286,1296,0.77
6956,January,2021,Ray,MO,Passenger,0,1,1,1,2,50.0
6957,January,2021,Honolulu,HI,Passenger,5,2,7,416,423,1.65
6958,January,2021,San Diego,CA,Passenger,13,5,18,2686,2704,0.67
6959,January,2021,Chelan,WA,Passenger,294,87,381,54481,54862,0.69
6960,January,2021,Jefferson,WA,Passenger,290,166,456,24802,25258,1.81
6961,January,2021,Howard,IN,Passenger,0,1,1,3,4,25.0
6962,January,2021,New London,CT,Passenger,1,2,3,229,232,1.29
6963,January,2021,El Dorado,CA,Passenger,1,0,1,32,33,3.03
6964,January,2021,Duval,FL,Passenger,0,2,2,352,354,0.56
6965,January,2021,Clackamas,OR,Passenger,3,0,3,177,180,1.67
6966,January,2021,DeKalb,IN,Passenger,1,0,1,0,1,100.0
6967,January,2021,Pacific,WA,Passenger,35,37,72,15798,15870,0.45
6968,January,2021,Montgomery,PA,Passenger,1,0,1,26,27,3.7
6969,January,2021,Douglas,WA,Passenger,84,46,130,28199,28329,0.46
6970,January,2021,Arlington,VA,Passenger,0,1,1,137,138,0.72
6971,January,2021,District of Columbia,DC,Passenger,3,1,4,201,205,1.95
6972,January,2021,Spartanburg,SC,Passenger,0,1,1,50,51,1.96
6973,January,2021,RÃ­o Grande,PR,Passenger,1,0,1,1,2,50.0
6974,January,2021,Kitsap,WA,Truck,0,0,0,54300,54300,0.0
6975,January,2021,Kittitas,WA,Passenger,134,52,186,29834,30020,0.62
6976,January,2021,Monroe,IL,Passenger,1,0,1,3,4,25.0
6977,January,2021,Harnett,NC,Passenger,1,0,1,182,183,0.55
6978,January,2021,Carroll,NH,Passenger,0,1,1,5,6,16.67
6979,January,2021,Portsmouth,VA,Passenger,0,1,1,76,77,1.3
6980,January,2021,Penobscot,ME,Passenger,0,1,1,9,10,10.0
6981,January,2021,Cape May,NJ,Passenger,0,1,1,9,10,10.0
6982,January,2021,Williamson,TX,Passenger,0,2,2,120,122,1.64
6983,January,2021,Erie,NY,Passenger,1,0,1,43,44,2.27
6984,January,2021,Sumter,FL,Passenger,0,1,1,10,11,9.09
6985,January,2021,Multnomah,OR,Passenger,3,5,8,671,679,1.18
6986,January,2021,Queens,NY,Passenger,1,0,1,50,51,1.96
6987,January,2021,Ferry,WA,Passenger,9,3,12,4341,4353,0.28
6988,January,2021,Wahkiakum,WA,Passenger,7,6,13,3040,3053,0.43
6989,January,2021,Pennington,SD,Passenger,1,0,1,34,35,2.86
6990,January,2021,Prince George's,MD,Passenger,2,1,3,144,147,2.04
6991,January,2021,Broward,FL,Passenger,2,1,3,106,109,2.75
6992,January,2021,San Joaquin,CA,Passenger,1,0,1,107,108,0.93
6993,January,2021,Maui,HI,Passenger,1,0,1,26,27,3.7
6994,January,2021,Nassau,FL,Passenger,1,0,1,34,35,2.86
6995,January,2021,Washington,OR,Passenger,1,0,1,401,402,0.25
6996,January,2021,Ramsey,MN,Passenger,1,0,1,34,35,2.86
6997,January,2021,Santa Cruz,CA,Passenger,1,0,1,27,28,3.57
6998,January,2021,Solano,CA,Passenger,1,0,1,198,199,0.5
6999,January,2021,Island,WA,Truck,0,0,0,21409,21409,0.0
7000,January,2021,Carson City,NV,Passenger,1,0,1,12,13,7.69
7001,January,2021,Columbia,WA,Truck,0,0,0,1547,1547,0.0
7002,January,2021,Spokane,WA,Truck,0,0,0,100880,100880,0.0
7003,January,2021,Ulster,NY,Passenger,1,0,1,7,8,12.5
7004,January,2021,Chesapeake,VA,Passenger,0,3,3,401,404,0.74
7005,January,2021,Kauai,HI,Passenger,1,0,1,14,15,6.67
7006,January,2021,Douglas,CO,Passenger,0,1,1,78,79,1.27
7007,January,2021,Cumberland,NC,Passenger,0,2,2,440,442,0.45
7008,January,2021,King,WA,Passenger,27793,8324,36117,1367229,1403346,2.57
7009,January,2021,Bartow,GA,Passenger,0,1,1,4,5,20.0
7010,January,2022,Hillsborough,FL,Passenger,0,1,1,132,133,0.75
7011,January,2022,Ray,MO,Passenger,0,1,1,1,2,50.0
7012,January,2022,Douglas,WA,Passenger,118,56,174,28586,28760,0.61
7013,January,2022,Rogers,OK,Passenger,1,0,1,2,3,33.33
7014,January,2022,New London,CT,Passenger,1,4,5,211,216,2.31
7015,January,2022,Howard,MD,Passenger,0,1,1,55,56,1.79
7016,January,2022,Duval,FL,Passenger,0,2,2,301,303,0.66
7017,January,2022,Montgomery,TX,Passenger,1,1,2,31,33,6.06
7018,January,2022,Whatcom,WA,Truck,3,0,3,43614,43617,0.01
7019,January,2022,Asotin,WA,Truck,0,0,0,6736,6736,0.0
7020,January,2022,Orange,FL,Passenger,1,0,1,99,100,1.0
7021,January,2022,Onslow,NC,Passenger,0,1,1,167,168,0.6
7022,January,2022,Garfield,WA,Truck,0,0,0,995,995,0.0
7023,January,2022,Williams,ND,Passenger,0,1,1,8,9,11.11
7024,January,2022,San Joaquin,CA,Passenger,1,1,2,90,92,2.17
7025,January,2022,Flathead,MT,Passenger,1,0,1,37,38,2.63
7026,January,2022,Whatcom,WA,Passenger,1665,673,2338,149528,151866,1.54
7027,January,2022,King,WA,Passenger,36353,10406,46759,1356535,1403294,3.33
7028,January,2022,Walla Walla,WA,Passenger,146,89,235,36290,36525,0.64
7029,January,2022,Stevens,WA,Passenger,58,47,105,30190,30295,0.35
7030,January,2022,Clark,WA,Passenger,3541,1572,5113,319486,324599,1.58
7031,January,2022,Monterey,CA,Passenger,0,1,1,134,135,0.74
7032,January,2022,Anchorage,AK,Passenger,1,0,1,122,123,0.81
7033,January,2022,Owyhee,ID,Passenger,1,0,1,2,3,33.33
7034,January,2022,San Juan,WA,Passenger,482,151,633,14173,14806,4.28
7035,January,2022,Frederick,MD,Passenger,1,1,2,68,70,2.86
7036,January,2022,King,WA,Truck,14,1,15,182672,182687,0.01
7037,January,2022,Anne Arundel,MD,Passenger,4,3,7,353,360,1.94
7038,January,2022,El Paso,CO,Passenger,3,0,3,641,644,0.47
7039,January,2022,Chelan,WA,Truck,0,0,0,23062,23062,0.0
7040,January,2022,Carroll,MD,Passenger,0,1,1,15,16,6.25
7041,January,2022,Cowlitz,WA,Truck,0,1,1,28923,28924,0.0
7042,January,2022,Cape May,NJ,Passenger,0,1,1,8,9,11.11
7043,January,2022,Snohomish,WA,Truck,3,0,3,125304,125307,0.0
7044,January,2022,Louisa,VA,Passenger,0,1,1,1,2,50.0
7045,January,2022,Lewis,WA,Passenger,213,165,378,59516,59894,0.63
7046,January,2022,District of Columbia,DC,Passenger,5,0,5,185,190,2.63
7047,January,2022,Sonoma,CA,Passenger,0,1,1,75,76,1.32
7048,January,2022,Gwinnett,GA,Passenger,1,0,1,56,57,1.75
7049,January,2022,Richmond,GA,Passenger,0,1,1,70,71,1.41
7050,January,2022,Okanogan,WA,Passenger,70,47,117,26533,26650,0.44
7051,January,2022,New Haven,CT,Passenger,0,2,2,30,32,6.25
7052,January,2022,Bartow,GA,Passenger,0,1,1,3,4,25.0
7053,January,2022,Salt Lake,UT,Passenger,1,1,2,149,151,1.32
7054,January,2022,Spokane,WA,Truck,0,0,0,102647,102647,0.0
7055,January,2022,Goochland,VA,Passenger,3,2,5,172,177,2.82
7056,January,2022,Pennington,SD,Passenger,2,0,2,29,31,6.45
7057,January,2022,Kings,NY,Passenger,1,0,1,66,67,1.49
7058,January,2022,Bexar,TX,Passenger,3,4,7,474,481,1.46
7059,January,2022,Yakima,WA,Passenger,294,177,471,168293,168764,0.28
7060,January,2022,Clackamas,OR,Passenger,2,0,2,157,159,1.26
7061,January,2022,Hidalgo,TX,Passenger,0,1,1,53,54,1.85
7062,January,2022,Las Animas,CO,Passenger,1,0,1,1,2,50.0
7063,January,2022,Carroll,NH,Passenger,0,1,1,5,6,16.67
7064,January,2022,Elmore,ID,Passenger,1,0,1,15,16,6.25
7065,January,2022,Skamania,WA,Passenger,60,43,103,8316,8419,1.22
7066,January,2022,St. Tammany,LA,Passenger,1,0,1,38,39,2.56
7067,January,2022,Charles,MD,Passenger,1,1,2,64,66,3.03
7068,January,2022,Jefferson,WA,Passenger,385,197,582,24693,25275,2.3
7069,January,2022,Walla Walla,WA,Truck,0,0,0,14104,14104,0.0
7070,January,2022,Arlington,VA,Passenger,1,0,1,130,131,0.76
7071,January,2022,Richland,SC,Passenger,0,1,1,126,127,0.79
7072,January,2022,Orange,CA,Passenger,5,2,7,379,386,1.81
7073,January,2022,Sedgwick,KS,Passenger,1,1,2,82,84,2.38
7074,January,2022,San Francisco,CA,Passenger,0,1,1,77,78,1.28
7075,January,2022,Burlington,NJ,Passenger,0,1,1,116,117,0.85
7076,January,2022,Island,WA,Passenger,734,344,1078,62598,63676,1.69
7077,January,2022,Kitsap,WA,Truck,0,0,0,54155,54155,0.0
7078,January,2022,Randolph,NC,Passenger,1,0,1,5,6,16.67
7079,January,2022,Benton,WA,Passenger,654,453,1107,135958,137065,0.81
7080,January,2022,Thurston,WA,Truck,3,0,3,55934,55937,0.01
7081,January,2022,Harnett,NC,Passenger,1,1,2,143,145,1.38
7082,January,2022,Calvert,MD,Passenger,0,2,2,79,81,2.47
7083,January,2022,Miami-Dade,FL,Passenger,1,0,1,88,89,1.12
7084,January,2022,RÃ­o Grande,PR,Passenger,1,0,1,0,1,100.0
7085,January,2022,Norfolk,VA,Passenger,3,3,6,301,307,1.95
7086,January,2022,Boulder,CO,Passenger,1,1,2,36,38,5.26
7087,January,2022,El Paso,TX,Passenger,2,0,2,344,346,0.58
7088,January,2022,Mason,WA,Truck,0,0,0,21187,21187,0.0
7089,January,2022,Larimer,CO,Passenger,1,0,1,49,50,2.0
7090,January,2022,Nueces,TX,Passenger,1,1,2,61,63,3.17
7091,January,2022,Dallas,TX,Passenger,1,0,1,129,130,0.77
7092,January,2022,Solano,CA,Passenger,1,0,1,172,173,0.58
7093,January,2022,Alameda,CA,Passenger,4,0,4,204,208,1.92
7094,January,2022,Kitsap,WA,Passenger,2191,970,3161,179910,183071,1.73
7095,January,2022,St. Clair,IL,Passenger,2,0,2,119,121,1.65
7096,January,2022,Santa Clara,CA,Passenger,8,1,9,228,237,3.8
7097,January,2022,Benton,WA,Truck,0,0,0,43600,43600,0.0
7098,January,2022,Pierce,WA,Passenger,4367,2153,6520,554116,560636,1.16
7099,January,2022,Portsmouth,VA,Passenger,0,1,1,76,77,1.3
7100,January,2022,Pierce,WA,Truck,0,0,0,144454,144454,0.0
7101,January,2022,Hamilton,OH,Passenger,1,0,1,30,31,3.23
7102,January,2022,Cumberland,NC,Passenger,1,2,3,385,388,0.77
7103,January,2022,Plaquemines,LA,Passenger,0,1,1,17,18,5.56
7104,January,2022,Washington,MD,Passenger,2,0,2,14,16,12.5
7105,January,2022,Suffolk,VA,Passenger,1,0,1,120,121,0.83
7106,January,2022,Howard,IN,Passenger,0,1,1,6,7,14.29
7107,January,2022,Harrison,MS,Passenger,2,0,2,43,45,4.44
7108,January,2022,Kittitas,WA,Truck,0,0,0,14768,14768,0.0
7109,January,2022,Wake,NC,Passenger,1,0,1,103,104,0.96
7110,January,2022,Virginia Beach,VA,Passenger,2,0,2,556,558,0.36
7111,January,2022,Williamson,TX,Passenger,1,2,3,88,91,3.3
7112,January,2022,Pacific,WA,Passenger,55,63,118,16055,16173,0.73
7114,January,2022,Moore,NC,Passenger,0,1,1,122,123,0.81
7115,January,2022,Grant,WA,Truck,0,0,0,27996,27996,0.0
7116,January,2022,Shelby,OH,Passenger,0,1,1,2,3,33.33
7117,January,2022,Clallam,WA,Passenger,391,241,632,50236,50868,1.24
7118,January,2022,Klamath,OR,Passenger,1,0,1,28,29,3.45
7119,January,2022,Broward,FL,Passenger,2,0,2,91,93,2.15
7120,January,2022,Prince William,VA,Passenger,1,1,2,200,202,0.99
7121,January,2022,Penobscot,ME,Passenger,0,1,1,7,8,12.5
7122,January,2022,Wilson,NC,Passenger,1,0,1,0,1,100.0
7123,January,2022,Garfield,WA,Passenger,0,3,3,1356,1359,0.22
7124,January,2022,Placer,CA,Passenger,2,0,2,71,73,2.74
7125,January,2022,San Mateo,CA,Passenger,2,0,2,77,79,2.53
7126,January,2022,Philadelphia,PA,Passenger,1,0,1,35,36,2.78
7127,January,2022,Franklin,WA,Truck,0,0,0,20891,20891,0.0
7128,January,2022,Ferry,WA,Passenger,14,3,17,4436,4453,0.38
7129,January,2022,Carson City,NV,Passenger,1,0,1,8,9,11.11
7130,January,2022,San Juan,WA,Truck,1,0,1,6022,6023,0.02
7131,January,2022,Montgomery,PA,Passenger,2,0,2,22,24,8.33
7132,January,2022,Chelan,WA,Passenger,421,117,538,54587,55125,0.98
7133,January,2022,Thurston,WA,Passenger,1920,973,2893,196481,199374,1.45
7134,January,2022,Clark,NV,Passenger,4,2,6,551,557,1.08
7135,January,2022,Klickitat,WA,Passenger,90,54,144,15313,15457,0.93
7136,January,2022,Kittitas,WA,Passenger,216,71,287,29812,30099,0.95
7137,January,2022,Clark,WA,Truck,2,0,2,83892,83894,0.0
7138,January,2022,Baltimore,MD,Passenger,1,0,1,79,80,1.25
7139,January,2022,Grays Harbor,WA,Passenger,197,158,355,49346,49701,0.71
7140,January,2022,Sarpy,NE,Passenger,1,0,1,57,58,1.72
7141,January,2022,Allen,IN,Passenger,1,0,1,14,15,6.67
7142,January,2022,Adams,WA,Truck,0,0,0,5434,5434,0.0
7143,January,2022,Essex,NJ,Passenger,2,0,2,10,12,16.67
7144,January,2022,Wood,OH,Passenger,0,1,1,4,5,20.0
7145,January,2022,Queens,NY,Passenger,1,0,1,49,50,2.0
7146,January,2022,Montgomery,MD,Passenger,3,2,5,195,200,2.5
7147,January,2022,Yakima,WA,Truck,0,0,0,61615,61615,0.0
7148,January,2022,Pinellas,FL,Passenger,0,1,1,84,85,1.18
7149,January,2022,Skagit,WA,Passenger,701,307,1008,90876,91884,1.1
7150,January,2022,Clallam,WA,Truck,1,0,1,22143,22144,0.0
7151,January,2022,DuPage,IL,Passenger,1,0,1,49,50,2.0
7152,January,2022,Marin,CA,Passenger,0,1,1,31,32,3.12
7153,January,2022,Lake,FL,Passenger,1,0,1,22,23,4.35
7154,January,2022,Honolulu,HI,Passenger,4,4,8,341,349,2.29
7155,January,2022,Yamhill,OR,Passenger,1,0,1,30,31,3.23
7156,January,2022,Juneau,AK,Passenger,0,1,1,28,29,3.45
7157,January,2022,Travis,TX,Passenger,1,0,1,123,124,0.81
7158,January,2022,Fort Bend,TX,Passenger,1,0,1,31,32,3.12
7159,January,2022,Lee,FL,Passenger,1,0,1,28,29,3.45
7160,January,2022,Sumter,SC,Passenger,0,1,1,34,35,2.86
7161,January,2022,Hawaii,HI,Passenger,1,0,1,37,38,2.63
7162,January,2022,Hudson,NJ,Passenger,2,0,2,36,38,5.26
7163,January,2022,Champaign,IL,Passenger,1,0,1,10,11,9.09
7164,January,2022,Lewis,WA,Truck,0,0,0,26654,26654,0.0
7165,January,2022,Maricopa,AZ,Passenger,7,2,9,1014,1023,0.88
7166,January,2022,Nassau,NY,Passenger,2,0,2,25,27,7.41
7167,January,2022,Okaloosa,FL,Passenger,0,1,1,105,106,0.94
7168,January,2022,Adams,WA,Passenger,17,14,31,13041,13072,0.24
7169,January,2022,Oldham,KY,Passenger,0,1,1,4,5,20.0
7170,January,2022,Wichita,TX,Passenger,1,0,1,41,42,2.38
7171,January,2022,Albemarle,VA,Passenger,1,0,1,18,19,5.26
7172,January,2022,Los Angeles,CA,Passenger,10,7,17,817,834,2.04
7173,January,2022,Jefferson,WA,Truck,0,0,0,9571,9571,0.0
7174,January,2022,Rockingham,NH,Passenger,1,0,1,17,18,5.56
7175,January,2022,Pend Oreille,WA,Passenger,17,9,26,9118,9144,0.28
7176,January,2022,Richmond,NY,Passenger,1,0,1,6,7,14.29
7177,January,2022,Middlesex,MA,Passenger,0,1,1,83,84,1.19
7178,January,2022,Cook,IL,Passenger,2,0,2,191,193,1.04
7179,January,2022,Leavenworth,KS,Passenger,0,1,1,105,106,0.94
7180,January,2022,Cowlitz,WA,Passenger,273,164,437,71316,71753,0.61
7181,January,2022,San Diego,CA,Passenger,15,8,23,2380,2403,0.96
7182,January,2022,Franklin,WA,Passenger,169,101,270,62152,62422,0.43
7183,January,2022,Stafford,VA,Passenger,2,1,3,90,93,3.23
7184,January,2022,Columbia,WA,Truck,0,0,0,1557,1557,0.0
7185,January,2022,San Bernardino,CA,Passenger,1,1,2,349,351,0.57
7186,January,2022,Fairfax,VA,Passenger,3,3,6,637,643,0.93
7187,January,2022,Jefferson,NY,Passenger,0,1,1,201,202,0.5
7188,January,2022,Stevens,WA,Truck,0,0,0,18938,18938,0.0
7189,January,2022,Fresno,CA,Passenger,1,0,1,154,155,0.65
7190,January,2022,Lincoln,WA,Truck,0,0,0,4835,4835,0.0
7191,January,2022,Sacramento,CA,Passenger,2,0,2,204,206,0.97
7192,January,2022,Escambia,FL,Passenger,0,1,1,136,137,0.73
7193,January,2022,Denton,TX,Passenger,1,0,1,70,71,1.41
7194,January,2022,Wahkiakum,WA,Truck,0,0,0,1816,1816,0.0
7195,January,2022,Yellowstone,MT,Passenger,0,1,1,32,33,3.03
7196,January,2022,Riverside,CA,Passenger,5,1,6,490,496,1.21
7197,January,2022,Okanogan,WA,Truck,0,0,0,16692,16692,0.0
7198,January,2022,Island,WA,Truck,1,0,1,21481,21482,0.0
7199,January,2022,Vigo,IN,Passenger,1,0,1,5,6,16.67
7200,January,2022,Charleston,SC,Passenger,2,1,3,70,73,4.11
7201,January,2022,Pend Oreille,WA,Truck,0,0,0,5731,5731,0.0
7202,January,2022,Loudoun,VA,Passenger,1,0,1,66,67,1.49
7203,January,2022,Columbia,WA,Passenger,6,2,8,2452,2460,0.33
7204,January,2022,Houston,GA,Passenger,1,0,1,40,41,2.44
7205,January,2022,Snohomish,WA,Passenger,7221,2278,9499,536658,546157,1.74
7206,January,2022,Ferry,WA,Truck,0,0,0,3582,3582,0.0
7207,January,2022,Spokane,WA,Passenger,1350,766,2116,326674,328790,0.64
7208,January,2022,Alexandria,VA,Passenger,2,0,2,111,113,1.77
7209,January,2022,Douglas,NE,Passenger,1,2,3,46,49,6.12
7210,January,2022,Manassas,VA,Passenger,0,1,1,7,8,12.5
7211,January,2022,Tarrant,TX,Passenger,1,0,1,126,127,0.79
7212,January,2022,Skagit,WA,Truck,1,0,1,32658,32659,0.0
7213,January,2022,Danville,VA,Passenger,1,0,1,0,1,100.0
7214,January,2022,Kern,CA,Passenger,0,1,1,195,196,0.51
7215,January,2022,Douglas,CO,Passenger,0,1,1,75,76,1.32
7216,January,2022,Suffolk,MA,Passenger,0,2,2,24,26,7.69
7217,January,2022,Harris,TX,Passenger,1,0,1,159,160,0.62
7218,January,2022,Galveston,TX,Passenger,0,1,1,20,21,4.76
7219,January,2022,New York,NY,Passenger,1,0,1,36,37,2.7
7220,January,2022,Whitman,WA,Truck,0,0,0,8565,8565,0.0
7221,January,2022,San Luis Obispo,CA,Passenger,1,0,1,55,56,1.79
7222,January,2022,Wahkiakum,WA,Passenger,17,11,28,3075,3103,0.9
7223,January,2022,Rockdale,GA,Passenger,1,0,1,7,8,12.5
7224,January,2022,Dorchester,SC,Passenger,1,0,1,63,64,1.56
7225,January,2022,Powhatan,VA,Passenger,1,0,1,1,2,50.0
7226,January,2022,Fairbanks North Star,AK,Passenger,0,1,1,76,77,1.3
7227,January,2022,Lincoln,OR,Passenger,0,1,1,32,33,3.03
7228,January,2022,Grays Harbor,WA,Truck,0,0,0,21347,21347,0.0
7229,January,2022,Boone,MO,Passenger,0,1,1,9,10,10.0
7230,January,2022,Lincoln,WA,Passenger,6,17,23,7738,7761,0.3
7231,January,2022,Ventura,CA,Passenger,2,1,3,237,240,1.25
7232,January,2022,Saratoga,NY,Passenger,1,0,1,39,40,2.5
7233,January,2022,Coryell,TX,Passenger,1,0,1,103,104,0.96
7234,January,2022,Asotin,WA,Passenger,23,17,40,12668,12708,0.31
7235,January,2022,Hennepin,MN,Passenger,3,0,3,62,65,4.62
7236,January,2022,Contra Costa,CA,Passenger,1,4,5,255,260,1.92
7237,January,2022,Santa Cruz,CA,Passenger,1,0,1,23,24,4.17
7238,January,2022,Allegheny,PA,Passenger,1,1,2,55,57,3.51
7239,January,2022,Erie,NY,Passenger,1,0,1,30,31,3.23
7240,January,2022,Camden,NJ,Passenger,0,1,1,13,14,7.14
7241,January,2022,Douglas,WA,Truck,0,0,0,12682,12682,0.0
7242,January,2022,Geary,KS,Passenger,1,0,1,91,92,1.09
7243,January,2022,Collin,TX,Passenger,1,0,1,100,101,0.99
7244,January,2022,Chesapeake,VA,Passenger,2,3,5,366,371,1.35
7245,January,2022,Grant,WA,Passenger,140,100,240,66811,67051,0.36
7246,January,2022,Pima,AZ,Passenger,1,1,2,246,248,0.81
7247,January,2022,Ulster,NY,Passenger,1,0,1,9,10,10.0
7248,January,2022,Kauai,HI,Passenger,1,0,1,17,18,5.56
7249,January,2022,Platte,MO,Passenger,1,0,1,17,18,5.56
7250,January,2022,Mason,WA,Passenger,272,161,433,47766,48199,0.9
7251,January,2022,Multnomah,OR,Passenger,1,4,5,587,592,0.84
7252,January,2022,DeKalb,GA,Passenger,1,0,1,54,55,1.82
7253,January,2022,St. Louis,MO,Passenger,1,0,1,72,73,1.37
7254,January,2022,Pacific,WA,Truck,0,0,0,8024,8024,0.0
7255,January,2022,Spartanburg,SC,Passenger,0,1,1,47,48,2.08
7256,January,2022,Kings,CA,Passenger,2,1,3,317,320,0.94
7257,January,2022,Lake,IL,Passenger,3,0,3,149,152,1.97
7258,January,2022,Prince George's,MD,Passenger,2,1,3,138,141,2.13
7259,January,2022,Sevier,AR,Passenger,0,1,1,0,1,100.0
7260,January,2022,Skamania,WA,Truck,0,0,0,3990,3990,0.0
7261,January,2022,Wilson,TX,Passenger,0,1,1,2,3,33.33
7262,January,2022,Bell,TX,Passenger,1,0,1,337,338,0.3
7263,January,2022,St. Mary's,MD,Passenger,1,0,1,200,201,0.5
7264,January,2022,Whitman,WA,Passenger,69,58,127,21971,22098,0.57
7265,January,2022,Hamilton,IN,Passenger,2,0,2,21,23,8.7
7266,January,2022,Greene,MO,Passenger,0,1,1,24,25,4.0
7267,January,2022,Klickitat,WA,Truck,0,0,0,8335,8335,0.0
7268,January,2022,Lane,OR,Passenger,0,1,1,104,105,0.95
7269,January,2022,Sarasota,FL,Passenger,2,0,2,28,30,6.67
7270,January,2023,St. Mary's,MD,Passenger,1,0,1,169,170,0.59
7271,January,2023,Chelan,WA,Truck,15,0,15,23105,23120,0.06
7272,January,2023,Hawaii,HI,Passenger,1,0,1,25,26,3.85
7273,January,2023,Randolph,NC,Passenger,1,0,1,4,5,20.0
7274,January,2023,Sarasota,FL,Passenger,1,0,1,16,17,5.88
7275,January,2023,San Joaquin,CA,Passenger,1,0,1,74,75,1.33
7276,January,2023,Clark,WA,Passenger,5070,2078,7148,314583,321731,2.22
7277,January,2023,Island,WA,Passenger,955,401,1356,61553,62909,2.16
7278,January,2023,Harnett,NC,Passenger,2,0,2,129,131,1.53
7279,January,2023,Douglas,NE,Passenger,2,1,3,28,31,9.68
7280,January,2023,Hamilton,OH,Passenger,1,0,1,25,26,3.85
7281,January,2023,Rock Island,IL,Passenger,0,1,1,14,15,6.67
7282,January,2023,Williamson,TX,Passenger,0,2,2,58,60,3.33
7283,January,2023,Allegheny,PA,Passenger,1,0,1,48,49,2.04
7284,January,2023,Santa Clara,CA,Passenger,9,2,11,167,178,6.18
7285,January,2023,Berkeley,SC,Passenger,0,1,1,108,109,0.92
7286,January,2023,Kent,DE,Passenger,1,0,1,48,49,2.04
7287,January,2023,Richmond,GA,Passenger,0,1,1,58,59,1.69
7288,January,2023,Rockdale,GA,Passenger,1,0,1,6,7,14.29
7289,January,2023,Prince George's,MD,Passenger,3,1,4,110,114,3.51
7290,January,2023,Yellowstone,MT,Passenger,0,1,1,16,17,5.88
7291,January,2023,San Juan,WA,Truck,9,0,9,5904,5913,0.15
7292,January,2023,Skamania,WA,Passenger,93,53,146,8110,8256,1.77
7293,January,2023,Whatcom,WA,Truck,37,0,37,42986,43023,0.09
7294,January,2023,Danville,VA,Passenger,1,0,1,0,1,100.0
7295,January,2023,Harris,TX,Passenger,1,0,1,118,119,0.84
7296,January,2023,Whitman,WA,Passenger,120,70,190,22014,22204,0.86
7297,January,2023,Montgomery,PA,Passenger,1,0,1,17,18,5.56
7298,January,2023,Harrison,MS,Passenger,1,0,1,32,33,3.03
7299,January,2023,Okaloosa,FL,Passenger,0,1,1,89,90,1.11
7300,January,2023,St. Louis,MO,Passenger,1,0,1,51,52,1.92
7301,January,2023,Galveston,TX,Passenger,0,1,1,16,17,5.88
7302,January,2023,Bexar,TX,Passenger,4,3,7,365,372,1.88
7303,January,2023,Grays Harbor,WA,Passenger,260,164,424,48595,49019,0.86
7304,January,2023,Cowlitz,WA,Truck,7,0,7,28344,28351,0.02
7305,January,2023,Arlington,VA,Passenger,1,0,1,104,105,0.95
7306,January,2023,Miami-Dade,FL,Passenger,1,0,1,61,62,1.61
7307,January,2023,Wahkiakum,WA,Truck,1,0,1,1794,1795,0.06
7308,January,2023,Ulster,NY,Passenger,1,0,1,4,5,20.0
7309,January,2023,Gwinnett,GA,Passenger,1,0,1,43,44,2.27
7310,January,2023,Chesapeake,VA,Passenger,2,3,5,286,291,1.72
7311,January,2023,King,WA,Truck,461,2,463,177951,178414,0.26
7312,January,2023,Honolulu,HI,Passenger,3,3,6,272,278,2.16
7313,January,2023,Elmore,ID,Passenger,1,0,1,11,12,8.33
7314,January,2023,Stevens,WA,Passenger,96,57,153,29986,30139,0.51
7315,January,2023,Frederick,MD,Passenger,1,0,1,55,56,1.79
7316,January,2023,Lewis,WA,Passenger,281,185,466,59747,60213,0.77
7317,January,2023,Broward,FL,Passenger,1,0,1,60,61,1.64
7318,January,2023,St. Clair,IL,Passenger,2,0,2,107,109,1.83
7319,January,2023,Asotin,WA,Passenger,30,20,50,12490,12540,0.4
7320,January,2023,Douglas,WA,Passenger,172,58,230,28592,28822,0.8
7321,January,2023,St. Tammany,LA,Passenger,1,0,1,29,30,3.33
7322,January,2023,Kittitas,WA,Truck,5,0,5,14551,14556,0.03
7323,January,2023,Camden,NJ,Passenger,0,1,1,12,13,7.69
7324,January,2023,Plaquemines,LA,Passenger,1,1,2,16,18,11.11
7325,January,2023,Alexandria,VA,Passenger,3,1,4,91,95,4.21
7326,January,2023,Contra Costa,CA,Passenger,0,3,3,203,206,1.46
7327,January,2023,Collin,TX,Passenger,2,0,2,46,48,4.17
7328,January,2023,Jefferson,WA,Truck,6,0,6,9368,9374,0.06
7329,January,2023,Riverside,CA,Passenger,7,0,7,384,391,1.79
7330,January,2023,Sedgwick,KS,Passenger,1,1,2,62,64,3.12
7331,January,2023,Virginia Beach,VA,Passenger,2,0,2,448,450,0.44
7332,January,2023,Bartow,GA,Passenger,0,1,1,3,4,25.0
7333,January,2023,Thurston,WA,Truck,42,0,42,54598,54640,0.08
7334,January,2023,Louisa,VA,Passenger,0,1,1,1,2,50.0
7335,January,2023,Fairbanks North Star,AK,Passenger,0,1,1,57,58,1.72
7336,January,2023,Adams,WA,Passenger,22,11,33,13010,13043,0.25
7337,January,2023,Los Angeles,CA,Passenger,4,5,9,635,644,1.4
7338,January,2023,Skagit,WA,Passenger,958,364,1322,89336,90658,1.46
7339,January,2023,Platte,MO,Passenger,1,0,1,18,19,5.26
7340,January,2023,Adams,CO,Passenger,1,0,1,32,33,3.03
7341,January,2023,Grant,WA,Truck,5,0,5,28035,28040,0.02
7342,January,2023,Richmond,NY,Passenger,1,0,1,6,7,14.29
7343,January,2023,Saratoga,NY,Passenger,1,1,2,34,36,5.56
7344,January,2023,Ferry,WA,Truck,0,0,0,3552,3552,0.0
7345,January,2023,Larimer,CO,Passenger,1,0,1,39,40,2.5
7346,January,2023,Nassau,NY,Passenger,1,0,1,21,22,4.55
7347,January,2023,Lee,FL,Passenger,1,0,1,24,25,4.0
7348,January,2023,Santa Barbara,CA,Passenger,1,0,1,65,66,1.52
7349,January,2023,Chelan,WA,Passenger,556,147,703,54338,55041,1.28
7350,January,2023,Douglas,WA,Truck,5,0,5,12874,12879,0.04
7351,January,2023,Klickitat,WA,Truck,4,0,4,8231,8235,0.05
7352,January,2023,Marin,CA,Passenger,0,1,1,29,30,3.33
7353,January,2023,Hoke,NC,Passenger,1,0,1,58,59,1.69
7354,January,2023,Island,WA,Truck,20,0,20,21176,21196,0.09
7355,January,2023,Clark,WA,Truck,62,0,62,81807,81869,0.08
7356,January,2023,San Bernardino,CA,Passenger,2,1,3,276,279,1.08
7357,January,2023,Essex,NJ,Passenger,2,0,2,7,9,22.22
7358,January,2023,Ray,MO,Passenger,0,1,1,0,1,100.0
7359,January,2023,Boulder,CO,Passenger,1,0,1,27,28,3.57
7360,January,2023,Geary,KS,Passenger,1,0,1,73,74,1.35
7361,January,2023,Pacific,WA,Passenger,72,81,153,15730,15883,0.96
7362,January,2023,Walla Walla,WA,Passenger,203,107,310,35733,36043,0.86
7363,January,2023,Bell,TX,Passenger,1,0,1,263,264,0.38
7364,January,2023,Lake,IL,Passenger,1,0,1,115,116,0.86
7365,January,2023,Norfolk,VA,Passenger,3,3,6,265,271,2.21
7366,January,2023,District of Columbia,DC,Passenger,4,0,4,152,156,2.56
7367,January,2023,Las Animas,CO,Passenger,1,0,1,0,1,100.0
7368,January,2023,DeKalb,GA,Passenger,1,0,1,39,40,2.5
7369,January,2023,Clark,NV,Passenger,4,2,6,405,411,1.46
7370,January,2023,Salt Lake,UT,Passenger,0,1,1,100,101,0.99
7371,January,2023,Oldham,KY,Passenger,0,1,1,4,5,20.0
7372,January,2023,Kitsap,WA,Passenger,2835,1163,3998,177157,181155,2.21
7373,January,2023,Montgomery,MD,Passenger,3,3,6,172,178,3.37
7374,January,2023,Hillsborough,FL,Passenger,0,1,1,103,104,0.96
7375,January,2023,Yakima,WA,Passenger,435,228,663,166438,167101,0.4
7376,January,2023,Lake,FL,Passenger,1,0,1,15,16,6.25
7377,January,2023,Cumberland,NC,Passenger,1,2,3,306,309,0.97
7378,January,2023,Garfield,WA,Passenger,1,3,4,1319,1323,0.3
7379,January,2023,Coryell,TX,Passenger,1,0,1,79,80,1.25
7380,January,2023,Yavapai,AZ,Passenger,1,0,1,22,23,4.35
7381,January,2023,Snohomish,WA,Truck,113,0,113,122400,122513,0.09
7382,January,2023,Wichita,TX,Passenger,2,0,2,34,36,5.56
7383,January,2023,Burlington,NJ,Passenger,0,2,2,93,95,2.11
7384,January,2023,Leavenworth,KS,Passenger,0,1,1,92,93,1.08
7385,January,2023,Kauai,HI,Passenger,1,1,2,13,15,13.33
7386,January,2023,Houston,GA,Passenger,1,0,1,24,25,4.0
7387,January,2023,Lincoln,WA,Truck,0,0,0,4853,4853,0.0
7388,January,2023,Santa Cruz,CA,Passenger,1,0,1,13,14,7.14
7389,January,2023,Lee,AL,Passenger,1,0,1,11,12,8.33
7390,January,2023,Sumter,SC,Passenger,0,1,1,31,32,3.12
7391,January,2023,Thurston,WA,Passenger,2703,1144,3847,191970,195817,1.96
7392,January,2023,Fairfax,VA,Passenger,5,3,8,559,567,1.41
7393,January,2023,Howard,MD,Passenger,0,1,1,43,44,2.27
7394,January,2023,Denton,TX,Passenger,1,0,1,45,46,2.17
7395,January,2023,Kittitas,WA,Passenger,312,94,406,29546,29952,1.36
7396,January,2023,Jefferson,NY,Passenger,1,1,2,183,185,1.08
7397,January,2023,Lane,OR,Passenger,0,1,1,74,75,1.33
7398,January,2023,Jackson,OK,Passenger,0,1,1,32,33,3.03
7399,January,2023,Dorchester,SC,Passenger,1,0,1,42,43,2.33
7400,January,2023,San Diego,CA,Passenger,17,9,26,1998,2024,1.28
7401,January,2023,Suffolk,VA,Passenger,1,0,1,113,114,0.88
7402,January,2023,Beaufort,SC,Passenger,1,0,1,19,20,5.0
7403,January,2023,New London,CT,Passenger,2,4,6,179,185,3.24
7404,January,2023,Whitman,WA,Truck,3,0,3,8648,8651,0.03
7406,January,2023,Okanogan,WA,Passenger,105,53,158,26127,26285,0.6
7407,January,2023,Douglas,CO,Passenger,0,1,1,55,56,1.79
7408,January,2023,Okanogan,WA,Truck,2,0,2,16435,16437,0.01
7409,January,2023,Grays Harbor,WA,Truck,2,0,2,21070,21072,0.01
7410,January,2023,Cape May,NJ,Passenger,0,1,1,7,8,12.5
7411,January,2023,Snohomish,WA,Passenger,10586,2793,13379,530262,543641,2.46
7412,January,2023,Charles,MD,Passenger,1,1,2,47,49,4.08
7413,January,2023,Lincoln,OR,Passenger,0,1,1,13,14,7.14
7414,January,2023,Mason,WA,Passenger,380,192,572,46777,47349,1.21
7415,January,2023,Garfield,WA,Truck,0,0,0,976,976,0.0
7416,January,2023,Rockingham,NH,Passenger,1,0,1,10,11,9.09
7417,January,2023,Clallam,WA,Truck,9,0,9,21848,21857,0.04
7418,January,2023,Franklin,WA,Passenger,262,124,386,61842,62228,0.62
7419,January,2023,Carroll,MD,Passenger,0,1,1,17,18,5.56
7420,January,2023,Spokane,WA,Truck,22,0,22,101916,101938,0.02
7421,January,2023,Stafford,VA,Passenger,3,1,4,78,82,4.88
7422,January,2023,Cowlitz,WA,Passenger,417,193,610,70247,70857,0.86
7423,January,2023,Wilson,TX,Passenger,0,1,1,2,3,33.33
7424,January,2023,Grant,WA,Passenger,230,113,343,66923,67266,0.51
7425,January,2023,Washington,MD,Passenger,2,0,2,14,16,12.5
7426,January,2023,Hamilton,OH,Truck,1,0,1,2,3,33.33
7427,January,2023,Moore,NC,Passenger,0,1,1,102,103,0.97
7428,January,2023,Fairfax,VA,Truck,1,0,1,96,97,1.03
7429,January,2023,Sacramento,CA,Passenger,4,0,4,159,163,2.45
7430,January,2023,Goochland,VA,Passenger,0,1,1,57,58,1.72
7431,January,2023,Columbia,WA,Truck,0,0,0,1579,1579,0.0
7432,January,2023,Portsmouth,VA,Passenger,0,1,1,63,64,1.56
7433,January,2023,Maricopa,AZ,Passenger,7,3,10,669,679,1.47
7434,January,2023,Polk,OR,Passenger,0,1,1,17,18,5.56
7435,January,2023,Newport News,VA,Passenger,1,0,1,94,95,1.05
7436,January,2023,King,WA,Passenger,49761,12517,62278,1334257,1396535,4.46
7437,January,2023,Placer,CA,Passenger,2,0,2,53,55,3.64
7438,January,2023,Mason,WA,Truck,8,0,8,20880,20888,0.04
7439,January,2023,Kootenai,ID,Truck,1,0,1,28,29,3.45
7440,January,2023,Ventura,CA,Passenger,2,1,3,201,204,1.47
7441,January,2023,Hidalgo,TX,Passenger,0,1,1,47,48,2.08
7442,January,2023,Pulaski,AR,Passenger,3,0,3,23,26,11.54
7443,January,2023,Clallam,WA,Passenger,499,267,766,49348,50114,1.53
7444,January,2023,Hennepin,MN,Passenger,1,0,1,35,36,2.78
7445,January,2023,Allen,IN,Passenger,1,0,1,11,12,8.33
7446,January,2023,El Paso,TX,Passenger,2,0,2,276,278,0.72
7447,January,2023,Kitsap,WA,Truck,41,0,41,52943,52984,0.08
7448,January,2023,Pend Oreille,WA,Truck,0,0,0,5572,5572,0.0
7449,January,2023,Lincoln,WA,Passenger,14,19,33,7764,7797,0.42
7450,January,2023,Skagit,WA,Truck,11,0,11,32085,32096,0.03
7451,January,2023,Anne Arundel,MD,Passenger,4,4,8,298,306,2.61
7452,January,2023,Monterey,CA,Passenger,1,1,2,113,115,1.74
7453,January,2023,Nueces,TX,Passenger,0,1,1,50,51,1.96
7454,January,2023,Emmet,MI,Passenger,0,1,1,0,1,100.0
7455,January,2023,Spokane,WA,Passenger,1998,953,2951,324493,327444,0.9
7456,January,2023,Arapahoe,CO,Passenger,0,1,1,65,66,1.52
7457,January,2023,Pierce,WA,Passenger,6394,2548,8942,537638,546580,1.64
7458,January,2023,Calvert,MD,Passenger,0,2,2,77,79,2.53
7459,January,2023,Napa,CA,Passenger,0,1,1,9,10,10.0
7460,January,2023,Vernon,LA,Passenger,1,0,1,71,72,1.39
7461,January,2023,Asotin,WA,Truck,0,0,0,6681,6681,0.0
7462,January,2023,Klickitat,WA,Passenger,127,53,180,15178,15358,1.17
7463,January,2023,Loudoun,VA,Passenger,3,1,4,58,62,6.45
7464,January,2023,Middlesex,MA,Passenger,2,1,3,60,63,4.76
7465,January,2023,Adams,WA,Truck,1,0,1,5377,5378,0.02
7466,January,2023,Yakima,WA,Truck,8,0,8,61183,61191,0.01
7467,January,2023,Duval,FL,Passenger,1,0,1,236,237,0.42
7468,January,2023,Kings,CA,Passenger,2,1,3,273,276,1.09
7469,January,2023,Franklin,WA,Truck,4,0,4,20981,20985,0.02
7470,January,2023,Escambia,FL,Passenger,0,1,1,109,110,0.91
7471,January,2023,San Juan,WA,Passenger,572,173,745,13878,14623,5.09
7472,January,2023,Columbia,WA,Passenger,8,1,9,2438,2447,0.37
7473,January,2023,Alameda,CA,Passenger,3,0,3,154,157,1.91
7474,January,2023,Montgomery,AL,Passenger,0,1,1,29,30,3.33
7475,January,2023,Onslow,NC,Passenger,0,1,1,141,142,0.7
7476,January,2023,Hudson,NJ,Passenger,1,0,1,27,28,3.57
7477,January,2023,Ferry,WA,Passenger,24,4,28,4346,4374,0.64
7478,January,2023,Lewis,WA,Truck,2,0,2,26285,26287,0.01
7479,January,2023,Charleston,SC,Passenger,2,2,4,54,58,6.9
7480,January,2023,Pacific,WA,Truck,2,0,2,7831,7833,0.03
7481,January,2023,Pend Oreille,WA,Passenger,23,14,37,8954,8991,0.41
7482,January,2023,Sarpy,NE,Passenger,1,0,1,46,47,2.13
7483,January,2023,Stevens,WA,Truck,2,0,2,18772,18774,0.01
7484,January,2023,Solano,CA,Passenger,4,0,4,140,144,2.78
7485,January,2023,El Paso,CO,Passenger,3,1,4,511,515,0.78
7486,January,2023,Cook,IL,Passenger,2,0,2,152,154,1.3
7487,January,2023,Whatcom,WA,Passenger,2153,822,2975,148714,151689,1.96
7488,January,2023,Dallas,TX,Passenger,1,0,1,79,80,1.25
7489,January,2023,Walla Walla,WA,Truck,3,0,3,13863,13866,0.02
7490,January,2023,Sheridan,WY,Passenger,1,0,1,5,6,16.67
7491,January,2023,Cumberland,PA,Passenger,1,0,1,32,33,3.03
7492,January,2023,Bryan,GA,Passenger,0,1,1,37,38,2.63
7493,January,2023,Orange,CA,Passenger,7,2,9,289,298,3.02
7494,January,2023,Benton,WA,Passenger,961,512,1473,135906,137379,1.07
7495,January,2023,Pierce,WA,Truck,97,0,97,139157,139254,0.07
7496,January,2023,Madison,IL,Passenger,1,0,1,15,16,6.25
7497,January,2023,Kern,CA,Passenger,1,1,2,186,188,1.06
7498,January,2023,Champaign,IL,Passenger,1,0,1,7,8,12.5
7499,January,2023,New Haven,CT,Passenger,0,2,2,22,24,8.33
7500,January,2023,Jefferson,WA,Passenger,495,236,731,24276,25007,2.92
7501,January,2023,Travis,TX,Passenger,1,0,1,77,78,1.28
7502,January,2023,Wahkiakum,WA,Passenger,25,15,40,3050,3090,1.29
7503,January,2023,Skamania,WA,Truck,1,0,1,3877,3878,0.03
7504,January,2023,Multnomah,OR,Passenger,0,2,2,432,434,0.46
7505,January,2023,Sonoma,CA,Passenger,1,1,2,60,62,3.23
7506,January,2023,Benton,WA,Truck,13,0,13,43322,43335,0.03
7507,July,2017,Pierce,WA,Passenger,986,856,1842,524592,526434,0.35
7508,July,2017,Jefferson,NY,Passenger,1,1,2,249,251,0.8
7509,July,2017,Allegheny,PA,Passenger,1,0,1,90,91,1.1
7510,July,2017,Clark,NV,Passenger,1,2,3,813,816,0.37
7511,July,2017,Volusia,FL,Passenger,0,1,1,45,46,2.17
7512,July,2017,Franklin,MA,Passenger,0,1,1,4,5,20.0
7513,July,2017,New Haven,CT,Passenger,0,1,1,57,58,1.72
7514,July,2017,Gwinnett,GA,Passenger,0,1,1,82,83,1.2
7515,July,2017,Walla Walla,WA,Truck,0,0,0,13177,13177,0.0
7516,July,2017,Sedgwick,KS,Passenger,0,1,1,109,110,0.91
7517,July,2017,Dane,WI,Passenger,1,0,1,86,87,1.15
7518,July,2017,Franklin,WA,Passenger,26,47,73,55735,55808,0.13
7519,July,2017,Clark,WA,Truck,0,0,0,77737,77737,0.0
7520,July,2017,Latah,ID,Passenger,0,1,1,97,98,1.02
7521,July,2017,Ferry,WA,Truck,0,0,0,3526,3526,0.0
7522,July,2017,Hardin,KY,Passenger,0,1,1,121,122,0.82
7523,July,2017,Clallam,WA,Truck,0,0,0,21043,21043,0.0
7524,July,2017,Pinal,AZ,Passenger,2,0,2,235,237,0.84
7525,July,2017,Nassau,NY,Passenger,1,1,2,39,41,4.88
7526,July,2017,Garfield,WA,Passenger,0,0,0,1296,1296,0.0
7527,July,2017,Yakima,WA,Truck,0,0,0,57469,57469,0.0
7528,July,2017,Island,WA,Truck,0,0,0,20500,20500,0.0
7529,July,2017,Anne Arundel,MD,Passenger,0,1,1,501,502,0.2
7530,July,2017,Kittitas,WA,Truck,0,0,0,13581,13581,0.0
7531,July,2017,Canyon,ID,Passenger,0,1,1,97,98,1.02
7532,July,2017,King,WA,Passenger,10255,4174,14429,1373311,1387740,1.04
7533,July,2017,Nueces,TX,Passenger,0,1,1,96,97,1.03
7534,July,2017,Kitsap,WA,Passenger,622,324,946,173384,174330,0.54
7535,July,2017,Morris,NJ,Passenger,1,0,1,25,26,3.85
7536,July,2017,Whitman,WA,Passenger,12,19,31,22108,22139,0.14
7537,July,2017,Flathead,MT,Passenger,1,0,1,60,61,1.64
7538,July,2017,Fairfax,VA,Passenger,2,2,4,848,852,0.47
7539,July,2017,Alameda,CA,Passenger,1,1,2,358,360,0.56
7540,July,2017,Mason,WA,Truck,0,0,0,19261,19261,0.0
7541,July,2017,Juneau,AK,Passenger,0,1,1,45,46,2.17
7542,July,2017,Wayne,MI,Passenger,0,1,1,69,70,1.43
7543,July,2017,Pend Oreille,WA,Truck,0,0,0,5582,5582,0.0
7544,July,2017,Tulare,CA,Passenger,1,0,1,195,196,0.51
7545,July,2017,Grant,WA,Passenger,19,30,49,61004,61053,0.08
7546,July,2017,Marion,OR,Passenger,1,0,1,162,163,0.61
7547,July,2017,St. Lucie,FL,Passenger,1,0,1,32,33,3.03
7548,July,2017,Jefferson,WA,Truck,0,0,0,9414,9414,0.0
7549,July,2017,Douglas,WA,Passenger,35,26,61,26756,26817,0.23
7550,July,2017,Orleans,LA,Passenger,0,1,1,47,48,2.08
7551,July,2017,Albemarle,VA,Passenger,0,1,1,32,33,3.03
7552,July,2017,Dallas,TX,Passenger,0,1,1,180,181,0.55
7553,July,2017,Grays Harbor,WA,Truck,0,0,0,19894,19894,0.0
7554,July,2017,Asotin,WA,Passenger,8,4,12,12439,12451,0.1
7555,July,2017,Shelby,TN,Passenger,0,1,1,109,110,0.91
7556,July,2017,Garfield,WA,Truck,0,0,0,926,926,0.0
7557,July,2017,San Diego,CA,Passenger,6,1,7,2699,2706,0.26
7558,July,2017,Lincoln,WA,Truck,0,0,0,4445,4445,0.0
7559,July,2017,Clark,WA,Passenger,795,517,1312,299957,301269,0.44
7560,July,2017,Montgomery,MD,Passenger,1,0,1,306,307,0.33
7561,July,2017,Multnomah,OR,Passenger,1,3,4,953,957,0.42
7562,July,2017,San Juan,WA,Truck,0,0,0,5547,5547,0.0
7563,July,2017,Lewis,WA,Truck,0,0,0,24914,24914,0.0
7564,July,2017,Hamilton,TN,Passenger,1,0,1,18,19,5.26
7565,July,2017,Skagit,WA,Passenger,141,104,245,88182,88427,0.28
7566,July,2017,Palm Beach,FL,Passenger,0,1,1,96,97,1.03
7567,July,2017,Hawaii,HI,Passenger,1,0,1,80,81,1.23
7568,July,2017,Skamania,WA,Passenger,9,7,16,8552,8568,0.19
7569,July,2017,Tuolumne,CA,Passenger,0,1,1,14,15,6.67
7570,July,2017,Essex,NJ,Passenger,1,0,1,14,15,6.67
7571,July,2017,Bergen,NJ,Passenger,0,2,2,30,32,6.25
7572,July,2017,Richmond,GA,Passenger,0,1,1,88,89,1.12
7573,July,2017,Deschutes,OR,Passenger,1,0,1,195,196,0.51
7574,July,2017,Thurston,WA,Passenger,418,350,768,187062,187830,0.41
7575,July,2017,Kittitas,WA,Passenger,24,19,43,27678,27721,0.16
7576,July,2017,Snohomish,WA,Passenger,1818,920,2738,513286,516024,0.53
7577,July,2017,Lincoln,WA,Passenger,2,5,7,7519,7526,0.09
7578,July,2017,Prince George's,MD,Passenger,0,1,1,187,188,0.53
7579,July,2017,Pierce,WA,Truck,0,0,0,137369,137369,0.0
7580,July,2017,Clallam,WA,Passenger,93,77,170,48417,48587,0.35
7581,July,2017,Jackson,MO,Passenger,1,0,1,57,58,1.72
7582,July,2017,Kent,MI,Passenger,0,1,1,37,38,2.63
7583,July,2017,San Mateo,CA,Passenger,0,1,1,151,152,0.66
7584,July,2017,Madison,ID,Passenger,1,0,1,39,40,2.5
7585,July,2017,Manassas,VA,Passenger,0,1,1,9,10,10.0
7586,July,2017,DeKalb,IN,Passenger,1,0,1,1,2,50.0
7587,July,2017,Okaloosa,FL,Passenger,1,0,1,183,184,0.54
7588,July,2017,Chelan,WA,Passenger,68,35,103,52135,52238,0.2
7589,July,2017,District of Columbia,DC,Passenger,0,3,3,211,214,1.4
7590,July,2017,Virginia Beach,VA,Passenger,2,1,3,653,656,0.46
7591,July,2017,Franklin,WA,Truck,0,0,0,18175,18175,0.0
7592,July,2017,Cowlitz,WA,Truck,0,0,0,27954,27954,0.0
7593,July,2017,Missoula,MT,Passenger,1,0,1,72,73,1.37
7594,July,2017,Santa Clara,CA,Passenger,5,2,7,399,406,1.72
7595,July,2017,Hamilton,IN,Passenger,1,0,1,58,59,1.69
7596,July,2017,Stevens,WA,Truck,0,0,0,18211,18211,0.0
7597,July,2017,Polk,FL,Passenger,1,0,1,63,64,1.56
7598,July,2017,Chelan,WA,Truck,0,0,0,21329,21329,0.0
7599,July,2017,Dale,AL,Passenger,0,1,1,64,65,1.54
7600,July,2017,Pacific,WA,Passenger,10,9,19,15197,15216,0.12
7601,July,2017,Montgomery,PA,Passenger,1,0,1,39,40,2.5
7602,July,2017,Carroll,NH,Passenger,0,1,1,1,2,50.0
7604,July,2017,Fulton,GA,Passenger,1,0,1,113,114,0.88
7605,July,2017,Monterey,CA,Passenger,0,2,2,199,201,1.0
7606,July,2017,Grant,WA,Truck,0,0,0,25271,25271,0.0
7607,July,2017,Honolulu,HI,Passenger,3,2,5,570,575,0.87
7608,July,2017,Charles,MD,Passenger,0,1,1,86,87,1.15
7609,July,2017,Skagit,WA,Truck,1,0,1,31485,31486,0.0
7610,July,2017,Okanogan,WA,Passenger,4,18,22,25634,25656,0.09
7611,July,2017,Cobb,GA,Passenger,0,1,1,77,78,1.28
7612,July,2017,Jefferson,WA,Passenger,107,61,168,23895,24063,0.7
7613,July,2017,Franklin,OH,Passenger,0,1,1,119,120,0.83
7614,July,2017,Columbia,WA,Truck,0,0,0,1533,1533,0.0
7615,July,2017,Utah,UT,Passenger,0,1,1,153,154,0.65
7616,July,2017,Wahkiakum,WA,Passenger,0,2,2,2836,2838,0.07
7617,July,2017,Benton,WA,Passenger,155,148,303,128671,128974,0.23
7618,July,2017,Orange,FL,Passenger,1,1,2,131,133,1.5
7619,July,2017,Spokane,WA,Truck,1,0,1,90744,90745,0.0
7620,July,2017,El Paso,CO,Passenger,2,0,2,789,791,0.25
7621,July,2017,Prince William,VA,Passenger,0,3,3,271,274,1.09
7622,July,2017,Frederick,MD,Passenger,0,1,1,82,83,1.2
7623,July,2017,Moore,NC,Passenger,0,1,1,199,200,0.5
7624,July,2017,Dakota,MN,Passenger,0,1,1,36,37,2.7
7625,July,2017,Pima,AZ,Passenger,1,2,3,425,428,0.7
7626,July,2017,Wahkiakum,WA,Truck,0,0,0,1659,1659,0.0
7627,July,2017,Santa Fe,NM,Passenger,0,1,1,43,44,2.27
7628,July,2017,Duval,FL,Passenger,1,1,2,378,380,0.53
7629,July,2017,New London,CT,Passenger,1,1,2,253,255,0.78
7630,July,2017,Okanogan,WA,Truck,0,0,0,16226,16226,0.0
7631,July,2017,Island,WA,Passenger,121,141,262,60273,60535,0.43
7632,July,2017,Yakima,WA,Passenger,49,62,111,159655,159766,0.07
7633,July,2017,Sangamon,IL,Passenger,1,0,1,11,12,8.33
7634,July,2017,Grays Harbor,WA,Passenger,36,35,71,44850,44921,0.16
7635,July,2017,Kitsap,WA,Truck,1,0,1,52511,52512,0.0
7636,July,2017,Columbia,WA,Passenger,1,1,2,2350,2352,0.09
7637,July,2017,Stevens,WA,Passenger,8,23,31,31395,31426,0.1
7638,July,2017,Klickitat,WA,Truck,0,0,0,7953,7953,0.0
7639,July,2017,Asotin,WA,Truck,0,0,0,6532,6532,0.0
7640,July,2017,DeKalb,GA,Passenger,1,0,1,84,85,1.18
7641,July,2017,Sumter,FL,Passenger,0,1,1,10,11,9.09
7642,July,2017,Walla Walla,WA,Passenger,27,26,53,34886,34939,0.15
7643,July,2017,Adams,WA,Truck,0,0,0,5123,5123,0.0
7644,July,2017,Pacific,WA,Truck,0,0,0,7495,7495,0.0
7645,July,2017,Pend Oreille,WA,Passenger,3,4,7,9321,9328,0.08
7646,July,2017,Spokane,WA,Passenger,262,213,475,296652,297127,0.16
7647,July,2017,Whatcom,WA,Truck,2,0,2,41660,41662,0.0
7648,July,2017,Travis,TX,Passenger,0,1,1,190,191,0.52
7649,July,2017,Maui,HI,Passenger,1,0,1,68,69,1.45
7650,July,2017,Benton,WA,Truck,0,0,0,40129,40129,0.0
7651,July,2017,Los Angeles,CA,Passenger,3,1,4,1271,1275,0.31
7652,July,2017,Norfolk,MA,Passenger,1,0,1,37,38,2.63
7653,July,2017,Cape May,NJ,Passenger,0,1,1,19,20,5.0
7654,July,2017,Arlington,VA,Passenger,1,1,2,167,169,1.18
7655,July,2017,Lumpkin,GA,Passenger,1,0,1,9,10,10.0
7656,July,2017,Portsmouth,VA,Passenger,0,1,1,66,67,1.49
7657,July,2017,San Juan,WA,Passenger,112,39,151,13563,13714,1.1
7658,July,2017,Ferry,WA,Passenger,1,1,2,4400,4402,0.05
7659,July,2017,Lee,AL,Passenger,1,0,1,36,37,2.7
7660,July,2017,Ramsey,MN,Passenger,1,0,1,40,41,2.44
7661,July,2017,Manatee,FL,Passenger,1,0,1,42,43,2.33
7662,July,2017,Snohomish,WA,Truck,1,0,1,121771,121772,0.0
7663,July,2017,Klickitat,WA,Passenger,22,24,46,14803,14849,0.31
7664,July,2017,Adams,WA,Passenger,3,3,6,12184,12190,0.05
7665,July,2017,Thurston,WA,Truck,0,0,0,53297,53297,0.0
7666,July,2017,Lane,OR,Passenger,0,1,1,228,229,0.44
7667,July,2017,Douglas,WA,Truck,0,0,0,11515,11515,0.0
7668,July,2017,Howard,MD,Passenger,0,2,2,92,94,2.13
7669,July,2017,Montgomery,TN,Passenger,1,0,1,280,281,0.36
7670,July,2017,Riverside,CA,Passenger,1,1,2,787,789,0.25
7671,July,2017,Skamania,WA,Truck,0,0,0,3873,3873,0.0
7672,July,2017,Mason,WA,Passenger,57,71,128,43631,43759,0.29
7673,July,2017,Maricopa,AZ,Passenger,2,0,2,1705,1707,0.12
7674,July,2017,Whitman,WA,Truck,0,0,0,8425,8425,0.0
7675,July,2017,Lewis,WA,Passenger,52,36,88,55557,55645,0.16
7676,July,2017,Bexar,TX,Passenger,1,1,2,888,890,0.22
7677,July,2017,Whatcom,WA,Passenger,474,179,653,143186,143839,0.45
7678,July,2017,Orange,CA,Passenger,3,1,4,627,631,0.63
7679,July,2017,King,WA,Truck,8,1,9,187250,187259,0.0
7680,July,2017,Norfolk,VA,Passenger,1,1,2,312,314,0.64
7681,July,2017,Saratoga,NY,Passenger,1,1,2,74,76,2.63
7682,July,2017,Tarrant,TX,Passenger,1,0,1,242,243,0.41
7683,July,2017,Nantucket,MA,Passenger,1,0,1,3,4,25.0
7684,July,2017,Santa Rosa,FL,Passenger,1,0,1,112,113,0.88
7685,July,2017,Cowlitz,WA,Passenger,52,61,113,69775,69888,0.16
7686,July,2017,Marin,CA,Passenger,1,0,1,58,59,1.69
7687,July,2017,Twin Falls,ID,Passenger,0,1,1,23,24,4.17
7688,July,2018,Whatcom,WA,Truck,2,0,2,42313,42315,0.0
7689,July,2018,Nantucket,MA,Passenger,1,0,1,4,5,20.0
7690,July,2018,Whatcom,WA,Passenger,637,318,955,147985,148940,0.64
7691,July,2018,Skagit,WA,Truck,1,0,1,32118,32119,0.0
7692,July,2018,Grays Harbor,WA,Truck,0,0,0,20227,20227,0.0
7693,July,2018,Washington,OR,Passenger,0,1,1,479,480,0.21
7694,July,2018,Pacific,WA,Truck,0,0,0,7611,7611,0.0
7695,July,2018,Charles,MD,Passenger,0,1,1,82,83,1.2
7696,July,2018,Okanogan,WA,Truck,0,0,0,16423,16423,0.0
7697,July,2018,Stevens,WA,Passenger,11,25,36,31650,31686,0.11
7698,July,2018,Jefferson,CO,Passenger,0,1,1,65,66,1.52
7699,July,2018,Lane,OR,Passenger,0,1,1,184,185,0.54
7700,July,2018,Hawaii,HI,Passenger,1,0,1,73,74,1.35
7701,July,2018,Clay,FL,Passenger,0,1,1,92,93,1.08
7702,July,2018,Lewis,WA,Truck,0,0,0,25583,25583,0.0
7703,July,2018,Franklin,MA,Passenger,0,1,1,1,2,50.0
7704,July,2018,Multnomah,OR,Passenger,3,4,7,791,798,0.88
7705,July,2018,DeKalb,GA,Passenger,1,0,1,79,80,1.25
7706,July,2018,Carson City,NV,Passenger,1,0,1,14,15,6.67
7707,July,2018,Clackamas,OR,Passenger,0,1,1,216,217,0.46
7708,July,2018,Island,WA,Truck,0,0,0,20994,20994,0.0
7709,July,2018,Cowlitz,WA,Truck,0,0,0,28560,28560,0.0
7710,July,2018,Los Angeles,CA,Passenger,7,4,11,1140,1151,0.96
7711,July,2018,Benton,WA,Passenger,193,197,390,131733,132123,0.3
7712,July,2018,Anne Arundel,MD,Passenger,0,1,1,450,451,0.22
7713,July,2018,Spokane,WA,Truck,1,0,1,92869,92870,0.0
7714,July,2018,Pima,AZ,Passenger,1,1,2,410,412,0.49
7715,July,2018,Garfield,WA,Passenger,1,1,2,1320,1322,0.15
7716,July,2018,Manassas,VA,Passenger,0,1,1,9,10,10.0
7717,July,2018,Richland,SC,Passenger,0,1,1,169,170,0.59
7718,July,2018,Lewis,WA,Passenger,83,59,142,57814,57956,0.25
7719,July,2018,Manatee,FL,Passenger,1,0,1,37,38,2.63
7720,July,2018,Morris,NJ,Passenger,1,0,1,16,17,5.88
7721,July,2018,Grant,WA,Truck,0,0,0,25943,25943,0.0
7722,July,2018,Virginia Beach,VA,Passenger,2,1,3,692,695,0.43
7723,July,2018,Cowlitz,WA,Passenger,57,77,134,71871,72005,0.19
7724,July,2018,Grant,WA,Passenger,33,47,80,63265,63345,0.13
7725,July,2018,Columbia,WA,Truck,0,0,0,1530,1530,0.0
7726,July,2018,Tarrant,TX,Passenger,1,0,1,218,219,0.46
7727,July,2018,Allegheny,PA,Passenger,1,0,1,77,78,1.28
7728,July,2018,San Mateo,CA,Passenger,1,1,2,130,132,1.52
7729,July,2018,Ada,ID,Passenger,0,2,2,319,321,0.62
7730,July,2018,Pierce,WA,Truck,0,0,0,138077,138077,0.0
7731,July,2018,Queens,NY,Passenger,1,0,1,61,62,1.61
7732,July,2018,Wahkiakum,WA,Truck,0,0,0,1681,1681,0.0
7733,July,2018,Richmond,GA,Passenger,0,1,1,92,93,1.08
7734,July,2018,Cochise,AZ,Passenger,0,1,1,119,120,0.83
7735,July,2018,Klickitat,WA,Truck,0,0,0,8126,8126,0.0
7736,July,2018,Jefferson,WA,Passenger,147,99,246,24581,24827,0.99
7737,July,2018,Grays Harbor,WA,Passenger,54,62,116,46760,46876,0.25
7738,July,2018,Yakima,WA,Passenger,65,93,158,163968,164126,0.1
7739,July,2018,Skamania,WA,Truck,0,0,0,3960,3960,0.0
7740,July,2018,Arlington,VA,Passenger,1,2,3,175,178,1.69
7741,July,2018,Clark,WA,Passenger,1042,744,1786,308652,310438,0.58
7742,July,2018,Shelby,TN,Passenger,0,1,1,102,103,0.97
7743,July,2018,Ramsey,MN,Passenger,1,0,1,40,41,2.44
7744,July,2018,Lincoln,WA,Passenger,3,6,9,7748,7757,0.12
7745,July,2018,Hennepin,MN,Passenger,1,0,1,108,109,0.92
7746,July,2018,Brevard,FL,Passenger,0,1,1,91,92,1.09
7747,July,2018,Sangamon,IL,Passenger,1,0,1,11,12,8.33
7748,July,2018,Washtenaw,MI,Passenger,1,0,1,38,39,2.56
7749,July,2018,Jefferson,NY,Passenger,0,1,1,226,227,0.44
7750,July,2018,San Juan,PR,Passenger,0,1,1,4,5,20.0
7751,July,2018,Frederick,MD,Passenger,0,1,1,86,87,1.15
7752,July,2018,Nueces,TX,Passenger,1,1,2,89,91,2.2
7753,July,2018,Carroll,NH,Passenger,0,1,1,1,2,50.0
7754,July,2018,Tuolumne,CA,Passenger,0,1,1,11,12,8.33
7755,July,2018,King,WA,Passenger,13479,5802,19281,1372470,1391751,1.39
7756,July,2018,Montgomery,PA,Passenger,2,0,2,34,36,5.56
7757,July,2018,Adams,WA,Passenger,5,5,10,12641,12651,0.08
7758,July,2018,Honolulu,HI,Passenger,1,2,3,525,528,0.57
7759,July,2018,Pinal,AZ,Passenger,2,0,2,204,206,0.97
7760,July,2018,Thurston,WA,Truck,0,0,0,54414,54414,0.0
7761,July,2018,Jefferson,WA,Truck,0,0,0,9588,9588,0.0
7762,July,2018,Moore,NC,Passenger,0,1,1,197,198,0.51
7763,July,2018,Lee,AL,Passenger,1,0,1,37,38,2.63
7764,July,2018,Franklin,WA,Passenger,38,66,104,58177,58281,0.18
7765,July,2018,Beaufort,SC,Passenger,1,0,1,37,38,2.63
7766,July,2018,Whitman,WA,Truck,0,0,0,8496,8496,0.0
7767,July,2018,Montgomery,TX,Passenger,1,0,1,62,63,1.59
7768,July,2018,Twin Falls,ID,Passenger,0,1,1,23,24,4.17
7769,July,2018,Island,WA,Passenger,206,194,400,62580,62980,0.64
7770,July,2018,Ferry,WA,Truck,0,0,0,3535,3535,0.0
7771,July,2018,New London,CT,Passenger,0,1,1,250,251,0.4
7772,July,2018,Kootenai,ID,Passenger,0,1,1,220,221,0.45
7773,July,2018,Orleans,LA,Passenger,0,1,1,47,48,2.08
7774,July,2018,Charleston,SC,Passenger,1,0,1,128,129,0.78
7775,July,2018,Gwinnett,GA,Passenger,0,1,1,82,83,1.2
7776,July,2018,Volusia,FL,Passenger,0,1,1,32,33,3.03
7777,July,2018,Monroe,IL,Passenger,1,0,1,5,6,16.67
7778,July,2018,District of Columbia,DC,Passenger,0,3,3,192,195,1.54
7779,July,2018,Madison,ID,Passenger,1,0,1,40,41,2.44
7780,July,2018,Collin,TX,Passenger,1,0,1,155,156,0.64
7781,July,2018,Franklin,WA,Truck,0,0,0,18741,18741,0.0
7782,July,2018,Lumpkin,GA,Passenger,1,0,1,7,8,12.5
7783,July,2018,Fulton,GA,Passenger,1,2,3,106,109,2.75
7784,July,2018,Chelan,WA,Truck,0,0,0,21950,21950,0.0
7785,July,2018,Skagit,WA,Passenger,215,171,386,90712,91098,0.42
7786,July,2018,Riverside,CA,Passenger,2,2,4,693,697,0.57
7787,July,2018,Thurston,WA,Passenger,577,497,1074,193753,194827,0.55
7788,July,2018,San Juan,WA,Passenger,149,62,211,14115,14326,1.47
7789,July,2018,Sedgwick,KS,Passenger,0,1,1,99,100,1.0
7790,July,2018,Douglas,WA,Passenger,43,32,75,27719,27794,0.27
7791,July,2018,San Diego,CA,Passenger,7,1,8,2569,2577,0.31
7792,July,2018,Montgomery,MD,Passenger,1,0,1,285,286,0.35
7793,July,2018,Alameda,CA,Passenger,0,1,1,343,344,0.29
7794,July,2018,Caddo,LA,Passenger,0,1,1,22,23,4.35
7795,July,2018,Skamania,WA,Passenger,13,9,22,8635,8657,0.25
7796,July,2018,Palm Beach,FL,Passenger,0,1,1,85,86,1.16
7797,July,2018,Pend Oreille,WA,Passenger,5,5,10,9578,9588,0.1
7798,July,2018,Santa Clara,CA,Passenger,7,0,7,372,379,1.85
7799,July,2018,Washoe,NV,Passenger,1,0,1,119,120,0.83
7800,July,2018,Mason,WA,Truck,0,0,0,20051,20051,0.0
7801,July,2018,DuPage,IL,Passenger,1,0,1,61,62,1.61
7802,July,2018,Mason,WA,Passenger,87,93,180,45864,46044,0.39
7803,July,2018,Essex,NJ,Passenger,1,0,1,11,12,8.33
7804,July,2018,Cook,IL,Passenger,1,0,1,257,258,0.39
7805,July,2018,Santa Fe,NM,Passenger,0,1,1,44,45,2.22
7806,July,2018,St. Lucie,FL,Passenger,1,0,1,29,30,3.33
7807,July,2018,Ventura,CA,Passenger,0,2,2,312,314,0.64
7809,July,2018,Stevens,WA,Truck,0,0,0,18650,18650,0.0
7810,July,2018,Hamilton,IN,Passenger,1,0,1,46,47,2.13
7811,July,2018,Klickitat,WA,Passenger,24,31,55,15220,15275,0.36
7812,July,2018,Howard,MD,Passenger,0,1,1,87,88,1.14
7813,July,2018,San Juan,WA,Truck,0,0,0,5730,5730,0.0
7814,July,2018,Kitsap,WA,Truck,1,0,1,53372,53373,0.0
7815,July,2018,Marion,IN,Passenger,1,0,1,118,119,0.84
7816,July,2018,Pierce,WA,Passenger,1262,1194,2456,533502,535958,0.46
7817,July,2018,Lincoln,WA,Truck,0,0,0,4557,4557,0.0
7818,July,2018,Snohomish,WA,Passenger,2404,1295,3699,522666,526365,0.7
7819,July,2018,Saratoga,NY,Passenger,1,1,2,63,65,3.08
7820,July,2018,Asotin,WA,Passenger,11,8,19,12637,12656,0.15
7821,July,2018,Deschutes,OR,Passenger,1,0,1,165,166,0.6
7822,July,2018,Kitsap,WA,Passenger,809,473,1282,178849,180131,0.71
7823,July,2018,King,WA,Truck,7,1,8,182983,182991,0.0
7824,July,2018,Bexar,TX,Passenger,2,4,6,741,747,0.8
7825,July,2018,Asotin,WA,Truck,0,0,0,6628,6628,0.0
7826,July,2018,San Francisco,CA,Passenger,1,1,2,124,126,1.59
7827,July,2018,Pend Oreille,WA,Truck,0,0,0,5699,5699,0.0
7828,July,2018,Pacific,WA,Passenger,19,21,40,15621,15661,0.26
7829,July,2018,Polk,FL,Passenger,1,0,1,65,66,1.52
7830,July,2018,Walla Walla,WA,Passenger,34,44,78,35739,35817,0.22
7831,July,2018,Benton,WA,Truck,0,0,0,41093,41093,0.0
7832,July,2018,Santa Rosa,FL,Passenger,1,0,1,94,95,1.05
7833,July,2018,Monterey,CA,Passenger,0,1,1,184,185,0.54
7834,July,2018,Contra Costa,CA,Passenger,0,1,1,449,450,0.22
7835,July,2018,Garfield,OK,Passenger,1,0,1,16,17,5.88
7836,July,2018,Nassau,NY,Passenger,2,0,2,37,39,5.13
7837,July,2018,DeKalb,IN,Passenger,1,0,1,1,2,50.0
7838,July,2018,Snohomish,WA,Truck,1,0,1,121679,121680,0.0
7839,July,2018,Hardin,KY,Passenger,0,1,1,120,121,0.83
7840,July,2018,Walla Walla,WA,Truck,0,0,0,13467,13467,0.0
7841,July,2018,Cape May,NJ,Passenger,0,1,1,21,22,4.55
7842,July,2018,Marin,CA,Passenger,1,0,1,55,56,1.79
7843,July,2018,Orange,CA,Passenger,4,1,5,553,558,0.9
7844,July,2018,Prince William,VA,Passenger,0,4,4,264,268,1.49
7845,July,2018,Wahkiakum,WA,Passenger,1,1,2,2938,2940,0.07
7846,July,2018,Norfolk,MA,Passenger,1,0,1,38,39,2.56
7847,July,2018,Clallam,WA,Truck,0,0,0,21477,21477,0.0
7848,July,2018,El Paso,CO,Passenger,2,1,3,755,758,0.4
7849,July,2018,Broward,FL,Passenger,1,1,2,131,133,1.5
7850,July,2018,Chelan,WA,Passenger,112,52,164,53574,53738,0.31
7851,July,2018,Maui,HI,Passenger,1,0,1,55,56,1.79
7852,July,2018,Lee,FL,Passenger,1,0,1,57,58,1.72
7853,July,2018,Juneau,AK,Passenger,0,1,1,48,49,2.04
7854,July,2018,St. Clair,IL,Passenger,0,1,1,152,153,0.65
7855,July,2018,Sumter,FL,Passenger,0,1,1,10,11,9.09
7856,July,2018,Spokane,WA,Passenger,347,320,667,304017,304684,0.22
7857,July,2018,Columbia,WA,Passenger,2,2,4,2419,2423,0.17
7858,July,2018,Clark,WA,Truck,0,0,0,79240,79240,0.0
7859,July,2018,Portsmouth,VA,Passenger,0,1,1,72,73,1.37
7860,July,2018,Maricopa,AZ,Passenger,2,1,3,1570,1573,0.19
7861,July,2018,New Haven,CT,Passenger,0,1,1,48,49,2.04
7862,July,2018,Prince George,VA,Passenger,0,1,1,76,77,1.3
7863,July,2018,Douglas,NE,Passenger,0,1,1,71,72,1.39
7864,July,2018,Orange,FL,Passenger,2,1,3,172,175,1.71
7865,July,2018,Prince George's,MD,Passenger,1,1,2,185,187,1.07
7866,July,2018,Flathead,MT,Passenger,1,0,1,49,50,2.0
7867,July,2018,Williamson,TX,Passenger,0,1,1,161,162,0.62
7868,July,2018,Duval,FL,Passenger,1,2,3,383,386,0.78
7869,July,2018,Norfolk,VA,Passenger,2,2,4,328,332,1.2
7870,July,2018,Kent,MI,Passenger,0,1,1,28,29,3.45
7871,July,2018,Camden,NJ,Passenger,0,1,1,32,33,3.03
7872,July,2018,Fairfax,VA,Passenger,2,2,4,832,836,0.48
7873,July,2018,St. Mary's,MD,Passenger,1,0,1,217,218,0.46
7874,July,2018,El Paso,TX,Passenger,1,0,1,509,510,0.2
7875,July,2018,Garfield,WA,Truck,0,0,0,956,956,0.0
7876,July,2018,Tulsa,OK,Passenger,1,1,2,47,49,4.08
7877,July,2018,Travis,TX,Passenger,0,1,1,191,192,0.52
7878,July,2018,Yakima,WA,Truck,0,0,0,58542,58542,0.0
7879,July,2018,Utah,UT,Passenger,0,1,1,133,134,0.75
7880,July,2018,Ferry,WA,Passenger,3,3,6,4424,4430,0.14
7881,July,2018,Clallam,WA,Passenger,127,111,238,49977,50215,0.47
7882,July,2018,Kittitas,WA,Truck,0,0,0,14053,14053,0.0
7883,July,2018,Dale,AL,Passenger,0,1,1,59,60,1.67
7884,July,2018,Adams,WA,Truck,0,0,0,5161,5161,0.0
7885,July,2018,Kittitas,WA,Passenger,48,32,80,28990,29070,0.28
7886,July,2018,Dakota,MN,Passenger,0,2,2,35,37,5.41
7887,July,2018,Douglas,WA,Truck,0,0,0,11970,11970,0.0
7888,July,2018,Clark,NV,Passenger,1,2,3,739,742,0.4
7889,July,2018,Latah,ID,Passenger,0,1,1,72,73,1.37
7890,July,2018,Okanogan,WA,Passenger,9,20,29,26029,26058,0.11
7891,July,2018,Whitman,WA,Passenger,19,28,47,22658,22705,0.21
7892,July,2018,Klamath,OR,Passenger,1,0,1,35,36,2.78
7893,July,2018,Dallas,TX,Passenger,0,1,1,193,194,0.52
7894,July,2019,Juneau,AK,Passenger,0,2,2,31,33,6.06
7895,July,2019,Lake,IL,Passenger,1,0,1,166,167,0.6
7896,July,2019,Riverside,CA,Passenger,3,2,5,653,658,0.76
7897,July,2019,Whatcom,WA,Truck,2,0,2,42929,42931,0.0
7898,July,2019,San Diego,CA,Passenger,10,3,13,2733,2746,0.47
7899,July,2019,Pend Oreille,WA,Truck,0,0,0,5730,5730,0.0
7900,July,2019,DuPage,IL,Passenger,3,0,3,57,60,5.0
7901,July,2019,Fresno,CA,Passenger,1,0,1,193,194,0.52
7902,July,2019,Albemarle,VA,Passenger,1,0,1,22,23,4.35
7903,July,2019,Montgomery,MD,Passenger,1,0,1,279,280,0.36
7904,July,2019,Walla Walla,WA,Passenger,52,61,113,36208,36321,0.31
7905,July,2019,Wayne,MI,Passenger,0,1,1,66,67,1.49
7906,July,2019,Nassau,NY,Passenger,4,0,4,38,42,9.52
7907,July,2019,Owyhee,ID,Passenger,1,0,1,5,6,16.67
7908,July,2019,Montgomery,PA,Passenger,2,0,2,37,39,5.13
7909,July,2019,Walla Walla,WA,Truck,0,0,0,13617,13617,0.0
7910,July,2019,Moore,NC,Passenger,0,1,1,183,184,0.54
7911,July,2019,Norfolk,MA,Passenger,1,0,1,38,39,2.56
7912,July,2019,Columbia,WA,Passenger,2,2,4,2454,2458,0.16
7913,July,2019,Charleston,SC,Passenger,1,0,1,114,115,0.87
7914,July,2019,Jefferson,NY,Passenger,0,2,2,214,216,0.93
7915,July,2019,Ada,ID,Passenger,0,2,2,306,308,0.65
7916,July,2019,Prince George's,MD,Passenger,1,1,2,177,179,1.12
7917,July,2019,DeKalb,IN,Passenger,1,0,1,1,2,50.0
7918,July,2019,Maui,HI,Passenger,1,0,1,45,46,2.17
7919,July,2019,Kittitas,WA,Passenger,79,41,120,29679,29799,0.4
7920,July,2019,Monroe,IL,Passenger,1,0,1,5,6,16.67
7921,July,2019,Denver,CO,Passenger,1,0,1,128,129,0.78
7922,July,2019,Thurston,WA,Truck,0,0,0,55259,55259,0.0
7923,July,2019,Manassas,VA,Passenger,0,1,1,9,10,10.0
7924,July,2019,Pinal,AZ,Passenger,2,0,2,191,193,1.04
7925,July,2019,Saratoga,NY,Passenger,1,0,1,54,55,1.82
7926,July,2019,Douglas,NE,Passenger,0,1,1,61,62,1.61
7927,July,2019,Columbia,WA,Truck,0,0,0,1529,1529,0.0
7928,July,2019,Garfield,WA,Passenger,1,1,2,1298,1300,0.15
7929,July,2019,Norfolk,VA,Passenger,2,2,4,351,355,1.13
7930,July,2019,Yakima,WA,Passenger,109,107,216,165397,165613,0.13
7931,July,2019,San Juan,WA,Passenger,220,72,292,14446,14738,1.98
7932,July,2019,Lewis,WA,Truck,0,0,0,25966,25966,0.0
7933,July,2019,Alexandria,VA,Passenger,1,0,1,147,148,0.68
7934,July,2019,Hawaii,HI,Passenger,1,0,1,59,60,1.67
7935,July,2019,Fairbanks North Star,AK,Passenger,0,1,1,98,99,1.01
7936,July,2019,El Paso,TX,Passenger,3,0,3,484,487,0.62
7937,July,2019,Skamania,WA,Passenger,25,18,43,8739,8782,0.49
7938,July,2019,Shelby,OH,Passenger,0,1,1,1,2,50.0
7939,July,2019,Pierce,WA,Truck,0,0,0,140021,140021,0.0
7940,July,2019,Cowlitz,WA,Passenger,106,107,213,73140,73353,0.29
7941,July,2019,Thurston,WA,Passenger,905,652,1557,198166,199723,0.78
7942,July,2019,Harnett,NC,Passenger,1,1,2,212,214,0.93
7943,July,2019,San Mateo,CA,Passenger,2,1,3,117,120,2.5
7944,July,2019,Richland,SC,Passenger,0,1,1,161,162,0.62
7945,July,2019,Skagit,WA,Truck,1,0,1,32524,32525,0.0
7946,July,2019,Los Angeles,CA,Passenger,8,5,13,1110,1123,1.16
7947,July,2019,Charles,MD,Passenger,0,1,1,88,89,1.12
7948,July,2019,Montgomery,AL,Passenger,0,1,1,43,44,2.27
7949,July,2019,Middlesex,MA,Passenger,1,1,2,114,116,1.72
7950,July,2019,Jefferson,CO,Passenger,0,2,2,57,59,3.39
7951,July,2019,Carson City,NV,Passenger,1,0,1,11,12,8.33
7952,July,2019,Clark,WA,Passenger,1588,944,2532,314921,317453,0.8
7953,July,2019,Lincoln,WA,Truck,0,0,0,4684,4684,0.0
7954,July,2019,New London,CT,Passenger,0,2,2,242,244,0.82
7955,July,2019,Cowlitz,WA,Truck,0,0,0,28867,28867,0.0
7956,July,2019,Clay,FL,Passenger,0,1,1,87,88,1.14
7957,July,2019,Oklahoma,OK,Passenger,0,1,1,125,126,0.79
7958,July,2019,Skagit,WA,Passenger,307,210,517,92211,92728,0.56
7959,July,2019,Deschutes,OR,Passenger,2,0,2,155,157,1.27
7960,July,2019,Houston,GA,Passenger,1,0,1,54,55,1.82
7961,July,2019,Shasta,CA,Passenger,1,0,1,40,41,2.44
7962,July,2019,Loudoun,VA,Passenger,1,0,1,96,97,1.03
7963,July,2019,Clackamas,OR,Passenger,1,1,2,213,215,0.93
7964,July,2019,Placer,CA,Passenger,1,0,1,99,100,1.0
7965,July,2019,Clark,WA,Truck,0,0,0,80613,80613,0.0
7967,July,2019,El Paso,CO,Passenger,2,1,3,737,740,0.41
7968,July,2019,Fairfax,VA,Passenger,3,2,5,781,786,0.64
7969,July,2019,Klickitat,WA,Truck,0,0,0,8255,8255,0.0
7970,July,2019,King,WA,Truck,5,1,6,182265,182271,0.0
7971,July,2019,Asotin,WA,Truck,0,0,0,6660,6660,0.0
7972,July,2019,New Haven,CT,Passenger,0,2,2,47,49,4.08
7973,July,2019,Benton,WA,Passenger,270,289,559,134166,134725,0.41
7974,July,2019,Ramsey,MN,Passenger,1,0,1,39,40,2.5
7975,July,2019,Kent,MI,Passenger,0,1,1,21,22,4.55
7976,July,2019,Valencia,NM,Passenger,1,0,1,6,7,14.29
7977,July,2019,Flathead,MT,Passenger,1,0,1,62,63,1.59
7978,July,2019,Wilson,TX,Passenger,0,1,1,6,7,14.29
7979,July,2019,Jefferson,WA,Truck,0,0,0,9683,9683,0.0
7980,July,2019,Twin Falls,ID,Passenger,0,1,1,24,25,4.0
7981,July,2019,Santa Fe,NM,Passenger,0,1,1,39,40,2.5
7982,July,2019,Bexar,TX,Passenger,2,5,7,658,665,1.05
7983,July,2019,Putnam,TN,Passenger,0,1,1,3,4,25.0
7984,July,2019,Skamania,WA,Truck,0,0,0,4063,4063,0.0
7985,July,2019,Mason,WA,Passenger,127,126,253,47316,47569,0.53
7986,July,2019,Dallas,TX,Passenger,1,0,1,203,204,0.49
7987,July,2019,Marion,OR,Passenger,1,0,1,117,118,0.85
7988,July,2019,Osceola,FL,Passenger,1,0,1,41,42,2.38
7989,July,2019,Solano,CA,Passenger,1,0,1,215,216,0.46
7990,July,2019,Randolph,NC,Passenger,1,0,1,6,7,14.29
7991,July,2019,St. Clair,IL,Passenger,0,1,1,158,159,0.63
7992,July,2019,Clallam,WA,Truck,1,0,1,21812,21813,0.0
7993,July,2019,Jefferson,WA,Passenger,202,118,320,25065,25385,1.26
7994,July,2019,Bergen,NJ,Passenger,1,0,1,26,27,3.7
7995,July,2019,Dale,AL,Passenger,0,1,1,59,60,1.67
7996,July,2019,Ferry,WA,Truck,0,0,0,3580,3580,0.0
7997,July,2019,Nantucket,MA,Passenger,1,0,1,2,3,33.33
7998,July,2019,Powhatan,VA,Passenger,1,0,1,0,1,100.0
7999,July,2019,Maricopa,AZ,Passenger,7,4,11,1530,1541,0.71
8000,July,2019,Sedgwick,KS,Passenger,1,1,2,99,101,1.98
8001,July,2019,Clark,NV,Passenger,4,2,6,690,696,0.86
8002,July,2019,Pima,AZ,Passenger,0,1,1,392,393,0.25
8003,July,2019,Sumter,FL,Passenger,0,1,1,10,11,9.09
8004,July,2019,Washtenaw,MI,Passenger,1,0,1,41,42,2.38
8005,July,2019,Snohomish,WA,Truck,0,0,0,122619,122619,0.0
8006,July,2019,Brevard,FL,Passenger,0,1,1,83,84,1.19
8007,July,2019,Palm Beach,FL,Passenger,0,1,1,85,86,1.16
8008,July,2019,Spartanburg,SC,Passenger,0,1,1,37,38,2.63
8009,July,2019,Asotin,WA,Passenger,12,8,20,12658,12678,0.16
8010,July,2019,Calvert,MD,Passenger,0,2,2,89,91,2.2
8011,July,2019,Suffolk,MA,Passenger,0,1,1,37,38,2.63
8012,July,2019,Harris,TX,Passenger,1,1,2,249,251,0.8
8013,July,2019,Benton,WA,Truck,0,0,0,42072,42072,0.0
8014,July,2019,DeKalb,GA,Passenger,1,0,1,77,78,1.28
8015,July,2019,Bucks,PA,Passenger,1,0,1,21,22,4.55
8016,July,2019,Mecklenburg,NC,Passenger,1,0,1,88,89,1.12
8017,July,2019,Dakota,MN,Passenger,0,1,1,37,38,2.63
8018,July,2019,RÃ­o Grande,PR,Passenger,1,0,1,1,2,50.0
8019,July,2019,Sarasota,FL,Passenger,1,0,1,24,25,4.0
8020,July,2019,Chelan,WA,Truck,0,0,0,22349,22349,0.0
8021,July,2019,Alameda,CA,Passenger,4,2,6,303,309,1.94
8022,July,2019,Cumberland,NC,Passenger,0,2,2,498,500,0.4
8023,July,2019,Frederick,MD,Passenger,1,1,2,81,83,2.41
8024,July,2019,Boone,MO,Passenger,0,1,1,10,11,9.09
8025,July,2019,Snohomish,WA,Passenger,3556,1617,5173,532742,537915,0.96
8026,July,2019,Island,WA,Truck,0,0,0,21312,21312,0.0
8027,July,2019,Franklin,WA,Passenger,53,71,124,60145,60269,0.21
8028,July,2019,Tarrant,TX,Passenger,2,0,2,201,203,0.99
8029,July,2019,Tulsa,OK,Passenger,1,1,2,45,47,4.26
8030,July,2019,Duval,FL,Passenger,1,2,3,372,375,0.8
8031,July,2019,Santa Rosa,FL,Passenger,1,0,1,90,91,1.1
8032,July,2019,Allegheny,PA,Passenger,1,0,1,78,79,1.27
8033,July,2019,Kitsap,WA,Truck,1,0,1,54128,54129,0.0
8034,July,2019,Lewis,WA,Passenger,100,96,196,59368,59564,0.33
8035,July,2019,Harrison,MS,Passenger,1,0,1,62,63,1.59
8036,July,2019,Penobscot,ME,Passenger,0,1,1,13,14,7.14
8037,July,2019,Saginaw,MI,Passenger,1,0,1,11,12,8.33
8038,July,2019,Grant,WA,Truck,0,0,0,26703,26703,0.0
8039,July,2019,Franklin,WA,Truck,0,0,0,19368,19368,0.0
8040,July,2019,Lake,FL,Passenger,1,0,1,19,20,5.0
8041,July,2019,Portsmouth,VA,Passenger,0,1,1,78,79,1.27
8042,July,2019,Nueces,TX,Passenger,1,1,2,93,95,2.11
8043,July,2019,Adams,WA,Passenger,5,6,11,12835,12846,0.09
8044,July,2019,Cochise,AZ,Passenger,0,1,1,111,112,0.89
8045,July,2019,Cook,IL,Passenger,1,0,1,240,241,0.41
8046,July,2019,Spokane,WA,Passenger,557,435,992,312718,313710,0.32
8047,July,2019,Wahkiakum,WA,Passenger,2,2,4,3007,3011,0.13
8048,July,2019,Broward,FL,Passenger,2,1,3,126,129,2.33
8049,July,2019,Yakima,WA,Truck,0,0,0,59260,59260,0.0
8050,July,2019,Manatee,FL,Passenger,1,0,1,31,32,3.12
8051,July,2019,Contra Costa,CA,Passenger,2,2,4,377,381,1.05
8052,July,2019,Grant,WA,Passenger,43,61,104,65017,65121,0.16
8053,July,2019,Klickitat,WA,Passenger,35,33,68,15579,15647,0.43
8054,July,2019,Carroll,NH,Passenger,0,1,1,3,4,25.0
8055,July,2019,San Juan,WA,Truck,0,0,0,5890,5890,0.0
8056,July,2019,Arlington,VA,Passenger,0,2,2,157,159,1.26
8057,July,2019,Stevens,WA,Passenger,19,30,49,31721,31770,0.15
8058,July,2019,Goochland,VA,Passenger,1,1,2,259,261,0.77
8059,July,2019,Pend Oreille,WA,Passenger,4,6,10,9537,9547,0.1
8060,July,2019,Guadalupe,TX,Passenger,1,0,1,73,74,1.35
8061,July,2019,Larimer,CO,Passenger,1,0,1,57,58,1.72
8062,July,2019,Orange,CA,Passenger,6,1,7,521,528,1.33
8063,July,2019,District of Columbia,DC,Passenger,1,1,2,211,213,0.94
8064,July,2019,Cascade,MT,Passenger,0,1,1,61,62,1.61
8065,July,2019,Adams,WA,Truck,0,0,0,5132,5132,0.0
8066,July,2019,St. Mary's,MD,Passenger,1,0,1,217,218,0.46
8067,July,2019,Kern,CA,Passenger,0,1,1,218,219,0.46
8068,July,2019,Montgomery,TX,Passenger,1,0,1,59,60,1.67
8069,July,2019,Shelby,TN,Passenger,0,1,1,90,91,1.1
8070,July,2019,Grays Harbor,WA,Truck,0,0,0,20535,20535,0.0
8071,July,2019,Vigo,IN,Passenger,1,0,1,6,7,14.29
8072,July,2019,Santa Cruz,CA,Passenger,1,0,1,39,40,2.5
8073,July,2019,Spokane,WA,Truck,1,0,1,95241,95242,0.0
8074,July,2019,Kootenai,ID,Passenger,1,1,2,221,223,0.9
8075,July,2019,Grays Harbor,WA,Passenger,82,85,167,47997,48164,0.35
8076,July,2019,Ferry,WA,Passenger,5,2,7,4399,4406,0.16
8077,July,2019,Collin,TX,Passenger,1,1,2,134,136,1.47
8078,July,2019,Travis,TX,Passenger,2,1,3,199,202,1.49
8079,July,2019,Kittitas,WA,Truck,0,0,0,14488,14488,0.0
8080,July,2019,Rogers,OK,Passenger,1,0,1,5,6,16.67
8081,July,2019,Wahkiakum,WA,Truck,0,0,0,1761,1761,0.0
8082,July,2019,Washoe,NV,Passenger,2,0,2,111,113,1.77
8083,July,2019,Prince William,VA,Passenger,1,3,4,248,252,1.59
8084,July,2019,Howard,MD,Passenger,0,1,1,74,75,1.33
8085,July,2019,Polk,FL,Passenger,1,0,1,66,67,1.49
8086,July,2019,Mason,WA,Truck,0,0,0,20412,20412,0.0
8087,July,2019,San Francisco,CA,Passenger,2,1,3,105,108,2.78
8088,July,2019,Lee,FL,Passenger,1,0,1,51,52,1.92
8089,July,2019,Okanogan,WA,Truck,0,0,0,16490,16490,0.0
8090,July,2019,Oldham,KY,Passenger,0,1,1,5,6,16.67
8091,July,2019,Island,WA,Passenger,328,243,571,63488,64059,0.89
8092,July,2019,Stevens,WA,Truck,0,0,0,18704,18704,0.0
8093,July,2019,Pacific,WA,Passenger,24,30,54,16029,16083,0.34
8094,July,2019,Virginia Beach,VA,Passenger,1,0,1,709,710,0.14
8095,July,2019,Garfield,WA,Truck,0,0,0,961,961,0.0
8096,July,2019,Lincoln,WA,Passenger,2,10,12,7793,7805,0.15
8097,July,2019,Camden,NJ,Passenger,0,1,1,25,26,3.85
8098,July,2019,Okanogan,WA,Passenger,23,26,49,26123,26172,0.19
8099,July,2019,Franklin,MA,Passenger,0,1,1,1,2,50.0
8100,July,2019,Williamson,TX,Passenger,0,2,2,144,146,1.37
8101,July,2019,Pierce,WA,Passenger,1877,1570,3447,544359,547806,0.63
8102,July,2019,Clallam,WA,Passenger,177,144,321,50640,50961,0.63
8103,July,2019,Pinellas,FL,Passenger,1,0,1,113,114,0.88
8104,July,2019,Fulton,GA,Passenger,0,2,2,102,104,1.92
8105,July,2019,Ventura,CA,Passenger,0,2,2,311,313,0.64
8106,July,2019,Richmond,GA,Passenger,0,1,1,91,92,1.09
8107,July,2019,Volusia,FL,Passenger,0,1,1,38,39,2.56
8108,July,2019,Hennepin,MN,Passenger,2,1,3,104,107,2.8
8109,July,2019,Douglas,WA,Passenger,60,37,97,28078,28175,0.34
8110,July,2019,Douglas,WA,Truck,0,0,0,12221,12221,0.0
8111,July,2019,Sangamon,IL,Passenger,1,0,1,6,7,14.29
8112,July,2019,Anne Arundel,MD,Passenger,1,2,3,440,443,0.68
8113,July,2019,Cape May,NJ,Passenger,0,1,1,15,16,6.25
8114,July,2019,Multnomah,OR,Passenger,5,6,11,742,753,1.46
8115,July,2019,Berkshire,MA,Passenger,0,1,1,4,5,20.0
8116,July,2019,Whitman,WA,Truck,0,0,0,8629,8629,0.0
8117,July,2019,Caddo,LA,Passenger,0,1,1,21,22,4.55
8118,July,2019,Whatcom,WA,Passenger,883,436,1319,151115,152434,0.87
8119,July,2019,Kitsap,WA,Passenger,1093,625,1718,181246,182964,0.94
8120,July,2019,King,WA,Passenger,19627,7112,26739,1391293,1418032,1.89
8121,July,2019,Pacific,WA,Truck,0,0,0,7669,7669,0.0
8122,July,2019,Chelan,WA,Passenger,161,68,229,54431,54660,0.42
8123,July,2019,San Joaquin,CA,Passenger,1,0,1,128,129,0.78
8124,July,2019,Tuolumne,CA,Passenger,0,1,1,12,13,7.69
8125,July,2019,Klamath,OR,Passenger,1,0,1,38,39,2.56
8126,July,2019,Santa Clara,CA,Passenger,4,2,6,365,371,1.62
8127,July,2019,Whitman,WA,Passenger,33,45,78,22702,22780,0.34
8128,July,2019,Honolulu,HI,Passenger,3,3,6,492,498,1.2
8129,July,2020,Snohomish,WA,Passenger,4583,1775,6358,535609,541967,1.17
8130,July,2020,Pacific,WA,Passenger,33,33,66,15766,15832,0.42
8131,July,2020,Richmond,GA,Passenger,0,1,1,82,83,1.2
8132,July,2020,Monterey,CA,Passenger,0,1,1,162,163,0.61
8133,July,2020,Skamania,WA,Truck,0,0,0,4032,4032,0.0
8134,July,2020,Fairbanks North Star,AK,Passenger,0,1,1,95,96,1.04
8135,July,2020,Frederick,MD,Passenger,1,1,2,75,77,2.6
8136,July,2020,Whitman,WA,Passenger,45,49,94,22124,22218,0.42
8137,July,2020,San Diego,CA,Passenger,14,5,19,2756,2775,0.68
8138,July,2020,Hamilton,IN,Passenger,1,0,1,40,41,2.44
8139,July,2020,Sacramento,CA,Passenger,1,0,1,262,263,0.38
8140,July,2020,Snohomish,WA,Truck,0,0,0,124342,124342,0.0
8141,July,2020,Pierce,WA,Passenger,2467,1697,4164,551463,555627,0.75
8142,July,2020,Whitman,WA,Truck,0,0,0,8507,8507,0.0
8143,July,2020,Harnett,NC,Passenger,1,0,1,196,197,0.51
8144,July,2020,Rockingham,NH,Passenger,1,0,1,21,22,4.55
8145,July,2020,King,WA,Truck,7,1,8,182955,182963,0.0
8146,July,2020,Harris,TX,Passenger,1,0,1,221,222,0.45
8147,July,2020,Fresno,CA,Passenger,1,0,1,175,176,0.57
8148,July,2020,Klickitat,WA,Truck,0,0,0,8117,8117,0.0
8149,July,2020,Middlesex,MA,Passenger,1,1,2,92,94,2.13
8150,July,2020,Ramsey,MN,Passenger,1,0,1,38,39,2.56
8151,July,2020,Nassau,NY,Passenger,4,0,4,29,33,12.12
8152,July,2020,Twin Falls,ID,Passenger,0,1,1,22,23,4.35
8153,July,2020,Hudson,NJ,Passenger,1,0,1,37,38,2.63
8154,July,2020,Montgomery,TX,Passenger,1,0,1,50,51,1.96
8155,July,2020,Goochland,VA,Passenger,3,1,4,255,259,1.54
8156,July,2020,Prince William,VA,Passenger,2,3,5,222,227,2.2
8157,July,2020,Cascade,MT,Passenger,0,1,1,53,54,1.85
8158,July,2020,Fort Bend,TX,Passenger,1,0,1,45,46,2.17
8159,July,2020,Chesapeake,VA,Passenger,0,2,2,414,416,0.48
8160,July,2020,Howard,MD,Passenger,0,1,1,69,70,1.43
8161,July,2020,Skagit,WA,Passenger,423,223,646,91309,91955,0.7
8162,July,2020,Cowlitz,WA,Truck,0,0,0,28879,28879,0.0
8163,July,2020,Pacific,WA,Truck,0,0,0,7714,7714,0.0
8164,July,2020,Putnam,TN,Passenger,0,1,1,3,4,25.0
8165,July,2020,Chelan,WA,Truck,0,0,0,22628,22628,0.0
8166,July,2020,Cumberland,NC,Passenger,0,3,3,461,464,0.65
8167,July,2020,Walla Walla,WA,Passenger,77,65,142,35905,36047,0.39
8168,July,2020,Thurston,WA,Truck,0,0,0,55895,55895,0.0
8169,July,2020,New London,CT,Passenger,1,2,3,240,243,1.23
8170,July,2020,Mason,WA,Truck,0,0,0,20714,20714,0.0
8171,July,2020,Pinellas,FL,Passenger,1,1,2,108,110,1.82
8172,July,2020,Williamson,TX,Passenger,0,2,2,135,137,1.46
8173,July,2020,El Paso,CO,Passenger,2,0,2,716,718,0.28
8174,July,2020,Lincoln,WA,Truck,0,0,0,4661,4661,0.0
8175,July,2020,Anne Arundel,MD,Passenger,0,1,1,412,413,0.24
8176,July,2020,Washtenaw,MI,Passenger,1,0,1,36,37,2.7
8177,July,2020,Williams,ND,Passenger,0,1,1,11,12,8.33
8178,July,2020,Tulsa,OK,Passenger,1,1,2,42,44,4.55
8179,July,2020,Kootenai,ID,Passenger,1,0,1,217,218,0.46
8180,July,2020,El Paso,TX,Passenger,3,0,3,417,420,0.71
8181,July,2020,Nassau,FL,Passenger,1,0,1,35,36,2.78
8182,July,2020,DeKalb,IN,Passenger,1,0,1,1,2,50.0
8183,July,2020,Ulster,NY,Passenger,1,0,1,7,8,12.5
8184,July,2020,Grays Harbor,WA,Passenger,109,112,221,48286,48507,0.46
8185,July,2020,Guadalupe,TX,Passenger,1,0,1,60,61,1.64
8186,July,2020,Kings,NY,Passenger,1,0,1,66,67,1.49
8187,July,2020,Fairfax,VA,Passenger,4,3,7,734,741,0.94
8188,July,2020,Larimer,CO,Passenger,1,0,1,51,52,1.92
8189,July,2020,RÃ­o Grande,PR,Passenger,1,0,1,1,2,50.0
8190,July,2020,Okanogan,WA,Truck,0,0,0,16492,16492,0.0
8191,July,2020,Orange,CA,Passenger,7,2,9,482,491,1.83
8192,July,2020,Alameda,CA,Passenger,2,0,2,264,266,0.75
8193,July,2020,Franklin,WA,Passenger,65,79,144,60778,60922,0.24
8194,July,2020,Lewis,WA,Passenger,107,115,222,58138,58360,0.38
8195,July,2020,Wahkiakum,WA,Truck,0,0,0,1742,1742,0.0
8196,July,2020,Island,WA,Passenger,430,272,702,62871,63573,1.1
8197,July,2020,Denton,TX,Passenger,1,0,1,88,89,1.12
8198,July,2020,Jefferson,CO,Passenger,0,1,1,57,58,1.72
8199,July,2020,Lewis,WA,Truck,0,0,0,26284,26284,0.0
8200,July,2020,Saginaw,MI,Passenger,1,0,1,10,11,9.09
8201,July,2020,Douglas,WA,Truck,0,0,0,12352,12352,0.0
8202,July,2020,Queens,NY,Passenger,1,0,1,50,51,1.96
8203,July,2020,Cape May,NJ,Passenger,0,1,1,13,14,7.14
8204,July,2020,Virginia Beach,VA,Passenger,1,0,1,665,666,0.15
8205,July,2020,Washington,OR,Passenger,1,0,1,432,433,0.23
8206,July,2020,Clallam,WA,Passenger,237,169,406,50056,50462,0.8
8207,July,2020,Allegheny,PA,Passenger,1,0,1,72,73,1.37
8208,July,2020,Stafford,VA,Passenger,1,1,2,91,93,2.15
8209,July,2020,District of Columbia,DC,Passenger,2,1,3,203,206,1.46
8210,July,2020,Pinal,AZ,Passenger,1,0,1,176,177,0.56
8211,July,2020,Ferry,WA,Passenger,7,3,10,4330,4340,0.23
8212,July,2020,Pierce,WA,Truck,0,0,0,142931,142931,0.0
8213,July,2020,Columbia,WA,Truck,0,0,0,1541,1541,0.0
8214,July,2020,Lake,FL,Passenger,1,0,1,22,23,4.35
8215,July,2020,Boone,MO,Passenger,0,1,1,10,11,9.09
8216,July,2020,Salt Lake,UT,Passenger,0,1,1,182,183,0.55
8217,July,2020,St. Mary's,MD,Passenger,1,0,1,218,219,0.46
8218,July,2020,Whatcom,WA,Passenger,1091,499,1590,149332,150922,1.05
8219,July,2020,Nueces,TX,Passenger,1,0,1,83,84,1.19
8220,July,2020,Skagit,WA,Truck,1,0,1,32590,32591,0.0
8221,July,2020,Penobscot,ME,Passenger,0,1,1,14,15,6.67
8222,July,2020,Manassas,VA,Passenger,0,1,1,5,6,16.67
8223,July,2020,Jefferson,WA,Passenger,249,142,391,24737,25128,1.56
8224,July,2020,Asotin,WA,Truck,0,0,0,6653,6653,0.0
8225,July,2020,Clark,WA,Truck,0,0,0,82429,82429,0.0
8226,July,2020,Montgomery,AL,Passenger,0,1,1,40,41,2.44
8227,July,2020,DeKalb,GA,Passenger,1,0,1,76,77,1.3
8228,July,2020,Powhatan,VA,Passenger,1,0,1,0,1,100.0
8229,July,2020,Collin,TX,Passenger,1,1,2,119,121,1.65
8230,July,2020,Grays Harbor,WA,Truck,0,0,0,20981,20981,0.0
8231,July,2020,Grant,WA,Truck,0,0,0,27176,27176,0.0
8232,July,2020,Stevens,WA,Passenger,37,35,72,30627,30699,0.23
8233,July,2020,Travis,TX,Passenger,2,1,3,170,173,1.73
8234,July,2020,Maui,HI,Passenger,1,0,1,32,33,3.03
8235,July,2020,Broward,FL,Passenger,2,1,3,107,110,2.73
8236,July,2020,Bradley,TN,Passenger,1,0,1,3,4,25.0
8237,July,2020,Kent,MI,Passenger,0,1,1,23,24,4.17
8238,July,2020,Asotin,WA,Passenger,16,12,28,12378,12406,0.23
8239,July,2020,Santa Clara,CA,Passenger,8,2,10,284,294,3.4
8240,July,2020,Moore,NC,Passenger,0,2,2,156,158,1.27
8241,July,2020,San Francisco,CA,Passenger,2,1,3,91,94,3.19
8242,July,2020,Pend Oreille,WA,Passenger,7,5,12,9246,9258,0.13
8243,July,2020,Kittitas,WA,Truck,0,0,0,14564,14564,0.0
8244,July,2020,Wilson,TX,Passenger,0,1,1,5,6,16.67
8245,July,2020,Garfield,WA,Truck,0,0,0,988,988,0.0
8246,July,2020,Cowlitz,WA,Passenger,146,117,263,72232,72495,0.36
8247,July,2020,Harrison,MS,Passenger,1,0,1,51,52,1.92
8248,July,2020,Charles,MD,Passenger,1,1,2,74,76,2.63
8249,July,2020,Loudoun,VA,Passenger,1,0,1,83,84,1.19
8250,July,2020,Jefferson,WA,Truck,0,0,0,9542,9542,0.0
8251,July,2020,Charleston,SC,Passenger,2,0,2,98,100,2.0
8252,July,2020,King,WA,Passenger,24904,7756,32660,1371156,1403816,2.33
8253,July,2020,San Juan,WA,Truck,0,0,0,5844,5844,0.0
8254,July,2020,Bartow,GA,Passenger,0,1,1,4,5,20.0
8255,July,2020,Clark,NV,Passenger,2,2,4,671,675,0.59
8256,July,2020,Shasta,CA,Passenger,1,0,1,38,39,2.56
8257,July,2020,Sarasota,FL,Passenger,2,0,2,24,26,7.69
8258,July,2020,Kitsap,WA,Truck,0,0,0,54144,54144,0.0
8259,July,2020,Clark,WA,Passenger,2097,1066,3163,317956,321119,0.98
8260,July,2020,Riverside,CA,Passenger,3,1,4,610,614,0.65
8261,July,2020,Maricopa,AZ,Passenger,5,6,11,1401,1412,0.78
8262,July,2020,St. Louis,MO,Passenger,1,0,1,97,98,1.02
8263,July,2020,Santa Cruz,CA,Passenger,1,0,1,31,32,3.12
8264,July,2020,Spokane,WA,Passenger,753,491,1244,316437,317681,0.39
8265,July,2020,Palm Beach,FL,Passenger,0,1,1,80,81,1.23
8266,July,2020,Utah,UT,Passenger,0,1,1,131,132,0.76
8267,July,2020,Skamania,WA,Passenger,31,20,51,8428,8479,0.6
8268,July,2020,Ventura,CA,Passenger,1,2,3,278,281,1.07
8269,July,2020,Rogers,OK,Passenger,1,0,1,4,5,20.0
8270,July,2020,Island,WA,Truck,1,0,1,21235,21236,0.0
8271,July,2020,Franklin,WA,Truck,0,0,0,20096,20096,0.0
8272,July,2020,Arapahoe,CO,Passenger,1,0,1,128,129,0.78
8273,July,2020,Boulder,CO,Passenger,0,1,1,44,45,2.22
8274,July,2020,Deschutes,OR,Passenger,2,0,2,130,132,1.52
8275,July,2020,Dallas,TX,Passenger,1,0,1,188,189,0.53
8276,July,2020,Carroll,NH,Passenger,0,1,1,4,5,20.0
8277,July,2020,Calvert,MD,Passenger,0,2,2,89,91,2.2
8278,July,2020,San Mateo,CA,Passenger,0,1,1,108,109,0.92
8279,July,2020,Fulton,GA,Passenger,1,2,3,101,104,2.88
8280,July,2020,Stevens,WA,Truck,0,0,0,18672,18672,0.0
8281,July,2020,San Joaquin,CA,Passenger,1,0,1,125,126,0.79
8283,July,2020,Sedgwick,KS,Passenger,1,1,2,96,98,2.04
8284,July,2020,Shelby,OH,Passenger,0,1,1,1,2,50.0
8285,July,2020,Garfield,WA,Passenger,0,1,1,1350,1351,0.07
8286,July,2020,Okanogan,WA,Passenger,37,34,71,25923,25994,0.27
8287,July,2020,Carson City,NV,Passenger,1,0,1,10,11,9.09
8288,July,2020,Morris,NJ,Passenger,1,0,1,17,18,5.56
8289,July,2020,Hawaii,HI,Passenger,1,0,1,55,56,1.79
8290,July,2020,Honolulu,HI,Passenger,4,2,6,440,446,1.35
8291,July,2020,Walla Walla,WA,Truck,0,0,0,13755,13755,0.0
8292,July,2020,Kittitas,WA,Passenger,104,47,151,29761,29912,0.5
8293,July,2020,Suffolk,MA,Passenger,0,2,2,36,38,5.26
8294,July,2020,Yakima,WA,Passenger,139,119,258,165771,166029,0.16
8295,July,2020,Douglas,NE,Passenger,0,1,1,50,51,1.96
8296,July,2020,Whatcom,WA,Truck,3,0,3,43156,43159,0.01
8297,July,2020,Yakima,WA,Truck,0,0,0,60200,60200,0.0
8298,July,2020,DuPage,IL,Passenger,3,0,3,58,61,4.92
8299,July,2020,Dakota,MN,Passenger,0,1,1,33,34,2.94
8300,July,2020,Benton,WA,Truck,0,0,0,42882,42882,0.0
8301,July,2020,Los Angeles,CA,Passenger,7,11,18,981,999,1.8
8302,July,2020,Mason,WA,Passenger,160,134,294,47372,47666,0.62
8303,July,2020,Jefferson,NY,Passenger,0,1,1,210,211,0.47
8304,July,2020,Chelan,WA,Passenger,240,82,322,54232,54554,0.59
8305,July,2020,Houston,GA,Passenger,1,0,1,55,56,1.79
8306,July,2020,Albemarle,VA,Passenger,1,0,1,20,21,4.76
8307,July,2020,Flathead,MT,Passenger,1,0,1,55,56,1.79
8308,July,2020,Clay,FL,Passenger,0,1,1,82,83,1.2
8309,July,2020,Oldham,KY,Passenger,0,1,1,4,5,20.0
8310,July,2020,Placer,CA,Passenger,2,0,2,85,87,2.3
8311,July,2020,Camden,NJ,Passenger,0,1,1,22,23,4.35
8312,July,2020,Lee,FL,Passenger,1,0,1,50,51,1.96
8313,July,2020,San Juan,WA,Passenger,311,94,405,13959,14364,2.82
8314,July,2020,Clallam,WA,Truck,1,0,1,21697,21698,0.0
8315,July,2020,Kitsap,WA,Passenger,1377,696,2073,179884,181957,1.14
8316,July,2020,Adams,WA,Passenger,9,7,16,12866,12882,0.12
8317,July,2020,Lake,IL,Passenger,1,0,1,163,164,0.61
8318,July,2020,Juneau,AK,Passenger,0,1,1,29,30,3.33
8319,July,2020,Klamath,OR,Passenger,1,0,1,33,34,2.94
8320,July,2020,Duval,FL,Passenger,0,2,2,361,363,0.55
8321,July,2020,Spartanburg,SC,Passenger,0,1,1,47,48,2.08
8322,July,2020,Monroe,IL,Passenger,1,0,1,4,5,20.0
8323,July,2020,Norfolk,VA,Passenger,2,2,4,346,350,1.14
8324,July,2020,Montgomery,OH,Passenger,0,1,1,48,49,2.04
8325,July,2020,Contra Costa,CA,Passenger,4,3,7,305,312,2.24
8326,July,2020,Prince George's,MD,Passenger,1,1,2,156,158,1.27
8327,July,2020,Greene,MO,Passenger,0,1,1,33,34,2.94
8328,July,2020,Okaloosa,FL,Passenger,0,1,1,138,139,0.72
8329,July,2020,Bexar,TX,Passenger,4,5,9,597,606,1.49
8330,July,2020,Erie,NY,Passenger,1,0,1,45,46,2.17
8331,July,2020,Pend Oreille,WA,Truck,0,0,0,5762,5762,0.0
8332,July,2020,Polk,FL,Passenger,1,0,1,64,65,1.54
8333,July,2020,Jones,GA,Passenger,1,0,1,1,2,50.0
8334,July,2020,Columbia,WA,Passenger,4,3,7,2418,2425,0.29
8335,July,2020,Vigo,IN,Passenger,1,0,1,5,6,16.67
8336,July,2020,Owyhee,ID,Passenger,1,0,1,3,4,25.0
8337,July,2020,Wahkiakum,WA,Passenger,6,6,12,3001,3013,0.4
8338,July,2020,St. Clair,IL,Passenger,1,0,1,136,137,0.73
8339,July,2020,Ada,ID,Passenger,0,1,1,261,262,0.38
8340,July,2020,Benton,WA,Passenger,373,321,694,134304,134998,0.51
8341,July,2020,Gwinnett,GA,Passenger,1,0,1,70,71,1.41
8342,July,2020,Arlington,VA,Passenger,0,2,2,148,150,1.33
8343,July,2020,Ferry,WA,Truck,0,0,0,3568,3568,0.0
8344,July,2020,New Haven,CT,Passenger,0,2,2,36,38,5.26
8345,July,2020,Brevard,FL,Passenger,0,1,1,84,85,1.18
8346,July,2020,Sumter,FL,Passenger,0,1,1,9,10,10.0
8347,July,2020,Solano,CA,Passenger,1,0,1,207,208,0.48
8348,July,2020,Klickitat,WA,Passenger,56,43,99,15115,15214,0.65
8349,July,2020,Portsmouth,VA,Passenger,0,1,1,75,76,1.32
8350,July,2020,Washoe,NV,Passenger,1,0,1,100,101,0.99
8351,July,2020,Richland,SC,Passenger,0,1,1,149,150,0.67
8352,July,2020,Hennepin,MN,Passenger,3,0,3,89,92,3.26
8353,July,2020,Suffolk,VA,Passenger,1,0,1,127,128,0.78
8354,July,2020,Adams,WA,Truck,0,0,0,5283,5283,0.0
8355,July,2020,Kern,CA,Passenger,0,1,1,223,224,0.45
8356,July,2020,Montgomery,PA,Passenger,1,0,1,29,30,3.33
8357,July,2020,Randolph,NC,Passenger,1,0,1,7,8,12.5
8358,July,2020,Valencia,NM,Passenger,1,0,1,6,7,14.29
8359,July,2020,Bucks,PA,Passenger,1,0,1,20,21,4.76
8360,July,2020,Multnomah,OR,Passenger,4,7,11,707,718,1.53
8361,July,2020,Pima,AZ,Passenger,3,1,4,334,338,1.18
8362,July,2020,Alexandria,VA,Passenger,2,0,2,138,140,1.43
8363,July,2020,Lincoln,WA,Passenger,5,11,16,7648,7664,0.21
8364,July,2020,Clackamas,OR,Passenger,2,0,2,190,192,1.04
8365,July,2020,Douglas,WA,Passenger,75,41,116,28050,28166,0.41
8366,July,2020,Spokane,WA,Truck,1,0,1,98982,98983,0.0
8367,July,2020,Grant,WA,Passenger,61,75,136,65284,65420,0.21
8368,July,2020,Denver,CO,Passenger,1,0,1,116,117,0.85
8369,July,2020,Thurston,WA,Passenger,1175,744,1919,197158,199077,0.96
8370,July,2020,Shelby,TN,Passenger,0,1,1,85,86,1.16
8371,July,2020,New York,NY,Passenger,1,0,1,57,58,1.72
8372,July,2021,Howard,IN,Passenger,0,1,1,5,6,16.67
8373,July,2021,Honolulu,HI,Passenger,5,2,7,382,389,1.8
8374,July,2021,San Juan,WA,Passenger,443,139,582,14241,14823,3.93
8375,July,2021,Louisa,VA,Passenger,0,1,1,1,2,50.0
8376,July,2021,Okanogan,WA,Truck,0,0,0,16751,16751,0.0
8377,July,2021,Montgomery,TX,Passenger,1,1,2,38,40,5.0
8378,July,2021,Benton,WA,Truck,0,0,0,43648,43648,0.0
8379,July,2021,San Diego,CA,Passenger,17,7,24,2530,2554,0.94
8380,July,2021,Larimer,CO,Passenger,1,0,1,50,51,1.96
8381,July,2021,Jefferson,WA,Truck,0,0,0,9618,9618,0.0
8382,July,2021,Snohomish,WA,Passenger,6126,2100,8226,539757,547983,1.5
8383,July,2021,Mason,WA,Passenger,216,139,355,48095,48450,0.73
8384,July,2021,Hampshire,MA,Passenger,1,0,1,6,7,14.29
8385,July,2021,Queens,NY,Passenger,2,0,2,47,49,4.08
8386,July,2021,Charles,MD,Passenger,1,1,2,69,71,2.82
8387,July,2021,Harrison,MS,Passenger,2,0,2,52,54,3.7
8388,July,2021,Platte,MO,Passenger,1,0,1,17,18,5.56
8389,July,2021,Clallam,WA,Passenger,341,220,561,50460,51021,1.1
8390,July,2021,Lincoln,WA,Truck,0,0,0,4759,4759,0.0
8391,July,2021,Harris,TX,Passenger,1,1,2,185,187,1.07
8392,July,2021,Powhatan,VA,Passenger,1,0,1,1,2,50.0
8393,July,2021,Onslow,NC,Passenger,0,1,1,178,179,0.56
8394,July,2021,Salt Lake,UT,Passenger,0,1,1,162,163,0.61
8395,July,2021,Douglas,WA,Passenger,100,51,151,28504,28655,0.53
8396,July,2021,Fresno,CA,Passenger,1,0,1,165,166,0.6
8397,July,2021,Oldham,KY,Passenger,0,1,1,4,5,20.0
8398,July,2021,San Mateo,CA,Passenger,1,0,1,95,96,1.04
8399,July,2021,Denver,CO,Passenger,1,0,1,116,117,0.85
8400,July,2021,San Juan,WA,Truck,0,0,0,5955,5955,0.0
8401,July,2021,Fairbanks North Star,AK,Passenger,0,1,1,83,84,1.19
8402,July,2021,Multnomah,OR,Passenger,2,6,8,634,642,1.25
8403,July,2021,Sarasota,FL,Passenger,2,0,2,27,29,6.9
8404,July,2021,Adams,WA,Truck,0,0,0,5392,5392,0.0
8405,July,2021,Wahkiakum,WA,Passenger,15,8,23,3091,3114,0.74
8406,July,2021,Yakima,WA,Passenger,236,161,397,169309,169706,0.23
8407,July,2021,New London,CT,Passenger,1,2,3,216,219,1.37
8408,July,2021,Lee,FL,Passenger,1,0,1,33,34,2.94
8409,July,2021,El Paso,CO,Passenger,3,0,3,666,669,0.45
8410,July,2021,Carroll,MD,Passenger,0,1,1,19,20,5.0
8411,July,2021,Chelan,WA,Passenger,350,101,451,54716,55167,0.82
8412,July,2021,Howard,MD,Passenger,0,1,1,59,60,1.67
8413,July,2021,Stevens,WA,Truck,0,0,0,18921,18921,0.0
8414,July,2021,Washington,MD,Passenger,2,0,2,13,15,13.33
8415,July,2021,Albemarle,VA,Passenger,1,0,1,19,20,5.0
8416,July,2021,Manassas,VA,Passenger,0,1,1,7,8,12.5
8417,July,2021,RÃ­o Grande,PR,Passenger,1,0,1,0,1,100.0
8418,July,2021,Whitman,WA,Truck,0,0,0,8590,8590,0.0
8419,July,2021,Portsmouth,VA,Passenger,0,1,1,78,79,1.27
8420,July,2021,Kings,CA,Passenger,1,0,1,319,320,0.31
8421,July,2021,Stevens,WA,Passenger,49,46,95,30404,30499,0.31
8422,July,2021,Rockdale,GA,Passenger,1,0,1,9,10,10.0
8423,July,2021,Montgomery,OH,Passenger,0,1,1,55,56,1.79
8424,July,2021,Maricopa,AZ,Passenger,6,3,9,1118,1127,0.8
8425,July,2021,Clackamas,OR,Passenger,2,0,2,173,175,1.14
8426,July,2021,Charleston,SC,Passenger,1,1,2,82,84,2.38
8427,July,2021,Mason,WA,Truck,0,0,0,21344,21344,0.0
8428,July,2021,Grant,WA,Passenger,120,90,210,66913,67123,0.31
8429,July,2021,Hidalgo,TX,Passenger,0,1,1,54,55,1.82
8430,July,2021,Lewis,WA,Passenger,165,144,309,59658,59967,0.52
8431,July,2021,Ray,MO,Passenger,0,1,1,1,2,50.0
8432,July,2021,Clark,WA,Truck,0,0,0,84269,84269,0.0
8433,July,2021,Baltimore,MD,Passenger,1,0,1,97,98,1.02
8434,July,2021,Santa Cruz,CA,Passenger,1,0,1,24,25,4.0
8435,July,2021,Los Angeles,CA,Passenger,10,11,21,871,892,2.35
8436,July,2021,Yamhill,OR,Passenger,1,0,1,34,35,2.86
8437,July,2021,Rockingham,NH,Passenger,1,0,1,21,22,4.55
8438,July,2021,Alameda,CA,Passenger,4,0,4,231,235,1.7
8439,July,2021,Okanogan,WA,Passenger,65,43,108,26539,26647,0.41
8440,July,2021,Orange,FL,Passenger,1,0,1,107,108,0.93
8441,July,2021,Wahkiakum,WA,Truck,0,0,0,1793,1793,0.0
8442,July,2021,Loudoun,VA,Passenger,1,0,1,72,73,1.37
8443,July,2021,Broward,FL,Passenger,2,0,2,107,109,1.83
8444,July,2021,Williamson,TX,Passenger,0,2,2,103,105,1.9
8445,July,2021,Juneau,AK,Passenger,0,1,1,26,27,3.7
8446,July,2021,Boulder,CO,Passenger,0,1,1,39,40,2.5
8447,July,2021,Dallas,TX,Passenger,1,0,1,148,149,0.67
8448,July,2021,Harnett,NC,Passenger,1,1,2,167,169,1.18
8449,July,2021,Sedgwick,KS,Passenger,1,1,2,81,83,2.41
8450,July,2021,Prince William,VA,Passenger,1,1,2,201,203,0.99
8451,July,2021,Pacific,WA,Passenger,46,53,99,16030,16129,0.61
8452,July,2021,Klickitat,WA,Truck,0,0,0,8313,8313,0.0
8453,July,2021,Lewis,WA,Truck,0,0,0,26765,26765,0.0
8454,July,2021,Kitsap,WA,Truck,0,0,0,54423,54423,0.0
8455,July,2021,Kings,NY,Passenger,1,0,1,65,66,1.52
8456,July,2021,Leavenworth,KS,Passenger,0,1,1,116,117,0.85
8457,July,2021,Thurston,WA,Truck,0,0,0,56500,56500,0.0
8458,July,2021,Lincoln,WA,Passenger,6,15,21,7722,7743,0.27
8459,July,2021,Owyhee,ID,Passenger,1,0,1,2,3,33.33
8460,July,2021,Rogers,OK,Passenger,1,0,1,3,4,25.0
8461,July,2021,Adams,WA,Passenger,16,12,28,13038,13066,0.21
8462,July,2021,Grays Harbor,WA,Truck,0,0,0,21418,21418,0.0
8463,July,2021,New York,NY,Passenger,1,0,1,42,43,2.33
8464,July,2021,Kern,CA,Passenger,0,1,1,210,211,0.47
8465,July,2021,Ferry,WA,Passenger,9,3,12,4379,4391,0.27
8466,July,2021,Anchorage,AK,Passenger,1,0,1,131,132,0.76
8467,July,2021,Placer,CA,Passenger,2,0,2,75,77,2.6
8468,July,2021,Jefferson,NY,Passenger,0,1,1,213,214,0.47
8469,July,2021,Fort Bend,TX,Passenger,1,0,1,36,37,2.7
8470,July,2021,Frederick,MD,Passenger,1,1,2,68,70,2.86
8471,July,2021,Sumter,SC,Passenger,0,1,1,37,38,2.63
8472,July,2021,Danville,VA,Passenger,1,0,1,0,1,100.0
8473,July,2021,Asotin,WA,Passenger,21,17,38,12708,12746,0.3
8474,July,2021,Skamania,WA,Truck,0,0,0,4027,4027,0.0
8475,July,2021,Thurston,WA,Passenger,1660,892,2552,197867,200419,1.27
8476,July,2021,Kitsap,WA,Passenger,1911,871,2782,180648,183430,1.52
8477,July,2021,Cowlitz,WA,Truck,0,0,0,29116,29116,0.0
8478,July,2021,Grant,WA,Truck,0,0,0,27936,27936,0.0
8479,July,2021,San Francisco,CA,Passenger,0,1,1,84,85,1.18
8480,July,2021,Skagit,WA,Passenger,608,281,889,91879,92768,0.96
8481,July,2021,Sacramento,CA,Passenger,2,0,2,213,215,0.93
8482,July,2021,Lane,OR,Passenger,0,1,1,120,121,0.83
8483,July,2021,Las Animas,CO,Passenger,1,0,1,0,1,100.0
8484,July,2021,Douglas,WA,Truck,0,0,0,12696,12696,0.0
8485,July,2021,Pierce,WA,Passenger,3637,2018,5655,559608,565263,1.0
8486,July,2021,Island,WA,Passenger,625,316,941,63232,64173,1.47
8487,July,2021,Flathead,MT,Passenger,1,0,1,42,43,2.33
8488,July,2021,Lake,FL,Passenger,1,0,1,22,23,4.35
8489,July,2021,Arapahoe,CO,Passenger,1,0,1,106,107,0.93
8490,July,2021,Denton,TX,Passenger,1,0,1,80,81,1.23
8491,July,2021,Anne Arundel,MD,Passenger,4,3,7,384,391,1.79
8492,July,2021,Williams,ND,Passenger,0,1,1,7,8,12.5
8493,July,2021,Franklin,WA,Truck,0,0,0,20725,20725,0.0
8494,July,2021,Chelan,WA,Truck,0,0,0,23102,23102,0.0
8495,July,2021,Benton,WA,Passenger,540,397,937,136282,137219,0.68
8496,July,2021,Snohomish,WA,Truck,1,0,1,126198,126199,0.0
8497,July,2021,Cumberland,NC,Passenger,0,2,2,416,418,0.48
8498,July,2021,Pima,AZ,Passenger,2,1,3,267,270,1.11
8499,July,2021,Bexar,TX,Passenger,3,4,7,514,521,1.34
8500,July,2021,Pierce,WA,Truck,0,0,0,145859,145859,0.0
8501,July,2021,Camden,NJ,Passenger,0,1,1,14,15,6.67
8502,July,2021,Whatcom,WA,Truck,4,0,4,43871,43875,0.01
8503,July,2021,Goochland,VA,Passenger,4,2,6,214,220,2.73
8504,July,2021,Wichita,TX,Passenger,1,0,1,40,41,2.44
8505,July,2021,Columbia,WA,Truck,0,0,0,1555,1555,0.0
8506,July,2021,Kauai,HI,Passenger,1,0,1,17,18,5.56
8507,July,2021,Montgomery,MD,Passenger,3,1,4,212,216,1.85
8508,July,2021,Suffolk,MA,Passenger,0,2,2,31,33,6.06
8509,July,2021,Collin,TX,Passenger,1,1,2,105,107,1.87
8510,July,2021,Lake,IL,Passenger,2,0,2,156,158,1.27
8511,July,2021,Skamania,WA,Passenger,51,36,87,8410,8497,1.02
8512,July,2021,DeKalb,GA,Passenger,1,0,1,58,59,1.69
8513,July,2021,Sevier,AR,Passenger,0,1,1,0,1,100.0
8514,July,2021,Penobscot,ME,Passenger,0,1,1,8,9,11.11
8515,July,2021,Norfolk,VA,Passenger,3,3,6,313,319,1.88
8516,July,2021,Hennepin,MN,Passenger,3,0,3,72,75,4.0
8517,July,2021,Plaquemines,LA,Passenger,0,1,1,16,17,5.88
8518,July,2021,Douglas,NE,Passenger,1,1,2,51,53,3.77
8519,July,2021,St. Louis,MO,Passenger,1,0,1,80,81,1.23
8520,July,2021,Allegheny,PA,Passenger,1,1,2,62,64,3.12
8521,July,2021,King,WA,Truck,5,1,6,184354,184360,0.0
8522,July,2021,Alexandria,VA,Passenger,2,0,2,122,124,1.61
8523,July,2021,Riverside,CA,Passenger,5,1,6,537,543,1.1
8524,July,2021,Garfield,WA,Passenger,0,3,3,1375,1378,0.22
8525,July,2021,Pennington,SD,Passenger,1,0,1,31,32,3.12
8526,July,2021,Saginaw,MI,Passenger,1,0,1,6,7,14.29
8527,July,2021,Clallam,WA,Truck,1,0,1,22036,22037,0.0
8528,July,2021,Kittitas,WA,Passenger,166,68,234,29980,30214,0.77
8529,July,2021,Calvert,MD,Passenger,0,2,2,88,90,2.22
8530,July,2021,Richmond,NY,Passenger,1,0,1,9,10,10.0
8531,July,2021,St. Mary's,MD,Passenger,1,0,1,205,206,0.49
8532,July,2021,Middlesex,MA,Passenger,1,1,2,93,95,2.11
8533,July,2021,Nueces,TX,Passenger,1,0,1,69,70,1.43
8534,July,2021,Missoula,MT,Passenger,1,0,1,54,55,1.82
8535,July,2021,Stafford,VA,Passenger,2,1,3,98,101,2.97
8536,July,2021,Saratoga,NY,Passenger,1,0,1,42,43,2.33
8537,July,2021,Miami-Dade,FL,Passenger,1,0,1,97,98,1.02
8538,July,2021,Asotin,WA,Truck,0,0,0,6768,6768,0.0
8539,July,2021,Yakima,WA,Truck,0,0,0,61720,61720,0.0
8540,July,2021,Greene,MO,Passenger,0,1,1,29,30,3.33
8541,July,2021,Wilson,TX,Passenger,0,1,1,3,4,25.0
8542,July,2021,Okaloosa,FL,Passenger,0,1,1,114,115,0.87
8543,July,2021,King,WA,Passenger,31555,9349,40904,1366948,1407852,2.91
8544,July,2021,Columbia,WA,Passenger,6,2,8,2472,2480,0.32
8545,July,2021,Philadelphia,PA,Passenger,1,0,1,44,45,2.22
8546,July,2021,Pacific,WA,Truck,0,0,0,7961,7961,0.0
8547,July,2021,Hudson,NJ,Passenger,1,0,1,42,43,2.33
8548,July,2021,Contra Costa,CA,Passenger,2,3,5,262,267,1.87
8549,July,2021,New Haven,CT,Passenger,0,2,2,28,30,6.67
8550,July,2021,Clark,NV,Passenger,4,2,6,602,608,0.99
8551,July,2021,Hawaii,HI,Passenger,1,0,1,44,45,2.22
8552,July,2021,Hillsborough,FL,Passenger,0,1,1,145,146,0.68
8553,July,2021,Moore,NC,Passenger,0,1,1,130,131,0.76
8554,July,2021,Bucks,PA,Passenger,1,0,1,15,16,6.25
8555,July,2021,Suffolk,VA,Passenger,1,0,1,125,126,0.79
8556,July,2021,Gwinnett,GA,Passenger,1,0,1,61,62,1.61
8557,July,2021,Orange,CA,Passenger,5,3,8,407,415,1.93
8558,July,2021,Polk,FL,Passenger,1,0,1,55,56,1.79
8559,July,2021,Clark,WA,Passenger,2977,1459,4436,322390,326826,1.36
8560,July,2021,Pend Oreille,WA,Truck,0,0,0,5747,5747,0.0
8561,July,2021,Prince George's,MD,Passenger,2,1,3,139,142,2.11
8562,July,2021,Wilson,NC,Passenger,1,0,1,0,1,100.0
8563,July,2021,Richmond,GA,Passenger,0,1,1,74,75,1.33
8564,July,2021,Shelby,OH,Passenger,0,1,1,1,2,50.0
8565,July,2021,Washington,OR,Passenger,1,0,1,377,378,0.26
8566,July,2021,Spartanburg,SC,Passenger,0,1,1,51,52,1.92
8567,July,2021,Whatcom,WA,Passenger,1475,618,2093,150663,152756,1.37
8568,July,2021,Sonoma,CA,Passenger,0,1,1,79,80,1.25
8569,July,2021,Klamath,OR,Passenger,1,0,1,28,29,3.45
8570,July,2021,Grays Harbor,WA,Passenger,176,146,322,49519,49841,0.65
8571,July,2021,Ferry,WA,Truck,0,0,0,3646,3646,0.0
8572,July,2021,Houston,GA,Passenger,1,0,1,46,47,2.13
8573,July,2021,Milwaukee,WI,Passenger,1,0,1,38,39,2.56
8574,July,2021,Duval,FL,Passenger,0,2,2,330,332,0.6
8575,July,2021,Champaign,IL,Passenger,1,0,1,11,12,8.33
8576,July,2021,Carroll,NH,Passenger,0,1,1,5,6,16.67
8577,July,2021,Douglas,CO,Passenger,0,1,1,77,78,1.28
8578,July,2021,Randolph,NC,Passenger,1,0,1,5,6,16.67
8579,July,2021,District of Columbia,DC,Passenger,5,1,6,199,205,2.93
8580,July,2021,San Joaquin,CA,Passenger,1,0,1,101,102,0.98
8581,July,2021,Carson City,NV,Passenger,1,0,1,10,11,9.09
8583,July,2021,Travis,TX,Passenger,3,3,6,153,159,3.77
8584,July,2021,El Dorado,CA,Passenger,1,0,1,30,31,3.23
8585,July,2021,Fairfax,VA,Passenger,4,4,8,679,687,1.16
8586,July,2021,Whitman,WA,Passenger,61,49,110,21944,22054,0.5
8587,July,2021,Allen,IN,Passenger,1,0,1,15,16,6.25
8588,July,2021,Klickitat,WA,Passenger,77,50,127,15342,15469,0.82
8589,July,2021,Cowlitz,WA,Passenger,229,146,375,72247,72622,0.52
8590,July,2021,Erie,NY,Passenger,1,0,1,37,38,2.63
8591,July,2021,Walla Walla,WA,Truck,0,0,0,14055,14055,0.0
8592,July,2021,Santa Clara,CA,Passenger,8,2,10,247,257,3.89
8593,July,2021,Island,WA,Truck,0,0,0,21573,21573,0.0
8594,July,2021,Monterey,CA,Passenger,0,1,1,143,144,0.69
8595,July,2021,Nassau,NY,Passenger,2,0,2,26,28,7.14
8596,July,2021,Garfield,WA,Truck,0,0,0,1004,1004,0.0
8597,July,2021,Boone,MO,Passenger,0,1,1,9,10,10.0
8598,July,2021,DuPage,IL,Passenger,1,0,1,51,52,1.92
8599,July,2021,Arlington,VA,Passenger,0,1,1,135,136,0.74
8600,July,2021,Cape May,NJ,Passenger,0,1,1,8,9,11.11
8601,July,2021,Pinellas,FL,Passenger,0,1,1,93,94,1.06
8602,July,2021,Montgomery,PA,Passenger,1,0,1,24,25,4.0
8603,July,2021,Ventura,CA,Passenger,1,2,3,250,253,1.19
8604,July,2021,Spokane,WA,Truck,0,0,0,102316,102316,0.0
8605,July,2021,Vigo,IN,Passenger,1,0,1,5,6,16.67
8606,July,2021,Hamilton,IN,Passenger,2,0,2,31,33,6.06
8607,July,2021,Bartow,GA,Passenger,0,1,1,3,4,25.0
8608,July,2021,Chesapeake,VA,Passenger,0,4,4,387,391,1.02
8609,July,2021,Skagit,WA,Truck,1,0,1,33023,33024,0.0
8610,July,2021,Essex,NJ,Passenger,1,0,1,10,11,9.09
8611,July,2021,Kittitas,WA,Truck,0,0,0,14792,14792,0.0
8612,July,2021,Ulster,NY,Passenger,1,0,1,8,9,11.11
8613,July,2021,Spokane,WA,Passenger,1119,653,1772,326073,327845,0.54
8614,July,2021,Pend Oreille,WA,Passenger,15,7,22,9264,9286,0.24
8615,July,2021,St. Clair,IL,Passenger,2,0,2,134,136,1.47
8616,July,2021,El Paso,TX,Passenger,3,0,3,365,368,0.82
8617,July,2021,Franklin,WA,Passenger,134,97,231,62058,62289,0.37
8618,July,2021,Walla Walla,WA,Passenger,115,76,191,36567,36758,0.52
8619,July,2021,Burlington,NJ,Passenger,0,1,1,126,127,0.79
8620,July,2021,Jones,GA,Passenger,1,0,1,1,2,50.0
8621,July,2021,Cook,IL,Passenger,1,0,1,196,197,0.51
8622,July,2021,Richland,SC,Passenger,0,1,1,134,135,0.74
8623,July,2021,Virginia Beach,VA,Passenger,2,0,2,611,613,0.33
8624,July,2021,Jefferson,WA,Passenger,339,183,522,24889,25411,2.05
8625,July,2022,Norfolk,VA,Passenger,2,3,5,277,282,1.77
8626,July,2022,Pacific,WA,Truck,0,0,0,7881,7881,0.0
8627,July,2022,Hidalgo,TX,Passenger,0,1,1,53,54,1.85
8628,July,2022,Rock Island,IL,Passenger,0,1,1,14,15,6.67
8629,July,2022,Tarrant,TX,Passenger,1,0,1,100,101,0.99
8630,July,2022,Clackamas,OR,Passenger,2,0,2,135,137,1.46
8631,July,2022,Clark,WA,Passenger,4229,1806,6035,315632,321667,1.88
8632,July,2022,Prince George's,MD,Passenger,3,1,4,114,118,3.39
8633,July,2022,Moore,NC,Passenger,0,1,1,110,111,0.9
8634,July,2022,Cowlitz,WA,Truck,2,0,2,28483,28485,0.01
8635,July,2022,Grays Harbor,WA,Passenger,214,162,376,48927,49303,0.76
8636,July,2022,Alexandria,VA,Passenger,3,0,3,106,109,2.75
8637,July,2022,Boulder,CO,Passenger,1,0,1,32,33,3.03
8638,July,2022,Collin,TX,Passenger,2,0,2,75,77,2.6
8639,July,2022,Pend Oreille,WA,Passenger,18,12,30,9043,9073,0.33
8640,July,2022,Santa Clara,CA,Passenger,10,2,12,207,219,5.48
8641,July,2022,Prince William,VA,Passenger,0,1,1,185,186,0.54
8642,July,2022,Benton,WA,Passenger,780,462,1242,135328,136570,0.91
8643,July,2022,Kings,CA,Passenger,2,1,3,297,300,1.0
8644,July,2022,Berkeley,SC,Passenger,0,1,1,115,116,0.86
8645,July,2022,Richmond,GA,Passenger,0,1,1,60,61,1.64
8646,July,2022,Skamania,WA,Passenger,76,47,123,8163,8286,1.48
8647,July,2022,Harrison,MS,Passenger,1,0,1,39,40,2.5
8648,July,2022,Allegheny,PA,Passenger,1,1,2,51,53,3.77
8649,July,2022,Lee,FL,Passenger,1,0,1,28,29,3.45
8650,July,2022,Loudoun,VA,Passenger,2,1,3,63,66,4.55
8651,July,2022,Clark,WA,Truck,9,0,9,82552,82561,0.01
8652,July,2022,Skagit,WA,Truck,5,0,5,32300,32305,0.02
8653,July,2022,Escambia,FL,Passenger,0,1,1,125,126,0.79
8654,July,2022,Santa Cruz,CA,Passenger,1,0,1,21,22,4.55
8655,July,2022,Spokane,WA,Truck,8,0,8,102044,102052,0.01
8656,July,2022,Lincoln,OR,Passenger,0,1,1,23,24,4.17
8657,July,2022,Bexar,TX,Passenger,4,3,7,424,431,1.62
8658,July,2022,Albemarle,VA,Passenger,1,0,1,16,17,5.88
8659,July,2022,Thurston,WA,Passenger,2242,1065,3307,193613,196920,1.68
8660,July,2022,Contra Costa,CA,Passenger,0,4,4,231,235,1.7
8661,July,2022,Spokane,WA,Passenger,1676,864,2540,324816,327356,0.78
8662,July,2022,Douglas,NE,Passenger,1,2,3,38,41,7.32
8663,July,2022,Clallam,WA,Passenger,432,246,678,49651,50329,1.35
8664,July,2022,Lake,FL,Passenger,1,0,1,16,17,5.88
8665,July,2022,Asotin,WA,Passenger,24,19,43,12650,12693,0.34
8666,July,2022,New London,CT,Passenger,2,5,7,187,194,3.61
8667,July,2022,Dorchester,SC,Passenger,1,0,1,49,50,2.0
8668,July,2022,Louisa,VA,Passenger,0,1,1,1,2,50.0
8669,July,2022,Chesapeake,VA,Passenger,3,3,6,320,326,1.84
8670,July,2022,Kern,CA,Passenger,0,1,1,186,187,0.53
8671,July,2022,Whitman,WA,Truck,2,0,2,8570,8572,0.02
8672,July,2022,Owyhee,ID,Passenger,1,0,1,2,3,33.33
8673,July,2022,Ferry,WA,Truck,0,0,0,3566,3566,0.0
8674,July,2022,Hillsborough,FL,Passenger,0,1,1,116,117,0.85
8675,July,2022,Sheridan,WY,Passenger,1,0,1,7,8,12.5
8676,July,2022,Richmond,NY,Passenger,1,0,1,6,7,14.29
8677,July,2022,Multnomah,OR,Passenger,0,3,3,503,506,0.59
8678,July,2022,Hoke,NC,Passenger,1,0,1,64,65,1.54
8679,July,2022,Columbia,WA,Truck,0,0,0,1577,1577,0.0
8680,July,2022,Danville,VA,Passenger,1,0,1,0,1,100.0
8681,July,2022,Monterey,CA,Passenger,1,1,2,124,126,1.59
8682,July,2022,Walla Walla,WA,Passenger,175,99,274,35828,36102,0.76
8683,July,2022,Sedgwick,KS,Passenger,1,1,2,70,72,2.78
8684,July,2022,Hawaii,HI,Passenger,1,0,1,34,35,2.86
8685,July,2022,Essex,NJ,Passenger,2,0,2,9,11,18.18
8686,July,2022,Stevens,WA,Truck,1,0,1,18912,18913,0.01
8687,July,2022,Arlington,VA,Passenger,1,0,1,121,122,0.82
8688,July,2022,San Mateo,CA,Passenger,2,0,2,75,77,2.6
8689,July,2022,Harris,TX,Passenger,1,0,1,127,128,0.78
8690,July,2022,Lewis,WA,Truck,0,0,0,26347,26347,0.0
8691,July,2022,Bell,TX,Passenger,1,0,1,301,302,0.33
8692,July,2022,Los Angeles,CA,Passenger,8,8,16,730,746,2.14
8693,July,2022,Jefferson,WA,Passenger,442,219,661,24548,25209,2.62
8694,July,2022,Kitsap,WA,Truck,13,0,13,53416,53429,0.02
8695,July,2022,Walla Walla,WA,Truck,1,0,1,13918,13919,0.01
8696,July,2022,Spartanburg,SC,Passenger,0,1,1,37,38,2.63
8697,July,2022,Ulster,NY,Passenger,1,0,1,8,9,11.11
8698,July,2022,St. Clair,IL,Passenger,2,0,2,115,117,1.71
8699,July,2022,Randolph,NC,Passenger,1,0,1,5,6,16.67
8700,July,2022,Alameda,CA,Passenger,4,0,4,177,181,2.21
8701,July,2022,Snohomish,WA,Truck,27,0,27,123535,123562,0.02
8702,July,2022,Adams,CO,Passenger,1,0,1,38,39,2.56
8703,July,2022,Lane,OR,Passenger,0,1,1,88,89,1.12
8704,July,2022,Suffolk,VA,Passenger,1,0,1,119,120,0.83
8705,July,2022,Placer,CA,Passenger,2,0,2,64,66,3.03
8706,July,2022,Stevens,WA,Passenger,72,54,126,30084,30210,0.42
8707,July,2022,Whitman,WA,Passenger,88,60,148,21969,22117,0.67
8708,July,2022,Marin,CA,Passenger,0,1,1,27,28,3.57
8709,July,2022,Pierce,WA,Passenger,5245,2337,7582,543947,551529,1.37
8710,July,2022,Wood,OH,Passenger,0,1,1,3,4,25.0
8711,July,2022,Hennepin,MN,Passenger,1,0,1,45,46,2.17
8712,July,2022,Goochland,VA,Passenger,2,1,3,109,112,2.68
8713,July,2022,Wake,NC,Passenger,1,0,1,78,79,1.27
8714,July,2022,San Juan,WA,Truck,4,0,4,5948,5952,0.07
8715,July,2022,Okanogan,WA,Truck,1,0,1,16589,16590,0.01
8716,July,2022,Carroll,NH,Passenger,0,1,1,5,6,16.67
8717,July,2022,Burlington,NJ,Passenger,0,2,2,104,106,1.89
8718,July,2022,Wahkiakum,WA,Truck,0,0,0,1801,1801,0.0
8719,July,2022,St. Mary's,MD,Passenger,1,0,1,184,185,0.54
8720,July,2022,Larimer,CO,Passenger,1,0,1,44,45,2.22
8721,July,2022,Sevier,AR,Passenger,0,1,1,0,1,100.0
8722,July,2022,Middlesex,MA,Passenger,2,1,3,71,74,4.05
8723,July,2022,Charles,MD,Passenger,1,1,2,56,58,3.45
8724,July,2022,Whatcom,WA,Passenger,1864,754,2618,148809,151427,1.73
8725,July,2022,Lincoln,WA,Passenger,9,16,25,7715,7740,0.32
8726,July,2022,Queens,NY,Passenger,1,0,1,39,40,2.5
8727,July,2022,Allen,IN,Passenger,1,0,1,13,14,7.14
8728,July,2022,Bartow,GA,Passenger,0,1,1,3,4,25.0
8729,July,2022,Nueces,TX,Passenger,1,1,2,52,54,3.7
8730,July,2022,Harnett,NC,Passenger,2,0,2,139,141,1.42
8731,July,2022,Jefferson,NY,Passenger,0,1,1,199,200,0.5
8732,July,2022,Franklin,WA,Passenger,203,110,313,61860,62173,0.5
8733,July,2022,Orange,CA,Passenger,6,2,8,328,336,2.38
8734,July,2022,Ferry,WA,Passenger,21,4,25,4378,4403,0.57
8735,July,2022,Williams,ND,Passenger,0,1,1,5,6,16.67
8736,July,2022,Maricopa,AZ,Passenger,7,1,8,845,853,0.94
8737,July,2022,San Joaquin,CA,Passenger,1,1,2,81,83,2.41
8738,July,2022,Arapahoe,CO,Passenger,0,1,1,76,77,1.3
8739,July,2022,New Haven,CT,Passenger,0,2,2,26,28,7.14
8740,July,2022,Wahkiakum,WA,Passenger,24,12,36,3071,3107,1.16
8741,July,2022,Franklin,WA,Truck,1,0,1,20873,20874,0.0
8742,July,2022,Garfield,WA,Passenger,1,3,4,1326,1330,0.3
8743,July,2022,Grays Harbor,WA,Truck,2,0,2,21240,21242,0.01
8744,July,2022,Rockdale,GA,Passenger,1,0,1,7,8,12.5
8745,July,2022,Wichita,TX,Passenger,1,0,1,38,39,2.56
8746,July,2022,Juneau,AK,Passenger,0,1,1,29,30,3.33
8747,July,2022,Duval,FL,Passenger,1,2,3,263,266,1.13
8748,July,2022,Manassas,VA,Passenger,0,1,1,8,9,11.11
8749,July,2022,Frederick,MD,Passenger,1,0,1,60,61,1.64
8750,July,2022,Kittitas,WA,Passenger,278,86,364,29692,30056,1.21
8751,July,2022,Lincoln,WA,Truck,0,0,0,4833,4833,0.0
8752,July,2022,Lake,IL,Passenger,2,0,2,129,131,1.53
8753,July,2022,Skagit,WA,Passenger,813,345,1158,89848,91006,1.27
8754,July,2022,Lewis,WA,Passenger,246,177,423,59694,60117,0.7
8755,July,2022,Philadelphia,PA,Passenger,1,0,1,34,35,2.86
8756,July,2022,Garfield,WA,Truck,0,0,0,976,976,0.0
8757,July,2022,Gwinnett,GA,Passenger,1,0,1,48,49,2.04
8758,July,2022,Saratoga,NY,Passenger,1,0,1,39,40,2.5
8759,July,2022,Honolulu,HI,Passenger,4,3,7,312,319,2.19
8760,July,2022,Coryell,TX,Passenger,1,0,1,91,92,1.09
8761,July,2022,Benton,WA,Truck,3,0,3,43487,43490,0.01
8762,July,2022,Salt Lake,UT,Passenger,1,1,2,118,120,1.67
8763,July,2022,Pierce,WA,Truck,20,0,20,141272,141292,0.01
8764,July,2022,Grant,WA,Passenger,183,100,283,66683,66966,0.42
8765,July,2022,Howard,IN,Passenger,0,1,1,4,5,20.0
8766,July,2022,Leavenworth,KS,Passenger,0,1,1,97,98,1.02
8767,July,2022,Chelan,WA,Passenger,478,125,603,54238,54841,1.1
8768,July,2022,Anchorage,AK,Passenger,1,0,1,114,115,0.87
8769,July,2022,Fairfax,VA,Passenger,6,3,9,590,599,1.5
8770,July,2022,Miami-Dade,FL,Passenger,1,0,1,75,76,1.32
8771,July,2022,San Juan,WA,Passenger,521,160,681,14025,14706,4.63
8772,July,2022,Kittitas,WA,Truck,1,0,1,14616,14617,0.01
8773,July,2022,Wilson,TX,Passenger,0,1,1,2,3,33.33
8774,July,2022,Onslow,NC,Passenger,0,1,1,157,158,0.63
8775,July,2022,DeKalb,GA,Passenger,1,0,1,45,46,2.17
8776,July,2022,Cumberland,NC,Passenger,1,2,3,339,342,0.88
8777,July,2022,Denton,TX,Passenger,1,0,1,61,62,1.61
8778,July,2022,Elmore,ID,Passenger,1,0,1,12,13,7.69
8779,July,2022,Kauai,HI,Passenger,1,0,1,15,16,6.25
8780,July,2022,Washington,MD,Passenger,2,0,2,15,17,11.76
8781,July,2022,Ventura,CA,Passenger,2,1,3,222,225,1.33
8782,July,2022,Thurston,WA,Truck,8,0,8,55356,55364,0.01
8783,July,2022,Columbia,WA,Passenger,7,0,7,2430,2437,0.29
8784,July,2022,San Diego,CA,Passenger,16,11,27,2199,2226,1.21
8785,July,2022,Stafford,VA,Passenger,2,1,3,84,87,3.45
8786,July,2022,Pacific,WA,Passenger,64,71,135,15841,15976,0.85
8787,July,2022,Nassau,NY,Passenger,2,0,2,23,25,8.0
8788,July,2022,Okanogan,WA,Passenger,88,49,137,26298,26435,0.52
8789,July,2022,Cowlitz,WA,Passenger,349,171,520,70574,71094,0.73
8790,July,2022,Rockingham,NH,Passenger,1,0,1,14,15,6.67
8791,July,2022,Douglas,WA,Truck,1,0,1,12747,12748,0.01
8792,July,2022,Yakima,WA,Passenger,353,198,551,166690,167241,0.33
8793,July,2022,Pennington,SD,Passenger,2,0,2,24,26,7.69
8794,July,2022,Portsmouth,VA,Passenger,0,1,1,73,74,1.35
8795,July,2022,Plaquemines,LA,Passenger,1,1,2,16,18,11.11
8796,July,2022,Las Animas,CO,Passenger,1,0,1,1,2,50.0
8797,July,2022,Douglas,WA,Passenger,138,60,198,28404,28602,0.69
8798,July,2022,Penobscot,ME,Passenger,0,1,1,8,9,11.11
8799,July,2022,Yellowstone,MT,Passenger,0,1,1,21,22,4.55
8800,July,2022,Williamson,TX,Passenger,1,2,3,77,80,3.75
8801,July,2022,Klickitat,WA,Truck,0,0,0,8286,8286,0.0
8802,July,2022,Island,WA,Truck,6,0,6,21337,21343,0.03
8803,July,2022,St. Louis,MO,Passenger,1,0,1,59,60,1.67
8804,July,2022,Fort Bend,TX,Passenger,1,0,1,24,25,4.0
8805,July,2022,Rogers,OK,Passenger,1,0,1,1,2,50.0
8806,July,2022,San Bernardino,CA,Passenger,1,1,2,310,312,0.64
8807,July,2022,Hamilton,IN,Passenger,1,0,1,17,18,5.56
8808,July,2022,Bryan,GA,Passenger,0,1,1,39,40,2.5
8809,July,2022,Ray,MO,Passenger,0,1,1,1,2,50.0
8810,July,2022,King,WA,Passenger,41908,11450,53358,1347349,1400707,3.81
8811,July,2022,Sumter,SC,Passenger,0,1,1,32,33,3.03
8812,July,2022,Adams,WA,Truck,1,0,1,5458,5459,0.02
8813,July,2022,Sonoma,CA,Passenger,0,1,1,73,74,1.35
8814,July,2022,Klickitat,WA,Passenger,106,56,162,15204,15366,1.05
8815,July,2022,Camden,NJ,Passenger,0,1,1,12,13,7.69
8816,July,2022,Skamania,WA,Truck,0,0,0,3948,3948,0.0
8817,July,2022,Fairbanks North Star,AK,Passenger,0,1,1,70,71,1.41
8818,July,2022,Chelan,WA,Truck,4,0,4,23054,23058,0.02
8819,July,2022,Cape May,NJ,Passenger,0,1,1,7,8,12.5
8820,July,2022,Mason,WA,Truck,4,0,4,20985,20989,0.02
8821,July,2022,Houston,GA,Passenger,1,0,1,30,31,3.23
8822,July,2022,Clallam,WA,Truck,3,0,3,21895,21898,0.01
8823,July,2022,Whatcom,WA,Truck,11,0,11,43223,43234,0.03
8824,July,2022,Douglas,CO,Passenger,0,1,1,68,69,1.45
8825,July,2022,Sarasota,FL,Passenger,2,0,2,22,24,8.33
8826,July,2022,Hamilton,OH,Passenger,1,0,1,26,27,3.7
8827,July,2022,Montgomery,AL,Passenger,0,1,1,33,34,2.94
8828,July,2022,Mason,WA,Passenger,320,176,496,47125,47621,1.04
8829,July,2022,District of Columbia,DC,Passenger,4,0,4,167,171,2.34
8830,July,2022,Adams,WA,Passenger,19,10,29,12942,12971,0.22
8831,July,2022,Virginia Beach,VA,Passenger,2,0,2,493,495,0.4
8832,July,2022,Sacramento,CA,Passenger,3,0,3,188,191,1.57
8833,July,2022,El Paso,TX,Passenger,2,0,2,317,319,0.63
8834,July,2022,Pend Oreille,WA,Truck,0,0,0,5648,5648,0.0
8835,July,2022,Oldham,KY,Passenger,0,1,1,4,5,20.0
8836,July,2022,Calvert,MD,Passenger,0,2,2,75,77,2.6
8837,July,2022,Okaloosa,FL,Passenger,0,1,1,97,98,1.02
8838,July,2022,Travis,TX,Passenger,1,0,1,98,99,1.01
8839,July,2022,Asotin,WA,Truck,0,0,0,6688,6688,0.0
8841,July,2022,Pulaski,AR,Passenger,1,0,1,26,27,3.7
8842,July,2022,St. Tammany,LA,Passenger,1,0,1,33,34,2.94
8843,July,2022,Montgomery,MD,Passenger,4,2,6,191,197,3.05
8844,July,2022,Hudson,NJ,Passenger,2,0,2,32,34,5.88
8845,July,2022,Island,WA,Passenger,835,380,1215,61863,63078,1.93
8846,July,2022,Charleston,SC,Passenger,2,2,4,59,63,6.35
8847,July,2022,Anne Arundel,MD,Passenger,4,4,8,330,338,2.37
8848,July,2022,Orange,FL,Passenger,1,0,1,81,82,1.22
8849,July,2022,Montgomery,PA,Passenger,1,0,1,20,21,4.76
8850,July,2022,Sarpy,NE,Passenger,1,0,1,52,53,1.89
8851,July,2022,Cumberland,PA,Passenger,1,0,1,36,37,2.7
8852,July,2022,Grant,WA,Truck,0,0,0,27963,27963,0.0
8853,July,2022,Geary,KS,Passenger,1,0,1,83,84,1.19
8854,July,2022,Riverside,CA,Passenger,7,1,8,439,447,1.79
8855,July,2022,Cook,IL,Passenger,2,0,2,175,177,1.13
8856,July,2022,Yakima,WA,Truck,1,0,1,61344,61345,0.0
8857,July,2022,Kitsap,WA,Passenger,2463,1074,3537,178200,181737,1.95
8858,July,2022,Howard,MD,Passenger,0,1,1,52,53,1.89
8859,July,2022,King,WA,Truck,123,2,125,180390,180515,0.07
8860,July,2022,Platte,MO,Passenger,1,0,1,21,22,4.55
8861,July,2022,Jefferson,WA,Truck,3,0,3,9457,9460,0.03
8862,July,2022,Greene,MO,Passenger,0,1,1,19,20,5.0
8863,July,2022,Broward,FL,Passenger,1,0,1,73,74,1.35
8864,July,2022,El Paso,CO,Passenger,2,1,3,567,570,0.53
8865,July,2022,Snohomish,WA,Passenger,8662,2565,11227,531561,542788,2.07
8866,July,2022,Clark,NV,Passenger,4,2,6,485,491,1.22
8867,July,2022,Carroll,MD,Passenger,0,1,1,16,17,5.88
8868,July,2022,Galveston,TX,Passenger,0,1,1,18,19,5.26
8869,July,2022,Solano,CA,Passenger,1,0,1,154,155,0.65
8870,July,2023,Madison,IL,Passenger,1,0,1,14,15,6.67
8871,July,2023,Oldham,KY,Passenger,0,1,1,3,4,25.0
8872,July,2023,Arapahoe,CO,Passenger,1,1,2,55,57,3.51
8873,July,2023,Bell,TX,Passenger,1,0,1,213,214,0.47
8874,July,2023,San Bernardino,CA,Passenger,2,1,3,231,234,1.28
8875,July,2023,Skagit,WA,Passenger,1139,417,1556,86446,88002,1.77
8876,July,2023,Grays Harbor,WA,Passenger,311,192,503,47081,47584,1.06
8877,July,2023,Chelan,WA,Truck,31,0,31,22570,22601,0.14
8878,July,2023,Yakima,WA,Truck,13,0,13,58999,59012,0.02
8879,July,2023,King,WA,Passenger,58610,14725,73335,1297605,1370940,5.35
8880,July,2023,Fairfax,VA,Passenger,5,3,8,487,495,1.62
8881,July,2023,Yakima,WA,Passenger,511,253,764,161420,162184,0.47
8882,July,2023,Beaufort,SC,Passenger,1,0,1,19,20,5.0
8883,July,2023,Stevens,WA,Truck,2,0,2,18253,18255,0.01
8884,July,2023,Pend Oreille,WA,Passenger,30,15,45,8645,8690,0.52
8885,July,2023,El Paso,CO,Passenger,3,1,4,425,429,0.93
8886,July,2023,Adams,CO,Passenger,1,0,1,21,22,4.55
8887,July,2023,Yellowstone,MT,Passenger,0,1,1,13,14,7.14
8888,July,2023,San Diego,CA,Passenger,14,9,23,1711,1734,1.33
8889,July,2023,Pierce,WA,Passenger,7775,2805,10580,516969,527549,2.01
8890,July,2023,Wahkiakum,WA,Passenger,27,17,44,2972,3016,1.46
8891,July,2023,Elmore,ID,Passenger,1,0,1,8,9,11.11
8892,July,2023,Kent,DE,Passenger,1,0,1,38,39,2.56
8893,July,2023,Pulaski,AR,Passenger,2,0,2,17,19,10.53
8894,July,2023,Virginia Beach,VA,Passenger,2,1,3,392,395,0.76
8895,July,2023,Jefferson,WA,Truck,12,0,12,9094,9106,0.13
8896,July,2023,Whitman,WA,Truck,5,0,5,8455,8460,0.06
8897,July,2023,Wahkiakum,WA,Truck,3,0,3,1728,1731,0.17
8898,July,2023,Marin,CA,Passenger,0,1,1,26,27,3.7
8899,July,2023,Travis,TX,Passenger,1,0,1,69,70,1.43
8900,July,2023,Columbia,WA,Passenger,10,1,11,2365,2376,0.46
8901,July,2023,Rockdale,GA,Passenger,1,0,1,3,4,25.0
8902,July,2023,Rock Island,IL,Passenger,0,1,1,13,14,7.14
8903,July,2023,San Juan,WA,Passenger,622,165,787,13491,14278,5.51
8904,July,2023,Jefferson,WA,Passenger,571,261,832,23782,24614,3.38
8905,July,2023,Franklin,WA,Truck,6,0,6,20274,20280,0.03
8906,July,2023,Santa Cruz,CA,Passenger,1,0,1,11,12,8.33
8907,July,2023,Lincoln,WA,Passenger,18,19,37,7476,7513,0.49
8908,July,2023,Allen,IN,Passenger,1,0,1,5,6,16.67
8909,July,2023,Boulder,CO,Passenger,1,0,1,21,22,4.55
8910,July,2023,King,WA,Truck,780,2,782,170537,171319,0.46
8911,July,2023,Ventura,CA,Passenger,1,1,2,182,184,1.09
8912,July,2023,Bexar,TX,Passenger,2,2,4,308,312,1.28
8913,July,2023,Lee,AL,Passenger,1,0,1,9,10,10.0
8914,July,2023,Ray,MO,Passenger,0,1,1,0,1,100.0
8915,July,2023,Houston,GA,Passenger,1,0,1,26,27,3.7
8916,July,2023,Columbia,WA,Truck,0,0,0,1509,1509,0.0
8917,July,2023,Collin,TX,Passenger,1,0,1,29,30,3.33
8918,July,2023,Okanogan,WA,Passenger,128,62,190,25306,25496,0.75
8919,July,2023,Sedgwick,KS,Passenger,1,0,1,46,47,2.13
8920,July,2023,Kootenai,ID,Truck,1,0,1,20,21,4.76
8921,July,2023,Montgomery,MD,Passenger,3,2,5,153,158,3.16
8922,July,2023,Miami-Dade,FL,Passenger,1,0,1,47,48,2.08
8923,July,2023,Clark,NV,Passenger,2,2,4,328,332,1.2
8924,July,2023,Newport News,VA,Passenger,1,0,1,85,86,1.16
8925,July,2023,Snohomish,WA,Truck,187,0,187,117767,117954,0.16
8926,July,2023,Alexandria,VA,Passenger,2,1,3,81,84,3.57
8927,July,2023,El Paso,TX,Passenger,2,0,2,225,227,0.88
8928,July,2023,Camden,NJ,Passenger,0,1,1,10,11,9.09
8929,July,2023,Clallam,WA,Passenger,563,289,852,47919,48771,1.75
8930,July,2023,Orange,CA,Passenger,6,2,8,246,254,3.15
8931,July,2023,Prince George's,MD,Passenger,3,1,4,97,101,3.96
8932,July,2023,Norfolk,VA,Passenger,2,2,4,238,242,1.65
8933,July,2023,Chesapeake,VA,Passenger,1,3,4,250,254,1.57
8934,July,2023,Asotin,WA,Passenger,35,23,58,12154,12212,0.47
8935,July,2023,DeKalb,GA,Passenger,1,0,1,30,31,3.23
8936,July,2023,Asotin,WA,Truck,0,0,0,6500,6500,0.0
8937,July,2023,Whitman,WA,Passenger,159,77,236,21502,21738,1.09
8938,July,2023,Galveston,TX,Passenger,0,1,1,13,14,7.14
8939,July,2023,Loudoun,VA,Passenger,2,0,2,55,57,3.51
8940,July,2023,Washington,MD,Passenger,1,0,1,12,13,7.69
8941,July,2023,Kauai,HI,Passenger,0,1,1,13,14,7.14
8942,July,2023,Sacramento,CA,Passenger,5,0,5,117,122,4.1
8943,July,2023,Kitsap,WA,Passenger,3267,1302,4569,172227,176796,2.58
8944,July,2023,District of Columbia,DC,Passenger,5,0,5,135,140,3.57
8945,July,2023,Yavapai,AZ,Passenger,1,0,1,17,18,5.56
8946,July,2023,Lincoln,OR,Passenger,0,1,1,12,13,7.69
8947,July,2023,Cowlitz,WA,Passenger,477,222,699,68070,68769,1.02
8948,July,2023,Charles,MD,Passenger,1,1,2,45,47,4.26
8949,July,2023,Sheridan,WY,Passenger,1,0,1,5,6,16.67
8950,July,2023,Solano,CA,Passenger,5,0,5,123,128,3.91
8951,July,2023,Kittitas,WA,Passenger,358,104,462,28484,28946,1.6
8952,July,2023,Pend Oreille,WA,Truck,0,0,0,5446,5446,0.0
8953,July,2023,Alameda,CA,Passenger,3,0,3,132,135,2.22
8954,July,2023,Cowlitz,WA,Truck,10,0,10,27395,27405,0.04
8955,July,2023,Gwinnett,GA,Passenger,1,0,1,33,34,2.94
8956,July,2023,Mason,WA,Truck,11,0,11,19979,19990,0.06
8957,July,2023,St. Tammany,LA,Passenger,1,0,1,26,27,3.7
8958,July,2023,Broward,FL,Passenger,1,0,1,50,51,1.96
8959,July,2023,Adams,WA,Truck,3,0,3,5136,5139,0.06
8960,July,2023,Douglas,WA,Passenger,213,65,278,28117,28395,0.98
8961,July,2023,Benton,WA,Truck,25,0,25,41955,41980,0.06
8962,July,2023,Jefferson,NY,Passenger,1,1,2,162,164,1.22
8963,July,2023,Skamania,WA,Passenger,105,56,161,7814,7975,2.02
8964,July,2023,Frederick,MD,Passenger,1,1,2,45,47,4.26
8965,July,2023,Wichita,TX,Passenger,2,0,2,29,31,6.45
8966,July,2023,Vernon,LA,Passenger,1,0,1,65,66,1.52
8967,July,2023,Fairfax,VA,Truck,1,0,1,77,78,1.28
8968,July,2023,Rockingham,NH,Passenger,1,0,1,10,11,9.09
8969,July,2023,Chelan,WA,Passenger,641,165,806,52924,53730,1.5
8970,July,2023,Leavenworth,KS,Passenger,0,1,1,86,87,1.15
8971,July,2023,Okanogan,WA,Truck,7,0,7,15946,15953,0.04
8972,July,2023,San Juan,WA,Truck,16,0,16,5767,5783,0.28
8973,July,2023,Goochland,VA,Passenger,0,1,1,22,23,4.35
8974,July,2023,Ferry,WA,Truck,0,0,0,3476,3476,0.0
8975,July,2023,Emmet,MI,Passenger,0,1,1,0,1,100.0
8976,July,2023,Clark,WA,Passenger,5943,2342,8285,305963,314248,2.64
8977,July,2023,Benton,OR,Passenger,1,0,1,27,28,3.57
8978,July,2023,Lewis,WA,Truck,7,0,7,25247,25254,0.03
8979,July,2023,St. Louis,MO,Passenger,1,0,1,42,43,2.33
8980,July,2023,Douglas,NE,Passenger,1,1,2,17,19,10.53
8981,July,2023,Lane,OR,Passenger,0,1,1,50,51,1.96
8982,July,2023,Lake,IL,Passenger,3,0,3,99,102,2.94
8983,July,2023,Thurston,WA,Passenger,3153,1230,4383,185812,190195,2.3
8984,July,2023,Garfield,WA,Passenger,0,3,3,1282,1285,0.23
8985,July,2023,Lewis,WA,Passenger,328,217,545,57742,58287,0.94
8986,July,2023,Suffolk,VA,Passenger,1,0,1,87,88,1.14
8987,July,2023,Klickitat,WA,Truck,11,0,11,8015,8026,0.14
8988,July,2023,Arlington,VA,Passenger,1,0,1,93,94,1.06
8989,July,2023,Snohomish,WA,Passenger,13023,3087,16110,515187,531297,3.03
8990,July,2023,Spokane,WA,Passenger,2340,1124,3464,315617,319081,1.09
8991,July,2023,Island,WA,Truck,33,0,33,20607,20640,0.16
8992,July,2023,Harrison,MS,Passenger,1,0,1,25,26,3.85
8993,July,2023,Benton,WA,Passenger,1158,568,1726,131666,133392,1.29
8994,July,2023,Carroll,MD,Passenger,0,1,1,16,17,5.88
8995,July,2023,Platte,MO,Passenger,1,0,1,16,17,5.88
8996,July,2023,Calvert,MD,Passenger,1,1,2,66,68,2.94
8997,July,2023,Maricopa,AZ,Passenger,6,3,9,510,519,1.73
8998,July,2023,New London,CT,Passenger,1,4,5,159,164,3.05
8999,July,2023,St. Clair,IL,Passenger,1,0,1,89,90,1.11
9000,July,2023,Mason,WA,Passenger,462,212,674,45044,45718,1.47
9001,July,2023,Ulster,NY,Passenger,1,0,1,4,5,20.0
9002,July,2023,Garfield,WA,Truck,0,0,0,950,950,0.0
9003,July,2023,Champaign,IL,Passenger,1,0,1,7,8,12.5
9004,July,2023,Coryell,TX,Passenger,1,0,1,67,68,1.47
9005,July,2023,Plaquemines,LA,Passenger,1,1,2,12,14,14.29
9006,July,2023,Honolulu,HI,Passenger,2,3,5,211,216,2.31
9007,July,2023,Placer,CA,Passenger,1,0,1,49,50,2.0
9008,July,2023,Polk,OR,Passenger,0,1,1,13,14,7.14
9009,July,2023,Charleston,SC,Passenger,1,2,3,42,45,6.67
9010,July,2023,Pacific,WA,Truck,4,0,4,7654,7658,0.05
9011,July,2023,Napa,CA,Passenger,0,1,1,8,9,11.11
9012,July,2023,Clallam,WA,Truck,19,0,19,21216,21235,0.09
9013,July,2023,Island,WA,Passenger,1106,442,1548,59897,61445,2.52
9014,July,2023,Walla Walla,WA,Truck,5,0,5,13311,13316,0.04
9015,July,2023,Grant,WA,Truck,12,0,12,27240,27252,0.04
9016,July,2023,Jackson,OK,Passenger,0,1,1,29,30,3.33
9017,July,2023,Harnett,NC,Passenger,4,0,4,111,115,3.48
9018,July,2023,Clark,WA,Truck,102,0,102,79248,79350,0.13
9019,July,2023,Cumberland,PA,Passenger,1,0,1,25,26,3.85
9020,July,2023,Klickitat,WA,Passenger,156,65,221,14764,14985,1.47
9022,July,2023,Onslow,NC,Passenger,0,1,1,129,130,0.77
9023,July,2023,Douglas,CO,Passenger,0,1,1,44,45,2.22
9024,July,2023,Richmond,NY,Passenger,1,0,1,5,6,16.67
9025,July,2023,Middlesex,MA,Passenger,2,1,3,53,56,5.36
9026,July,2023,Ferry,WA,Passenger,21,4,25,4197,4222,0.59
9027,July,2023,Saratoga,NY,Passenger,1,1,2,27,29,6.9
9028,July,2023,New Haven,CT,Passenger,0,2,2,19,21,9.52
9029,July,2023,Cape May,NJ,Passenger,0,1,1,7,8,12.5
9030,July,2023,Escambia,FL,Passenger,0,1,1,98,99,1.01
9031,July,2023,Spokane,WA,Truck,42,0,42,99373,99415,0.04
9032,July,2023,Grant,WA,Passenger,287,131,418,65201,65619,0.64
9033,July,2023,Douglas,WA,Truck,5,0,5,12696,12701,0.04
9034,July,2023,Randolph,NC,Passenger,1,0,1,3,4,25.0
9035,July,2023,Hidalgo,TX,Passenger,0,1,1,38,39,2.56
9036,July,2023,Pacific,WA,Passenger,78,88,166,15312,15478,1.07
9037,July,2023,Kittitas,WA,Truck,10,0,10,14172,14182,0.07
9038,July,2023,Wilson,TX,Passenger,0,1,1,2,3,33.33
9039,July,2023,Thurston,WA,Truck,64,0,64,52520,52584,0.12
9040,July,2023,Santa Clara,CA,Passenger,8,1,9,127,136,6.62
9041,July,2023,Howard,MD,Passenger,0,1,1,38,39,2.56
9042,July,2023,Contra Costa,CA,Passenger,0,3,3,172,175,1.71
9043,July,2023,Sarpy,NE,Passenger,1,0,1,41,42,2.38
9044,July,2023,Skamania,WA,Truck,1,0,1,3727,3728,0.03
9045,July,2023,Whatcom,WA,Passenger,2522,891,3413,144372,147785,2.31
9046,July,2023,St. Mary's,MD,Passenger,1,0,1,158,159,0.63
9047,July,2023,Berkeley,SC,Passenger,0,1,1,87,88,1.14
9048,July,2023,Richmond,GA,Passenger,0,1,1,50,51,1.96
9049,July,2023,Franklin,WA,Passenger,315,141,456,60118,60574,0.75
9050,July,2023,Kern,CA,Passenger,1,1,2,154,156,1.28
9051,July,2023,Burlington,NJ,Passenger,0,2,2,80,82,2.44
9052,July,2023,Monterey,CA,Passenger,1,0,1,94,95,1.05
9053,July,2023,Whatcom,WA,Truck,63,0,63,41534,41597,0.15
9054,July,2023,Hudson,NJ,Passenger,1,0,1,13,14,7.14
9055,July,2023,Kings,CA,Passenger,2,1,3,242,245,1.22
9056,July,2023,Hennepin,MN,Passenger,1,0,1,23,24,4.17
9057,July,2023,Larimer,CO,Passenger,1,0,1,28,29,3.45
9058,July,2023,Portsmouth,VA,Passenger,0,1,1,56,57,1.75
9059,July,2023,Lincoln,WA,Truck,0,0,0,4756,4756,0.0
9060,July,2023,Grays Harbor,WA,Truck,9,0,9,20411,20420,0.04
9061,July,2023,Dallas,TX,Passenger,1,0,1,62,63,1.59
9062,July,2023,Moore,NC,Passenger,0,1,1,95,96,1.04
9063,July,2023,Stafford,VA,Passenger,3,1,4,65,69,5.8
9064,July,2023,Hillsborough,FL,Passenger,0,1,1,86,87,1.15
9065,July,2023,Kitsap,WA,Truck,80,0,80,51022,51102,0.16
9066,July,2023,Adams,WA,Passenger,24,12,36,12621,12657,0.28
9067,July,2023,Walla Walla,WA,Passenger,223,113,336,34442,34778,0.97
9068,July,2023,Cook,IL,Passenger,2,0,2,122,124,1.61
9069,July,2023,Sarasota,FL,Passenger,1,0,1,15,16,6.25
9070,July,2023,Hamilton,OH,Passenger,1,0,1,24,25,4.0
9071,July,2023,Stevens,WA,Passenger,117,69,186,28933,29119,0.64
9072,July,2023,Hamilton,OH,Truck,1,0,1,2,3,33.33
9073,July,2023,Anne Arundel,MD,Passenger,6,4,10,262,272,3.68
9074,July,2023,Riverside,CA,Passenger,6,0,6,325,331,1.81
9075,July,2023,Salt Lake,UT,Passenger,0,1,1,77,78,1.28
9076,July,2023,Williamson,TX,Passenger,0,1,1,38,39,2.56
9077,July,2023,Pierce,WA,Truck,166,0,166,132850,133016,0.12
9078,July,2023,Las Animas,CO,Passenger,1,0,1,0,1,100.0
9079,July,2023,Los Angeles,CA,Passenger,4,4,8,509,517,1.55
9080,July,2023,Santa Barbara,CA,Passenger,1,0,1,57,58,1.72
9081,July,2023,Hoke,NC,Passenger,1,0,1,47,48,2.08
9082,July,2023,Hawaii,HI,Passenger,1,0,1,23,24,4.17
9083,July,2023,Essex,NJ,Passenger,2,0,2,4,6,33.33
9084,July,2023,Dorchester,SC,Passenger,1,0,1,33,34,2.94
9085,July,2023,Skagit,WA,Truck,23,0,23,30998,31021,0.07
9086,July,2023,Multnomah,OR,Passenger,0,2,2,359,361,0.55
9087,July,2023,Nueces,TX,Passenger,1,1,2,48,50,4.0
9088,July,2023,Sonoma,CA,Passenger,1,1,2,43,45,4.44
9089,July,2023,Cumberland,NC,Passenger,1,2,3,268,271,1.11
9090,June,2017,Franklin,MA,Passenger,0,1,1,4,5,20.0
9091,June,2017,Prince George's,MD,Passenger,0,1,1,183,184,0.54
9092,June,2017,Honolulu,HI,Passenger,3,2,5,591,596,0.84
9093,June,2017,Ferry,WA,Truck,0,0,0,3537,3537,0.0
9094,June,2017,Saratoga,NY,Passenger,1,1,2,75,77,2.6
9095,June,2017,Travis,TX,Passenger,0,1,1,191,192,0.52
9096,June,2017,Bergen,NJ,Passenger,0,2,2,31,33,6.06
9097,June,2017,Hamilton,IN,Passenger,1,0,1,58,59,1.69
9098,June,2017,Grays Harbor,WA,Passenger,35,31,66,44778,44844,0.15
9099,June,2017,Canyon,ID,Passenger,0,1,1,100,101,0.99
9100,June,2017,Howard,MD,Passenger,0,2,2,93,95,2.11
9101,June,2017,Morris,NJ,Passenger,1,0,1,24,25,4.0
9102,June,2017,Kitsap,WA,Truck,1,0,1,52519,52520,0.0
9103,June,2017,Garfield,WA,Truck,0,0,0,940,940,0.0
9104,June,2017,Palm Beach,FL,Passenger,0,1,1,98,99,1.01
9105,June,2017,Douglas,WA,Truck,0,0,0,11527,11527,0.0
9106,June,2017,Snohomish,WA,Passenger,1793,903,2696,513181,515877,0.52
9107,June,2017,Douglas,WA,Passenger,34,26,60,26716,26776,0.22
9108,June,2017,Chelan,WA,Passenger,67,37,104,52044,52148,0.2
9109,June,2017,Moore,NC,Passenger,0,1,1,199,200,0.5
9110,June,2017,Maui,HI,Passenger,1,0,1,69,70,1.43
9111,June,2017,Missoula,MT,Passenger,1,0,1,72,73,1.37
9112,June,2017,Bexar,TX,Passenger,1,1,2,938,940,0.21
9113,June,2017,Whitman,WA,Truck,0,0,0,8429,8429,0.0
9114,June,2017,Clallam,WA,Truck,0,0,0,21016,21016,0.0
9115,June,2017,Franklin,WA,Truck,0,0,0,18122,18122,0.0
9116,June,2017,Prince William,VA,Passenger,0,3,3,270,273,1.1
9117,June,2017,Santa Clara,CA,Passenger,5,2,7,400,407,1.72
9118,June,2017,Snohomish,WA,Truck,1,0,1,121886,121887,0.0
9119,June,2017,Twin Falls,ID,Passenger,0,1,1,23,24,4.17
9120,June,2017,Pinal,AZ,Passenger,2,0,2,243,245,0.82
9121,June,2017,Walla Walla,WA,Truck,0,0,0,13205,13205,0.0
9122,June,2017,Ramsey,MN,Passenger,1,0,1,41,42,2.38
9123,June,2017,Alameda,CA,Passenger,1,1,2,365,367,0.54
9124,June,2017,San Juan,WA,Passenger,107,40,147,13551,13698,1.07
9125,June,2017,Kitsap,WA,Passenger,605,319,924,173378,174302,0.53
9126,June,2017,Cape May,NJ,Passenger,0,1,1,19,20,5.0
9127,June,2017,Orange,CA,Passenger,3,1,4,627,631,0.63
9128,June,2017,Volusia,FL,Passenger,0,1,1,47,48,2.08
9129,June,2017,New Haven,CT,Passenger,0,1,1,57,58,1.72
9130,June,2017,DeKalb,GA,Passenger,1,0,1,85,86,1.16
9131,June,2017,Hawaii,HI,Passenger,1,0,1,81,82,1.22
9132,June,2017,Pacific,WA,Truck,0,0,0,7471,7471,0.0
9133,June,2017,Wahkiakum,WA,Passenger,0,2,2,2832,2834,0.07
9134,June,2017,Norfolk,VA,Passenger,1,1,2,316,318,0.63
9135,June,2017,Kittitas,WA,Truck,0,0,0,13560,13560,0.0
9136,June,2017,Cumberland,NC,Passenger,1,0,1,584,585,0.17
9137,June,2017,Stevens,WA,Passenger,8,23,31,31384,31415,0.1
9138,June,2017,Skamania,WA,Truck,0,0,0,3892,3892,0.0
9139,June,2017,Arlington,VA,Passenger,1,1,2,167,169,1.18
9140,June,2017,Anne Arundel,MD,Passenger,0,1,1,499,500,0.2
9141,June,2017,Albemarle,VA,Passenger,0,1,1,32,33,3.03
9142,June,2017,Pima,AZ,Passenger,1,2,3,430,433,0.69
9143,June,2017,Norfolk,MA,Passenger,1,0,1,39,40,2.5
9144,June,2017,Grays Harbor,WA,Truck,0,0,0,19888,19888,0.0
9145,June,2017,Manassas,VA,Passenger,0,1,1,9,10,10.0
9146,June,2017,Okanogan,WA,Truck,0,0,0,16204,16204,0.0
9147,June,2017,Kent,MI,Passenger,0,1,1,37,38,2.63
9148,June,2017,Salt Lake,UT,Passenger,0,1,1,266,267,0.37
9149,June,2017,Lewis,WA,Truck,0,0,0,24838,24838,0.0
9150,June,2017,Klickitat,WA,Truck,0,0,0,7971,7971,0.0
9151,June,2017,Polk,FL,Passenger,1,0,1,64,65,1.54
9152,June,2017,Tarrant,TX,Passenger,1,0,1,252,253,0.4
9153,June,2017,Asotin,WA,Truck,0,0,0,6502,6502,0.0
9154,June,2017,Juneau,AK,Passenger,0,1,1,45,46,2.17
9156,June,2017,Skagit,WA,Passenger,140,103,243,88070,88313,0.28
9157,June,2017,Manatee,FL,Passenger,1,0,1,46,47,2.13
9158,June,2017,Spokane,WA,Passenger,253,208,461,296812,297273,0.16
9159,June,2017,Cowlitz,WA,Truck,0,0,0,27913,27913,0.0
9160,June,2017,Whatcom,WA,Passenger,462,175,637,143061,143698,0.44
9161,June,2017,Monterey,CA,Passenger,0,1,1,206,207,0.48
9162,June,2017,Whatcom,WA,Truck,2,0,2,41620,41622,0.0
9163,June,2017,Dallas,TX,Passenger,0,1,1,186,187,0.53
9164,June,2017,St. Lucie,FL,Passenger,1,0,1,33,34,2.94
9165,June,2017,Franklin,WA,Passenger,26,45,71,55615,55686,0.13
9166,June,2017,Jefferson,NY,Passenger,1,1,2,252,254,0.79
9167,June,2017,Nassau,NY,Passenger,0,1,1,39,40,2.5
9168,June,2017,Walla Walla,WA,Passenger,25,26,51,34843,34894,0.15
9169,June,2017,Essex,NJ,Passenger,1,0,1,14,15,6.67
9170,June,2017,Hardin,KY,Passenger,0,1,1,121,122,0.82
9171,June,2017,Shelby,TN,Passenger,0,1,1,110,111,0.9
9172,June,2017,Ferry,WA,Passenger,1,1,2,4394,4396,0.05
9173,June,2017,Jefferson,WA,Passenger,104,61,165,23850,24015,0.69
9174,June,2017,Marin,CA,Passenger,1,0,1,59,60,1.67
9175,June,2017,Mason,WA,Truck,0,0,0,19273,19273,0.0
9176,June,2017,Madison,ID,Passenger,1,0,1,39,40,2.5
9177,June,2017,Pierce,WA,Truck,0,0,0,137535,137535,0.0
9178,June,2017,Mason,WA,Passenger,56,68,124,43451,43575,0.28
9179,June,2017,Cowlitz,WA,Passenger,50,60,110,69653,69763,0.16
9180,June,2017,King,WA,Passenger,10028,4104,14132,1375372,1389504,1.02
9181,June,2017,Nueces,TX,Passenger,0,1,1,96,97,1.03
9182,June,2017,Clark,WA,Truck,0,0,0,77648,77648,0.0
9183,June,2017,Whitman,WA,Passenger,10,20,30,22038,22068,0.14
9184,June,2017,Charles,MD,Passenger,0,1,1,88,89,1.12
9185,June,2017,El Paso,CO,Passenger,2,1,3,805,808,0.37
9186,June,2017,Pend Oreille,WA,Passenger,3,4,7,9316,9323,0.08
9187,June,2017,Orange,FL,Passenger,1,1,2,134,136,1.47
9188,June,2017,Sangamon,IL,Passenger,1,0,1,11,12,8.33
9189,June,2017,Garfield,WA,Passenger,0,0,0,1295,1295,0.0
9190,June,2017,Flathead,MT,Passenger,1,0,1,61,62,1.61
9191,June,2017,Portsmouth,VA,Passenger,0,1,1,68,69,1.45
9192,June,2017,Okaloosa,FL,Passenger,1,0,1,183,184,0.54
9193,June,2017,Montgomery,MD,Passenger,1,0,1,306,307,0.33
9194,June,2017,Cascade,MT,Passenger,0,1,1,59,60,1.67
9195,June,2017,Riverside,CA,Passenger,1,1,2,808,810,0.25
9196,June,2017,Asotin,WA,Passenger,6,3,9,12427,12436,0.07
9197,June,2017,Nantucket,MA,Passenger,1,0,1,3,4,25.0
9198,June,2017,Jackson,MO,Passenger,1,0,1,60,61,1.64
9199,June,2017,Orleans,LA,Passenger,0,1,1,46,47,2.13
9200,June,2017,Marion,OR,Passenger,1,0,1,165,166,0.6
9201,June,2017,Carroll,NH,Passenger,0,1,1,1,2,50.0
9202,June,2017,Skamania,WA,Passenger,9,7,16,8566,8582,0.19
9203,June,2017,Montgomery,TN,Passenger,1,0,1,283,284,0.35
9204,June,2017,Wahkiakum,WA,Truck,0,0,0,1644,1644,0.0
9205,June,2017,Tuolumne,CA,Passenger,0,1,1,14,15,6.67
9206,June,2017,Cobb,GA,Passenger,0,1,1,76,77,1.3
9207,June,2017,Deschutes,OR,Passenger,1,0,1,196,197,0.51
9208,June,2017,Franklin,OH,Passenger,0,1,1,122,123,0.81
9209,June,2017,Los Angeles,CA,Passenger,3,1,4,1294,1298,0.31
9210,June,2017,Grant,WA,Truck,0,0,0,25220,25220,0.0
9211,June,2017,Dale,AL,Passenger,0,1,1,64,65,1.54
9212,June,2017,DeKalb,IN,Passenger,1,0,1,1,2,50.0
9213,June,2017,Allegheny,PA,Passenger,1,0,1,93,94,1.06
9214,June,2017,Utah,UT,Passenger,0,1,1,156,157,0.64
9215,June,2017,Latah,ID,Passenger,0,1,1,103,104,0.96
9216,June,2017,Lincoln,WA,Truck,0,0,0,4429,4429,0.0
9217,June,2017,Lumpkin,GA,Passenger,1,0,1,9,10,10.0
9218,June,2017,Ventura,CA,Passenger,0,1,1,356,357,0.28
9219,June,2017,Lee,AL,Passenger,1,0,1,36,37,2.7
9220,June,2017,Lane,OR,Passenger,0,1,1,237,238,0.42
9221,June,2017,Santa Rosa,FL,Passenger,1,0,1,113,114,0.88
9222,June,2017,San Juan,WA,Truck,0,0,0,5535,5535,0.0
9223,June,2017,Dakota,MN,Passenger,0,1,1,37,38,2.63
9224,June,2017,San Diego,CA,Passenger,5,1,6,2725,2731,0.22
9225,June,2017,Santa Fe,NM,Passenger,0,1,1,46,47,2.13
9226,June,2017,Clark,NV,Passenger,1,2,3,829,832,0.36
9227,June,2017,Multnomah,OR,Passenger,1,3,4,998,1002,0.4
9228,June,2017,Okanogan,WA,Passenger,4,17,21,25707,25728,0.08
9229,June,2017,Grant,WA,Passenger,20,27,47,60844,60891,0.08
9230,June,2017,Klickitat,WA,Passenger,22,24,46,14799,14845,0.31
9231,June,2017,Skagit,WA,Truck,1,0,1,31458,31459,0.0
9232,June,2017,Yakima,WA,Truck,0,0,0,57351,57351,0.0
9233,June,2017,Benton,WA,Truck,0,0,0,40055,40055,0.0
9234,June,2017,Benton,WA,Passenger,148,143,291,128515,128806,0.23
9235,June,2017,Adams,WA,Passenger,2,3,5,12204,12209,0.04
9236,June,2017,Virginia Beach,VA,Passenger,2,1,3,652,655,0.46
9237,June,2017,Tulare,CA,Passenger,1,0,1,198,199,0.5
9238,June,2017,Harnett,NC,Passenger,1,0,1,258,259,0.39
9239,June,2017,Island,WA,Truck,0,0,0,20501,20501,0.0
9240,June,2017,Maricopa,AZ,Passenger,2,0,2,1748,1750,0.11
9241,June,2017,Adams,WA,Truck,0,0,0,5106,5106,0.0
9242,June,2017,Yakima,WA,Passenger,45,57,102,159401,159503,0.06
9243,June,2017,Wayne,MI,Passenger,0,1,1,69,70,1.43
9244,June,2017,Sedgwick,KS,Passenger,0,1,1,110,111,0.9
9245,June,2017,Clackamas,OR,Passenger,0,1,1,292,293,0.34
9246,June,2017,District of Columbia,DC,Passenger,0,3,3,218,221,1.36
9247,June,2017,Kittitas,WA,Passenger,21,17,38,27579,27617,0.14
9248,June,2017,Dane,WI,Passenger,1,0,1,103,104,0.96
9249,June,2017,Columbia,WA,Passenger,1,1,2,2353,2355,0.08
9250,June,2017,Lewis,WA,Passenger,51,34,85,55546,55631,0.15
9251,June,2017,Stevens,WA,Truck,0,0,0,18273,18273,0.0
9252,June,2017,Hamilton,TN,Passenger,1,0,1,19,20,5.0
9253,June,2017,Columbia,WA,Truck,0,0,0,1531,1531,0.0
9254,June,2017,King,WA,Truck,8,1,9,187744,187753,0.0
9255,June,2017,Fairfax,VA,Passenger,2,2,4,858,862,0.46
9256,June,2017,Pierce,WA,Passenger,956,842,1798,524957,526755,0.34
9257,June,2017,Gwinnett,GA,Passenger,0,1,1,84,85,1.18
9258,June,2017,Pacific,WA,Passenger,10,7,17,15145,15162,0.11
9259,June,2017,Montgomery,PA,Passenger,1,0,1,40,41,2.44
9260,June,2017,Chelan,WA,Truck,0,0,0,21303,21303,0.0
9261,June,2017,New London,CT,Passenger,1,1,2,253,255,0.78
9262,June,2017,Jefferson,WA,Truck,0,0,0,9424,9424,0.0
9263,June,2017,Northampton,PA,Passenger,1,0,1,147,148,0.68
9264,June,2017,Richmond,GA,Passenger,0,1,1,89,90,1.11
9265,June,2017,Pend Oreille,WA,Truck,0,0,0,5574,5574,0.0
9266,June,2017,Island,WA,Passenger,117,136,253,60111,60364,0.42
9267,June,2017,Duval,FL,Passenger,1,1,2,383,385,0.52
9268,June,2017,Thurston,WA,Truck,0,0,0,53295,53295,0.0
9269,June,2017,Fulton,GA,Passenger,1,0,1,115,116,0.86
9270,June,2017,Spokane,WA,Truck,1,0,1,90624,90625,0.0
9271,June,2017,Sumter,FL,Passenger,0,1,1,10,11,9.09
9272,June,2017,Thurston,WA,Passenger,398,336,734,186654,187388,0.39
9273,June,2017,Lincoln,WA,Passenger,2,5,7,7527,7534,0.09
9274,June,2017,Clark,WA,Passenger,787,504,1291,299553,300844,0.43
9275,June,2017,San Mateo,CA,Passenger,0,1,1,151,152,0.66
9276,June,2017,Clallam,WA,Passenger,90,76,166,48373,48539,0.34
9277,June,2018,Spokane,WA,Passenger,340,316,656,303132,303788,0.22
9278,June,2018,Norfolk,MA,Passenger,1,0,1,38,39,2.56
9279,June,2018,Garfield,WA,Truck,0,0,0,950,950,0.0
9280,June,2018,Lewis,WA,Truck,0,0,0,25481,25481,0.0
9281,June,2018,DeKalb,GA,Passenger,1,0,1,80,81,1.23
9282,June,2018,Dale,AL,Passenger,0,1,1,58,59,1.69
9283,June,2018,Clark,NV,Passenger,1,2,3,742,745,0.4
9284,June,2018,Volusia,FL,Passenger,0,1,1,33,34,2.94
9285,June,2018,Lumpkin,GA,Passenger,1,0,1,7,8,12.5
9286,June,2018,Pierce,WA,Passenger,1228,1173,2401,532275,534676,0.45
9287,June,2018,District of Columbia,DC,Passenger,0,3,3,188,191,1.57
9288,June,2018,Clallam,WA,Truck,0,0,0,21442,21442,0.0
9289,June,2018,Hardin,KY,Passenger,0,1,1,120,121,0.83
9290,June,2018,Bexar,TX,Passenger,2,4,6,750,756,0.79
9291,June,2018,Nantucket,MA,Passenger,1,0,1,4,5,20.0
9292,June,2018,Jefferson,WA,Truck,0,0,0,9548,9548,0.0
9293,June,2018,Moore,NC,Passenger,0,1,1,194,195,0.51
9294,June,2018,King,WA,Passenger,13167,5678,18845,1371166,1390011,1.36
9295,June,2018,Richland,SC,Passenger,0,1,1,169,170,0.59
9296,June,2018,Multnomah,OR,Passenger,3,4,7,801,808,0.87
9297,June,2018,Tuolumne,CA,Passenger,0,1,1,11,12,8.33
9298,June,2018,Skagit,WA,Truck,1,0,1,32042,32043,0.0
9299,June,2018,Lincoln,WA,Truck,0,0,0,4559,4559,0.0
9300,June,2018,Camden,NJ,Passenger,0,1,1,33,34,2.94
9301,June,2018,Clark,WA,Passenger,1009,719,1728,307969,309697,0.56
9302,June,2018,Contra Costa,CA,Passenger,0,1,1,452,453,0.22
9303,June,2018,Santa Clara,CA,Passenger,7,0,7,375,382,1.83
9304,June,2018,Lee,AL,Passenger,1,0,1,35,36,2.78
9305,June,2018,Los Angeles,CA,Passenger,7,4,11,1150,1161,0.95
9306,June,2018,Maricopa,AZ,Passenger,2,1,3,1583,1586,0.19
9307,June,2018,Santa Rosa,FL,Passenger,1,0,1,96,97,1.03
9308,June,2018,Pierce,WA,Truck,0,0,0,137831,137831,0.0
9309,June,2018,Manatee,FL,Passenger,1,0,1,37,38,2.63
9310,June,2018,Flathead,MT,Passenger,1,0,1,50,51,1.96
9311,June,2018,Broward,FL,Passenger,1,1,2,131,133,1.5
9312,June,2018,Wahkiakum,WA,Passenger,1,2,3,2915,2918,0.1
9313,June,2018,Island,WA,Passenger,197,188,385,62531,62916,0.61
9314,June,2018,Tarrant,TX,Passenger,1,0,1,219,220,0.45
9315,June,2018,Alameda,CA,Passenger,0,1,1,347,348,0.29
9316,June,2018,Orange,FL,Passenger,2,1,3,174,177,1.69
9317,June,2018,Pima,AZ,Passenger,1,1,2,411,413,0.48
9318,June,2018,Adams,WA,Passenger,5,5,10,12616,12626,0.08
9319,June,2018,Dakota,MN,Passenger,0,2,2,38,40,5.0
9320,June,2018,Beaufort,SC,Passenger,1,0,1,38,39,2.56
9321,June,2018,Allegheny,PA,Passenger,1,0,1,77,78,1.28
9322,June,2018,Garfield,WA,Passenger,1,1,2,1316,1318,0.15
9323,June,2018,Saratoga,NY,Passenger,1,1,2,64,66,3.03
9324,June,2018,Sacramento,CA,Passenger,1,0,1,299,300,0.33
9325,June,2018,Lewis,WA,Passenger,80,59,139,57688,57827,0.24
9326,June,2018,Snohomish,WA,Truck,1,0,1,121653,121654,0.0
9327,June,2018,Franklin,WA,Truck,0,0,0,18663,18663,0.0
9328,June,2018,Ferry,WA,Passenger,3,3,6,4425,4431,0.14
9329,June,2018,Hennepin,MN,Passenger,1,0,1,108,109,0.92
9330,June,2018,DeKalb,IN,Passenger,1,0,1,1,2,50.0
9331,June,2018,Stevens,WA,Passenger,11,25,36,31637,31673,0.11
9332,June,2018,Pacific,WA,Passenger,17,20,37,15572,15609,0.24
9333,June,2018,Cook,IL,Passenger,1,0,1,265,266,0.38
9334,June,2018,Columbia,WA,Passenger,2,2,4,2424,2428,0.16
9335,June,2018,New Haven,CT,Passenger,0,1,1,49,50,2.0
9336,June,2018,Anne Arundel,MD,Passenger,0,1,1,449,450,0.22
9337,June,2018,Dallas,TX,Passenger,0,1,1,191,192,0.52
9338,June,2018,Fulton,GA,Passenger,1,1,2,101,103,1.94
9339,June,2018,Fairfax,VA,Passenger,2,2,4,831,835,0.48
9340,June,2018,Douglas,WA,Truck,0,0,0,11947,11947,0.0
9341,June,2018,Franklin,MA,Passenger,0,1,1,1,2,50.0
9342,June,2018,Manassas,VA,Passenger,0,1,1,9,10,10.0
9343,June,2018,Orange,CA,Passenger,4,1,5,556,561,0.89
9344,June,2018,Kitsap,WA,Truck,1,0,1,53204,53205,0.0
9345,June,2018,Canyon,ID,Passenger,0,1,1,91,92,1.09
9346,June,2018,Monroe,IL,Passenger,1,0,1,5,6,16.67
9347,June,2018,Queens,NY,Passenger,1,0,1,61,62,1.61
9348,June,2018,Kootenai,ID,Passenger,0,1,1,219,220,0.45
9349,June,2018,Thurston,WA,Truck,0,0,0,54326,54326,0.0
9350,June,2018,Richmond,GA,Passenger,0,1,1,90,91,1.1
9351,June,2018,San Francisco,CA,Passenger,1,1,2,129,131,1.53
9352,June,2018,Klamath,OR,Passenger,1,0,1,35,36,2.78
9353,June,2018,Washtenaw,MI,Passenger,1,0,1,38,39,2.56
9354,June,2018,Caddo,LA,Passenger,0,1,1,23,24,4.17
9355,June,2018,Stevens,WA,Truck,0,0,0,18609,18609,0.0
9356,June,2018,Okanogan,WA,Passenger,9,19,28,25958,25986,0.11
9357,June,2018,Gwinnett,GA,Passenger,0,1,1,81,82,1.22
9358,June,2018,Carroll,NH,Passenger,0,1,1,1,2,50.0
9359,June,2018,Mason,WA,Truck,0,0,0,19955,19955,0.0
9360,June,2018,Tulsa,OK,Passenger,0,1,1,48,49,2.04
9361,June,2018,Ramsey,MN,Passenger,1,0,1,39,40,2.5
9362,June,2018,Kittitas,WA,Truck,0,0,0,14056,14056,0.0
9363,June,2018,Norfolk,VA,Passenger,2,2,4,329,333,1.2
9364,June,2018,Garfield,OK,Passenger,1,0,1,17,18,5.56
9365,June,2018,Lane,OR,Passenger,0,1,1,184,185,0.54
9366,June,2018,Prince William,VA,Passenger,0,4,4,263,267,1.5
9367,June,2018,St. Mary's,MD,Passenger,1,0,1,216,217,0.46
9368,June,2018,Skagit,WA,Passenger,206,166,372,90487,90859,0.41
9369,June,2018,San Diego,CA,Passenger,7,1,8,2582,2590,0.31
9370,June,2018,El Paso,TX,Passenger,1,0,1,518,519,0.19
9371,June,2018,Madison,ID,Passenger,1,0,1,39,40,2.5
9372,June,2018,Ferry,WA,Truck,0,0,0,3512,3512,0.0
9373,June,2018,Chelan,WA,Passenger,110,53,163,53555,53718,0.3
9374,June,2018,Mason,WA,Passenger,82,92,174,45712,45886,0.38
9375,June,2018,Okanogan,WA,Truck,0,0,0,16431,16431,0.0
9376,June,2018,Clay,FL,Passenger,0,1,1,94,95,1.05
9377,June,2018,Grays Harbor,WA,Truck,0,0,0,20226,20226,0.0
9378,June,2018,Kittitas,WA,Passenger,47,32,79,28926,29005,0.27
9379,June,2018,Hamilton,IN,Passenger,1,0,1,46,47,2.13
9380,June,2018,Yakima,WA,Truck,0,0,0,58487,58487,0.0
9381,June,2018,Ada,ID,Passenger,0,2,2,322,324,0.62
9382,June,2018,Duval,FL,Passenger,1,2,3,382,385,0.78
9383,June,2018,Maui,HI,Passenger,1,0,1,55,56,1.79
9384,June,2018,Hawaii,HI,Passenger,1,0,1,71,72,1.39
9385,June,2018,Charleston,SC,Passenger,1,0,1,125,126,0.79
9386,June,2018,Yakima,WA,Passenger,60,88,148,163780,163928,0.09
9387,June,2018,Asotin,WA,Passenger,9,6,15,12602,12617,0.12
9388,June,2018,Nassau,NY,Passenger,2,0,2,37,39,5.13
9389,June,2018,Grant,WA,Passenger,31,45,76,63139,63215,0.12
9390,June,2018,Whatcom,WA,Passenger,631,301,932,147658,148590,0.63
9391,June,2018,Sedgwick,KS,Passenger,0,1,1,99,100,1.0
9392,June,2018,New London,CT,Passenger,0,1,1,252,253,0.4
9393,June,2018,Pend Oreille,WA,Truck,0,0,0,5682,5682,0.0
9394,June,2018,Montgomery,PA,Passenger,2,0,2,34,36,5.56
9395,June,2018,Kitsap,WA,Passenger,796,460,1256,178527,179783,0.7
9396,June,2018,Charles,MD,Passenger,0,1,1,82,83,1.2
9397,June,2018,Whitman,WA,Passenger,19,28,47,22602,22649,0.21
9398,June,2018,St. Lucie,FL,Passenger,1,0,1,28,29,3.45
9399,June,2018,Pend Oreille,WA,Passenger,5,5,10,9547,9557,0.1
9400,June,2018,Arlington,VA,Passenger,1,2,3,172,175,1.71
9401,June,2018,Northampton,PA,Passenger,0,1,1,66,67,1.49
9402,June,2018,Riverside,CA,Passenger,2,2,4,699,703,0.57
9403,June,2018,Frederick,MD,Passenger,0,1,1,85,86,1.16
9404,June,2018,Shelby,TN,Passenger,0,1,1,102,103,0.97
9405,June,2018,San Mateo,CA,Passenger,1,1,2,131,133,1.5
9406,June,2018,Juneau,AK,Passenger,0,1,1,47,48,2.08
9407,June,2018,Morris,NJ,Passenger,1,0,1,18,19,5.26
9408,June,2018,Columbia,WA,Truck,0,0,0,1527,1527,0.0
9409,June,2018,Marin,CA,Passenger,1,0,1,55,56,1.79
9410,June,2018,San Juan,WA,Passenger,145,61,206,14069,14275,1.44
9411,June,2018,Nueces,TX,Passenger,1,1,2,89,91,2.2
9412,June,2018,Collin,TX,Passenger,1,0,1,153,154,0.65
9413,June,2018,Lincoln,WA,Passenger,2,6,8,7685,7693,0.1
9415,June,2018,Deschutes,OR,Passenger,1,0,1,168,169,0.59
9416,June,2018,Monterey,CA,Passenger,0,1,1,185,186,0.54
9417,June,2018,Benton,WA,Truck,0,0,0,41024,41024,0.0
9418,June,2018,Marion,IN,Passenger,1,0,1,117,118,0.85
9419,June,2018,Klickitat,WA,Passenger,25,30,55,15166,15221,0.36
9420,June,2018,Prince George,VA,Passenger,0,1,1,74,75,1.33
9421,June,2018,Chelan,WA,Truck,0,0,0,21872,21872,0.0
9422,June,2018,Virginia Beach,VA,Passenger,2,1,3,689,692,0.43
9423,June,2018,Okaloosa,FL,Passenger,1,0,1,171,172,0.58
9424,June,2018,Essex,NJ,Passenger,1,0,1,11,12,8.33
9425,June,2018,Pinal,AZ,Passenger,2,0,2,204,206,0.97
9426,June,2018,Cowlitz,WA,Passenger,55,74,129,71731,71860,0.18
9427,June,2018,Adams,WA,Truck,0,0,0,5165,5165,0.0
9428,June,2018,Portsmouth,VA,Passenger,0,1,1,73,74,1.35
9429,June,2018,Kent,MI,Passenger,0,1,1,27,28,3.57
9430,June,2018,Orleans,LA,Passenger,0,1,1,47,48,2.08
9431,June,2018,Howard,MD,Passenger,0,1,1,88,89,1.12
9432,June,2018,Santa Fe,NM,Passenger,0,1,1,43,44,2.27
9433,June,2018,Benton,WA,Passenger,192,199,391,131476,131867,0.3
9434,June,2018,Skamania,WA,Truck,0,0,0,3946,3946,0.0
9435,June,2018,Montgomery,MD,Passenger,1,0,1,284,285,0.35
9436,June,2018,Montgomery,TX,Passenger,1,0,1,63,64,1.56
9437,June,2018,Brevard,FL,Passenger,0,1,1,94,95,1.05
9438,June,2018,St. Clair,IL,Passenger,0,1,1,153,154,0.65
9439,June,2018,King,WA,Truck,7,1,8,183054,183062,0.0
9440,June,2018,Klickitat,WA,Truck,0,0,0,8117,8117,0.0
9441,June,2018,Grays Harbor,WA,Passenger,52,58,110,46575,46685,0.24
9442,June,2018,Walla Walla,WA,Truck,0,0,0,13416,13416,0.0
9443,June,2018,Pacific,WA,Truck,0,0,0,7600,7600,0.0
9444,June,2018,Polk,FL,Passenger,1,0,1,66,67,1.49
9445,June,2018,Wahkiakum,WA,Truck,0,0,0,1675,1675,0.0
9446,June,2018,Clackamas,OR,Passenger,0,1,1,226,227,0.44
9447,June,2018,Jefferson,CO,Passenger,0,1,1,65,66,1.52
9448,June,2018,Sumter,FL,Passenger,0,1,1,9,10,10.0
9449,June,2018,Travis,TX,Passenger,0,1,1,187,188,0.53
9450,June,2018,San Juan,WA,Truck,0,0,0,5713,5713,0.0
9451,June,2018,Franklin,WA,Passenger,39,66,105,57858,57963,0.18
9452,June,2018,Clark,WA,Truck,0,0,0,79122,79122,0.0
9453,June,2018,Whitman,WA,Truck,0,0,0,8493,8493,0.0
9454,June,2018,El Paso,CO,Passenger,2,1,3,752,755,0.4
9455,June,2018,Cowlitz,WA,Truck,0,0,0,28460,28460,0.0
9456,June,2018,Asotin,WA,Truck,0,0,0,6616,6616,0.0
9457,June,2018,Cochise,AZ,Passenger,0,1,1,122,123,0.81
9458,June,2018,Walla Walla,WA,Passenger,34,43,77,35660,35737,0.22
9459,June,2018,Douglas,WA,Passenger,43,31,74,27649,27723,0.27
9460,June,2018,Cape May,NJ,Passenger,0,1,1,21,22,4.55
9461,June,2018,Washoe,NV,Passenger,1,0,1,118,119,0.84
9462,June,2018,Island,WA,Truck,0,0,0,20955,20955,0.0
9463,June,2018,Skamania,WA,Passenger,11,9,20,8660,8680,0.23
9464,June,2018,Latah,ID,Passenger,0,1,1,74,75,1.33
9465,June,2018,Jefferson,WA,Passenger,144,97,241,24453,24694,0.98
9466,June,2018,Grant,WA,Truck,0,0,0,25921,25921,0.0
9467,June,2018,DuPage,IL,Passenger,1,0,1,62,63,1.59
9468,June,2018,Lee,FL,Passenger,1,0,1,56,57,1.75
9469,June,2018,Utah,UT,Passenger,0,1,1,132,133,0.75
9470,June,2018,Spokane,WA,Truck,1,0,1,92636,92637,0.0
9471,June,2018,Clallam,WA,Passenger,124,112,236,49911,50147,0.47
9472,June,2018,Sangamon,IL,Passenger,1,0,1,11,12,8.33
9473,June,2018,Snohomish,WA,Passenger,2349,1262,3611,521519,525130,0.69
9474,June,2018,Washington,OR,Passenger,0,1,1,480,481,0.21
9475,June,2018,Honolulu,HI,Passenger,1,2,3,523,526,0.57
9476,June,2018,Palm Beach,FL,Passenger,0,1,1,83,84,1.19
9477,June,2018,Prince George's,MD,Passenger,1,1,2,184,186,1.08
9478,June,2018,Ventura,CA,Passenger,0,2,2,321,323,0.62
9479,June,2018,Twin Falls,ID,Passenger,0,1,1,22,23,4.35
9480,June,2018,Thurston,WA,Passenger,572,481,1053,193030,194083,0.54
9481,June,2018,Williamson,TX,Passenger,0,1,1,161,162,0.62
9482,June,2018,Jefferson,NY,Passenger,0,1,1,223,224,0.45
9483,June,2018,Whatcom,WA,Truck,2,0,2,42285,42287,0.0
9484,June,2019,Santa Clara,CA,Passenger,5,2,7,364,371,1.89
9485,June,2019,Brevard,FL,Passenger,0,1,1,85,86,1.16
9486,June,2019,Polk,FL,Passenger,1,0,1,68,69,1.45
9487,June,2019,Santa Fe,NM,Passenger,0,1,1,39,40,2.5
9488,June,2019,Clark,NV,Passenger,3,2,5,690,695,0.72
9489,June,2019,Franklin,WA,Passenger,52,70,122,59912,60034,0.2
9490,June,2019,Williamson,TX,Passenger,0,1,1,142,143,0.7
9491,June,2019,Norfolk,MA,Passenger,1,0,1,37,38,2.63
9492,June,2019,Dallas,TX,Passenger,1,0,1,202,203,0.49
9493,June,2019,Mason,WA,Passenger,124,122,246,47188,47434,0.52
9494,June,2019,Marion,OR,Passenger,1,0,1,117,118,0.85
9495,June,2019,Santa Cruz,CA,Passenger,1,0,1,41,42,2.38
9496,June,2019,Chelan,WA,Truck,0,0,0,22281,22281,0.0
9497,June,2019,Ramsey,MN,Passenger,1,0,1,43,44,2.27
9498,June,2019,Alexandria,VA,Passenger,1,0,1,147,148,0.68
9499,June,2019,Montgomery,MD,Passenger,1,0,1,277,278,0.36
9500,June,2019,Saratoga,NY,Passenger,1,0,1,54,55,1.82
9501,June,2019,Montgomery,AL,Passenger,0,1,1,43,44,2.27
9502,June,2019,Stevens,WA,Passenger,19,31,50,31694,31744,0.16
9503,June,2019,Washtenaw,MI,Passenger,1,0,1,40,41,2.44
9504,June,2019,Douglas,WA,Truck,0,0,0,12182,12182,0.0
9505,June,2019,Deschutes,OR,Passenger,2,0,2,156,158,1.27
9506,June,2019,Solano,CA,Passenger,1,0,1,211,212,0.47
9507,June,2019,Kootenai,ID,Passenger,1,1,2,220,222,0.9
9508,June,2019,Collin,TX,Passenger,1,1,2,129,131,1.53
9509,June,2019,Skagit,WA,Truck,1,0,1,32442,32443,0.0
9510,June,2019,Contra Costa,CA,Passenger,2,2,4,386,390,1.03
9511,June,2019,Tarrant,TX,Passenger,2,0,2,202,204,0.98
9512,June,2019,Portsmouth,VA,Passenger,0,1,1,75,76,1.32
9513,June,2019,San Mateo,CA,Passenger,2,1,3,115,118,2.54
9514,June,2019,District of Columbia,DC,Passenger,1,1,2,205,207,0.97
9515,June,2019,Klamath,OR,Passenger,1,0,1,38,39,2.56
9516,June,2019,Chelan,WA,Passenger,157,68,225,54354,54579,0.41
9517,June,2019,Skamania,WA,Truck,0,0,0,4062,4062,0.0
9518,June,2019,Clark,WA,Truck,0,0,0,80332,80332,0.0
9519,June,2019,Benton,WA,Passenger,259,279,538,133796,134334,0.4
9520,June,2019,Ferry,WA,Passenger,5,2,7,4388,4395,0.16
9521,June,2019,Prince George's,MD,Passenger,1,1,2,179,181,1.1
9522,June,2019,Kent,MI,Passenger,0,1,1,21,22,4.55
9523,June,2019,Kittitas,WA,Truck,0,0,0,14422,14422,0.0
9524,June,2019,Pend Oreille,WA,Truck,0,0,0,5732,5732,0.0
9525,June,2019,Guadalupe,TX,Passenger,1,0,1,73,74,1.35
9526,June,2019,Charles,MD,Passenger,0,1,1,87,88,1.14
9527,June,2019,Palm Beach,FL,Passenger,0,1,1,85,86,1.16
9528,June,2019,Douglas,NE,Passenger,0,1,1,62,63,1.59
9529,June,2019,Maui,HI,Passenger,1,0,1,45,46,2.17
9530,June,2019,Spokane,WA,Passenger,539,433,972,311797,312769,0.31
9531,June,2019,DeKalb,IN,Passenger,1,0,1,1,2,50.0
9532,June,2019,Putnam,TN,Passenger,0,1,1,3,4,25.0
9533,June,2019,Adams,WA,Passenger,5,6,11,12757,12768,0.09
9534,June,2019,King,WA,Passenger,19080,7013,26093,1389199,1415292,1.84
9535,June,2019,Adams,WA,Truck,0,0,0,5128,5128,0.0
9536,June,2019,Klickitat,WA,Truck,0,0,0,8251,8251,0.0
9537,June,2019,San Diego,CA,Passenger,10,3,13,2686,2699,0.48
9539,June,2019,Shasta,CA,Passenger,1,0,1,42,43,2.33
9540,June,2019,Wahkiakum,WA,Passenger,2,2,4,3009,3013,0.13
9541,June,2019,Okanogan,WA,Passenger,22,25,47,26076,26123,0.18
9542,June,2019,Multnomah,OR,Passenger,5,5,10,736,746,1.34
9543,June,2019,Kitsap,WA,Truck,1,0,1,54095,54096,0.0
9544,June,2019,Riverside,CA,Passenger,2,2,4,655,659,0.61
9545,June,2019,Oklahoma,OK,Passenger,0,1,1,124,125,0.8
9546,June,2019,Cascade,MT,Passenger,0,1,1,61,62,1.61
9547,June,2019,Garfield,WA,Truck,0,0,0,964,964,0.0
9548,June,2019,Ventura,CA,Passenger,0,2,2,314,316,0.63
9549,June,2019,San Joaquin,CA,Passenger,1,0,1,126,127,0.79
9550,June,2019,Klickitat,WA,Passenger,35,32,67,15557,15624,0.43
9551,June,2019,Anne Arundel,MD,Passenger,1,2,3,440,443,0.68
9552,June,2019,Fresno,CA,Passenger,1,0,1,190,191,0.52
9553,June,2019,Hennepin,MN,Passenger,2,1,3,102,105,2.86
9554,June,2019,Skamania,WA,Passenger,23,18,41,8725,8766,0.47
9555,June,2019,DeKalb,GA,Passenger,1,0,1,79,80,1.25
9556,June,2019,Randolph,NC,Passenger,1,0,1,6,7,14.29
9557,June,2019,Asotin,WA,Truck,0,0,0,6667,6667,0.0
9558,June,2019,Rogers,OK,Passenger,1,0,1,5,6,16.67
9559,June,2019,Wahkiakum,WA,Truck,0,0,0,1755,1755,0.0
9560,June,2019,Island,WA,Passenger,317,240,557,63386,63943,0.87
9561,June,2019,Lewis,WA,Truck,0,0,0,25951,25951,0.0
9562,June,2019,Columbia,WA,Truck,0,0,0,1532,1532,0.0
9563,June,2019,Loudoun,VA,Passenger,1,0,1,96,97,1.03
9564,June,2019,Lewis,WA,Passenger,99,92,191,59123,59314,0.32
9565,June,2019,Sarasota,FL,Passenger,1,0,1,24,25,4.0
9566,June,2019,Shelby,OH,Passenger,0,1,1,1,2,50.0
9567,June,2019,Carroll,NH,Passenger,0,1,1,3,4,25.0
9568,June,2019,Spokane,WA,Truck,1,0,1,94860,94861,0.0
9569,June,2019,Broward,FL,Passenger,2,1,3,125,128,2.34
9570,June,2019,Placer,CA,Passenger,1,0,1,103,104,0.96
9571,June,2019,Carson City,NV,Passenger,1,0,1,11,12,8.33
9572,June,2019,Lincoln,WA,Truck,0,0,0,4676,4676,0.0
9573,June,2019,Pend Oreille,WA,Passenger,4,5,9,9531,9540,0.09
9574,June,2019,Norfolk,VA,Passenger,2,1,3,348,351,0.85
9575,June,2019,Nantucket,MA,Passenger,1,0,1,2,3,33.33
9576,June,2019,Arlington,VA,Passenger,0,2,2,158,160,1.25
9577,June,2019,Thurston,WA,Passenger,875,639,1514,197699,199213,0.76
9578,June,2019,Pierce,WA,Truck,0,0,0,139794,139794,0.0
9579,June,2019,Stevens,WA,Truck,0,0,0,18659,18659,0.0
9580,June,2019,Howard,MD,Passenger,0,1,1,75,76,1.32
9581,June,2019,Mason,WA,Truck,0,0,0,20361,20361,0.0
9582,June,2019,St. Mary's,MD,Passenger,1,0,1,212,213,0.47
9583,June,2019,Prince William,VA,Passenger,1,3,4,249,253,1.58
9584,June,2019,Wayne,MI,Passenger,0,1,1,66,67,1.49
9585,June,2019,Thurston,WA,Truck,0,0,0,55124,55124,0.0
9586,June,2019,Bexar,TX,Passenger,3,5,8,664,672,1.19
9587,June,2019,Allegheny,PA,Passenger,1,0,1,78,79,1.27
9588,June,2019,New London,CT,Passenger,0,2,2,239,241,0.83
9589,June,2019,Tuolumne,CA,Passenger,0,1,1,12,13,7.69
9590,June,2019,Asotin,WA,Passenger,12,8,20,12641,12661,0.16
9591,June,2019,Monroe,IL,Passenger,1,0,1,5,6,16.67
9592,June,2019,Cook,IL,Passenger,1,0,1,241,242,0.41
9593,June,2019,Travis,TX,Passenger,2,1,3,197,200,1.5
9594,June,2019,Garfield,WA,Passenger,1,1,2,1298,1300,0.15
9595,June,2019,Whatcom,WA,Passenger,853,428,1281,150709,151990,0.84
9596,June,2019,RÃ­o Grande,PR,Passenger,1,0,1,1,2,50.0
9597,June,2019,Ferry,WA,Truck,0,0,0,3570,3570,0.0
9598,June,2019,New Haven,CT,Passenger,0,2,2,48,50,4.0
9599,June,2019,Penobscot,ME,Passenger,0,1,1,12,13,7.69
9600,June,2019,Pacific,WA,Passenger,25,29,54,15975,16029,0.34
9601,June,2019,Pinellas,FL,Passenger,1,0,1,113,114,0.88
9602,June,2019,Fairfax,VA,Passenger,3,2,5,772,777,0.64
9603,June,2019,Moore,NC,Passenger,0,1,1,186,187,0.53
9604,June,2019,Cape May,NJ,Passenger,0,1,1,15,16,6.25
9605,June,2019,Grays Harbor,WA,Truck,0,0,0,20455,20455,0.0
9606,June,2019,Sedgwick,KS,Passenger,1,1,2,102,104,1.92
9607,June,2019,Harnett,NC,Passenger,1,1,2,217,219,0.91
9608,June,2019,Kern,CA,Passenger,0,1,1,222,223,0.45
9609,June,2019,Camden,NJ,Passenger,0,1,1,24,25,4.0
9610,June,2019,Maricopa,AZ,Passenger,6,3,9,1526,1535,0.59
9611,June,2019,Charleston,SC,Passenger,1,0,1,115,116,0.86
9612,June,2019,Orange,CA,Passenger,6,1,7,528,535,1.31
9613,June,2019,Bergen,NJ,Passenger,1,0,1,27,28,3.57
9614,June,2019,Whitman,WA,Passenger,31,46,77,22712,22789,0.34
9615,June,2019,Washoe,NV,Passenger,2,0,2,114,116,1.72
9616,June,2019,Los Angeles,CA,Passenger,8,5,13,1099,1112,1.17
9617,June,2019,Grays Harbor,WA,Passenger,73,85,158,47923,48081,0.33
9618,June,2019,Jefferson,CO,Passenger,0,2,2,57,59,3.39
9619,June,2019,Clark,WA,Passenger,1538,926,2464,313856,316320,0.78
9620,June,2019,Clallam,WA,Passenger,173,141,314,50501,50815,0.62
9621,June,2019,Mecklenburg,NC,Passenger,1,0,1,86,87,1.15
9622,June,2019,Denver,CO,Passenger,1,0,1,133,134,0.75
9623,June,2019,Grant,WA,Truck,0,0,0,26631,26631,0.0
9624,June,2019,Houston,GA,Passenger,1,0,1,54,55,1.82
9625,June,2019,Pinal,AZ,Passenger,2,0,2,195,197,1.02
9626,June,2019,Clallam,WA,Truck,1,0,1,21740,21741,0.0
9627,June,2019,San Juan,WA,Truck,0,0,0,5866,5866,0.0
9628,June,2019,Okanogan,WA,Truck,0,0,0,16482,16482,0.0
9629,June,2019,Wilson,TX,Passenger,0,1,1,6,7,14.29
9630,June,2019,Jefferson,WA,Passenger,197,119,316,24995,25311,1.25
9631,June,2019,Middlesex,MA,Passenger,1,1,2,117,119,1.68
9632,June,2019,Nueces,TX,Passenger,1,1,2,99,101,1.98
9633,June,2019,Calvert,MD,Passenger,0,2,2,87,89,2.25
9634,June,2019,Whatcom,WA,Truck,2,0,2,42910,42912,0.0
9635,June,2019,Lake,FL,Passenger,1,0,1,19,20,5.0
9636,June,2019,Cowlitz,WA,Truck,0,0,0,28865,28865,0.0
9637,June,2019,Goochland,VA,Passenger,1,1,2,257,259,0.77
9638,June,2019,Pacific,WA,Truck,0,0,0,7654,7654,0.0
9639,June,2019,Suffolk,MA,Passenger,0,1,1,39,40,2.5
9640,June,2019,Yakima,WA,Passenger,105,104,209,165147,165356,0.13
9641,June,2019,Twin Falls,ID,Passenger,0,1,1,23,24,4.17
9642,June,2019,Richland,SC,Passenger,0,1,1,160,161,0.62
9643,June,2019,Sumter,FL,Passenger,0,1,1,10,11,9.09
9644,June,2019,Jefferson,NY,Passenger,0,2,2,214,216,0.93
9645,June,2019,Skagit,WA,Passenger,298,200,498,91940,92438,0.54
9646,June,2019,Nassau,NY,Passenger,4,0,4,38,42,9.52
9647,June,2019,Vigo,IN,Passenger,1,0,1,6,7,14.29
9648,June,2019,Pierce,WA,Passenger,1808,1556,3364,543069,546433,0.62
9649,June,2019,Harris,TX,Passenger,1,1,2,246,248,0.81
9650,June,2019,Ada,ID,Passenger,0,2,2,307,309,0.65
9651,June,2019,San Juan,WA,Passenger,212,72,284,14409,14693,1.93
9652,June,2019,Snohomish,WA,Passenger,3473,1593,5066,531506,536572,0.94
9653,June,2019,Alameda,CA,Passenger,4,2,6,306,312,1.92
9654,June,2019,Valencia,NM,Passenger,1,0,1,7,8,12.5
9655,June,2019,Bucks,PA,Passenger,1,0,1,19,20,5.0
9656,June,2019,Fulton,GA,Passenger,1,2,3,105,108,2.78
9657,June,2019,Kitsap,WA,Passenger,1050,605,1655,180817,182472,0.91
9658,June,2019,Cochise,AZ,Passenger,0,1,1,114,115,0.87
9659,June,2019,Honolulu,HI,Passenger,3,3,6,501,507,1.18
9660,June,2019,Montgomery,PA,Passenger,2,0,2,37,39,5.13
9661,June,2019,Sangamon,IL,Passenger,1,0,1,6,7,14.29
9662,June,2019,Cumberland,NC,Passenger,0,2,2,503,505,0.4
9663,June,2019,Larimer,CO,Passenger,1,0,1,58,59,1.69
9664,June,2019,Volusia,FL,Passenger,0,1,1,38,39,2.56
9665,June,2019,Dale,AL,Passenger,0,1,1,59,60,1.67
9666,June,2019,Franklin,MA,Passenger,0,1,1,1,2,50.0
9667,June,2019,Yakima,WA,Truck,0,0,0,59138,59138,0.0
9668,June,2019,Lee,FL,Passenger,1,0,1,52,53,1.89
9669,June,2019,Walla Walla,WA,Passenger,49,61,110,36186,36296,0.3
9670,June,2019,Pima,AZ,Passenger,0,1,1,393,394,0.25
9671,June,2019,Jefferson,WA,Truck,0,0,0,9667,9667,0.0
9672,June,2019,Saginaw,MI,Passenger,1,0,1,11,12,8.33
9673,June,2019,Manassas,VA,Passenger,0,1,1,9,10,10.0
9674,June,2019,Clackamas,OR,Passenger,1,1,2,212,214,0.93
9675,June,2019,Shelby,TN,Passenger,0,1,1,92,93,1.08
9676,June,2019,El Paso,TX,Passenger,3,0,3,481,484,0.62
9677,June,2019,Island,WA,Truck,0,0,0,21261,21261,0.0
9678,June,2019,Santa Rosa,FL,Passenger,1,0,1,88,89,1.12
9679,June,2019,Columbia,WA,Passenger,2,2,4,2450,2454,0.16
9680,June,2019,Virginia Beach,VA,Passenger,1,0,1,713,714,0.14
9681,June,2019,San Francisco,CA,Passenger,2,1,3,105,108,2.78
9682,June,2019,Walla Walla,WA,Truck,0,0,0,13593,13593,0.0
9683,June,2019,King,WA,Truck,5,1,6,182076,182082,0.0
9684,June,2019,Kittitas,WA,Passenger,81,38,119,29608,29727,0.4
9685,June,2019,Owyhee,ID,Passenger,1,0,1,5,6,16.67
9686,June,2019,Frederick,MD,Passenger,1,1,2,79,81,2.47
9687,June,2019,Manatee,FL,Passenger,1,0,1,32,33,3.03
9688,June,2019,Lincoln,WA,Passenger,2,8,10,7776,7786,0.13
9689,June,2019,Spartanburg,SC,Passenger,0,1,1,36,37,2.7
9690,June,2019,Flathead,MT,Passenger,1,0,1,62,63,1.59
9691,June,2019,El Paso,CO,Passenger,2,1,3,731,734,0.41
9692,June,2019,St. Clair,IL,Passenger,0,1,1,163,164,0.61
9693,June,2019,Oldham,KY,Passenger,0,1,1,5,6,16.67
9694,June,2019,Clay,FL,Passenger,0,1,1,88,89,1.12
9695,June,2019,Benton,WA,Truck,0,0,0,41914,41914,0.0
9696,June,2019,Richmond,GA,Passenger,0,1,1,93,94,1.06
9697,June,2019,DuPage,IL,Passenger,2,0,2,61,63,3.17
9698,June,2019,Whitman,WA,Truck,0,0,0,8584,8584,0.0
9699,June,2019,Cowlitz,WA,Passenger,98,108,206,73013,73219,0.28
9700,June,2019,Albemarle,VA,Passenger,1,0,1,23,24,4.17
9701,June,2019,Franklin,WA,Truck,0,0,0,19271,19271,0.0
9702,June,2019,Dakota,MN,Passenger,0,1,1,37,38,2.63
9703,June,2019,Juneau,AK,Passenger,0,2,2,30,32,6.25
9704,June,2019,Grant,WA,Passenger,41,61,102,64706,64808,0.16
9705,June,2019,Duval,FL,Passenger,1,2,3,373,376,0.8
9706,June,2019,Caddo,LA,Passenger,0,1,1,22,23,4.35
9707,June,2019,Snohomish,WA,Truck,0,0,0,122375,122375,0.0
9708,June,2019,Montgomery,TX,Passenger,2,0,2,60,62,3.23
9709,June,2019,Tulsa,OK,Passenger,1,1,2,46,48,4.17
9710,June,2019,Douglas,WA,Passenger,57,37,94,28032,28126,0.33
9711,June,2019,Berkshire,MA,Passenger,0,1,1,4,5,20.0
9712,June,2019,Hawaii,HI,Passenger,1,0,1,57,58,1.72
9713,June,2020,Pacific,WA,Passenger,33,33,66,15754,15820,0.42
9714,June,2020,Wahkiakum,WA,Truck,0,0,0,1737,1737,0.0
9715,June,2020,Utah,UT,Passenger,0,1,1,129,130,0.77
9716,June,2020,Hennepin,MN,Passenger,3,0,3,85,88,3.41
9717,June,2020,Franklin,WA,Passenger,60,76,136,60644,60780,0.22
9718,June,2020,King,WA,Passenger,24109,7712,31821,1371025,1402846,2.27
9719,June,2020,Island,WA,Truck,1,0,1,21212,21213,0.0
9720,June,2020,Chesapeake,VA,Passenger,0,2,2,417,419,0.48
9721,June,2020,Monroe,IL,Passenger,1,0,1,4,5,20.0
9722,June,2020,Allegheny,PA,Passenger,1,0,1,71,72,1.39
9723,June,2020,Arapahoe,CO,Passenger,1,0,1,129,130,0.77
9724,June,2020,Boone,MO,Passenger,0,1,1,10,11,9.09
9725,June,2020,Stafford,VA,Passenger,1,1,2,92,94,2.13
9726,June,2020,Clark,WA,Truck,0,0,0,82225,82225,0.0
9727,June,2020,Shelby,TN,Passenger,0,1,1,87,88,1.14
9728,June,2020,Hamilton,IN,Passenger,1,0,1,40,41,2.44
9729,June,2020,New London,CT,Passenger,1,2,3,245,248,1.21
9730,June,2020,Solano,CA,Passenger,1,0,1,209,210,0.48
9731,June,2020,Pierce,WA,Passenger,2380,1692,4072,549665,553737,0.74
9732,June,2020,Fairfax,VA,Passenger,4,3,7,727,734,0.95
9733,June,2020,San Joaquin,CA,Passenger,1,0,1,127,128,0.78
9734,June,2020,San Juan,WA,Passenger,302,93,395,13968,14363,2.75
9735,June,2020,Cascade,MT,Passenger,0,1,1,53,54,1.85
9736,June,2020,Spokane,WA,Passenger,730,487,1217,315451,316668,0.38
9737,June,2020,Williams,ND,Passenger,0,1,1,11,12,8.33
9738,June,2020,Lewis,WA,Passenger,102,111,213,58176,58389,0.36
9739,June,2020,Cumberland,NC,Passenger,0,3,3,460,463,0.65
9740,June,2020,Cowlitz,WA,Truck,0,0,0,28868,28868,0.0
9741,June,2020,Queens,NY,Passenger,1,0,1,50,51,1.96
9742,June,2020,Honolulu,HI,Passenger,4,2,6,441,447,1.34
9743,June,2020,Island,WA,Passenger,420,268,688,62807,63495,1.08
9744,June,2020,Douglas,NE,Passenger,0,1,1,52,53,1.89
9745,June,2020,Montgomery,OH,Passenger,0,1,1,48,49,2.04
9746,June,2020,Ferry,WA,Passenger,5,3,8,4330,4338,0.18
9747,June,2020,Oldham,KY,Passenger,0,1,1,4,5,20.0
9748,June,2020,Grant,WA,Truck,0,0,0,27083,27083,0.0
9749,June,2020,Loudoun,VA,Passenger,1,0,1,85,86,1.16
9750,June,2020,Gwinnett,GA,Passenger,1,0,1,73,74,1.35
9751,June,2020,Washington,OR,Passenger,1,0,1,436,437,0.23
9752,June,2020,Mason,WA,Passenger,159,135,294,47272,47566,0.62
9753,June,2020,Monterey,CA,Passenger,0,1,1,163,164,0.61
9754,June,2020,Riverside,CA,Passenger,3,1,4,619,623,0.64
9755,June,2020,Skamania,WA,Truck,0,0,0,4011,4011,0.0
9756,June,2020,Norfolk,VA,Passenger,2,2,4,344,348,1.15
9757,June,2020,Bexar,TX,Passenger,3,5,8,599,607,1.32
9758,June,2020,Kitsap,WA,Truck,0,0,0,54064,54064,0.0
9759,June,2020,Cape May,NJ,Passenger,0,1,1,13,14,7.14
9760,June,2020,Portsmouth,VA,Passenger,0,1,1,76,77,1.3
9761,June,2020,Denver,CO,Passenger,1,0,1,116,117,0.85
9763,June,2020,Lake,IL,Passenger,1,0,1,163,164,0.61
9764,June,2020,Kittitas,WA,Passenger,99,47,146,29805,29951,0.49
9765,June,2020,Lincoln,WA,Passenger,5,12,17,7624,7641,0.22
9766,June,2020,Brevard,FL,Passenger,0,1,1,83,84,1.19
9767,June,2020,Calvert,MD,Passenger,0,2,2,90,92,2.17
9768,June,2020,Denton,TX,Passenger,1,0,1,87,88,1.14
9769,June,2020,Rockingham,NH,Passenger,1,0,1,23,24,4.17
9770,June,2020,Chelan,WA,Passenger,231,78,309,54185,54494,0.57
9771,June,2020,Ulster,NY,Passenger,1,0,1,7,8,12.5
9772,June,2020,Frederick,MD,Passenger,1,1,2,75,77,2.6
9773,June,2020,Broward,FL,Passenger,2,1,3,109,112,2.68
9774,June,2020,Clay,FL,Passenger,0,1,1,81,82,1.22
9775,June,2020,Ventura,CA,Passenger,1,2,3,278,281,1.07
9776,June,2020,Stevens,WA,Truck,0,0,0,18645,18645,0.0
9777,June,2020,Benton,WA,Truck,0,0,0,42703,42703,0.0
9778,June,2020,Collin,TX,Passenger,1,1,2,118,120,1.67
9779,June,2020,Charleston,SC,Passenger,1,0,1,103,104,0.96
9780,June,2020,Erie,NY,Passenger,1,0,1,43,44,2.27
9781,June,2020,King,WA,Truck,5,1,6,182171,182177,0.0
9782,June,2020,Harris,TX,Passenger,1,0,1,227,228,0.44
9783,June,2020,San Francisco,CA,Passenger,1,1,2,93,95,2.11
9784,June,2020,Williamson,TX,Passenger,0,2,2,138,140,1.43
9785,June,2020,Dallas,TX,Passenger,1,0,1,193,194,0.52
9786,June,2020,Montgomery,TX,Passenger,1,0,1,50,51,1.96
9787,June,2020,Dakota,MN,Passenger,0,1,1,33,34,2.94
9788,June,2020,Kootenai,ID,Passenger,1,0,1,219,220,0.45
9789,June,2020,San Diego,CA,Passenger,14,5,19,2757,2776,0.68
9790,June,2020,Fresno,CA,Passenger,1,0,1,180,181,0.55
9791,June,2020,Skagit,WA,Truck,1,0,1,32470,32471,0.0
9792,June,2020,Owyhee,ID,Passenger,1,0,1,3,4,25.0
9793,June,2020,Pinal,AZ,Passenger,1,0,1,180,181,0.55
9794,June,2020,Pend Oreille,WA,Truck,0,0,0,5760,5760,0.0
9795,June,2020,Flathead,MT,Passenger,1,0,1,59,60,1.67
9796,June,2020,Bartow,GA,Passenger,0,1,1,4,5,20.0
9797,June,2020,St. Clair,IL,Passenger,1,0,1,137,138,0.72
9798,June,2020,Garfield,WA,Truck,0,0,0,974,974,0.0
9799,June,2020,Carson City,NV,Passenger,1,0,1,10,11,9.09
9800,June,2020,Columbia,WA,Passenger,4,3,7,2415,2422,0.29
9801,June,2020,Fort Bend,TX,Passenger,1,0,1,46,47,2.13
9802,June,2020,Clackamas,OR,Passenger,2,0,2,196,198,1.01
9803,June,2020,Harnett,NC,Passenger,1,0,1,200,201,0.5
9804,June,2020,Osceola,FL,Passenger,1,0,1,38,39,2.56
9805,June,2020,Jones,GA,Passenger,1,0,1,1,2,50.0
9806,June,2020,Kern,CA,Passenger,0,1,1,224,225,0.44
9807,June,2020,Suffolk,MA,Passenger,0,2,2,35,37,5.41
9808,June,2020,Mason,WA,Truck,0,0,0,20604,20604,0.0
9809,June,2020,Skagit,WA,Passenger,407,221,628,91153,91781,0.68
9810,June,2020,Stevens,WA,Passenger,36,33,69,30654,30723,0.22
9811,June,2020,Yakima,WA,Passenger,132,119,251,165352,165603,0.15
9812,June,2020,Anne Arundel,MD,Passenger,0,1,1,417,418,0.24
9813,June,2020,Prince William,VA,Passenger,2,3,5,219,224,2.23
9814,June,2020,Cowlitz,WA,Passenger,138,115,253,72319,72572,0.35
9815,June,2020,Adams,WA,Truck,0,0,0,5263,5263,0.0
9816,June,2020,Franklin,WA,Truck,0,0,0,19973,19973,0.0
9817,June,2020,Arlington,VA,Passenger,0,2,2,149,151,1.32
9818,June,2020,Spokane,WA,Truck,1,0,1,98330,98331,0.0
9819,June,2020,Benton,WA,Passenger,359,321,680,134227,134907,0.5
9820,June,2020,Kent,MI,Passenger,0,1,1,23,24,4.17
9821,June,2020,Asotin,WA,Truck,0,0,0,6638,6638,0.0
9822,June,2020,Duval,FL,Passenger,0,2,2,359,361,0.55
9823,June,2020,Thurston,WA,Passenger,1143,736,1879,196906,198785,0.95
9824,June,2020,Sumter,FL,Passenger,0,1,1,9,10,10.0
9825,June,2020,Middlesex,MA,Passenger,1,1,2,94,96,2.08
9826,June,2020,Washoe,NV,Passenger,1,0,1,103,104,0.96
9827,June,2020,Sacramento,CA,Passenger,1,0,1,264,265,0.38
9828,June,2020,Santa Cruz,CA,Passenger,1,0,1,32,33,3.03
9829,June,2020,Richland,SC,Passenger,0,1,1,154,155,0.65
9830,June,2020,Klickitat,WA,Passenger,53,41,94,15173,15267,0.62
9831,June,2020,Fulton,GA,Passenger,1,2,3,100,103,2.91
9832,June,2020,Clark,WA,Passenger,2014,1058,3072,317682,320754,0.96
9833,June,2020,Los Angeles,CA,Passenger,7,11,18,984,1002,1.8
9834,June,2020,Howard,MD,Passenger,0,1,1,72,73,1.37
9835,June,2020,Alameda,CA,Passenger,2,0,2,268,270,0.74
9836,June,2020,Pierce,WA,Truck,0,0,0,142167,142167,0.0
9837,June,2020,Maricopa,AZ,Passenger,5,6,11,1410,1421,0.77
9838,June,2020,Goochland,VA,Passenger,2,1,3,256,259,1.16
9839,June,2020,Boulder,CO,Passenger,0,1,1,43,44,2.27
9840,June,2020,St. Mary's,MD,Passenger,1,0,1,219,220,0.45
9841,June,2020,RÃ­o Grande,PR,Passenger,1,0,1,1,2,50.0
9842,June,2020,District of Columbia,DC,Passenger,2,1,3,205,208,1.44
9843,June,2020,Valencia,NM,Passenger,1,0,1,5,6,16.67
9844,June,2020,Pend Oreille,WA,Passenger,7,6,13,9243,9256,0.14
9845,June,2020,Okanogan,WA,Truck,0,0,0,16445,16445,0.0
9846,June,2020,Jefferson,WA,Passenger,236,139,375,24797,25172,1.49
9847,June,2020,Grays Harbor,WA,Passenger,106,111,217,48145,48362,0.45
9848,June,2020,Walla Walla,WA,Truck,0,0,0,13745,13745,0.0
9849,June,2020,Albemarle,VA,Passenger,1,0,1,21,22,4.55
9850,June,2020,Travis,TX,Passenger,2,1,3,177,180,1.67
9851,June,2020,DeKalb,GA,Passenger,1,0,1,80,81,1.23
9852,June,2020,Alexandria,VA,Passenger,1,0,1,140,141,0.71
9853,June,2020,Fairbanks North Star,AK,Passenger,0,1,1,96,97,1.03
9854,June,2020,Tulsa,OK,Passenger,1,1,2,43,45,4.44
9855,June,2020,Palm Beach,FL,Passenger,0,1,1,79,80,1.25
9856,June,2020,Moore,NC,Passenger,0,2,2,161,163,1.23
9857,June,2020,Thurston,WA,Truck,0,0,0,55742,55742,0.0
9858,June,2020,Montgomery,PA,Passenger,1,0,1,30,31,3.23
9859,June,2020,Lake,FL,Passenger,1,0,1,22,23,4.35
9860,June,2020,Jefferson,WA,Truck,0,0,0,9533,9533,0.0
9861,June,2020,Sedgwick,KS,Passenger,1,1,2,92,94,2.13
9862,June,2020,El Paso,CO,Passenger,2,0,2,715,717,0.28
9863,June,2020,San Mateo,CA,Passenger,0,1,1,110,111,0.9
9864,June,2020,Whatcom,WA,Truck,3,0,3,43006,43009,0.01
9865,June,2020,Vigo,IN,Passenger,1,0,1,5,6,16.67
9866,June,2020,Jefferson,NY,Passenger,0,1,1,210,211,0.47
9867,June,2020,Greene,MO,Passenger,0,1,1,32,33,3.03
9868,June,2020,Pacific,WA,Truck,0,0,0,7699,7699,0.0
9869,June,2020,Camden,NJ,Passenger,0,1,1,21,22,4.55
9870,June,2020,Bucks,PA,Passenger,1,0,1,19,20,5.0
9871,June,2020,Powhatan,VA,Passenger,1,0,1,0,1,100.0
9872,June,2020,Whatcom,WA,Passenger,1064,498,1562,149248,150810,1.04
9873,June,2020,Shelby,OH,Passenger,0,1,1,1,2,50.0
9874,June,2020,Multnomah,OR,Passenger,4,7,11,709,720,1.53
9875,June,2020,Asotin,WA,Passenger,16,12,28,12321,12349,0.23
9876,June,2020,New Haven,CT,Passenger,0,2,2,38,40,5.0
9877,June,2020,Sarasota,FL,Passenger,2,0,2,25,27,7.41
9878,June,2020,DeKalb,IN,Passenger,1,0,1,1,2,50.0
9879,June,2020,Whitman,WA,Passenger,44,48,92,22140,22232,0.41
9880,June,2020,Ramsey,MN,Passenger,1,0,1,39,40,2.5
9881,June,2020,Santa Clara,CA,Passenger,7,2,9,298,307,2.93
9882,June,2020,Klamath,OR,Passenger,1,0,1,33,34,2.94
9883,June,2020,Kitsap,WA,Passenger,1330,686,2016,179815,181831,1.11
9884,June,2020,Hawaii,HI,Passenger,1,0,1,56,57,1.75
9885,June,2020,San Juan,WA,Truck,0,0,0,5854,5854,0.0
9886,June,2020,Deschutes,OR,Passenger,3,0,3,133,136,2.21
9887,June,2020,Charles,MD,Passenger,1,1,2,73,75,2.67
9888,June,2020,Adams,WA,Passenger,9,7,16,12786,12802,0.12
9889,June,2020,Houston,GA,Passenger,1,0,1,56,57,1.75
9890,June,2020,Contra Costa,CA,Passenger,3,3,6,314,320,1.88
9891,June,2020,Randolph,NC,Passenger,1,0,1,6,7,14.29
9892,June,2020,Lewis,WA,Truck,0,0,0,26209,26209,0.0
9893,June,2020,Yakima,WA,Truck,0,0,0,59894,59894,0.0
9894,June,2020,Whitman,WA,Truck,0,0,0,8508,8508,0.0
9895,June,2020,Ada,ID,Passenger,0,1,1,270,271,0.37
9896,June,2020,Montgomery,AL,Passenger,0,1,1,39,40,2.5
9897,June,2020,Shasta,CA,Passenger,1,0,1,36,37,2.7
9898,June,2020,Klickitat,WA,Truck,0,0,0,8102,8102,0.0
9899,June,2020,Ferry,WA,Truck,0,0,0,3555,3555,0.0
9900,June,2020,St. Louis,MO,Passenger,1,0,1,97,98,1.02
9901,June,2020,Prince George's,MD,Passenger,1,1,2,163,165,1.21
9902,June,2020,Wahkiakum,WA,Passenger,6,6,12,2991,3003,0.4
9903,June,2020,Orange,CA,Passenger,7,2,9,492,501,1.8
9904,June,2020,Douglas,WA,Passenger,71,40,111,28002,28113,0.39
9905,June,2020,Grays Harbor,WA,Truck,0,0,0,20910,20910,0.0
9906,June,2020,Polk,FL,Passenger,1,0,1,64,65,1.54
9907,June,2020,Nassau,NY,Passenger,4,0,4,29,33,12.12
9908,June,2020,Grant,WA,Passenger,59,71,130,65239,65369,0.2
9909,June,2020,Lincoln,WA,Truck,0,0,0,4624,4624,0.0
9910,June,2020,Kittitas,WA,Truck,0,0,0,14591,14591,0.0
9911,June,2020,Clallam,WA,Truck,1,0,1,21760,21761,0.0
9912,June,2020,Saginaw,MI,Passenger,1,0,1,10,11,9.09
9913,June,2020,Clallam,WA,Passenger,228,168,396,50092,50488,0.78
9914,June,2020,El Paso,TX,Passenger,3,0,3,421,424,0.71
9915,June,2020,Jefferson,CO,Passenger,0,1,1,59,60,1.67
9916,June,2020,Twin Falls,ID,Passenger,0,1,1,24,25,4.0
9917,June,2020,Garfield,WA,Passenger,0,1,1,1351,1352,0.07
9918,June,2020,Guadalupe,TX,Passenger,1,0,1,64,65,1.54
9919,June,2020,DuPage,IL,Passenger,3,0,3,58,61,4.92
9920,June,2020,Snohomish,WA,Truck,0,0,0,123942,123942,0.0
9921,June,2020,Nassau,FL,Passenger,1,0,1,36,37,2.7
9922,June,2020,Richmond,GA,Passenger,0,1,1,84,85,1.18
9923,June,2020,Pima,AZ,Passenger,3,1,4,339,343,1.17
9924,June,2020,Larimer,CO,Passenger,1,0,1,51,52,1.92
9925,June,2020,Juneau,AK,Passenger,0,2,2,28,30,6.67
9926,June,2020,Lee,FL,Passenger,1,0,1,50,51,1.96
9927,June,2020,Salt Lake,UT,Passenger,0,1,1,194,195,0.51
9928,June,2020,Putnam,TN,Passenger,0,1,1,3,4,25.0
9929,June,2020,Nueces,TX,Passenger,1,0,1,82,83,1.2
9930,June,2020,Columbia,WA,Truck,0,0,0,1532,1532,0.0
9931,June,2020,Okaloosa,FL,Passenger,0,1,1,137,138,0.72
9932,June,2020,Pinellas,FL,Passenger,1,1,2,109,111,1.8
9933,June,2020,Virginia Beach,VA,Passenger,1,0,1,666,667,0.15
9934,June,2020,Manassas,VA,Passenger,0,1,1,4,5,20.0
9935,June,2020,Snohomish,WA,Passenger,4434,1765,6199,534548,540747,1.15
9936,June,2020,Penobscot,ME,Passenger,0,1,1,13,14,7.14
9937,June,2020,Douglas,WA,Truck,0,0,0,12308,12308,0.0
9938,June,2020,Rogers,OK,Passenger,1,0,1,5,6,16.67
9939,June,2020,Suffolk,VA,Passenger,1,0,1,127,128,0.78
9940,June,2020,Skamania,WA,Passenger,31,18,49,8481,8530,0.57
9941,June,2020,Walla Walla,WA,Passenger,73,62,135,35832,35967,0.38
9942,June,2020,Spartanburg,SC,Passenger,0,1,1,46,47,2.13
9943,June,2020,Harrison,MS,Passenger,1,0,1,53,54,1.85
9944,June,2020,Washtenaw,MI,Passenger,1,0,1,36,37,2.7
9945,June,2020,Chelan,WA,Truck,0,0,0,22520,22520,0.0
9946,June,2020,Okanogan,WA,Passenger,36,33,69,25848,25917,0.27
9947,June,2020,Wilson,TX,Passenger,0,1,1,5,6,16.67
9948,June,2020,Clark,NV,Passenger,2,2,4,675,679,0.59
9949,June,2020,Maui,HI,Passenger,1,0,1,31,32,3.12
9950,June,2020,Hudson,NJ,Passenger,1,0,1,38,39,2.56
9951,June,2020,Placer,CA,Passenger,2,0,2,89,91,2.2
9952,June,2020,Carroll,NH,Passenger,0,1,1,4,5,20.0
9953,June,2021,Gwinnett,GA,Passenger,1,0,1,62,63,1.59
9954,June,2021,Duval,FL,Passenger,0,2,2,335,337,0.59
9955,June,2021,Jefferson,WA,Passenger,331,184,515,24891,25406,2.03
9956,June,2021,Ventura,CA,Passenger,1,2,3,255,258,1.16
9957,June,2021,Douglas,NE,Passenger,1,1,2,50,52,3.85
9958,June,2021,Snohomish,WA,Passenger,5886,2048,7934,540300,548234,1.45
9959,June,2021,Stevens,WA,Passenger,45,45,90,30479,30569,0.29
9960,June,2021,Carroll,MD,Passenger,0,1,1,18,19,5.26
9961,June,2021,Mason,WA,Truck,0,0,0,21335,21335,0.0
9962,June,2021,Chelan,WA,Passenger,336,99,435,54745,55180,0.79
9963,June,2021,Snohomish,WA,Truck,1,0,1,126272,126273,0.0
9964,June,2021,Bucks,PA,Passenger,1,0,1,15,16,6.25
9965,June,2021,Spokane,WA,Truck,0,0,0,102350,102350,0.0
9966,June,2021,Pima,AZ,Passenger,2,1,3,273,276,1.09
9967,June,2021,Williams,ND,Passenger,0,1,1,7,8,12.5
9968,June,2021,Whatcom,WA,Passenger,1419,602,2021,150844,152865,1.32
9969,June,2021,San Mateo,CA,Passenger,1,0,1,99,100,1.0
9970,June,2021,Pacific,WA,Passenger,45,53,98,16057,16155,0.61
9971,June,2021,King,WA,Passenger,30495,9167,39662,1368513,1408175,2.82
9972,June,2021,Chelan,WA,Truck,0,0,0,23127,23127,0.0
9973,June,2021,Miami-Dade,FL,Passenger,1,0,1,97,98,1.02
9975,June,2021,Charleston,SC,Passenger,1,1,2,83,85,2.35
9976,June,2021,Thurston,WA,Truck,0,0,0,56575,56575,0.0
9977,June,2021,Montgomery,PA,Passenger,1,0,1,24,25,4.0
9978,June,2021,Grays Harbor,WA,Truck,0,0,0,21450,21450,0.0
9979,June,2021,Charles,MD,Passenger,1,1,2,69,71,2.82
9980,June,2021,Cook,IL,Passenger,1,0,1,202,203,0.49
9981,June,2021,Asotin,WA,Passenger,20,17,37,12728,12765,0.29
9982,June,2021,Arlington,VA,Passenger,0,1,1,137,138,0.72
9983,June,2021,Cape May,NJ,Passenger,0,1,1,8,9,11.11
9984,June,2021,Okanogan,WA,Truck,0,0,0,16757,16757,0.0
9985,June,2021,Whatcom,WA,Truck,4,0,4,43913,43917,0.01
9986,June,2021,District of Columbia,DC,Passenger,5,1,6,199,205,2.93
9987,June,2021,Sacramento,CA,Passenger,2,0,2,214,216,0.93
9988,June,2021,Fairbanks North Star,AK,Passenger,0,1,1,85,86,1.16
9989,June,2021,Pacific,WA,Truck,0,0,0,7965,7965,0.0
9990,June,2021,Philadelphia,PA,Passenger,1,0,1,47,48,2.08
9991,June,2021,Carson City,NV,Passenger,1,0,1,10,11,9.09
9992,June,2021,Wahkiakum,WA,Passenger,15,8,23,3109,3132,0.73
9993,June,2021,San Francisco,CA,Passenger,0,1,1,85,86,1.16
9994,June,2021,Albemarle,VA,Passenger,1,0,1,19,20,5.0
9995,June,2021,Skamania,WA,Truck,0,0,0,4029,4029,0.0
9996,June,2021,Howard,MD,Passenger,0,1,1,59,60,1.67
9997,June,2021,Boone,MO,Passenger,0,1,1,9,10,10.0
9998,June,2021,Hidalgo,TX,Passenger,0,1,1,56,57,1.75
9999,June,2021,Santa Clara,CA,Passenger,8,2,10,245,255,3.92
10000,June,2021,Grant,WA,Truck,0,0,0,27912,27912,0.0
10001,June,2021,Benton,WA,Passenger,518,394,912,136405,137317,0.66
10002,June,2021,Prince George's,MD,Passenger,2,1,3,139,142,2.11
10003,June,2021,Clark,WA,Truck,0,0,0,84343,84343,0.0
10004,June,2021,Orange,FL,Passenger,1,0,1,111,112,0.89
10005,June,2021,Asotin,WA,Truck,0,0,0,6792,6792,0.0
10006,June,2021,Anchorage,AK,Passenger,1,0,1,133,134,0.75
10007,June,2021,Montgomery,OH,Passenger,0,1,1,56,57,1.75
10008,June,2021,Kern,CA,Passenger,0,1,1,211,212,0.47
10009,June,2021,Ferry,WA,Passenger,9,3,12,4373,4385,0.27
10010,June,2021,Wilson,NC,Passenger,1,0,1,0,1,100.0
10011,June,2021,Franklin,WA,Passenger,123,97,220,62016,62236,0.35
10012,June,2021,Dakota,MN,Passenger,0,1,1,25,26,3.85
10013,June,2021,Cumberland,NC,Passenger,0,2,2,420,422,0.47
10014,June,2021,Salt Lake,UT,Passenger,0,1,1,167,168,0.6
10015,June,2021,Bartow,GA,Passenger,0,1,1,3,4,25.0
10016,June,2021,Riverside,CA,Passenger,5,1,6,544,550,1.09
10017,June,2021,Shelby,OH,Passenger,0,1,1,1,2,50.0
10018,June,2021,Cowlitz,WA,Passenger,224,142,366,72350,72716,0.5
10019,June,2021,Ray,MO,Passenger,0,1,1,1,2,50.0
10020,June,2021,Island,WA,Passenger,617,317,934,63262,64196,1.45
10021,June,2021,Missoula,MT,Passenger,1,0,1,60,61,1.64
10022,June,2021,Danville,VA,Passenger,1,0,1,0,1,100.0
10023,June,2021,Boulder,CO,Passenger,0,1,1,44,45,2.22
10024,June,2021,Flathead,MT,Passenger,1,0,1,43,44,2.27
10025,June,2021,RÃ­o Grande,PR,Passenger,1,0,1,0,1,100.0
10026,June,2021,Kitsap,WA,Truck,0,0,0,54475,54475,0.0
10027,June,2021,Randolph,NC,Passenger,1,0,1,7,8,12.5
10028,June,2021,Ulster,NY,Passenger,1,0,1,8,9,11.11
10029,June,2021,Harris,TX,Passenger,1,1,2,194,196,1.02
10030,June,2021,Richmond,GA,Passenger,0,1,1,77,78,1.28
10031,June,2021,Loudoun,VA,Passenger,1,0,1,74,75,1.33
10032,June,2021,Milwaukee,WI,Passenger,1,0,1,38,39,2.56
10033,June,2021,Nueces,TX,Passenger,1,0,1,73,74,1.35
10034,June,2021,El Paso,TX,Passenger,3,0,3,374,377,0.8
10035,June,2021,Ferry,WA,Truck,0,0,0,3641,3641,0.0
10036,June,2021,Wilson,TX,Passenger,0,1,1,3,4,25.0
10037,June,2021,Garfield,WA,Truck,0,0,0,998,998,0.0
10038,June,2021,Whitman,WA,Truck,0,0,0,8585,8585,0.0
10039,June,2021,Contra Costa,CA,Passenger,2,3,5,261,266,1.88
10040,June,2021,Queens,NY,Passenger,2,0,2,49,51,3.92
10041,June,2021,Pierce,WA,Truck,0,0,0,146075,146075,0.0
10042,June,2021,Okanogan,WA,Passenger,63,38,101,26512,26613,0.38
10043,June,2021,Hamilton,IN,Passenger,2,0,2,32,34,5.88
10044,June,2021,Harrison,MS,Passenger,2,0,2,51,53,3.77
10045,June,2021,Jefferson,WA,Truck,0,0,0,9625,9625,0.0
10046,June,2021,Jones,GA,Passenger,1,0,1,1,2,50.0
10047,June,2021,Pend Oreille,WA,Passenger,14,7,21,9267,9288,0.23
10048,June,2021,Kittitas,WA,Truck,0,0,0,14785,14785,0.0
10049,June,2021,DuPage,IL,Passenger,1,0,1,50,51,1.96
10050,June,2021,Skagit,WA,Truck,1,0,1,33029,33030,0.0
10051,June,2021,Honolulu,HI,Passenger,5,2,7,392,399,1.75
10052,June,2021,Klickitat,WA,Truck,0,0,0,8301,8301,0.0
10053,June,2021,Douglas,WA,Passenger,93,48,141,28517,28658,0.49
10054,June,2021,Placer,CA,Passenger,2,0,2,77,79,2.53
10055,June,2021,Los Angeles,CA,Passenger,10,11,21,878,899,2.34
10056,June,2021,Montgomery,MD,Passenger,3,1,4,218,222,1.8
10057,June,2021,Grant,WA,Passenger,107,89,196,66973,67169,0.29
10058,June,2021,Richmond,NY,Passenger,1,0,1,9,10,10.0
10059,June,2021,Yakima,WA,Truck,0,0,0,61725,61725,0.0
10060,June,2021,Denver,CO,Passenger,1,0,1,118,119,0.84
10061,June,2021,Chesapeake,VA,Passenger,0,4,4,389,393,1.02
10062,June,2021,Dallas,TX,Passenger,1,0,1,158,159,0.63
10063,June,2021,Wahkiakum,WA,Truck,0,0,0,1797,1797,0.0
10064,June,2021,El Paso,CO,Passenger,3,0,3,669,672,0.45
10065,June,2021,Middlesex,MA,Passenger,1,1,2,93,95,2.11
10066,June,2021,Manassas,VA,Passenger,0,1,1,7,8,12.5
10067,June,2021,Greene,MO,Passenger,0,1,1,29,30,3.33
10068,June,2021,Kings,CA,Passenger,1,0,1,319,320,0.31
10069,June,2021,Kings,NY,Passenger,1,0,1,67,68,1.47
10070,June,2021,Sedgwick,KS,Passenger,1,1,2,83,85,2.35
10071,June,2021,Grays Harbor,WA,Passenger,168,144,312,49450,49762,0.63
10072,June,2021,Yakima,WA,Passenger,225,155,380,169332,169712,0.22
10073,June,2021,New York,NY,Passenger,1,0,1,44,45,2.22
10074,June,2021,Franklin,WA,Truck,0,0,0,20697,20697,0.0
10075,June,2021,San Juan,WA,Passenger,431,135,566,14255,14821,3.82
10076,June,2021,Columbia,WA,Passenger,6,2,8,2468,2476,0.32
10077,June,2021,Suffolk,MA,Passenger,0,2,2,30,32,6.25
10078,June,2021,Calvert,MD,Passenger,0,2,2,90,92,2.17
10079,June,2021,Kittitas,WA,Passenger,160,67,227,29984,30211,0.75
10080,June,2021,Clallam,WA,Passenger,329,217,546,50489,51035,1.07
10081,June,2021,Broward,FL,Passenger,2,0,2,107,109,1.83
10082,June,2021,Lewis,WA,Passenger,163,139,302,59680,59982,0.5
10083,June,2021,Clackamas,OR,Passenger,2,0,2,170,172,1.16
10084,June,2021,St. Mary's,MD,Passenger,1,0,1,205,206,0.49
10085,June,2021,Washington,OR,Passenger,1,0,1,383,384,0.26
10086,June,2021,Clark,WA,Passenger,2841,1423,4264,322560,326824,1.3
10087,June,2021,Douglas,CO,Passenger,0,1,1,75,76,1.32
10088,June,2021,Houston,GA,Passenger,1,0,1,47,48,2.08
10089,June,2021,Fort Bend,TX,Passenger,1,0,1,36,37,2.7
10090,June,2021,Monterey,CA,Passenger,0,1,1,147,148,0.68
10091,June,2021,Nassau,NY,Passenger,2,0,2,26,28,7.14
10092,June,2021,Whitman,WA,Passenger,58,47,105,21996,22101,0.48
10093,June,2021,Cowlitz,WA,Truck,0,0,0,29122,29122,0.0
10094,June,2021,Alameda,CA,Passenger,3,0,3,236,239,1.26
10095,June,2021,Platte,MO,Passenger,1,0,1,17,18,5.56
10096,June,2021,Adams,WA,Truck,0,0,0,5386,5386,0.0
10097,June,2021,Hillsborough,FL,Passenger,0,1,1,146,147,0.68
10098,June,2021,Jefferson,NY,Passenger,0,1,1,214,215,0.47
10099,June,2021,Norfolk,VA,Passenger,2,3,5,316,321,1.56
10100,June,2021,Hudson,NJ,Passenger,1,0,1,42,43,2.33
10101,June,2021,San Juan,WA,Truck,0,0,0,5942,5942,0.0
10102,June,2021,Kauai,HI,Passenger,1,0,1,17,18,5.56
10103,June,2021,Lee,FL,Passenger,1,0,1,35,36,2.78
10104,June,2021,Erie,NY,Passenger,1,0,1,37,38,2.63
10105,June,2021,Vigo,IN,Passenger,1,0,1,5,6,16.67
10106,June,2021,Adams,WA,Passenger,16,11,27,13035,13062,0.21
10107,June,2021,Richland,SC,Passenger,0,1,1,134,135,0.74
10108,June,2021,Oldham,KY,Passenger,0,1,1,4,5,20.0
10109,June,2021,Larimer,CO,Passenger,1,0,1,50,51,1.96
10110,June,2021,Pierce,WA,Passenger,3470,1997,5467,560461,565928,0.97
10111,June,2021,Penobscot,ME,Passenger,0,1,1,8,9,11.11
10112,June,2021,Lewis,WA,Truck,0,0,0,26859,26859,0.0
10113,June,2021,Pinellas,FL,Passenger,0,1,1,93,94,1.06
10114,June,2021,Harnett,NC,Passenger,1,1,2,167,169,1.18
10115,June,2021,Goochland,VA,Passenger,4,2,6,217,223,2.69
10116,June,2021,Champaign,IL,Passenger,1,0,1,11,12,8.33
10117,June,2021,Collin,TX,Passenger,1,1,2,109,111,1.8
10118,June,2021,Prince William,VA,Passenger,1,1,2,210,212,0.94
10119,June,2021,Mason,WA,Passenger,215,140,355,48176,48531,0.73
10120,June,2021,Howard,IN,Passenger,0,1,1,5,6,16.67
10121,June,2021,Rogers,OK,Passenger,1,0,1,3,4,25.0
10122,June,2021,Stafford,VA,Passenger,2,1,3,99,102,2.94
10123,June,2021,Walla Walla,WA,Passenger,113,74,187,36614,36801,0.51
10124,June,2021,Lincoln,WA,Truck,0,0,0,4754,4754,0.0
10125,June,2021,Wichita,TX,Passenger,1,0,1,40,41,2.44
10126,June,2021,Sarasota,FL,Passenger,2,0,2,28,30,6.67
10127,June,2021,Maui,HI,Passenger,1,0,1,26,27,3.7
10128,June,2021,Rockingham,NH,Passenger,1,0,1,21,22,4.55
10129,June,2021,Klickitat,WA,Passenger,70,51,121,15279,15400,0.79
10130,June,2021,Lane,OR,Passenger,0,1,1,125,126,0.79
10131,June,2021,Williamson,TX,Passenger,0,2,2,105,107,1.87
10132,June,2021,Fresno,CA,Passenger,1,0,1,168,169,0.59
10133,June,2021,Owyhee,ID,Passenger,1,0,1,3,4,25.0
10134,June,2021,Powhatan,VA,Passenger,1,0,1,1,2,50.0
10135,June,2021,Columbia,WA,Truck,0,0,0,1546,1546,0.0
10136,June,2021,Sumter,SC,Passenger,0,1,1,39,40,2.5
10137,June,2021,Saginaw,MI,Passenger,1,0,1,6,7,14.29
10138,June,2021,Yamhill,OR,Passenger,1,0,1,35,36,2.78
10139,June,2021,Spokane,WA,Passenger,1069,646,1715,326466,328181,0.52
10140,June,2021,Travis,TX,Passenger,3,3,6,156,162,3.7
10141,June,2021,Clark,NV,Passenger,4,2,6,614,620,0.97
10142,June,2021,Juneau,AK,Passenger,0,1,1,26,27,3.7
10143,June,2021,Lake,IL,Passenger,2,0,2,157,159,1.26
10144,June,2021,Moore,NC,Passenger,0,1,1,129,130,0.77
10145,June,2021,Pend Oreille,WA,Truck,0,0,0,5748,5748,0.0
10146,June,2021,Frederick,MD,Passenger,1,1,2,67,69,2.9
10147,June,2021,Okaloosa,FL,Passenger,0,1,1,115,116,0.86
10148,June,2021,Walla Walla,WA,Truck,0,0,0,14076,14076,0.0
10149,June,2021,Spartanburg,SC,Passenger,0,1,1,50,51,1.96
10150,June,2021,Montgomery,TX,Passenger,1,1,2,39,41,4.88
10151,June,2021,Allegheny,PA,Passenger,1,1,2,62,64,3.12
10152,June,2021,Orange,CA,Passenger,4,3,7,416,423,1.65
10153,June,2021,San Joaquin,CA,Passenger,1,0,1,106,107,0.93
10154,June,2021,Bexar,TX,Passenger,3,4,7,524,531,1.32
10155,June,2021,New London,CT,Passenger,1,2,3,221,224,1.34
10156,June,2021,Skagit,WA,Passenger,589,274,863,91973,92836,0.93
10157,June,2021,King,WA,Truck,6,1,7,184630,184637,0.0
10158,June,2021,Carroll,NH,Passenger,0,1,1,5,6,16.67
10159,June,2021,Alexandria,VA,Passenger,2,0,2,123,125,1.6
10160,June,2021,Benton,WA,Truck,0,0,0,43627,43627,0.0
10161,June,2021,Camden,NJ,Passenger,0,1,1,15,16,6.25
10162,June,2021,Sumter,FL,Passenger,0,1,1,8,9,11.11
10163,June,2021,New Haven,CT,Passenger,0,2,2,28,30,6.67
10164,June,2021,Polk,FL,Passenger,1,0,1,54,55,1.82
10165,June,2021,Lake,FL,Passenger,1,0,1,22,23,4.35
10166,June,2021,El Dorado,CA,Passenger,1,0,1,31,32,3.12
10167,June,2021,Skamania,WA,Passenger,44,34,78,8407,8485,0.92
10168,June,2021,Thurston,WA,Passenger,1585,872,2457,198143,200600,1.22
10169,June,2021,Hennepin,MN,Passenger,3,0,3,75,78,3.85
10170,June,2021,Pennington,SD,Passenger,1,0,1,30,31,3.23
10171,June,2021,Douglas,WA,Truck,0,0,0,12685,12685,0.0
10172,June,2021,Stevens,WA,Truck,0,0,0,18947,18947,0.0
10173,June,2021,Kitsap,WA,Passenger,1851,859,2710,180524,183234,1.48
10174,June,2021,Washington,MD,Passenger,1,0,1,13,14,7.14
10175,June,2021,Burlington,NJ,Passenger,0,1,1,129,130,0.77
10176,June,2021,Plaquemines,LA,Passenger,0,1,1,16,17,5.88
10177,June,2021,Suffolk,VA,Passenger,1,0,1,125,126,0.79
10178,June,2021,San Diego,CA,Passenger,16,6,22,2559,2581,0.85
10179,June,2021,Leavenworth,KS,Passenger,0,1,1,116,117,0.85
10180,June,2021,Sevier,AR,Passenger,0,1,1,0,1,100.0
10181,June,2021,Multnomah,OR,Passenger,2,5,7,639,646,1.08
10182,June,2021,St. Louis,MO,Passenger,1,0,1,81,82,1.22
10183,June,2021,DeKalb,GA,Passenger,1,0,1,58,59,1.69
10184,June,2021,Louisa,VA,Passenger,0,1,1,1,2,50.0
10185,June,2021,Maricopa,AZ,Passenger,6,3,9,1153,1162,0.77
10186,June,2021,Lincoln,WA,Passenger,5,13,18,7738,7756,0.23
10187,June,2021,Allen,IN,Passenger,1,0,1,15,16,6.25
10188,June,2021,Hampshire,MA,Passenger,1,0,1,5,6,16.67
10189,June,2021,Hawaii,HI,Passenger,1,0,1,46,47,2.13
10190,June,2021,Clallam,WA,Truck,1,0,1,22026,22027,0.0
10191,June,2021,Arapahoe,CO,Passenger,1,0,1,110,111,0.9
10192,June,2021,Portsmouth,VA,Passenger,0,1,1,76,77,1.3
10193,June,2021,Garfield,WA,Passenger,0,3,3,1375,1378,0.22
10194,June,2021,Virginia Beach,VA,Passenger,3,0,3,614,617,0.49
10195,June,2021,Santa Cruz,CA,Passenger,1,0,1,25,26,3.85
10196,June,2021,Fairfax,VA,Passenger,4,4,8,684,692,1.16
10197,June,2021,Morris,NJ,Passenger,1,0,1,15,16,6.25
10198,June,2021,Island,WA,Truck,0,0,0,21624,21624,0.0
10199,June,2021,Anne Arundel,MD,Passenger,4,2,6,388,394,1.52
10200,June,2021,St. Clair,IL,Passenger,2,0,2,135,137,1.46
10201,June,2021,Klamath,OR,Passenger,1,0,1,29,30,3.33
10202,June,2022,San Joaquin,CA,Passenger,1,1,2,85,87,2.3
10203,June,2022,Broward,FL,Passenger,1,0,1,74,75,1.33
10204,June,2022,Boulder,CO,Passenger,1,0,1,33,34,2.94
10205,June,2022,Clallam,WA,Truck,3,0,3,21937,21940,0.01
10206,June,2022,Fairfax,VA,Passenger,6,3,9,597,606,1.49
10207,June,2022,Middlesex,MA,Passenger,2,1,3,73,76,3.95
10208,June,2022,Albemarle,VA,Passenger,1,0,1,16,17,5.88
10209,June,2022,San Mateo,CA,Passenger,2,0,2,78,80,2.5
10210,June,2022,Montgomery,AL,Passenger,0,1,1,33,34,2.94
10211,June,2022,Cumberland,NC,Passenger,1,2,3,351,354,0.85
10212,June,2022,Hudson,NJ,Passenger,2,0,2,34,36,5.56
10213,June,2022,Lane,OR,Passenger,0,1,1,88,89,1.12
10214,June,2022,Sonoma,CA,Passenger,0,1,1,74,75,1.33
10215,June,2022,Howard,IN,Passenger,0,1,1,4,5,20.0
10216,June,2022,Denton,TX,Passenger,1,0,1,62,63,1.59
10217,June,2022,Whitman,WA,Truck,1,0,1,8572,8573,0.01
10218,June,2022,Yakima,WA,Truck,1,0,1,61408,61409,0.0
10219,June,2022,Los Angeles,CA,Passenger,8,8,16,745,761,2.1
10220,June,2022,Lee,FL,Passenger,1,0,1,29,30,3.33
10221,June,2022,Collin,TX,Passenger,2,0,2,79,81,2.47
10222,June,2022,Essex,NJ,Passenger,2,0,2,9,11,18.18
10223,June,2022,Adams,WA,Truck,1,0,1,5468,5469,0.02
10224,June,2022,Ferry,WA,Passenger,19,4,23,4409,4432,0.52
10225,June,2022,Howard,MD,Passenger,0,1,1,54,55,1.82
10226,June,2022,El Paso,CO,Passenger,3,1,4,588,592,0.68
10227,June,2022,Lewis,WA,Truck,0,0,0,26412,26412,0.0
10228,June,2022,Pima,AZ,Passenger,1,0,1,216,217,0.46
10229,June,2022,Arlington,VA,Passenger,1,0,1,123,124,0.81
10230,June,2022,San Diego,CA,Passenger,15,11,26,2238,2264,1.15
10231,June,2022,Dorchester,SC,Passenger,1,0,1,53,54,1.85
10232,June,2022,Island,WA,Passenger,818,379,1197,61948,63145,1.9
10233,June,2022,Kitsap,WA,Truck,4,0,4,53663,53667,0.01
10234,June,2022,Kauai,HI,Passenger,1,0,1,15,16,6.25
10235,June,2022,Washington,MD,Passenger,2,0,2,15,17,11.76
10236,June,2022,Lincoln,WA,Passenger,8,18,26,7710,7736,0.34
10237,June,2022,Stevens,WA,Truck,0,0,0,18951,18951,0.0
10238,June,2022,Oldham,KY,Passenger,0,1,1,4,5,20.0
10239,June,2022,Allegheny,PA,Passenger,1,1,2,51,53,3.77
10240,June,2022,Adams,WA,Passenger,17,10,27,12936,12963,0.21
10241,June,2022,Lake,IL,Passenger,2,0,2,134,136,1.47
10242,June,2022,Mason,WA,Truck,1,0,1,21067,21068,0.0
10243,June,2022,Okanogan,WA,Truck,1,0,1,16648,16649,0.01
10244,June,2022,Jefferson,WA,Passenger,434,217,651,24594,25245,2.58
10245,June,2022,Kern,CA,Passenger,0,1,1,186,187,0.53
10246,June,2022,Island,WA,Truck,4,0,4,21382,21386,0.02
10247,June,2022,Monterey,CA,Passenger,1,1,2,126,128,1.56
10248,June,2022,Bell,TX,Passenger,1,0,1,307,308,0.32
10249,June,2022,Thurston,WA,Passenger,2182,1055,3237,194425,197662,1.64
10250,June,2022,Rogers,OK,Passenger,1,0,1,1,2,50.0
10251,June,2022,Walla Walla,WA,Truck,0,0,0,13934,13934,0.0
10252,June,2022,Fairbanks North Star,AK,Passenger,0,1,1,72,73,1.37
10253,June,2022,Whatcom,WA,Truck,7,0,7,43365,43372,0.02
10254,June,2022,Garfield,WA,Truck,0,0,0,984,984,0.0
10255,June,2022,Clark,NV,Passenger,4,2,6,502,508,1.18
10256,June,2022,Camden,NJ,Passenger,0,1,1,13,14,7.14
10257,June,2022,Mason,WA,Passenger,311,177,488,47350,47838,1.02
10258,June,2022,St. Tammany,LA,Passenger,1,0,1,33,34,2.94
10259,June,2022,Cook,IL,Passenger,2,0,2,182,184,1.09
10260,June,2022,Pennington,SD,Passenger,2,0,2,26,28,7.14
10261,June,2022,Sacramento,CA,Passenger,3,0,3,187,190,1.58
10262,June,2022,Riverside,CA,Passenger,8,1,9,449,458,1.97
10263,June,2022,Benton,WA,Truck,3,0,3,43576,43579,0.01
10264,June,2022,Douglas,CO,Passenger,0,1,1,70,71,1.41
10265,June,2022,Carson City,NV,Passenger,1,0,1,7,8,12.5
10266,June,2022,Spokane,WA,Truck,1,0,1,102259,102260,0.0
10267,June,2022,Douglas,WA,Truck,0,0,0,12790,12790,0.0
10268,June,2022,Duval,FL,Passenger,1,2,3,267,270,1.11
10269,June,2022,San Luis Obispo,CA,Passenger,1,0,1,53,54,1.85
10270,June,2022,Hillsborough,FL,Passenger,0,1,1,119,120,0.83
10271,June,2022,Danville,VA,Passenger,1,0,1,0,1,100.0
10272,June,2022,Prince George's,MD,Passenger,3,1,4,118,122,3.28
10273,June,2022,Maricopa,AZ,Passenger,7,2,9,873,882,1.02
10274,June,2022,Harrison,MS,Passenger,1,0,1,42,43,2.33
10275,June,2022,Gwinnett,GA,Passenger,1,0,1,47,48,2.08
10276,June,2022,Geary,KS,Passenger,1,0,1,83,84,1.19
10277,June,2022,Skamania,WA,Passenger,73,47,120,8213,8333,1.44
10278,June,2022,Wahkiakum,WA,Passenger,23,11,34,3072,3106,1.09
10279,June,2022,Pend Oreille,WA,Passenger,17,11,28,9056,9084,0.31
10280,June,2022,Wahkiakum,WA,Truck,0,0,0,1804,1804,0.0
10281,June,2022,Lincoln,OR,Passenger,0,1,1,26,27,3.7
10282,June,2022,Las Animas,CO,Passenger,1,0,1,1,2,50.0
10284,June,2022,Loudoun,VA,Passenger,2,1,3,64,67,4.48
10285,June,2022,Placer,CA,Passenger,2,0,2,65,67,2.99
10286,June,2022,San Juan,WA,Passenger,513,157,670,14067,14737,4.55
10287,June,2022,Stevens,WA,Passenger,68,54,122,30173,30295,0.4
10288,June,2022,Platte,MO,Passenger,1,0,1,21,22,4.55
10289,June,2022,San Bernardino,CA,Passenger,1,1,2,320,322,0.62
10290,June,2022,Skagit,WA,Passenger,780,337,1117,90139,91256,1.22
10291,June,2022,Douglas,NE,Passenger,1,2,3,39,42,7.14
10292,June,2022,Pinellas,FL,Passenger,0,1,1,71,72,1.39
10293,June,2022,Leavenworth,KS,Passenger,0,1,1,102,103,0.97
10294,June,2022,Skagit,WA,Truck,3,0,3,32352,32355,0.01
10295,June,2022,Clallam,WA,Passenger,421,249,670,49776,50446,1.33
10296,June,2022,Rock Island,IL,Passenger,0,1,1,14,15,6.67
10297,June,2022,New Haven,CT,Passenger,0,2,2,27,29,6.9
10298,June,2022,Stafford,VA,Passenger,2,1,3,87,90,3.33
10299,June,2022,Yellowstone,MT,Passenger,0,1,1,22,23,4.35
10300,June,2022,Coryell,TX,Passenger,1,0,1,97,98,1.02
10301,June,2022,Galveston,TX,Passenger,0,1,1,18,19,5.26
10302,June,2022,Burlington,NJ,Passenger,0,2,2,108,110,1.82
10303,June,2022,Nueces,TX,Passenger,1,1,2,52,54,3.7
10304,June,2022,Klickitat,WA,Truck,0,0,0,8294,8294,0.0
10305,June,2022,Orange,FL,Passenger,1,0,1,87,88,1.14
10306,June,2022,Santa Clara,CA,Passenger,10,2,12,216,228,5.26
10307,June,2022,Montgomery,TX,Passenger,1,0,1,28,29,3.45
10308,June,2022,Chelan,WA,Truck,3,0,3,23068,23071,0.01
10309,June,2022,Queens,NY,Passenger,1,0,1,38,39,2.56
10310,June,2022,Boone,MO,Passenger,0,1,1,8,9,11.11
10311,June,2022,Berkeley,SC,Passenger,0,1,1,117,118,0.85
10312,June,2022,Richmond,NY,Passenger,1,0,1,6,7,14.29
10313,June,2022,Okaloosa,FL,Passenger,0,1,1,98,99,1.01
10314,June,2022,Cape May,NJ,Passenger,0,1,1,7,8,12.5
10315,June,2022,Harris,TX,Passenger,1,0,1,136,137,0.73
10316,June,2022,Alexandria,VA,Passenger,3,0,3,108,111,2.7
10317,June,2022,Jefferson,NY,Passenger,0,1,1,201,202,0.5
10318,June,2022,Plaquemines,LA,Passenger,1,1,2,16,18,11.11
10319,June,2022,Allen,IN,Passenger,1,0,1,13,14,7.14
10320,June,2022,Lincoln,WA,Truck,0,0,0,4832,4832,0.0
10321,June,2022,Williams,ND,Passenger,0,1,1,6,7,14.29
10322,June,2022,New London,CT,Passenger,2,5,7,183,190,3.68
10323,June,2022,Sumter,SC,Passenger,0,1,1,32,33,3.03
10324,June,2022,Sarasota,FL,Passenger,2,0,2,23,25,8.0
10325,June,2022,Garfield,WA,Passenger,0,3,3,1322,1325,0.23
10326,June,2022,Franklin,WA,Truck,0,0,0,20900,20900,0.0
10327,June,2022,DuPage,IL,Passenger,1,0,1,45,46,2.17
10328,June,2022,King,WA,Truck,66,1,67,180923,180990,0.04
10329,June,2022,Benton,WA,Passenger,751,461,1212,135364,136576,0.89
10330,June,2022,Asotin,WA,Truck,0,0,0,6720,6720,0.0
10331,June,2022,Charles,MD,Passenger,1,1,2,55,57,3.51
10332,June,2022,Penobscot,ME,Passenger,0,1,1,7,8,12.5
10333,June,2022,Asotin,WA,Passenger,23,19,42,12740,12782,0.33
10334,June,2022,Montgomery,PA,Passenger,2,0,2,21,23,8.7
10335,June,2022,Kittitas,WA,Truck,1,0,1,14655,14656,0.01
10336,June,2022,Moore,NC,Passenger,0,1,1,113,114,0.88
10337,June,2022,Salt Lake,UT,Passenger,1,1,2,123,125,1.6
10338,June,2022,St. Louis,MO,Passenger,1,0,1,61,62,1.61
10339,June,2022,Pend Oreille,WA,Truck,0,0,0,5670,5670,0.0
10340,June,2022,Spartanburg,SC,Passenger,0,1,1,38,39,2.56
10341,June,2022,King,WA,Passenger,40732,11318,52050,1349910,1401960,3.71
10342,June,2022,Sarpy,NE,Passenger,1,0,1,52,53,1.89
10343,June,2022,Pacific,WA,Truck,0,0,0,7916,7916,0.0
10344,June,2022,Calvert,MD,Passenger,0,2,2,76,78,2.56
10345,June,2022,Owyhee,ID,Passenger,1,0,1,2,3,33.33
10346,June,2022,Charleston,SC,Passenger,2,2,4,59,63,6.35
10347,June,2022,Skamania,WA,Truck,0,0,0,3971,3971,0.0
10348,June,2022,Hennepin,MN,Passenger,1,0,1,46,47,2.13
10349,June,2022,El Paso,TX,Passenger,2,0,2,324,326,0.61
10350,June,2022,Kittitas,WA,Passenger,266,83,349,29763,30112,1.16
10351,June,2022,Montgomery,MD,Passenger,4,2,6,195,201,2.99
10352,June,2022,Bexar,TX,Passenger,4,3,7,429,436,1.61
10353,June,2022,Okanogan,WA,Passenger,83,50,133,26390,26523,0.5
10354,June,2022,Chelan,WA,Passenger,461,126,587,54351,54938,1.07
10355,June,2022,Spokane,WA,Passenger,1602,848,2450,325470,327920,0.75
10356,June,2022,Wichita,TX,Passenger,1,0,1,38,39,2.56
10357,June,2022,Contra Costa,CA,Passenger,0,4,4,241,245,1.63
10358,June,2022,Lake,FL,Passenger,1,0,1,18,19,5.26
10359,June,2022,Ulster,NY,Passenger,1,0,1,9,10,10.0
10360,June,2022,Grant,WA,Truck,0,0,0,28025,28025,0.0
10361,June,2022,Hamilton,OH,Passenger,1,0,1,27,28,3.57
10362,June,2022,Carroll,NH,Passenger,0,1,1,5,6,16.67
10363,June,2022,Kitsap,WA,Passenger,2393,1054,3447,178654,182101,1.89
10364,June,2022,Pierce,WA,Passenger,5062,2311,7373,546060,553433,1.33
10365,June,2022,Tarrant,TX,Passenger,1,0,1,107,108,0.93
10366,June,2022,Whitman,WA,Passenger,87,60,147,22018,22165,0.66
10367,June,2022,Travis,TX,Passenger,1,0,1,104,105,0.95
10368,June,2022,Snohomish,WA,Passenger,8361,2528,10889,532982,543871,2.0
10369,June,2022,Columbia,WA,Passenger,7,0,7,2444,2451,0.29
10370,June,2022,Elmore,ID,Passenger,1,0,1,12,13,7.69
10371,June,2022,San Juan,WA,Truck,1,0,1,5986,5987,0.02
10372,June,2022,Walla Walla,WA,Passenger,172,101,273,35914,36187,0.75
10373,June,2022,Bartow,GA,Passenger,0,1,1,3,4,25.0
10374,June,2022,Suffolk,VA,Passenger,1,0,1,121,122,0.82
10375,June,2022,Randolph,NC,Passenger,1,0,1,5,6,16.67
10376,June,2022,Saratoga,NY,Passenger,1,0,1,39,40,2.5
10377,June,2022,Richmond,GA,Passenger,0,1,1,63,64,1.56
10378,June,2022,Sheridan,WY,Passenger,1,0,1,6,7,14.29
10379,June,2022,Goochland,VA,Passenger,2,2,4,114,118,3.39
10380,June,2022,Rockingham,NH,Passenger,1,0,1,14,15,6.67
10381,June,2022,Prince William,VA,Passenger,0,1,1,188,189,0.53
10382,June,2022,Escambia,FL,Passenger,0,1,1,126,127,0.79
10383,June,2022,Douglas,WA,Passenger,131,58,189,28498,28687,0.66
10384,June,2022,Grant,WA,Passenger,175,99,274,66817,67091,0.41
10385,June,2022,Louisa,VA,Passenger,0,1,1,1,2,50.0
10386,June,2022,Clark,WA,Passenger,4095,1781,5876,316688,322564,1.82
10387,June,2022,Grays Harbor,WA,Truck,1,0,1,21324,21325,0.0
10388,June,2022,Wilson,TX,Passenger,0,1,1,2,3,33.33
10389,June,2022,Carroll,MD,Passenger,0,1,1,15,16,6.25
10390,June,2022,Greene,MO,Passenger,0,1,1,20,21,4.76
10391,June,2022,Richland,SC,Passenger,0,1,1,123,124,0.81
10392,June,2022,DeKalb,GA,Passenger,1,0,1,46,47,2.13
10393,June,2022,Sedgwick,KS,Passenger,1,1,2,74,76,2.63
10394,June,2022,Orange,CA,Passenger,5,2,7,338,345,2.03
10395,June,2022,Multnomah,OR,Passenger,0,3,3,520,523,0.57
10396,June,2022,Juneau,AK,Passenger,0,1,1,29,30,3.33
10397,June,2022,Adams,CO,Passenger,1,0,1,37,38,2.63
10398,June,2022,Larimer,CO,Passenger,1,0,1,45,46,2.17
10399,June,2022,Hamilton,IN,Passenger,1,0,1,20,21,4.76
10400,June,2022,Sevier,AR,Passenger,0,1,1,0,1,100.0
10401,June,2022,Philadelphia,PA,Passenger,1,0,1,33,34,2.94
10402,June,2022,Clackamas,OR,Passenger,2,0,2,139,141,1.42
10403,June,2022,Honolulu,HI,Passenger,4,4,8,315,323,2.48
10404,June,2022,Norfolk,VA,Passenger,2,3,5,283,288,1.74
10405,June,2022,Onslow,NC,Passenger,0,1,1,159,160,0.62
10406,June,2022,Solano,CA,Passenger,1,0,1,157,158,0.63
10407,June,2022,Anne Arundel,MD,Passenger,4,4,8,335,343,2.33
10408,June,2022,Kings,CA,Passenger,2,1,3,298,301,1.0
10409,June,2022,Cowlitz,WA,Truck,2,1,3,28556,28559,0.01
10410,June,2022,Cowlitz,WA,Passenger,336,172,508,70742,71250,0.71
10411,June,2022,Anchorage,AK,Passenger,1,0,1,116,117,0.85
10412,June,2022,Marin,CA,Passenger,0,1,1,29,30,3.33
10413,June,2022,Hidalgo,TX,Passenger,0,1,1,56,57,1.75
10414,June,2022,Whatcom,WA,Passenger,1814,737,2551,149016,151567,1.68
10415,June,2022,Grays Harbor,WA,Passenger,210,160,370,49043,49413,0.75
10416,June,2022,District of Columbia,DC,Passenger,4,0,4,171,175,2.29
10417,June,2022,St. Clair,IL,Passenger,2,0,2,116,118,1.69
10418,June,2022,Klickitat,WA,Passenger,103,55,158,15251,15409,1.03
10419,June,2022,Frederick,MD,Passenger,1,1,2,61,63,3.17
10420,June,2022,St. Mary's,MD,Passenger,1,0,1,191,192,0.52
10421,June,2022,Williamson,TX,Passenger,1,2,3,78,81,3.7
10422,June,2022,Santa Cruz,CA,Passenger,1,0,1,22,23,4.35
10423,June,2022,Portsmouth,VA,Passenger,0,1,1,75,76,1.32
10424,June,2022,Ray,MO,Passenger,0,1,1,1,2,50.0
10425,June,2022,Lewis,WA,Passenger,235,177,412,59751,60163,0.68
10426,June,2022,Virginia Beach,VA,Passenger,2,0,2,501,503,0.4
10427,June,2022,Fort Bend,TX,Passenger,1,0,1,26,27,3.7
10428,June,2022,Clark,WA,Truck,7,0,7,82837,82844,0.01
10429,June,2022,Ferry,WA,Truck,0,0,0,3577,3577,0.0
10430,June,2022,Nassau,NY,Passenger,2,0,2,23,25,8.0
10431,June,2022,Hawaii,HI,Passenger,1,0,1,36,37,2.7
10432,June,2022,Chesapeake,VA,Passenger,2,3,5,330,335,1.49
10433,June,2022,Franklin,WA,Passenger,186,109,295,62000,62295,0.47
10434,June,2022,Alameda,CA,Passenger,4,0,4,180,184,2.17
10435,June,2022,Columbia,WA,Truck,0,0,0,1579,1579,0.0
10436,June,2022,Manassas,VA,Passenger,0,1,1,8,9,11.11
10437,June,2022,Pierce,WA,Truck,6,0,6,141892,141898,0.0
10438,June,2022,Yakima,WA,Passenger,336,190,526,167038,167564,0.31
10439,June,2022,Fresno,CA,Passenger,1,0,1,134,135,0.74
10440,June,2022,Wood,OH,Passenger,0,1,1,4,5,20.0
10441,June,2022,Suffolk,MA,Passenger,0,1,1,19,20,5.0
10442,June,2022,Wake,NC,Passenger,1,0,1,80,81,1.23
10443,June,2022,Ventura,CA,Passenger,1,1,2,226,228,0.88
10444,June,2022,Miami-Dade,FL,Passenger,1,0,1,77,78,1.28
10445,June,2022,Arapahoe,CO,Passenger,0,1,1,77,78,1.28
10446,June,2022,Pacific,WA,Passenger,61,71,132,15895,16027,0.82
10447,June,2022,Thurston,WA,Truck,7,0,7,55513,55520,0.01
10448,June,2022,Snohomish,WA,Truck,12,0,12,123913,123925,0.01
10449,June,2022,Harnett,NC,Passenger,2,0,2,141,143,1.4
10450,June,2022,Rockdale,GA,Passenger,1,0,1,8,9,11.11
10451,June,2022,Jefferson,WA,Truck,2,0,2,9461,9463,0.02
10452,June,2022,Houston,GA,Passenger,1,0,1,30,31,3.23
10453,June,2023,Thurston,WA,Truck,60,0,60,53269,53329,0.11
10454,June,2023,Santa Barbara,CA,Passenger,1,0,1,58,59,1.69
10455,June,2023,Spokane,WA,Truck,40,0,40,100674,100714,0.04
10456,June,2023,Lincoln,WA,Truck,0,0,0,4817,4817,0.0
10457,June,2023,Clark,WA,Passenger,5813,2318,8131,309808,317939,2.56
10458,June,2023,Jefferson,NY,Passenger,1,1,2,165,167,1.2
10459,June,2023,Middlesex,MA,Passenger,2,1,3,57,60,5.0
10460,June,2023,Sarasota,FL,Passenger,1,0,1,15,16,6.25
10461,June,2023,Ferry,WA,Passenger,21,4,25,4268,4293,0.58
10462,June,2023,Sonoma,CA,Passenger,1,1,2,45,47,4.26
10463,June,2023,Grays Harbor,WA,Passenger,296,186,482,47792,48274,1.0
10464,June,2023,Island,WA,Passenger,1074,439,1513,60607,62120,2.44
10465,June,2023,Vernon,LA,Passenger,1,0,1,64,65,1.54
10466,June,2023,Boulder,CO,Passenger,1,0,1,22,23,4.35
10467,June,2023,San Juan,WA,Passenger,616,172,788,13654,14442,5.46
10468,June,2023,Virginia Beach,VA,Passenger,2,0,2,399,401,0.5
10469,June,2023,Bell,TX,Passenger,1,0,1,223,224,0.45
10470,June,2023,Collin,TX,Passenger,1,0,1,33,34,2.94
10471,June,2023,Larimer,CO,Passenger,1,0,1,30,31,3.23
10472,June,2023,Ray,MO,Passenger,0,1,1,0,1,100.0
10473,June,2023,Coryell,TX,Passenger,1,0,1,68,69,1.45
10474,June,2023,Island,WA,Truck,32,0,32,20856,20888,0.15
10475,June,2023,Adams,CO,Passenger,1,0,1,23,24,4.17
10476,June,2023,Platte,MO,Passenger,1,0,1,16,17,5.88
10477,June,2023,Douglas,WA,Truck,5,0,5,12829,12834,0.04
10478,June,2023,Stevens,WA,Truck,1,0,1,18505,18506,0.01
10479,June,2023,Suffolk,VA,Passenger,1,0,1,95,96,1.04
10480,June,2023,Maricopa,AZ,Passenger,6,3,9,531,540,1.67
10481,June,2023,Santa Clara,CA,Passenger,8,1,9,137,146,6.16
10482,June,2023,Whitman,WA,Truck,4,0,4,8514,8518,0.05
10483,June,2023,Garfield,WA,Truck,0,0,0,957,957,0.0
10484,June,2023,Wahkiakum,WA,Passenger,27,17,44,3011,3055,1.44
10485,June,2023,Miami-Dade,FL,Passenger,1,0,1,51,52,1.92
10486,June,2023,Gwinnett,GA,Passenger,1,0,1,36,37,2.7
10487,June,2023,San Bernardino,CA,Passenger,2,1,3,241,244,1.23
10488,June,2023,Grant,WA,Passenger,277,126,403,66206,66609,0.61
10489,June,2023,Napa,CA,Passenger,0,1,1,8,9,11.11
10490,June,2023,Rockingham,NH,Passenger,1,0,1,10,11,9.09
10491,June,2023,San Diego,CA,Passenger,16,9,25,1770,1795,1.39
10492,June,2023,Hillsborough,FL,Passenger,0,1,1,93,94,1.06
10493,June,2023,Berkeley,SC,Passenger,0,1,1,90,91,1.1
10494,June,2023,Douglas,CO,Passenger,0,1,1,45,46,2.17
10495,June,2023,Ferry,WA,Truck,0,0,0,3530,3530,0.0
10496,June,2023,Washington,MD,Passenger,1,0,1,12,13,7.69
10497,June,2023,Clallam,WA,Truck,20,0,20,21479,21499,0.09
10498,June,2023,Solano,CA,Passenger,5,0,5,129,134,3.73
10499,June,2023,Los Angeles,CA,Passenger,4,4,8,540,548,1.46
10500,June,2023,Santa Cruz,CA,Passenger,1,0,1,12,13,7.69
10501,June,2023,Yakima,WA,Passenger,501,257,758,163736,164494,0.46
10502,June,2023,Goochland,VA,Passenger,0,1,1,29,30,3.33
10503,June,2023,Hudson,NJ,Passenger,1,0,1,13,14,7.14
10504,June,2023,Richmond,NY,Passenger,1,0,1,6,7,14.29
10505,June,2023,Franklin,WA,Truck,5,0,5,20588,20593,0.02
10506,June,2023,Harnett,NC,Passenger,4,0,4,114,118,3.39
10507,June,2023,Hennepin,MN,Passenger,1,0,1,27,28,3.57
10508,June,2023,Lake,IL,Passenger,3,0,3,102,105,2.86
10509,June,2023,El Paso,TX,Passenger,2,0,2,238,240,0.83
10510,June,2023,Pend Oreille,WA,Truck,0,0,0,5519,5519,0.0
10511,June,2023,Fairbanks North Star,AK,Passenger,0,1,1,44,45,2.22
10512,June,2023,Alameda,CA,Passenger,3,0,3,140,143,2.1
10513,June,2023,District of Columbia,DC,Passenger,5,0,5,138,143,3.5
10514,June,2023,Calvert,MD,Passenger,1,1,2,66,68,2.94
10515,June,2023,Hamilton,OH,Passenger,1,0,1,24,25,4.0
10516,June,2023,Skamania,WA,Truck,1,0,1,3776,3777,0.03
10517,June,2023,Snohomish,WA,Passenger,12560,3041,15601,521750,537351,2.9
10518,June,2023,Howard,MD,Passenger,0,1,1,40,41,2.44
10519,June,2023,Ulster,NY,Passenger,1,0,1,4,5,20.0
10520,June,2023,Rock Island,IL,Passenger,0,1,1,13,14,7.14
10521,June,2023,Contra Costa,CA,Passenger,0,3,3,182,185,1.62
10522,June,2023,Dallas,TX,Passenger,1,0,1,67,68,1.47
10523,June,2023,Pacific,WA,Truck,4,0,4,7732,7736,0.05
10524,June,2023,Cumberland,PA,Passenger,1,0,1,26,27,3.7
10525,June,2023,Hoke,NC,Passenger,1,0,1,50,51,1.96
10526,June,2023,Fairfax,VA,Truck,1,0,1,81,82,1.22
10527,June,2023,Stafford,VA,Passenger,3,1,4,68,72,5.56
10528,June,2023,Sarpy,NE,Passenger,1,0,1,42,43,2.33
10529,June,2023,Arapahoe,CO,Passenger,1,1,2,59,61,3.28
10530,June,2023,Benton,WA,Passenger,1136,563,1699,133564,135263,1.26
10531,June,2023,Kern,CA,Passenger,1,1,2,158,160,1.25
10532,June,2023,Richmond,GA,Passenger,0,1,1,54,55,1.82
10533,June,2023,Ventura,CA,Passenger,1,1,2,185,187,1.07
10534,June,2023,Asotin,WA,Truck,0,0,0,6592,6592,0.0
10535,June,2023,Madison,IL,Passenger,1,0,1,14,15,6.67
10536,June,2023,New London,CT,Passenger,1,4,5,163,168,2.98
10537,June,2023,Moore,NC,Passenger,0,1,1,96,97,1.03
10538,June,2023,Loudoun,VA,Passenger,2,0,2,55,57,3.51
10539,June,2023,Burlington,NJ,Passenger,0,2,2,84,86,2.33
10540,June,2023,Spokane,WA,Passenger,2298,1094,3392,319256,322648,1.05
10541,June,2023,San Juan,WA,Truck,11,0,11,5823,5834,0.19
10542,June,2023,Kitsap,WA,Passenger,3208,1283,4491,174228,178719,2.51
10543,June,2023,Adams,WA,Passenger,25,12,37,12863,12900,0.29
10544,June,2023,Oldham,KY,Passenger,0,1,1,3,4,25.0
10545,June,2023,St. Tammany,LA,Passenger,1,0,1,28,29,3.45
10546,June,2023,Wahkiakum,WA,Truck,2,0,2,1746,1748,0.11
10547,June,2023,Mason,WA,Passenger,442,206,648,45684,46332,1.4
10548,June,2023,Jefferson,WA,Truck,12,0,12,9231,9243,0.13
10549,June,2023,Pend Oreille,WA,Passenger,30,13,43,8795,8838,0.49
10550,June,2023,Kent,DE,Passenger,1,0,1,41,42,2.38
10551,June,2023,Benton,WA,Truck,24,0,24,42574,42598,0.06
10552,June,2023,Walla Walla,WA,Truck,5,0,5,13510,13515,0.04
10553,June,2023,Kittitas,WA,Truck,8,0,8,14383,14391,0.06
10554,June,2023,Skamania,WA,Passenger,104,59,163,7905,8068,2.02
10555,June,2023,Saratoga,NY,Passenger,1,1,2,27,29,6.9
10556,June,2023,Stevens,WA,Passenger,112,68,180,29348,29528,0.61
10557,June,2023,Portsmouth,VA,Passenger,0,1,1,56,57,1.75
10558,June,2023,Garfield,WA,Passenger,1,3,4,1291,1295,0.31
10559,June,2023,Lewis,WA,Truck,7,0,7,25651,25658,0.03
10560,June,2023,Adams,WA,Truck,3,0,3,5232,5235,0.06
10561,June,2023,Pacific,WA,Passenger,76,88,164,15453,15617,1.05
10562,June,2023,Cape May,NJ,Passenger,0,1,1,7,8,12.5
10563,June,2023,Houston,GA,Passenger,1,0,1,26,27,3.7
10564,June,2023,Escambia,FL,Passenger,0,1,1,99,100,1.0
10565,June,2023,Galveston,TX,Passenger,0,1,1,13,14,7.14
10566,June,2023,Lincoln,WA,Passenger,16,18,34,7573,7607,0.45
10567,June,2023,Anne Arundel,MD,Passenger,5,4,9,270,279,3.23
10568,June,2023,Yellowstone,MT,Passenger,0,1,1,13,14,7.14
10569,June,2023,Leavenworth,KS,Passenger,0,1,1,88,89,1.12
10570,June,2023,Plaquemines,LA,Passenger,1,1,2,12,14,14.29
10571,June,2023,DeKalb,GA,Passenger,1,0,1,35,36,2.78
10572,June,2023,Yavapai,AZ,Passenger,1,0,1,18,19,5.26
10573,June,2023,Okanogan,WA,Truck,7,0,7,16188,16195,0.04
10574,June,2023,Las Animas,CO,Passenger,1,0,1,0,1,100.0
10575,June,2023,Arlington,VA,Passenger,1,0,1,95,96,1.04
10576,June,2023,Beaufort,SC,Passenger,1,0,1,19,20,5.0
10577,June,2023,Carroll,MD,Passenger,0,1,1,16,17,5.88
10578,June,2023,Sedgwick,KS,Passenger,1,0,1,50,51,1.96
10579,June,2023,St. Clair,IL,Passenger,1,0,1,91,92,1.09
10580,June,2023,St. Louis,MO,Passenger,1,0,1,44,45,2.22
10581,June,2023,Columbia,WA,Truck,0,0,0,1535,1535,0.0
10582,June,2023,Benton,OR,Passenger,1,0,1,29,30,3.33
10583,June,2023,Jefferson,WA,Passenger,560,258,818,24060,24878,3.29
10584,June,2023,Riverside,CA,Passenger,6,0,6,337,343,1.75
10585,June,2023,Hamilton,OH,Truck,1,0,1,2,3,33.33
10586,June,2023,Bexar,TX,Passenger,2,2,4,317,321,1.25
10587,June,2023,Snohomish,WA,Truck,173,0,173,119726,119899,0.14
10589,June,2023,Allen,IN,Passenger,1,0,1,7,8,12.5
10590,June,2023,Wichita,TX,Passenger,2,0,2,30,32,6.25
10591,June,2023,New Haven,CT,Passenger,0,2,2,20,22,9.09
10592,June,2023,Clark,NV,Passenger,3,2,5,345,350,1.43
10593,June,2023,Broward,FL,Passenger,1,0,1,52,53,1.89
10594,June,2023,Columbia,WA,Passenger,11,1,12,2395,2407,0.5
10595,June,2023,Kings,CA,Passenger,2,1,3,246,249,1.2
10596,June,2023,Pierce,WA,Passenger,7556,2770,10326,524039,534365,1.93
10597,June,2023,Dorchester,SC,Passenger,1,0,1,34,35,2.86
10598,June,2023,Hidalgo,TX,Passenger,0,1,1,38,39,2.56
10599,June,2023,Onslow,NC,Passenger,0,1,1,131,132,0.76
10600,June,2023,Champaign,IL,Passenger,1,0,1,7,8,12.5
10601,June,2023,Sheridan,WY,Passenger,1,0,1,5,6,16.67
10602,June,2023,Williamson,TX,Passenger,0,1,1,43,44,2.27
10603,June,2023,Newport News,VA,Passenger,1,0,1,88,89,1.12
10604,June,2023,Hawaii,HI,Passenger,1,0,1,25,26,3.85
10605,June,2023,Charles,MD,Passenger,1,1,2,48,50,4.0
10606,June,2023,Kitsap,WA,Truck,76,0,76,51739,51815,0.15
10607,June,2023,Frederick,MD,Passenger,1,1,2,47,49,4.08
10608,June,2023,Clallam,WA,Passenger,545,283,828,48445,49273,1.68
10609,June,2023,Franklin,WA,Passenger,302,137,439,61004,61443,0.71
10610,June,2023,Lewis,WA,Passenger,327,206,533,58421,58954,0.9
10611,June,2023,Chesapeake,VA,Passenger,2,3,5,258,263,1.9
10612,June,2023,Randolph,NC,Passenger,1,0,1,3,4,25.0
10613,June,2023,Whatcom,WA,Passenger,2467,871,3338,145997,149335,2.24
10614,June,2023,Kootenai,ID,Truck,1,0,1,23,24,4.17
10615,June,2023,Polk,OR,Passenger,0,1,1,14,15,6.67
10616,June,2023,Multnomah,OR,Passenger,0,2,2,382,384,0.52
10617,June,2023,Wilson,TX,Passenger,0,1,1,2,3,33.33
10618,June,2023,Mason,WA,Truck,11,0,11,20405,20416,0.05
10619,June,2023,Pierce,WA,Truck,163,0,163,135232,135395,0.12
10620,June,2023,Skagit,WA,Truck,21,0,21,31455,31476,0.07
10621,June,2023,Nueces,TX,Passenger,1,1,2,48,50,4.0
10622,June,2023,Alexandria,VA,Passenger,2,1,3,83,86,3.49
10623,June,2023,Cumberland,NC,Passenger,1,2,3,276,279,1.08
10624,June,2023,Cowlitz,WA,Truck,9,0,9,27797,27806,0.03
10625,June,2023,Camden,NJ,Passenger,0,1,1,12,13,7.69
10626,June,2023,Skagit,WA,Passenger,1105,413,1518,87670,89188,1.7
10627,June,2023,Monterey,CA,Passenger,1,0,1,98,99,1.01
10628,June,2023,Grays Harbor,WA,Truck,7,0,7,20684,20691,0.03
10629,June,2023,Kittitas,WA,Passenger,350,103,453,28878,29331,1.54
10630,June,2023,El Paso,CO,Passenger,3,1,4,441,445,0.9
10631,June,2023,Cook,IL,Passenger,2,0,2,127,129,1.55
10632,June,2023,Lane,OR,Passenger,0,1,1,55,56,1.79
10633,June,2023,Elmore,ID,Passenger,1,0,1,8,9,11.11
10634,June,2023,Chelan,WA,Truck,31,0,31,22830,22861,0.14
10635,June,2023,Whatcom,WA,Truck,58,0,58,42106,42164,0.14
10636,June,2023,Walla Walla,WA,Passenger,219,111,330,34992,35322,0.93
10637,June,2023,Clark,WA,Truck,97,0,97,80308,80405,0.12
10638,June,2023,Douglas,WA,Passenger,209,64,273,28488,28761,0.95
10639,June,2023,Prince George's,MD,Passenger,3,1,4,97,101,3.96
10640,June,2023,Pulaski,AR,Passenger,3,0,3,17,20,15.0
10641,June,2023,Lee,AL,Passenger,1,0,1,11,12,8.33
10642,June,2023,Yakima,WA,Truck,13,0,13,60023,60036,0.02
10643,June,2023,Okanogan,WA,Passenger,123,63,186,25802,25988,0.72
10644,June,2023,Kauai,HI,Passenger,1,1,2,14,16,12.5
10645,June,2023,Rockdale,GA,Passenger,1,0,1,3,4,25.0
10646,June,2023,Placer,CA,Passenger,1,0,1,50,51,1.96
10647,June,2023,Geary,KS,Passenger,1,0,1,66,67,1.49
10648,June,2023,Montgomery,MD,Passenger,3,2,5,160,165,3.03
10649,June,2023,Chelan,WA,Passenger,637,162,799,53633,54432,1.47
10650,June,2023,St. Mary's,MD,Passenger,1,0,1,158,159,0.63
10651,June,2023,Sacramento,CA,Passenger,5,0,5,126,131,3.82
10652,June,2023,Essex,NJ,Passenger,2,0,2,4,6,33.33
10653,June,2023,Thurston,WA,Passenger,3092,1222,4314,188101,192415,2.24
10654,June,2023,Klickitat,WA,Truck,12,0,12,8137,8149,0.15
10655,June,2023,Travis,TX,Passenger,1,0,1,73,74,1.35
10656,June,2023,Grant,WA,Truck,11,0,11,27666,27677,0.04
10657,June,2023,Honolulu,HI,Passenger,2,3,5,225,230,2.17
10658,June,2023,Douglas,NE,Passenger,1,1,2,22,24,8.33
10659,June,2023,Whitman,WA,Passenger,150,79,229,21790,22019,1.04
10660,June,2023,Norfolk,VA,Passenger,2,2,4,243,247,1.62
10661,June,2023,Marin,CA,Passenger,0,1,1,26,27,3.7
10662,June,2023,Lincoln,OR,Passenger,0,1,1,12,13,7.69
10663,June,2023,Emmet,MI,Passenger,0,1,1,0,1,100.0
10664,June,2023,King,WA,Passenger,56981,14563,71544,1312113,1383657,5.17
10665,June,2023,King,WA,Truck,723,2,725,173265,173990,0.42
10666,June,2023,Harrison,MS,Passenger,1,0,1,26,27,3.7
10667,June,2023,Fairfax,VA,Passenger,5,3,8,508,516,1.55
10668,June,2023,Orange,CA,Passenger,6,2,8,249,257,3.11
10669,June,2023,Jackson,OK,Passenger,0,1,1,30,31,3.23
10670,June,2023,Asotin,WA,Passenger,35,22,57,12311,12368,0.46
10671,June,2023,Klickitat,WA,Passenger,151,63,214,14939,15153,1.41
10672,June,2023,Charleston,SC,Passenger,1,2,3,45,48,6.25
10673,June,2023,Cowlitz,WA,Passenger,470,215,685,68949,69634,0.98
10674,June,2023,Salt Lake,UT,Passenger,0,1,1,80,81,1.23
10675,March,2017,Cape May,NJ,Passenger,0,1,1,18,19,5.26
10676,March,2017,Pacific,WA,Passenger,6,8,14,15078,15092,0.09
10677,March,2017,Kittitas,WA,Passenger,17,16,33,27117,27150,0.12
10678,March,2017,Pima,AZ,Passenger,0,2,2,445,447,0.45
10679,March,2017,Lincoln,WA,Truck,0,0,0,4469,4469,0.0
10680,March,2017,Portsmouth,VA,Passenger,0,1,1,67,68,1.47
10681,March,2017,Skagit,WA,Truck,1,0,1,31426,31427,0.0
10682,March,2017,Virginia Beach,VA,Passenger,2,1,3,652,655,0.46
10683,March,2017,Manatee,FL,Passenger,1,0,1,52,53,1.89
10684,March,2017,Prince George's,MD,Passenger,0,1,1,183,184,0.54
10685,March,2017,Clark,NV,Passenger,1,3,4,865,869,0.46
10686,March,2017,Manassas,VA,Passenger,0,1,1,9,10,10.0
10687,March,2017,Harnett,NC,Passenger,1,0,1,258,259,0.39
10688,March,2017,El Paso,CO,Passenger,1,1,2,825,827,0.24
10689,March,2017,Charles,MD,Passenger,0,1,1,91,92,1.09
10690,March,2017,Yakima,WA,Passenger,36,50,86,159228,159314,0.05
10691,March,2017,Cascade,MT,Passenger,0,1,1,60,61,1.64
10692,March,2017,Wahkiakum,WA,Passenger,0,2,2,2849,2851,0.07
10693,March,2017,Pierce,WA,Passenger,876,784,1660,526368,528028,0.31
10694,March,2017,Howard,MD,Passenger,0,2,2,89,91,2.2
10695,March,2017,Pacific,WA,Truck,0,0,0,7480,7480,0.0
10696,March,2017,Jackson,MO,Passenger,1,0,1,68,69,1.45
10697,March,2017,Saratoga,NY,Passenger,1,1,2,77,79,2.53
10698,March,2017,Yakima,WA,Truck,0,0,0,57266,57266,0.0
10699,March,2017,Cobb,GA,Passenger,0,1,1,79,80,1.25
10700,March,2017,Franklin,MA,Passenger,0,1,1,4,5,20.0
10701,March,2017,Dane,WI,Passenger,1,0,1,153,154,0.65
10702,March,2017,Nueces,TX,Passenger,0,1,1,100,101,0.99
10703,March,2017,Fulton,GA,Passenger,1,1,2,123,125,1.6
10704,March,2017,Albemarle,VA,Passenger,0,1,1,30,31,3.23
10705,March,2017,Montgomery,MD,Passenger,1,0,1,306,307,0.33
10706,March,2017,Canyon,ID,Passenger,0,1,1,104,105,0.95
10707,March,2017,Lane,OR,Passenger,0,1,1,257,258,0.39
10708,March,2017,Monroe,NY,Passenger,1,0,1,29,30,3.33
10709,March,2017,Grant,WA,Truck,0,0,0,25045,25045,0.0
10710,March,2017,Santa Fe,NM,Passenger,0,1,1,45,46,2.17
10711,March,2017,Clallam,WA,Truck,0,0,0,21041,21041,0.0
10712,March,2017,Anne Arundel,MD,Passenger,0,1,1,503,504,0.2
10713,March,2017,San Mateo,CA,Passenger,0,1,1,157,158,0.63
10714,March,2017,Cowlitz,WA,Truck,0,0,0,27906,27906,0.0
10715,March,2017,Los Angeles,CA,Passenger,3,1,4,1365,1369,0.29
10716,March,2017,Ferry,WA,Passenger,2,1,3,4386,4389,0.07
10717,March,2017,Orange,CA,Passenger,2,1,3,659,662,0.45
10718,March,2017,Sumter,FL,Passenger,0,1,1,10,11,9.09
10719,March,2017,Kitsap,WA,Passenger,572,289,861,172480,173341,0.5
10720,March,2017,Douglas,OR,Passenger,0,1,1,75,76,1.32
10721,March,2017,Spokane,WA,Passenger,232,202,434,295454,295888,0.15
10722,March,2017,Fairfax,VA,Passenger,2,2,4,867,871,0.46
10723,March,2017,Klickitat,WA,Passenger,21,23,44,14774,14818,0.3
10724,March,2017,Lewis,WA,Passenger,45,34,79,55095,55174,0.14
10725,March,2017,Douglas,WA,Passenger,29,19,48,26592,26640,0.18
10726,March,2017,Utah,UT,Passenger,0,1,1,168,169,0.59
10727,March,2017,Grant,WA,Passenger,17,21,38,60332,60370,0.06
10728,March,2017,Hawaii,HI,Passenger,1,0,1,87,88,1.14
10729,March,2017,Adams,WA,Truck,0,0,0,5070,5070,0.0
10730,March,2017,Mason,WA,Truck,0,0,0,19230,19230,0.0
10731,March,2017,Grays Harbor,WA,Truck,0,0,0,19865,19865,0.0
10732,March,2017,Orleans,LA,Passenger,0,1,1,50,51,1.96
10733,March,2017,DeKalb,IN,Passenger,1,0,1,1,2,50.0
10734,March,2017,Asotin,WA,Truck,0,0,0,6511,6511,0.0
10735,March,2017,King,WA,Passenger,9317,3787,13104,1382738,1395842,0.94
10736,March,2017,Dallas,TX,Passenger,1,1,2,206,208,0.96
10737,March,2017,Ferry,WA,Truck,0,0,0,3554,3554,0.0
10738,March,2017,San Juan,WA,Passenger,88,34,122,13420,13542,0.9
10739,March,2017,Columbia,WA,Truck,0,0,0,1529,1529,0.0
10740,March,2017,New London,CT,Passenger,1,1,2,263,265,0.75
10741,March,2017,Clackamas,OR,Passenger,1,2,3,339,342,0.88
10742,March,2017,Hamilton,IN,Passenger,1,0,1,64,65,1.54
10743,March,2017,Pend Oreille,WA,Truck,0,0,0,5583,5583,0.0
10744,March,2017,Travis,TX,Passenger,0,1,1,192,193,0.52
10745,March,2017,Guilford,NC,Passenger,1,0,1,31,32,3.12
10746,March,2017,Deschutes,OR,Passenger,1,0,1,202,203,0.49
10747,March,2017,Lewis,NY,Passenger,0,1,1,10,11,9.09
10748,March,2017,Dakota,MN,Passenger,0,1,1,41,42,2.38
10749,March,2017,Wahkiakum,WA,Truck,0,0,0,1635,1635,0.0
10750,March,2017,Clark,WA,Truck,0,0,0,77572,77572,0.0
10751,March,2017,Hardin,KY,Passenger,0,1,1,126,127,0.79
10752,March,2017,Douglas,WA,Truck,0,0,0,11441,11441,0.0
10753,March,2017,Ventura,CA,Passenger,0,2,2,375,377,0.53
10754,March,2017,Richmond,GA,Passenger,0,1,1,95,96,1.04
10755,March,2017,Chelan,WA,Passenger,55,30,85,51678,51763,0.16
10756,March,2017,Tarrant,TX,Passenger,0,2,2,289,291,0.69
10757,March,2017,Muscogee,GA,Passenger,0,1,1,253,254,0.39
10758,March,2017,Benton,WA,Passenger,140,139,279,127941,128220,0.22
10759,March,2017,Jefferson,NY,Passenger,1,1,2,260,262,0.76
10760,March,2017,Nantucket,MA,Passenger,1,0,1,3,4,25.0
10761,March,2017,Jefferson,WA,Truck,0,0,0,9447,9447,0.0
10762,March,2017,Marin,CA,Passenger,1,0,1,59,60,1.67
10763,March,2017,Okanogan,WA,Truck,0,0,0,16304,16304,0.0
10764,March,2017,Stevens,WA,Passenger,6,20,26,31284,31310,0.08
10765,March,2017,Clallam,WA,Passenger,77,65,142,48078,48220,0.29
10766,March,2017,Duval,FL,Passenger,1,1,2,373,375,0.53
10767,March,2017,San Juan,WA,Truck,0,0,0,5583,5583,0.0
10768,March,2017,Whatcom,WA,Passenger,416,156,572,142234,142806,0.4
10769,March,2017,Pinal,AZ,Passenger,2,0,2,263,265,0.75
10770,March,2017,Montgomery,TN,Passenger,1,0,1,287,288,0.35
10771,March,2017,Moore,NC,Passenger,0,1,1,208,209,0.48
10772,March,2017,Missoula,MT,Passenger,1,0,1,80,81,1.23
10773,March,2017,Island,WA,Truck,0,0,0,20500,20500,0.0
10774,March,2017,Okanogan,WA,Passenger,3,16,19,25642,25661,0.07
10775,March,2017,Nassau,NY,Passenger,0,1,1,40,41,2.44
10776,March,2017,Essex,NJ,Passenger,1,0,1,16,17,5.88
10777,March,2017,Chelan,WA,Truck,0,0,0,21220,21220,0.0
10778,March,2017,Grays Harbor,WA,Passenger,27,26,53,44419,44472,0.12
10779,March,2017,Franklin,WA,Truck,0,0,0,17960,17960,0.0
10780,March,2017,Norfolk,VA,Passenger,1,1,2,304,306,0.65
10781,March,2017,Whatcom,WA,Truck,2,0,2,41393,41395,0.0
10782,March,2017,Gwinnett,GA,Passenger,0,1,1,84,85,1.18
10783,March,2017,Northampton,PA,Passenger,2,0,2,209,211,0.95
10784,March,2017,Lee,AL,Passenger,1,0,1,35,36,2.78
10785,March,2017,Asotin,WA,Passenger,5,2,7,12335,12342,0.06
10786,March,2017,Benton,WA,Truck,0,0,0,39849,39849,0.0
10787,March,2017,Garfield,WA,Truck,0,0,0,940,940,0.0
10788,March,2017,Thurston,WA,Passenger,365,313,678,185430,186108,0.36
10789,March,2017,Shelby,TN,Passenger,0,1,1,110,111,0.9
10790,March,2017,Wayne,MI,Passenger,0,1,1,71,72,1.39
10791,March,2017,Clark,WA,Passenger,718,454,1172,298270,299442,0.39
10792,March,2017,Latah,ID,Passenger,0,1,1,121,122,0.82
10793,March,2017,Hidalgo,TX,Passenger,0,1,1,97,98,1.02
10794,March,2017,Madison,ID,Passenger,1,0,1,44,45,2.22
10795,March,2017,Dale,AL,Passenger,0,1,1,64,65,1.54
10796,March,2017,Monterey,CA,Passenger,0,1,1,218,219,0.46
10797,March,2017,Kittitas,WA,Truck,0,0,0,13423,13423,0.0
10798,March,2017,Thurston,WA,Truck,0,0,0,53299,53299,0.0
10799,March,2017,Pierce,WA,Truck,0,0,0,138175,138175,0.0
10800,March,2017,Whitman,WA,Passenger,9,18,27,21937,21964,0.12
10801,March,2017,Prince William,VA,Passenger,0,3,3,275,278,1.08
10802,March,2017,DeKalb,GA,Passenger,1,0,1,84,85,1.18
10803,March,2017,Cumberland,NC,Passenger,1,0,1,622,623,0.16
10804,March,2017,Adams,WA,Passenger,2,4,6,12107,12113,0.05
10805,March,2017,Honolulu,HI,Passenger,4,2,6,616,622,0.96
10806,March,2017,Skagit,WA,Passenger,118,91,209,87516,87725,0.24
10807,March,2017,Volusia,FL,Passenger,0,1,1,46,47,2.13
10808,March,2017,Snohomish,WA,Truck,1,0,1,122199,122200,0.0
10809,March,2017,Bexar,TX,Passenger,1,2,3,1088,1091,0.27
10810,March,2017,Allegheny,PA,Passenger,1,0,1,91,92,1.09
10811,March,2017,Middlesex,MA,Passenger,1,0,1,152,153,0.65
10812,March,2017,Norfolk,MA,Passenger,1,0,1,37,38,2.63
10813,March,2017,Walla Walla,WA,Truck,0,0,0,13186,13186,0.0
10814,March,2017,Klickitat,WA,Truck,0,0,0,7941,7941,0.0
10815,March,2017,Multnomah,OR,Passenger,0,3,3,1110,1113,0.27
10816,March,2017,Snohomish,WA,Passenger,1656,849,2505,513393,515898,0.49
10817,March,2017,Stevens,WA,Truck,0,0,0,18309,18309,0.0
10818,March,2017,Salt Lake,UT,Passenger,0,1,1,309,310,0.32
10819,March,2017,Marion,OR,Passenger,1,0,1,195,196,0.51
10820,March,2017,Maricopa,AZ,Passenger,2,0,2,1827,1829,0.11
10821,March,2017,King,WA,Truck,8,1,9,189758,189767,0.0
10822,March,2017,Walla Walla,WA,Passenger,20,22,42,34821,34863,0.12
10823,March,2017,Arlington,VA,Passenger,1,1,2,168,170,1.18
10824,March,2017,New Haven,CT,Passenger,0,1,1,61,62,1.61
10825,March,2017,Morris,NJ,Passenger,1,0,1,22,23,4.35
10826,March,2017,Orange,FL,Passenger,1,1,2,152,154,1.3
10827,March,2017,Franklin,WA,Passenger,26,47,73,55311,55384,0.13
10828,March,2017,Skamania,WA,Passenger,8,8,16,8529,8545,0.19
10829,March,2017,Garfield,WA,Passenger,0,0,0,1283,1283,0.0
10830,March,2017,San Diego,CA,Passenger,5,1,6,2806,2812,0.21
10831,March,2017,Pend Oreille,WA,Passenger,1,4,5,9307,9312,0.05
10832,March,2017,Tulare,CA,Passenger,1,0,1,194,195,0.51
10833,March,2017,Whitman,WA,Truck,0,0,0,8389,8389,0.0
10834,March,2017,Polk,FL,Passenger,1,0,1,66,67,1.49
10835,March,2017,Franklin,OH,Passenger,0,1,1,115,116,0.86
10836,March,2017,Alameda,CA,Passenger,3,1,4,383,387,1.03
10837,March,2017,Hamilton,TN,Passenger,1,0,1,26,27,3.7
10838,March,2017,Okaloosa,FL,Passenger,1,0,1,193,194,0.52
10839,March,2017,St. Lucie,FL,Passenger,1,0,1,31,32,3.12
10840,March,2017,Maui,HI,Passenger,1,0,1,71,72,1.39
10841,March,2017,Columbia,WA,Passenger,0,1,1,2355,2356,0.04
10842,March,2017,Island,WA,Passenger,105,129,234,59602,59836,0.39
10843,March,2017,Riverside,CA,Passenger,1,1,2,828,830,0.24
10844,March,2017,Lincoln,WA,Passenger,2,4,6,7506,7512,0.08
10845,March,2017,Santa Clara,CA,Passenger,6,2,8,415,423,1.89
10846,March,2017,Cowlitz,WA,Passenger,51,48,99,69297,69396,0.14
10847,March,2017,Montgomery,PA,Passenger,1,0,1,42,43,2.33
10848,March,2017,Juneau,AK,Passenger,0,1,1,53,54,1.85
10849,March,2017,Bergen,NJ,Passenger,0,2,2,32,34,5.88
10850,March,2017,Jefferson,WA,Passenger,94,57,151,23648,23799,0.63
10851,March,2017,Carroll,NH,Passenger,0,1,1,0,1,100.0
10852,March,2017,Mason,WA,Passenger,50,65,115,42929,43044,0.27
10853,March,2017,Kitsap,WA,Truck,1,0,1,52317,52318,0.0
10854,March,2017,District of Columbia,DC,Passenger,0,3,3,224,227,1.32
10855,March,2017,Lewis,WA,Truck,0,0,0,24813,24813,0.0
10856,March,2017,Spokane,WA,Truck,1,0,1,90256,90257,0.0
10857,March,2017,Skamania,WA,Truck,0,0,0,3882,3882,0.0
10858,March,2017,Oklahoma,OK,Passenger,0,1,1,168,169,0.59
10860,March,2018,Kittitas,WA,Truck,0,0,0,13984,13984,0.0
10861,March,2018,Thurston,WA,Passenger,518,432,950,191158,192108,0.49
10862,March,2018,Hardin,KY,Passenger,0,1,1,118,119,0.84
10863,March,2018,Los Angeles,CA,Passenger,5,4,9,1180,1189,0.76
10864,March,2018,Pend Oreille,WA,Passenger,4,3,7,9455,9462,0.07
10865,March,2018,El Paso,CO,Passenger,2,0,2,753,755,0.26
10866,March,2018,DuPage,IL,Passenger,1,0,1,65,66,1.52
10867,March,2018,Okanogan,WA,Truck,0,0,0,16333,16333,0.0
10868,March,2018,Chelan,WA,Truck,0,0,0,21720,21720,0.0
10870,March,2018,Anne Arundel,MD,Passenger,0,2,2,466,468,0.43
10871,March,2018,Cowlitz,WA,Truck,0,0,0,28271,28271,0.0
10872,March,2018,Saratoga,NY,Passenger,1,1,2,66,68,2.94
10873,March,2018,Pinal,AZ,Passenger,2,0,2,209,211,0.95
10874,March,2018,Cowlitz,WA,Passenger,55,70,125,71222,71347,0.18
10875,March,2018,Stevens,WA,Truck,0,0,0,18427,18427,0.0
10876,March,2018,Whatcom,WA,Truck,2,0,2,42069,42071,0.0
10877,March,2018,Orleans,LA,Passenger,0,1,1,46,47,2.13
10878,March,2018,Pierce,WA,Passenger,1126,1053,2179,527857,530036,0.41
10879,March,2018,Flathead,MT,Passenger,1,0,1,51,52,1.92
10880,March,2018,Montgomery,MD,Passenger,1,0,1,296,297,0.34
10881,March,2018,Ferry,WA,Passenger,1,3,4,4404,4408,0.09
10882,March,2018,Walla Walla,WA,Truck,0,0,0,13311,13311,0.0
10883,March,2018,Pierce,WA,Truck,0,0,0,137102,137102,0.0
10884,March,2018,Lewis,WA,Truck,0,0,0,25255,25255,0.0
10885,March,2018,Lumpkin,GA,Passenger,1,0,1,7,8,12.5
10886,March,2018,Santa Clara,CA,Passenger,6,1,7,377,384,1.82
10887,March,2018,Riverside,CA,Passenger,2,2,4,706,710,0.56
10888,March,2018,Ferry,WA,Truck,0,0,0,3504,3504,0.0
10889,March,2018,San Mateo,CA,Passenger,1,1,2,135,137,1.46
10890,March,2018,DeKalb,GA,Passenger,1,0,1,81,82,1.22
10891,March,2018,Canyon,ID,Passenger,0,1,1,94,95,1.05
10892,March,2018,Douglas,WA,Passenger,42,33,75,27415,27490,0.27
10893,March,2018,Dale,AL,Passenger,0,1,1,62,63,1.59
10894,March,2018,Monterey,CA,Passenger,0,2,2,190,192,1.04
10895,March,2018,Jefferson,WA,Passenger,132,88,220,24289,24509,0.9
10896,March,2018,Montgomery,TX,Passenger,1,0,1,63,64,1.56
10897,March,2018,Nueces,TX,Passenger,1,1,2,94,96,2.08
10898,March,2018,Twin Falls,ID,Passenger,0,1,1,24,25,4.0
10899,March,2018,Charles,MD,Passenger,0,1,1,81,82,1.22
10900,March,2018,Columbia,WA,Truck,0,0,0,1532,1532,0.0
10901,March,2018,Montgomery,PA,Passenger,1,0,1,35,36,2.78
10902,March,2018,Kittitas,WA,Passenger,40,30,70,28748,28818,0.24
10903,March,2018,Clark,WA,Truck,0,0,0,78628,78628,0.0
10904,March,2018,Travis,TX,Passenger,0,1,1,188,189,0.53
10905,March,2018,Jefferson,NY,Passenger,1,0,1,224,225,0.44
10906,March,2018,Garfield,WA,Truck,0,0,0,952,952,0.0
10907,March,2018,Hamilton,IN,Passenger,1,0,1,49,50,2.0
10908,March,2018,Asotin,WA,Passenger,8,5,13,12627,12640,0.1
10909,March,2018,Norfolk,MA,Passenger,1,0,1,37,38,2.63
10910,March,2018,Prince George,VA,Passenger,0,1,1,74,75,1.33
10911,March,2018,Cook,IL,Passenger,1,0,1,279,280,0.36
10912,March,2018,Clallam,WA,Truck,0,0,0,21314,21314,0.0
10913,March,2018,Santa Fe,NM,Passenger,0,1,1,41,42,2.38
10914,March,2018,New Haven,CT,Passenger,0,1,1,51,52,1.92
10915,March,2018,Columbia,WA,Passenger,2,1,3,2409,2412,0.12
10916,March,2018,Sumter,FL,Passenger,0,1,1,10,11,9.09
10917,March,2018,Whatcom,WA,Passenger,574,260,834,146117,146951,0.57
10918,March,2018,Alameda,CA,Passenger,0,1,1,353,354,0.28
10919,March,2018,Whitman,WA,Passenger,18,23,41,22489,22530,0.18
10920,March,2018,Pend Oreille,WA,Truck,0,0,0,5658,5658,0.0
10921,March,2018,Tarrant,TX,Passenger,1,0,1,218,219,0.46
10922,March,2018,Klickitat,WA,Passenger,25,27,52,14973,15025,0.35
10923,March,2018,Skamania,WA,Passenger,12,8,20,8667,8687,0.23
10924,March,2018,Walla Walla,WA,Passenger,32,36,68,35462,35530,0.19
10925,March,2018,Douglas,WA,Truck,0,0,0,11857,11857,0.0
10926,March,2018,St. Clair,IL,Passenger,0,1,1,154,155,0.65
10927,March,2018,Yakima,WA,Truck,0,0,0,58175,58175,0.0
10928,March,2018,Utah,UT,Passenger,0,1,1,136,137,0.73
10929,March,2018,Arlington,VA,Passenger,1,2,3,173,176,1.7
10930,March,2018,Pacific,WA,Truck,0,0,0,7577,7577,0.0
10931,March,2018,Sangamon,IL,Passenger,1,0,1,11,12,8.33
10932,March,2018,Orange,CA,Passenger,3,1,4,570,574,0.7
10933,March,2018,Cape May,NJ,Passenger,0,1,1,21,22,4.55
10934,March,2018,San Diego,CA,Passenger,6,1,7,2555,2562,0.27
10935,March,2018,Manassas,VA,Passenger,0,1,1,8,9,11.11
10936,March,2018,Queens,NY,Passenger,1,0,1,63,64,1.56
10937,March,2018,Yakima,WA,Passenger,63,81,144,162826,162970,0.09
10938,March,2018,Howard,MD,Passenger,0,1,1,87,88,1.14
10939,March,2018,King,WA,Truck,7,1,8,183718,183726,0.0
10940,March,2018,Richmond,GA,Passenger,0,1,1,89,90,1.11
10941,March,2018,Honolulu,HI,Passenger,2,2,4,546,550,0.73
10942,March,2018,Island,WA,Truck,0,0,0,20857,20857,0.0
10943,March,2018,Maui,HI,Passenger,1,0,1,63,64,1.56
10944,March,2018,Lane,OR,Passenger,0,1,1,188,189,0.53
10945,March,2018,Hamilton,TN,Passenger,1,0,1,23,24,4.17
10946,March,2018,Duval,FL,Passenger,1,2,3,374,377,0.8
10947,March,2018,Morris,NJ,Passenger,1,0,1,19,20,5.0
10948,March,2018,Pima,AZ,Passenger,1,1,2,414,416,0.48
10949,March,2018,Mason,WA,Passenger,68,83,151,45217,45368,0.33
10950,March,2018,Skamania,WA,Truck,0,0,0,3925,3925,0.0
10951,March,2018,Adams,WA,Truck,0,0,0,5152,5152,0.0
10952,March,2018,Polk,FL,Passenger,1,0,1,62,63,1.59
10953,March,2018,Juneau,AK,Passenger,0,1,1,44,45,2.22
10954,March,2018,Broward,FL,Passenger,0,1,1,132,133,0.75
10955,March,2018,Chelan,WA,Passenger,96,41,137,53348,53485,0.26
10956,March,2018,Sacramento,CA,Passenger,1,0,1,294,295,0.34
10957,March,2018,Williamson,TX,Passenger,0,1,1,160,161,0.62
10958,March,2018,Lincoln,WA,Truck,0,0,0,4515,4515,0.0
10959,March,2018,Frederick,MD,Passenger,0,1,1,87,88,1.14
10960,March,2018,Franklin,WA,Passenger,34,55,89,57213,57302,0.16
10961,March,2018,King,WA,Passenger,11972,5152,17124,1367947,1385071,1.24
10962,March,2018,DeKalb,IN,Passenger,1,0,1,1,2,50.0
10963,March,2018,Pacific,WA,Passenger,15,18,33,15463,15496,0.21
10964,March,2018,Klickitat,WA,Truck,0,0,0,8045,8045,0.0
10965,March,2018,Santa Rosa,FL,Passenger,1,0,1,100,101,0.99
10966,March,2018,San Juan,WA,Passenger,140,50,190,13939,14129,1.34
10967,March,2018,Prince William,VA,Passenger,0,4,4,266,270,1.48
10968,March,2018,Maricopa,AZ,Passenger,2,1,3,1564,1567,0.19
10969,March,2018,Kitsap,WA,Truck,1,0,1,52964,52965,0.0
10970,March,2018,Shelby,TN,Passenger,0,1,1,101,102,0.98
10971,March,2018,Bexar,TX,Passenger,2,2,4,789,793,0.5
10972,March,2018,Garfield,WA,Passenger,1,0,1,1330,1331,0.08
10973,March,2018,Dakota,MN,Passenger,0,2,2,37,39,5.13
10974,March,2018,Madison,ID,Passenger,1,0,1,39,40,2.5
10975,March,2018,Essex,NJ,Passenger,1,0,1,11,12,8.33
10976,March,2018,Spokane,WA,Truck,1,0,1,91900,91901,0.0
10977,March,2018,Hawaii,HI,Passenger,1,0,1,78,79,1.27
10978,March,2018,Multnomah,OR,Passenger,3,4,7,817,824,0.85
10979,March,2018,Marion,IN,Passenger,1,0,1,116,117,0.85
10980,March,2018,Grant,WA,Truck,0,0,0,25746,25746,0.0
10981,March,2018,Jefferson,WA,Truck,0,0,0,9515,9515,0.0
10982,March,2018,Snohomish,WA,Truck,1,0,1,121231,121232,0.0
10983,March,2018,San Juan,WA,Truck,0,0,0,5658,5658,0.0
10984,March,2018,Palm Beach,FL,Passenger,0,1,1,85,86,1.16
10985,March,2018,Grays Harbor,WA,Truck,0,0,0,20078,20078,0.0
10986,March,2018,Asotin,WA,Truck,0,0,0,6593,6593,0.0
10987,March,2018,Grant,WA,Passenger,32,42,74,62599,62673,0.12
10988,March,2018,Mason,WA,Truck,0,0,0,19793,19793,0.0
10989,March,2018,Gwinnett,GA,Passenger,0,1,1,78,79,1.27
10990,March,2018,Lincoln,WA,Passenger,2,5,7,7578,7585,0.09
10991,March,2018,Franklin,MA,Passenger,0,1,1,2,3,33.33
10992,March,2018,Clay,FL,Passenger,0,1,1,102,103,0.97
10993,March,2018,Norfolk,VA,Passenger,1,2,3,325,328,0.91
10994,March,2018,Stevens,WA,Passenger,9,21,30,31603,31633,0.09
10995,March,2018,Garfield,OK,Passenger,1,0,1,21,22,4.55
10996,March,2018,Volusia,FL,Passenger,0,1,1,34,35,2.86
10997,March,2018,Nantucket,MA,Passenger,1,0,1,4,5,20.0
10998,March,2018,Dallas,TX,Passenger,0,1,1,187,188,0.53
10999,March,2018,Prince George's,MD,Passenger,0,1,1,182,183,0.55
11000,March,2018,Montgomery,TN,Passenger,1,0,1,267,268,0.37
11001,March,2018,Grays Harbor,WA,Passenger,45,46,91,46091,46182,0.2
11002,March,2018,Contra Costa,CA,Passenger,0,1,1,467,468,0.21
11003,March,2018,Allegheny,PA,Passenger,1,0,1,77,78,1.28
11004,March,2018,Lewis,WA,Passenger,55,47,102,57151,57253,0.18
11005,March,2018,Fulton,GA,Passenger,1,0,1,99,100,1.0
11006,March,2018,Sedgwick,KS,Passenger,0,1,1,104,105,0.95
11007,March,2018,Manatee,FL,Passenger,1,0,1,37,38,2.63
11008,March,2018,Kitsap,WA,Passenger,740,428,1168,176885,178053,0.66
11009,March,2018,Snohomish,WA,Passenger,2133,1159,3292,517925,521217,0.63
11010,March,2018,Brevard,FL,Passenger,0,1,1,100,101,0.99
11011,March,2018,Washtenaw,MI,Passenger,1,0,1,39,40,2.5
11012,March,2018,Nassau,NY,Passenger,1,0,1,35,36,2.78
11013,March,2018,Moore,NC,Passenger,0,1,1,199,200,0.5
11014,March,2018,Virginia Beach,VA,Passenger,2,1,3,682,685,0.44
11015,March,2018,Okanogan,WA,Passenger,7,19,26,25733,25759,0.1
11016,March,2018,Fairfax,VA,Passenger,2,2,4,824,828,0.48
11017,March,2018,Lee,AL,Passenger,1,0,1,33,34,2.94
11018,March,2018,Marin,CA,Passenger,1,0,1,54,55,1.82
11019,March,2018,Deschutes,OR,Passenger,1,0,1,172,173,0.58
11020,March,2018,Kent,MI,Passenger,0,1,1,34,35,2.86
11021,March,2018,Skagit,WA,Passenger,173,154,327,89895,90222,0.36
11022,March,2018,Clark,WA,Passenger,918,641,1559,306002,307561,0.51
11023,March,2018,Ramsey,MN,Passenger,1,0,1,37,38,2.63
11024,March,2018,Franklin,WA,Truck,0,0,0,18617,18617,0.0
11025,March,2018,Skagit,WA,Truck,1,0,1,31922,31923,0.0
11026,March,2018,Clark,NV,Passenger,1,2,3,744,747,0.4
11027,March,2018,Richland,SC,Passenger,0,1,1,172,173,0.58
11028,March,2018,Benton,WA,Passenger,176,187,363,130785,131148,0.28
11029,March,2018,New London,CT,Passenger,1,1,2,249,251,0.8
11030,March,2018,Benton,WA,Truck,0,0,0,40794,40794,0.0
11031,March,2018,Island,WA,Passenger,175,178,353,62057,62410,0.57
11032,March,2018,Wahkiakum,WA,Passenger,1,2,3,2871,2874,0.1
11033,March,2018,Orange,FL,Passenger,2,1,3,169,172,1.74
11034,March,2018,District of Columbia,DC,Passenger,0,3,3,195,198,1.52
11035,March,2018,St. Lucie,FL,Passenger,1,0,1,27,28,3.57
11036,March,2018,Caddo,LA,Passenger,0,1,1,22,23,4.35
11037,March,2018,Ada,ID,Passenger,0,2,2,336,338,0.59
11038,March,2018,Adams,WA,Passenger,5,4,9,12470,12479,0.07
11039,March,2018,Spokane,WA,Passenger,304,273,577,301278,301855,0.19
11040,March,2018,Latah,ID,Passenger,0,1,1,78,79,1.27
11041,March,2018,Ventura,CA,Passenger,0,1,1,327,328,0.3
11042,March,2018,Whitman,WA,Truck,0,0,0,8453,8453,0.0
11043,March,2018,Okaloosa,FL,Passenger,1,0,1,175,176,0.57
11044,March,2018,Northampton,PA,Passenger,0,1,1,63,64,1.56
11045,March,2018,Portsmouth,VA,Passenger,0,1,1,72,73,1.37
11046,March,2018,El Paso,TX,Passenger,1,0,1,524,525,0.19
11047,March,2018,Tuolumne,CA,Passenger,0,1,1,14,15,6.67
11048,March,2018,Clallam,WA,Passenger,119,104,223,49504,49727,0.45
11049,March,2018,Thurston,WA,Truck,0,0,0,54007,54007,0.0
11050,March,2018,Carroll,NH,Passenger,0,1,1,1,2,50.0
11051,March,2018,Jefferson,CO,Passenger,0,1,1,75,76,1.32
11052,March,2018,Wahkiakum,WA,Truck,0,0,0,1668,1668,0.0
11053,March,2019,Douglas,WA,Truck,0,0,0,12157,12157,0.0
11054,March,2019,DeKalb,IN,Passenger,1,0,1,1,2,50.0
11055,March,2019,Guadalupe,TX,Passenger,1,0,1,77,78,1.28
11056,March,2019,Randolph,NC,Passenger,1,0,1,6,7,14.29
11057,March,2019,Cook,IL,Passenger,1,0,1,244,245,0.41
11058,March,2019,Camden,NJ,Passenger,0,1,1,26,27,3.7
11059,March,2019,Washtenaw,MI,Passenger,1,0,1,37,38,2.63
11060,March,2019,Anne Arundel,MD,Passenger,0,2,2,452,454,0.44
11061,March,2019,Grays Harbor,WA,Passenger,69,80,149,47589,47738,0.31
11062,March,2019,Portsmouth,VA,Passenger,0,1,1,76,77,1.3
11063,March,2019,New London,CT,Passenger,0,2,2,249,251,0.8
11064,March,2019,Lumpkin,GA,Passenger,1,0,1,6,7,14.29
11065,March,2019,Owyhee,ID,Passenger,1,0,1,5,6,16.67
11066,March,2019,Oldham,KY,Passenger,0,1,1,5,6,16.67
11067,March,2019,Clark,WA,Truck,0,0,0,79992,79992,0.0
11068,March,2019,Pima,AZ,Passenger,1,1,2,401,403,0.5
11069,March,2019,Kent,MI,Passenger,0,1,1,21,22,4.55
11070,March,2019,Goochland,VA,Passenger,1,1,2,248,250,0.8
11071,March,2019,Lee,FL,Passenger,1,0,1,52,53,1.89
11072,March,2019,New Haven,CT,Passenger,0,2,2,49,51,3.92
11073,March,2019,Cumberland,NC,Passenger,0,2,2,506,508,0.39
11074,March,2019,El Paso,TX,Passenger,2,0,2,493,495,0.4
11075,March,2019,Sangamon,IL,Passenger,2,0,2,7,9,22.22
11076,March,2019,Montgomery,PA,Passenger,2,0,2,37,39,5.13
11077,March,2019,Middlesex,MA,Passenger,1,1,2,118,120,1.67
11078,March,2019,Kern,CA,Passenger,0,1,1,225,226,0.44
11079,March,2019,Howard,MD,Passenger,0,1,1,78,79,1.27
11080,March,2019,Wahkiakum,WA,Passenger,1,1,2,3008,3010,0.07
11081,March,2019,Jefferson,WA,Passenger,179,118,297,24880,25177,1.18
11082,March,2019,Mecklenburg,NC,Passenger,1,0,1,79,80,1.25
11083,March,2019,Pinal,AZ,Passenger,2,0,2,198,200,1.0
11084,March,2019,St. Clair,IL,Passenger,0,1,1,162,163,0.61
11085,March,2019,Kootenai,ID,Passenger,1,1,2,212,214,0.93
11086,March,2019,Charleston,SC,Passenger,1,0,1,121,122,0.82
11087,March,2019,Chelan,WA,Passenger,144,67,211,54156,54367,0.39
11088,March,2019,Snohomish,WA,Passenger,3195,1519,4714,527994,532708,0.88
11089,March,2019,San Juan,PR,Passenger,0,1,1,3,4,25.0
11090,March,2019,Los Angeles,CA,Passenger,7,5,12,1089,1101,1.09
11091,March,2019,Clallam,WA,Truck,0,0,0,21617,21617,0.0
11092,March,2019,Columbia,WA,Truck,0,0,0,1527,1527,0.0
11093,March,2019,Lewis,WA,Truck,0,0,0,25755,25755,0.0
11094,March,2019,Honolulu,HI,Passenger,2,3,5,500,505,0.99
11095,March,2019,Shasta,CA,Passenger,1,0,1,41,42,2.38
11096,March,2019,King,WA,Truck,6,1,7,181762,181769,0.0
11097,March,2019,Clark,WA,Passenger,1358,881,2239,311974,314213,0.71
11098,March,2019,Fairfax,VA,Passenger,3,2,5,795,800,0.62
11099,March,2019,Travis,TX,Passenger,2,1,3,202,205,1.46
11100,March,2019,Garfield,WA,Passenger,1,1,2,1310,1312,0.15
11101,March,2019,St. Mary's,MD,Passenger,1,0,1,213,214,0.47
11103,March,2019,Whatcom,WA,Truck,2,0,2,42724,42726,0.0
11104,March,2019,Stevens,WA,Passenger,18,27,45,31632,31677,0.14
11105,March,2019,Santa Cruz,CA,Passenger,1,0,1,41,42,2.38
11106,March,2019,Shelby,TN,Passenger,0,1,1,96,97,1.03
11107,March,2019,St. Lucie,FL,Passenger,1,0,1,30,31,3.23
11108,March,2019,Snohomish,WA,Truck,1,0,1,121910,121911,0.0
11109,March,2019,Skagit,WA,Truck,1,0,1,32255,32256,0.0
11110,March,2019,Pacific,WA,Passenger,23,26,49,15850,15899,0.31
11111,March,2019,Richmond,GA,Passenger,0,1,1,93,94,1.06
11112,March,2019,San Diego,CA,Passenger,10,3,13,2649,2662,0.49
11113,March,2019,Clark,NV,Passenger,3,2,5,706,711,0.7
11114,March,2019,Chelan,WA,Truck,0,0,0,22127,22127,0.0
11115,March,2019,Benton,WA,Truck,0,0,0,41532,41532,0.0
11116,March,2019,Thurston,WA,Passenger,802,598,1400,196182,197582,0.71
11117,March,2019,Collin,TX,Passenger,1,1,2,134,136,1.47
11118,March,2019,Walla Walla,WA,Passenger,44,56,100,36067,36167,0.28
11119,March,2019,Spartanburg,SC,Passenger,0,1,1,33,34,2.94
11120,March,2019,Alameda,CA,Passenger,3,2,5,317,322,1.55
11121,March,2019,Yakima,WA,Passenger,89,102,191,164203,164394,0.12
11122,March,2019,Pend Oreille,WA,Truck,0,0,0,5721,5721,0.0
11123,March,2019,Ada,ID,Passenger,0,2,2,308,310,0.65
11124,March,2019,Walla Walla,WA,Truck,0,0,0,13552,13552,0.0
11125,March,2019,Klamath,OR,Passenger,1,0,1,38,39,2.56
11126,March,2019,Maricopa,AZ,Passenger,6,2,8,1544,1552,0.52
11127,March,2019,DuPage,IL,Passenger,1,0,1,61,62,1.61
11128,March,2019,El Paso,CO,Passenger,3,2,5,752,757,0.66
11129,March,2019,Juneau,AK,Passenger,0,1,1,33,34,2.94
11130,March,2019,Hennepin,MN,Passenger,2,0,2,103,105,1.9
11131,March,2019,DeKalb,GA,Passenger,1,0,1,80,81,1.23
11132,March,2019,Kitsap,WA,Truck,1,0,1,53744,53745,0.0
11133,March,2019,Fresno,CA,Passenger,1,0,1,188,189,0.53
11134,March,2019,Kittitas,WA,Truck,0,0,0,14249,14249,0.0
11135,March,2019,Arlington,VA,Passenger,1,2,3,162,165,1.82
11136,March,2019,Bergen,NJ,Passenger,1,0,1,25,26,3.85
11137,March,2019,Montgomery,MD,Passenger,1,0,1,274,275,0.36
11138,March,2019,Fulton,GA,Passenger,1,2,3,110,113,2.65
11139,March,2019,Volusia,FL,Passenger,0,1,1,36,37,2.7
11140,March,2019,Columbia,WA,Passenger,2,2,4,2427,2431,0.16
11141,March,2019,Larimer,CO,Passenger,1,0,1,58,59,1.69
11142,March,2019,Okanogan,WA,Passenger,20,21,41,25907,25948,0.16
11143,March,2019,Island,WA,Truck,0,0,0,21186,21186,0.0
11144,March,2019,Sedgwick,KS,Passenger,0,1,1,103,104,0.96
11145,March,2019,Ferry,WA,Passenger,3,2,5,4362,4367,0.11
11146,March,2019,Clay,FL,Passenger,0,1,1,84,85,1.18
11147,March,2019,Klickitat,WA,Truck,0,0,0,8207,8207,0.0
11148,March,2019,Calvert,MD,Passenger,0,1,1,87,88,1.14
11149,March,2019,Twin Falls,ID,Passenger,0,1,1,21,22,4.55
11150,March,2019,Wayne,MI,Passenger,0,1,1,68,69,1.45
11151,March,2019,Cascade,MT,Passenger,0,1,1,55,56,1.79
11152,March,2019,Riverside,CA,Passenger,2,2,4,662,666,0.6
11153,March,2019,Skamania,WA,Truck,0,0,0,4017,4017,0.0
11154,March,2019,Suffolk,MA,Passenger,0,1,1,41,42,2.38
11155,March,2019,Prince George's,MD,Passenger,1,1,2,182,184,1.09
11156,March,2019,Flathead,MT,Passenger,1,0,1,60,61,1.64
11157,March,2019,Island,WA,Passenger,300,234,534,63126,63660,0.84
11158,March,2019,Allegheny,PA,Passenger,1,0,1,85,86,1.16
11159,March,2019,Tuolumne,CA,Passenger,0,1,1,12,13,7.69
11160,March,2019,Asotin,WA,Truck,0,0,0,6632,6632,0.0
11161,March,2019,Caddo,LA,Passenger,0,1,1,23,24,4.17
11162,March,2019,Denver,CO,Passenger,1,0,1,132,133,0.75
11163,March,2019,Stevens,WA,Truck,0,0,0,18708,18708,0.0
11164,March,2019,Gwinnett,GA,Passenger,0,1,1,76,77,1.3
11165,March,2019,Palm Beach,FL,Passenger,0,1,1,93,94,1.06
11166,March,2019,San Juan,WA,Truck,0,0,0,5811,5811,0.0
11167,March,2019,Douglas,NE,Passenger,0,1,1,64,65,1.54
11168,March,2019,Vigo,IN,Passenger,1,0,1,5,6,16.67
11169,March,2019,Wahkiakum,WA,Truck,0,0,0,1725,1725,0.0
11170,March,2019,Marion,OR,Passenger,1,0,1,116,117,0.85
11171,March,2019,Tulsa,OK,Passenger,1,1,2,47,49,4.08
11172,March,2019,Richland,SC,Passenger,0,1,1,164,165,0.61
11173,March,2019,Spokane,WA,Truck,1,0,1,94016,94017,0.0
11174,March,2019,San Francisco,CA,Passenger,2,1,3,111,114,2.63
11175,March,2019,Cochise,AZ,Passenger,0,1,1,115,116,0.86
11176,March,2019,Nassau,NY,Passenger,3,0,3,39,42,7.14
11177,March,2019,Santa Clara,CA,Passenger,8,1,9,361,370,2.43
11178,March,2019,Jefferson,WA,Truck,0,0,0,9645,9645,0.0
11179,March,2019,Lincoln,WA,Truck,0,0,0,4683,4683,0.0
11180,March,2019,Bexar,TX,Passenger,3,4,7,682,689,1.02
11181,March,2019,Thurston,WA,Truck,0,0,0,54948,54948,0.0
11182,March,2019,Klickitat,WA,Passenger,32,31,63,15424,15487,0.41
11183,March,2019,King,WA,Passenger,17678,6779,24457,1381383,1405840,1.74
11184,March,2019,Skagit,WA,Passenger,281,189,470,91327,91797,0.51
11185,March,2019,Orange,CA,Passenger,5,1,6,532,538,1.12
11186,March,2019,Montgomery,AL,Passenger,0,1,1,43,44,2.27
11187,March,2019,Manatee,FL,Passenger,1,0,1,32,33,3.03
11188,March,2019,Virginia Beach,VA,Passenger,1,1,2,698,700,0.29
11189,March,2019,Tarrant,TX,Passenger,2,0,2,201,203,0.99
11190,March,2019,Whitman,WA,Truck,0,0,0,8502,8502,0.0
11191,March,2019,Montgomery,TX,Passenger,2,0,2,61,63,3.17
11192,March,2019,Adams,WA,Truck,0,0,0,5105,5105,0.0
11193,March,2019,Manassas,VA,Passenger,0,1,1,9,10,10.0
11194,March,2019,Whatcom,WA,Passenger,792,386,1178,149745,150923,0.78
11195,March,2019,Norfolk,MA,Passenger,1,0,1,36,37,2.7
11196,March,2019,Monroe,IL,Passenger,1,0,1,4,5,20.0
11197,March,2019,Charles,MD,Passenger,0,1,1,78,79,1.27
11198,March,2019,Carroll,NH,Passenger,0,1,1,2,3,33.33
11199,March,2019,Sumter,FL,Passenger,0,1,1,10,11,9.09
11200,March,2019,Rogers,OK,Passenger,1,0,1,4,5,20.0
11201,March,2019,Lincoln,WA,Passenger,3,6,9,7733,7742,0.12
11202,March,2019,Washoe,NV,Passenger,2,0,2,107,109,1.83
11203,March,2019,Lee,AL,Passenger,1,0,1,35,36,2.78
11204,March,2019,Franklin,WA,Passenger,52,68,120,59371,59491,0.2
11205,March,2019,Benton,WA,Passenger,236,251,487,132992,133479,0.36
11206,March,2019,Kittitas,WA,Passenger,71,37,108,29440,29548,0.37
11207,March,2019,Pierce,WA,Passenger,1635,1457,3092,539431,542523,0.57
11208,March,2019,Hawaii,HI,Passenger,1,0,1,61,62,1.61
11209,March,2019,Harris,TX,Passenger,0,1,1,251,252,0.4
11210,March,2019,Spokane,WA,Passenger,491,393,884,307777,308661,0.29
11211,March,2019,Cape May,NJ,Passenger,0,1,1,19,20,5.0
11212,March,2019,Asotin,WA,Passenger,12,9,21,12660,12681,0.17
11213,March,2019,Multnomah,OR,Passenger,4,5,9,747,756,1.19
11214,March,2019,Clallam,WA,Passenger,154,129,283,50317,50600,0.56
11215,March,2019,District of Columbia,DC,Passenger,1,1,2,204,206,0.97
11216,March,2019,Dale,AL,Passenger,0,1,1,56,57,1.75
11217,March,2019,Brevard,FL,Passenger,0,1,1,87,88,1.14
11218,March,2019,Okanogan,WA,Truck,0,0,0,16439,16439,0.0
11219,March,2019,San Mateo,CA,Passenger,2,1,3,126,129,2.33
11220,March,2019,Frederick,MD,Passenger,1,1,2,81,83,2.41
11221,March,2019,Prince William,VA,Passenger,0,4,4,257,261,1.53
11222,March,2019,Polk,FL,Passenger,1,0,1,65,66,1.52
11223,March,2019,Kitsap,WA,Passenger,997,569,1566,179919,181485,0.86
11224,March,2019,Grant,WA,Passenger,34,55,89,64210,64299,0.14
11225,March,2019,Douglas,WA,Passenger,53,34,87,27889,27976,0.31
11226,March,2019,Bucks,PA,Passenger,1,0,1,17,18,5.56
11227,March,2019,Norfolk,VA,Passenger,2,2,4,350,354,1.13
11228,March,2019,Ramsey,MN,Passenger,1,0,1,42,43,2.33
11229,March,2019,Mason,WA,Truck,0,0,0,20274,20274,0.0
11230,March,2019,Clackamas,OR,Passenger,1,1,2,205,207,0.97
11231,March,2019,Santa Rosa,FL,Passenger,1,0,1,87,88,1.14
11232,March,2019,Yakima,WA,Truck,0,0,0,58746,58746,0.0
11233,March,2019,Williamson,TX,Passenger,0,1,1,146,147,0.68
11234,March,2019,Pacific,WA,Truck,0,0,0,7655,7655,0.0
11235,March,2019,Hardin,KY,Passenger,0,1,1,103,104,0.96
11236,March,2019,Grays Harbor,WA,Truck,0,0,0,20376,20376,0.0
11237,March,2019,Broward,FL,Passenger,2,1,3,126,129,2.33
11238,March,2019,Dakota,MN,Passenger,0,2,2,35,37,5.41
11239,March,2019,Penobscot,ME,Passenger,0,1,1,13,14,7.14
11240,March,2019,Santa Fe,NM,Passenger,0,1,1,39,40,2.5
11241,March,2019,Cowlitz,WA,Passenger,84,101,185,72544,72729,0.25
11242,March,2019,Skamania,WA,Passenger,21,15,36,8722,8758,0.41
11243,March,2019,Moore,NC,Passenger,0,1,1,178,179,0.56
11244,March,2019,Contra Costa,CA,Passenger,1,2,3,394,397,0.76
11245,March,2019,Valencia,NM,Passenger,1,0,1,9,10,10.0
11246,March,2019,Houston,GA,Passenger,1,0,1,55,56,1.79
11247,March,2019,San Juan,WA,Passenger,197,70,267,14290,14557,1.83
11248,March,2019,Alexandria,VA,Passenger,1,0,1,156,157,0.64
11249,March,2019,Carson City,NV,Passenger,1,0,1,14,15,6.67
11250,March,2019,Jefferson,CO,Passenger,0,2,2,58,60,3.33
11251,March,2019,Duval,FL,Passenger,1,2,3,382,385,0.78
11252,March,2019,Garfield,WA,Truck,0,0,0,954,954,0.0
11253,March,2019,Whitman,WA,Passenger,27,41,68,22715,22783,0.3
11254,March,2019,Jefferson,NY,Passenger,0,2,2,223,225,0.89
11255,March,2019,Nantucket,MA,Passenger,1,0,1,4,5,20.0
11256,March,2019,Berkshire,MA,Passenger,0,1,1,4,5,20.0
11257,March,2019,Maui,HI,Passenger,1,0,1,49,50,2.0
11258,March,2019,Franklin,MA,Passenger,0,1,1,1,2,50.0
11259,March,2019,Deschutes,OR,Passenger,2,0,2,157,159,1.26
11260,March,2019,Pierce,WA,Truck,0,0,0,139004,139004,0.0
11261,March,2019,Harnett,NC,Passenger,1,0,1,216,217,0.46
11262,March,2019,Adams,WA,Passenger,4,6,10,12632,12642,0.08
11263,March,2019,Grant,WA,Truck,0,0,0,26337,26337,0.0
11264,March,2019,Pend Oreille,WA,Passenger,5,5,10,9474,9484,0.11
11265,March,2019,Lewis,WA,Passenger,95,90,185,58524,58709,0.32
11266,March,2019,Saratoga,NY,Passenger,1,0,1,58,59,1.69
11267,March,2019,Albemarle,VA,Passenger,1,0,1,23,24,4.17
11268,March,2019,Ferry,WA,Truck,0,0,0,3594,3594,0.0
11269,March,2019,Franklin,WA,Truck,0,0,0,19136,19136,0.0
11270,March,2019,Mason,WA,Passenger,114,117,231,46714,46945,0.49
11271,March,2019,Washington,OR,Passenger,0,1,1,463,464,0.22
11272,March,2019,Cowlitz,WA,Truck,0,0,0,28781,28781,0.0
11273,March,2019,Ventura,CA,Passenger,0,2,2,311,313,0.64
11274,March,2019,Nueces,TX,Passenger,1,1,2,93,95,2.11
11275,March,2020,Travis,TX,Passenger,2,1,3,185,188,1.6
11276,March,2020,El Paso,CO,Passenger,2,0,2,728,730,0.27
11277,March,2020,Ada,ID,Passenger,0,1,1,286,287,0.35
11278,March,2020,New London,CT,Passenger,1,2,3,245,248,1.21
11279,March,2020,Douglas,WA,Truck,0,0,0,12333,12333,0.0
11280,March,2020,Bexar,TX,Passenger,2,5,7,620,627,1.12
11281,March,2020,Adams,WA,Passenger,7,7,14,12891,12905,0.11
11283,March,2020,Walla Walla,WA,Passenger,68,63,131,36237,36368,0.36
11284,March,2020,Erie,NY,Passenger,1,0,1,44,45,2.22
11285,March,2020,San Mateo,CA,Passenger,0,1,1,114,115,0.87
11286,March,2020,Walla Walla,WA,Truck,0,0,0,13647,13647,0.0
11287,March,2020,Sacramento,CA,Passenger,1,0,1,271,272,0.37
11288,March,2020,Larimer,CO,Passenger,1,0,1,55,56,1.79
11289,March,2020,Yakima,WA,Truck,0,0,0,59596,59596,0.0
11290,March,2020,Stevens,WA,Passenger,33,33,66,31263,31329,0.21
11291,March,2020,Clackamas,OR,Passenger,2,1,3,209,212,1.42
11292,March,2020,Santa Cruz,CA,Passenger,1,0,1,37,38,2.63
11293,March,2020,Oklahoma,OK,Passenger,0,1,1,129,130,0.77
11294,March,2020,Brevard,FL,Passenger,0,1,1,86,87,1.15
11295,March,2020,Suffolk,VA,Passenger,1,0,1,124,125,0.8
11296,March,2020,Cowlitz,WA,Truck,0,0,0,28852,28852,0.0
11297,March,2020,Sedgwick,KS,Passenger,1,1,2,93,95,2.11
11298,March,2020,Rockingham,NH,Passenger,1,0,1,27,28,3.57
11299,March,2020,San Juan,WA,Truck,0,0,0,5932,5932,0.0
11300,March,2020,Hudson,NJ,Passenger,1,0,1,39,40,2.5
11301,March,2020,Owyhee,ID,Passenger,1,0,1,3,4,25.0
11302,March,2020,Mason,WA,Truck,0,0,0,20576,20576,0.0
11303,March,2020,Clark,NV,Passenger,3,2,5,682,687,0.73
11304,March,2020,Riverside,CA,Passenger,3,1,4,639,643,0.62
11305,March,2020,Lewis,WA,Passenger,105,108,213,59209,59422,0.36
11306,March,2020,Vigo,IN,Passenger,1,0,1,5,6,16.67
11307,March,2020,Skagit,WA,Truck,1,0,1,32552,32553,0.0
11308,March,2020,Skagit,WA,Passenger,391,216,607,92155,92762,0.65
11309,March,2020,Boone,MO,Passenger,0,1,1,12,13,7.69
11310,March,2020,El Paso,TX,Passenger,3,0,3,440,443,0.68
11311,March,2020,Osceola,FL,Passenger,1,0,1,41,42,2.38
11312,March,2020,Virginia Beach,VA,Passenger,1,0,1,681,682,0.15
11313,March,2020,Fairfax,VA,Passenger,4,3,7,747,754,0.93
11314,March,2020,Pinal,AZ,Passenger,1,0,1,188,189,0.53
11315,March,2020,Thurston,WA,Truck,0,0,0,55680,55680,0.0
11316,March,2020,Multnomah,OR,Passenger,4,7,11,731,742,1.48
11317,March,2020,Prince George's,MD,Passenger,1,1,2,168,170,1.18
11318,March,2020,Whatcom,WA,Truck,3,0,3,43025,43028,0.01
11319,March,2020,Placer,CA,Passenger,2,0,2,92,94,2.13
11320,March,2020,Jones,GA,Passenger,1,0,1,1,2,50.0
11321,March,2020,Polk,FL,Passenger,1,0,1,68,69,1.45
11322,March,2020,Shasta,CA,Passenger,1,0,1,38,39,2.56
11323,March,2020,Harnett,NC,Passenger,1,1,2,205,207,0.97
11324,March,2020,Ferry,WA,Passenger,5,3,8,4365,4373,0.18
11325,March,2020,Palm Beach,FL,Passenger,0,2,2,80,82,2.44
11326,March,2020,Howard,MD,Passenger,0,1,1,70,71,1.41
11327,March,2020,Island,WA,Passenger,406,269,675,63248,63923,1.06
11328,March,2020,Jefferson,NY,Passenger,0,1,1,212,213,0.47
11329,March,2020,Washtenaw,MI,Passenger,1,0,1,36,37,2.7
11330,March,2020,Grant,WA,Passenger,58,71,129,65493,65622,0.2
11331,March,2020,Powhatan,VA,Passenger,1,0,1,0,1,100.0
11332,March,2020,Tulsa,OK,Passenger,1,1,2,45,47,4.26
11333,March,2020,Sarasota,FL,Passenger,2,0,2,26,28,7.14
11334,March,2020,Fresno,CA,Passenger,1,0,1,187,188,0.53
11335,March,2020,Denver,CO,Passenger,1,0,1,121,122,0.82
11336,March,2020,Lewis,WA,Truck,0,0,0,26030,26030,0.0
11337,March,2020,Shelby,OH,Passenger,0,1,1,1,2,50.0
11338,March,2020,Spokane,WA,Passenger,704,473,1177,317986,319163,0.37
11339,March,2020,Kitsap,WA,Passenger,1297,674,1971,181797,183768,1.07
11340,March,2020,Washoe,NV,Passenger,1,0,1,109,110,0.91
11341,March,2020,Bucks,PA,Passenger,1,0,1,20,21,4.76
11342,March,2020,Clallam,WA,Truck,1,0,1,21817,21818,0.0
11343,March,2020,Alexandria,VA,Passenger,1,0,1,142,143,0.7
11344,March,2020,Alameda,CA,Passenger,3,1,4,280,284,1.41
11345,March,2020,Arlington,VA,Passenger,0,2,2,155,157,1.27
11346,March,2020,Pierce,WA,Truck,0,0,0,141601,141601,0.0
11347,March,2020,Goochland,VA,Passenger,2,1,3,260,263,1.14
11348,March,2020,Washington,OR,Passenger,1,0,1,453,454,0.22
11349,March,2020,Wahkiakum,WA,Passenger,6,5,11,3006,3017,0.36
11350,March,2020,Santa Clara,CA,Passenger,7,2,9,324,333,2.7
11351,March,2020,Mason,WA,Passenger,153,135,288,47512,47800,0.6
11352,March,2020,Boulder,CO,Passenger,0,1,1,47,48,2.08
11353,March,2020,San Joaquin,CA,Passenger,1,0,1,132,133,0.75
11354,March,2020,Whatcom,WA,Passenger,1057,490,1547,151217,152764,1.01
11355,March,2020,Snohomish,WA,Passenger,4370,1757,6127,537415,543542,1.13
11356,March,2020,Cowlitz,WA,Passenger,134,114,248,73167,73415,0.34
11357,March,2020,St. Clair,IL,Passenger,1,0,1,140,141,0.71
11358,March,2020,Thurston,WA,Passenger,1131,728,1859,198621,200480,0.93
11359,March,2020,Montgomery,AL,Passenger,0,1,1,38,39,2.56
11360,March,2020,Prince William,VA,Passenger,2,3,5,228,233,2.15
11361,March,2020,Lincoln,WA,Truck,0,0,0,4659,4659,0.0
11362,March,2020,Williams,ND,Passenger,0,1,1,13,14,7.14
11363,March,2020,Guadalupe,TX,Passenger,1,0,1,65,66,1.52
11364,March,2020,Ulster,NY,Passenger,1,0,1,8,9,11.11
11365,March,2020,Calvert,MD,Passenger,0,2,2,90,92,2.17
11366,March,2020,Nassau,NY,Passenger,4,0,4,35,39,10.26
11367,March,2020,Broward,FL,Passenger,3,1,4,116,120,3.33
11368,March,2020,Lake,FL,Passenger,1,0,1,21,22,4.55
11369,March,2020,Saginaw,MI,Passenger,1,0,1,11,12,8.33
11370,March,2020,Orange,CA,Passenger,7,2,9,500,509,1.77
11371,March,2020,Camden,NJ,Passenger,0,2,2,20,22,9.09
11372,March,2020,Douglas,NE,Passenger,0,1,1,56,57,1.75
11373,March,2020,Columbia,WA,Truck,0,0,0,1533,1533,0.0
11374,March,2020,Jefferson,WA,Passenger,234,141,375,25071,25446,1.47
11375,March,2020,Fairbanks North Star,AK,Passenger,0,1,1,98,99,1.01
11376,March,2020,Charleston,SC,Passenger,1,0,1,107,108,0.93
11377,March,2020,Pend Oreille,WA,Passenger,8,7,15,9369,9384,0.16
11378,March,2020,Snohomish,WA,Truck,0,0,0,123723,123723,0.0
11379,March,2020,Rogers,OK,Passenger,1,0,1,5,6,16.67
11380,March,2020,Chesapeake,VA,Passenger,0,2,2,427,429,0.47
11381,March,2020,Adams,WA,Truck,0,0,0,5219,5219,0.0
11382,March,2020,Contra Costa,CA,Passenger,3,2,5,327,332,1.51
11383,March,2020,King,WA,Passenger,23884,7720,31604,1397089,1428693,2.21
11384,March,2020,Clark,WA,Truck,0,0,0,82047,82047,0.0
11385,March,2020,Middlesex,MA,Passenger,1,1,2,102,104,1.92
11386,March,2020,Franklin,WA,Passenger,58,77,135,61018,61153,0.22
11387,March,2020,Franklin,WA,Truck,0,0,0,19901,19901,0.0
11388,March,2020,Dakota,MN,Passenger,0,1,1,32,33,3.03
11389,March,2020,Flathead,MT,Passenger,1,0,1,64,65,1.54
11390,March,2020,Randolph,NC,Passenger,1,0,1,7,8,12.5
11391,March,2020,Benton,WA,Truck,0,0,0,42519,42519,0.0
11392,March,2020,Suffolk,MA,Passenger,0,2,2,37,39,5.13
11393,March,2020,Moore,NC,Passenger,0,1,1,163,164,0.61
11394,March,2020,Juneau,AK,Passenger,0,2,2,31,33,6.06
11395,March,2020,Collin,TX,Passenger,1,1,2,126,128,1.56
11396,March,2020,Lee,FL,Passenger,1,0,1,51,52,1.92
11397,March,2020,Carroll,NH,Passenger,0,1,1,4,5,20.0
11398,March,2020,Klamath,OR,Passenger,1,0,1,36,37,2.7
11399,March,2020,Nueces,TX,Passenger,1,0,1,83,84,1.19
11400,March,2020,Garfield,WA,Truck,0,0,0,976,976,0.0
11401,March,2020,Solano,CA,Passenger,1,0,1,212,213,0.47
11402,March,2020,Loudoun,VA,Passenger,1,0,1,89,90,1.11
11403,March,2020,Norfolk,VA,Passenger,2,2,4,349,353,1.13
11404,March,2020,Carson City,NV,Passenger,1,0,1,11,12,8.33
11405,March,2020,Honolulu,HI,Passenger,4,2,6,465,471,1.27
11406,March,2020,Kootenai,ID,Passenger,1,1,2,228,230,0.87
11407,March,2020,Klickitat,WA,Truck,0,0,0,8273,8273,0.0
11408,March,2020,Clay,FL,Passenger,0,1,1,83,84,1.19
11409,March,2020,District of Columbia,DC,Passenger,1,1,2,206,208,0.96
11410,March,2020,Pima,AZ,Passenger,3,1,4,358,362,1.1
11411,March,2020,RÃ­o Grande,PR,Passenger,1,0,1,1,2,50.0
11412,March,2020,Sumter,FL,Passenger,0,1,1,9,10,10.0
11413,March,2020,Skamania,WA,Passenger,29,18,47,8716,8763,0.54
11414,March,2020,Deschutes,OR,Passenger,3,0,3,143,146,2.05
11415,March,2020,Shelby,TN,Passenger,0,1,1,89,90,1.11
11416,March,2020,Grays Harbor,WA,Passenger,107,109,216,48321,48537,0.45
11417,March,2020,Wilson,TX,Passenger,0,1,1,7,8,12.5
11418,March,2020,Kittitas,WA,Truck,0,0,0,14621,14621,0.0
11419,March,2020,Greene,MO,Passenger,0,1,1,31,32,3.12
11420,March,2020,Williamson,TX,Passenger,0,2,2,142,144,1.39
11421,March,2020,Montgomery,PA,Passenger,1,0,1,35,36,2.78
11422,March,2020,Gwinnett,GA,Passenger,1,0,1,74,75,1.33
11423,March,2020,Whitman,WA,Truck,0,0,0,8549,8549,0.0
11424,March,2020,Fulton,GA,Passenger,1,2,3,106,109,2.75
11425,March,2020,Penobscot,ME,Passenger,0,1,1,15,16,6.25
11426,March,2020,Queens,NY,Passenger,1,0,1,53,54,1.85
11427,March,2020,Houston,GA,Passenger,1,0,1,57,58,1.72
11428,March,2020,Putnam,TN,Passenger,0,1,1,3,4,25.0
11429,March,2020,Douglas,WA,Passenger,71,40,111,28174,28285,0.39
11430,March,2020,Benton,WA,Passenger,344,319,663,135166,135829,0.49
11431,March,2020,Asotin,WA,Passenger,16,12,28,12596,12624,0.22
11432,March,2020,Pacific,WA,Passenger,29,34,63,16025,16088,0.39
11433,March,2020,Hennepin,MN,Passenger,3,1,4,94,98,4.08
11434,March,2020,Montgomery,OH,Passenger,0,1,1,46,47,2.13
11435,March,2020,Jefferson,CO,Passenger,0,1,1,57,58,1.72
11436,March,2020,Kitsap,WA,Truck,1,0,1,54213,54214,0.0
11437,March,2020,Pierce,WA,Passenger,2310,1693,4003,551180,555183,0.72
11438,March,2020,Hamilton,IN,Passenger,1,0,1,40,41,2.44
11439,March,2020,Skamania,WA,Truck,0,0,0,4082,4082,0.0
11440,March,2020,Cumberland,NC,Passenger,0,2,2,481,483,0.41
11441,March,2020,Charles,MD,Passenger,0,1,1,74,75,1.33
11442,March,2020,Dallas,TX,Passenger,1,0,1,200,201,0.5
11443,March,2020,Hawaii,HI,Passenger,1,0,1,60,61,1.64
11444,March,2020,Pend Oreille,WA,Truck,0,0,0,5757,5757,0.0
11445,March,2020,San Juan,WA,Passenger,291,86,377,14281,14658,2.57
11446,March,2020,Island,WA,Truck,1,0,1,21265,21266,0.0
11447,March,2020,Okanogan,WA,Passenger,34,31,65,26068,26133,0.25
11448,March,2020,Frederick,MD,Passenger,1,1,2,79,81,2.47
11449,March,2020,Richland,SC,Passenger,0,1,1,155,156,0.64
11450,March,2020,Kent,MI,Passenger,0,1,1,23,24,4.17
11451,March,2020,San Francisco,CA,Passenger,2,1,3,99,102,2.94
11452,March,2020,Tarrant,TX,Passenger,1,0,1,179,180,0.56
11453,March,2020,Lincoln,WA,Passenger,2,12,14,7750,7764,0.18
11454,March,2020,Garfield,WA,Passenger,0,1,1,1350,1351,0.07
11455,March,2020,Cascade,MT,Passenger,0,1,1,55,56,1.79
11456,March,2020,Grant,WA,Truck,0,0,0,27056,27056,0.0
11457,March,2020,Maricopa,AZ,Passenger,7,6,13,1457,1470,0.88
11458,March,2020,Fort Bend,TX,Passenger,1,0,1,47,48,2.08
11459,March,2020,Montgomery,TX,Passenger,1,0,1,52,53,1.89
11460,March,2020,San Diego,CA,Passenger,12,5,17,2781,2798,0.61
11461,March,2020,Klickitat,WA,Passenger,51,41,92,15597,15689,0.59
11462,March,2020,Maui,HI,Passenger,1,0,1,34,35,2.86
11463,March,2020,Harris,TX,Passenger,1,0,1,236,237,0.42
11464,March,2020,Asotin,WA,Truck,0,0,0,6667,6667,0.0
11465,March,2020,Lake,IL,Passenger,1,0,1,166,167,0.6
11466,March,2020,Duval,FL,Passenger,0,2,2,363,365,0.55
11467,March,2020,Oldham,KY,Passenger,0,1,1,4,5,20.0
11468,March,2020,Anne Arundel,MD,Passenger,1,1,2,424,426,0.47
11469,March,2020,Chelan,WA,Truck,0,0,0,22551,22551,0.0
11470,March,2020,St. Mary's,MD,Passenger,1,0,1,215,216,0.46
11471,March,2020,Ferry,WA,Truck,0,0,0,3565,3565,0.0
11472,March,2020,Twin Falls,ID,Passenger,0,1,1,28,29,3.45
11473,March,2020,Tuolumne,CA,Passenger,0,1,1,10,11,9.09
11474,March,2020,Chelan,WA,Passenger,220,79,299,54482,54781,0.55
11475,March,2020,Columbia,WA,Passenger,3,3,6,2416,2422,0.25
11476,March,2020,Portsmouth,VA,Passenger,0,1,1,79,80,1.25
11477,March,2020,DeKalb,IN,Passenger,1,0,1,1,2,50.0
11478,March,2020,Stevens,WA,Truck,0,0,0,18700,18700,0.0
11479,March,2020,Pinellas,FL,Passenger,1,1,2,109,111,1.8
11480,March,2020,Stafford,VA,Passenger,1,1,2,91,93,2.15
11481,March,2020,Allegheny,PA,Passenger,1,0,1,74,75,1.33
11482,March,2020,Spokane,WA,Truck,1,0,1,97458,97459,0.0
11483,March,2020,Ramsey,MN,Passenger,1,0,1,40,41,2.44
11484,March,2020,Whitman,WA,Passenger,42,46,88,22485,22573,0.39
11485,March,2020,Spartanburg,SC,Passenger,0,1,1,47,48,2.08
11486,March,2020,St. Louis,MO,Passenger,1,0,1,100,101,0.99
11487,March,2020,Wahkiakum,WA,Truck,0,0,0,1760,1760,0.0
11488,March,2020,Pacific,WA,Truck,0,0,0,7711,7711,0.0
11489,March,2020,Albemarle,VA,Passenger,1,0,1,21,22,4.55
11490,March,2020,Kittitas,WA,Passenger,98,49,147,29998,30145,0.49
11491,March,2020,Kern,CA,Passenger,0,1,1,220,221,0.45
11492,March,2020,Okanogan,WA,Truck,0,0,0,16458,16458,0.0
11493,March,2020,Harrison,MS,Passenger,1,0,1,58,59,1.69
11494,March,2020,Ventura,CA,Passenger,0,3,3,293,296,1.01
11495,March,2020,Clallam,WA,Passenger,214,166,380,50661,51041,0.74
11496,March,2020,Valencia,NM,Passenger,1,0,1,5,6,16.67
11497,March,2020,Denton,TX,Passenger,1,0,1,92,93,1.08
11498,March,2020,Clark,WA,Passenger,1983,1061,3044,320288,323332,0.94
11499,March,2020,Cape May,NJ,Passenger,0,1,1,13,14,7.14
11500,March,2020,Yakima,WA,Passenger,124,116,240,165838,166078,0.14
11501,March,2020,Arapahoe,CO,Passenger,1,0,1,141,142,0.7
11502,March,2020,Monroe,IL,Passenger,1,0,1,4,5,20.0
11503,March,2020,Richmond,GA,Passenger,0,1,1,89,90,1.11
11504,March,2020,Cochise,AZ,Passenger,0,1,1,102,103,0.97
11505,March,2020,Grays Harbor,WA,Truck,0,0,0,20787,20787,0.0
11506,March,2020,DuPage,IL,Passenger,3,0,3,61,64,4.69
11507,March,2020,New Haven,CT,Passenger,0,2,2,41,43,4.65
11508,March,2020,DeKalb,GA,Passenger,1,0,1,81,82,1.22
11509,March,2020,Jefferson,WA,Truck,0,0,0,9594,9594,0.0
11510,March,2020,King,WA,Truck,5,1,6,182420,182426,0.0
11511,March,2020,Los Angeles,CA,Passenger,7,11,18,1027,1045,1.72
11512,March,2020,Manassas,VA,Passenger,0,1,1,5,6,16.67
11513,March,2021,Richmond,GA,Passenger,0,1,1,75,76,1.32
11514,March,2021,Sacramento,CA,Passenger,2,0,2,232,234,0.85
11515,March,2021,San Francisco,CA,Passenger,1,1,2,90,92,2.17
11516,March,2021,El Paso,CO,Passenger,3,0,3,681,684,0.44
11517,March,2021,Greene,MO,Passenger,0,1,1,31,32,3.12
11518,March,2021,Houston,GA,Passenger,1,0,1,49,50,2.0
11519,March,2021,Clallam,WA,Truck,1,0,1,21955,21956,0.0
11520,March,2021,Skagit,WA,Truck,1,0,1,32932,32933,0.0
11521,March,2021,Kent,MI,Passenger,0,1,1,26,27,3.7
11522,March,2021,Ray,MO,Passenger,0,1,1,1,2,50.0
11523,March,2021,District of Columbia,DC,Passenger,3,1,4,200,204,1.96
11524,March,2021,Williams,ND,Passenger,0,1,1,10,11,9.09
11525,March,2021,Carroll,MD,Passenger,0,1,1,19,20,5.0
11526,March,2021,Queens,NY,Passenger,2,0,2,49,51,3.92
11527,March,2021,Yakima,WA,Passenger,188,135,323,168230,168553,0.19
11528,March,2021,Pacific,WA,Passenger,39,40,79,15920,15999,0.49
11529,March,2021,Pacific,WA,Truck,0,0,0,7879,7879,0.0
11530,March,2021,Charleston,SC,Passenger,2,0,2,84,86,2.33
11531,March,2021,Anchorage,AK,Passenger,1,0,1,140,141,0.71
11532,March,2021,San Juan,WA,Passenger,394,123,517,14117,14634,3.53
11533,March,2021,Okaloosa,FL,Passenger,0,1,1,127,128,0.78
11534,March,2021,Tulsa,OK,Passenger,1,0,1,41,42,2.38
11535,March,2021,Sevier,AR,Passenger,0,1,1,0,1,100.0
11536,March,2021,Leavenworth,KS,Passenger,0,1,1,118,119,0.84
11537,March,2021,Moore,NC,Passenger,0,1,1,134,135,0.74
11538,March,2021,Whatcom,WA,Truck,4,0,4,43783,43787,0.01
11539,March,2021,Multnomah,OR,Passenger,3,5,8,660,668,1.2
11540,March,2021,Bartow,GA,Passenger,0,1,1,4,5,20.0
11541,March,2021,Yamhill,OR,Passenger,1,0,1,37,38,2.63
11542,March,2021,Fairfax,VA,Passenger,4,4,8,695,703,1.14
11543,March,2021,Jones,GA,Passenger,1,0,1,1,2,50.0
11544,March,2021,Alameda,CA,Passenger,3,0,3,251,254,1.18
11545,March,2021,Lewis,WA,Passenger,130,134,264,59293,59557,0.44
11546,March,2021,Sedgwick,KS,Passenger,1,1,2,86,88,2.27
11547,March,2021,Ferry,WA,Truck,0,0,0,3623,3623,0.0
11548,March,2021,Prince George's,MD,Passenger,2,1,3,140,143,2.1
11549,March,2021,Pennington,SD,Passenger,1,0,1,32,33,3.03
11550,March,2021,Thurston,WA,Passenger,1432,824,2256,197465,199721,1.13
11551,March,2021,Dakota,MN,Passenger,0,1,1,25,26,3.85
11552,March,2021,San Mateo,CA,Passenger,1,1,2,102,104,1.92
11553,March,2021,Goochland,VA,Passenger,4,3,7,237,244,2.87
11554,March,2021,Chelan,WA,Passenger,304,94,398,54537,54935,0.72
11555,March,2021,Kittitas,WA,Passenger,146,55,201,29891,30092,0.67
11556,March,2021,Kings,NY,Passenger,1,0,1,67,68,1.47
11557,March,2021,Polk,FL,Passenger,1,0,1,53,54,1.85
11558,March,2021,Klickitat,WA,Truck,0,0,0,8173,8173,0.0
11559,March,2021,Manassas,VA,Passenger,0,1,1,6,7,14.29
11560,March,2021,Shelby,OH,Passenger,0,1,1,1,2,50.0
11561,March,2021,Bucks,PA,Passenger,1,0,1,18,19,5.26
11562,March,2021,Middlesex,MA,Passenger,1,1,2,93,95,2.11
11563,March,2021,Island,WA,Truck,0,0,0,21460,21460,0.0
11564,March,2021,Douglas,NE,Passenger,1,1,2,49,51,3.92
11565,March,2021,Montgomery,TX,Passenger,1,1,2,43,45,4.44
11566,March,2021,Cape May,NJ,Passenger,0,1,1,8,9,11.11
11567,March,2021,Grant,WA,Truck,0,0,0,27760,27760,0.0
11568,March,2021,Kitsap,WA,Truck,0,0,0,54392,54392,0.0
11569,March,2021,Jefferson,WA,Truck,0,0,0,9591,9591,0.0
11570,March,2021,Santa Cruz,CA,Passenger,1,0,1,29,30,3.33
11571,March,2021,King,WA,Passenger,28522,8567,37089,1365152,1402241,2.64
11572,March,2021,Allegheny,PA,Passenger,1,1,2,65,67,2.99
11573,March,2021,Snohomish,WA,Passenger,5384,1931,7315,538886,546201,1.34
11574,March,2021,Philadelphia,PA,Passenger,1,0,1,55,56,1.79
11575,March,2021,Frederick,MD,Passenger,1,1,2,71,73,2.74
11576,March,2021,Bexar,TX,Passenger,4,5,9,546,555,1.62
11577,March,2021,Spartanburg,SC,Passenger,0,1,1,50,51,1.96
11578,March,2021,Walla Walla,WA,Truck,0,0,0,13966,13966,0.0
11579,March,2021,Skamania,WA,Truck,0,0,0,4027,4027,0.0
11580,March,2021,Lane,OR,Passenger,0,1,1,125,126,0.79
11581,March,2021,St. Mary's,MD,Passenger,1,0,1,213,214,0.47
11582,March,2021,Nassau,NY,Passenger,4,0,4,27,31,12.9
11583,March,2021,Honolulu,HI,Passenger,5,2,7,407,414,1.69
11584,March,2021,Washoe,NV,Passenger,1,0,1,96,97,1.03
11585,March,2021,Ferry,WA,Passenger,10,3,13,4349,4362,0.3
11586,March,2021,Grays Harbor,WA,Passenger,150,131,281,49026,49307,0.57
11587,March,2021,Riverside,CA,Passenger,5,1,6,574,580,1.03
11588,March,2021,DuPage,IL,Passenger,2,0,2,54,56,3.57
11589,March,2021,Kauai,HI,Passenger,1,0,1,15,16,6.25
11590,March,2021,Nueces,TX,Passenger,1,0,1,79,80,1.25
11591,March,2021,St. Clair,IL,Passenger,1,0,1,138,139,0.72
11592,March,2021,Walla Walla,WA,Passenger,107,72,179,36286,36465,0.49
11593,March,2021,Lee,FL,Passenger,1,0,1,38,39,2.56
11594,March,2021,San Diego,CA,Passenger,14,5,19,2637,2656,0.72
11595,March,2021,Mason,WA,Truck,0,0,0,21168,21168,0.0
11596,March,2021,Yakima,WA,Truck,0,0,0,61384,61384,0.0
11597,March,2021,Kittitas,WA,Truck,0,0,0,14757,14757,0.0
11598,March,2021,Prince William,VA,Passenger,1,1,2,212,214,0.93
11599,March,2021,Douglas,WA,Truck,0,0,0,12557,12557,0.0
11600,March,2021,Pima,AZ,Passenger,2,1,3,302,305,0.98
11601,March,2021,Kitsap,WA,Passenger,1675,800,2475,179749,182224,1.36
11602,March,2021,Adams,WA,Truck,0,0,0,5375,5375,0.0
11603,March,2021,Fulton,GA,Passenger,0,2,2,81,83,2.41
11604,March,2021,Maui,HI,Passenger,1,0,1,26,27,3.7
11605,March,2021,DeKalb,GA,Passenger,1,0,1,63,64,1.56
11606,March,2021,Cumberland,NC,Passenger,0,2,2,436,438,0.46
11607,March,2021,Monroe,IL,Passenger,1,0,1,3,4,25.0
11608,March,2021,Howard,MD,Passenger,0,1,1,63,64,1.56
11609,March,2021,Platte,MO,Passenger,1,0,1,19,20,5.0
11610,March,2021,Franklin,WA,Truck,0,0,0,20608,20608,0.0
11611,March,2021,Hawaii,HI,Passenger,1,0,1,48,49,2.04
11612,March,2021,Spokane,WA,Truck,0,0,0,101439,101439,0.0
11613,March,2021,Okanogan,WA,Truck,0,0,0,16672,16672,0.0
11614,March,2021,Garfield,WA,Truck,0,0,0,1012,1012,0.0
11615,March,2021,Maricopa,AZ,Passenger,5,4,9,1234,1243,0.72
11616,March,2021,Larimer,CO,Passenger,1,0,1,53,54,1.85
11617,March,2021,Orange,FL,Passenger,1,0,1,112,113,0.88
11618,March,2021,Salt Lake,UT,Passenger,0,1,1,171,172,0.58
11619,March,2021,Harrison,MS,Passenger,2,0,2,51,53,3.77
11620,March,2021,Snohomish,WA,Truck,1,0,1,125936,125937,0.0
11621,March,2021,Washington,OR,Passenger,1,0,1,394,395,0.25
11622,March,2021,El Dorado,CA,Passenger,1,0,1,30,31,3.23
11623,March,2021,Arlington,VA,Passenger,0,1,1,136,137,0.73
11624,March,2021,Orange,CA,Passenger,4,3,7,440,447,1.57
11625,March,2021,Wichita,TX,Passenger,1,0,1,40,41,2.44
11626,March,2021,Boone,MO,Passenger,0,1,1,10,11,9.09
11627,March,2021,Clark,WA,Truck,0,0,0,83850,83850,0.0
11628,March,2021,Lincoln,WA,Passenger,5,13,18,7691,7709,0.23
11629,March,2021,Cowlitz,WA,Truck,0,0,0,29052,29052,0.0
11630,March,2021,Douglas,CO,Passenger,0,1,1,77,78,1.28
11631,March,2021,Montgomery,OH,Passenger,0,1,1,55,56,1.79
11632,March,2021,Skagit,WA,Passenger,539,260,799,91602,92401,0.86
11633,March,2021,Clallam,WA,Passenger,299,199,498,50123,50621,0.98
11634,March,2021,Portsmouth,VA,Passenger,0,1,1,76,77,1.3
11635,March,2021,Hampshire,MA,Passenger,1,0,1,6,7,14.29
11636,March,2021,Clackamas,OR,Passenger,3,0,3,175,178,1.69
11637,March,2021,Clark,NV,Passenger,4,2,6,639,645,0.93
11638,March,2021,Island,WA,Passenger,556,299,855,63006,63861,1.34
11639,March,2021,St. Louis,MO,Passenger,1,0,1,91,92,1.09
11640,March,2021,Whitman,WA,Truck,0,0,0,8553,8553,0.0
11641,March,2021,Lewis,WA,Truck,0,0,0,26811,26811,0.0
11642,March,2021,Suffolk,VA,Passenger,1,0,1,124,125,0.8
11643,March,2021,Stafford,VA,Passenger,2,1,3,97,100,3.0
11644,March,2021,Fairbanks North Star,AK,Passenger,0,1,1,85,86,1.16
11645,March,2021,Carroll,NH,Passenger,0,1,1,5,6,16.67
11646,March,2021,Owyhee,ID,Passenger,1,0,1,3,4,25.0
11647,March,2021,Montgomery,MD,Passenger,1,0,1,228,229,0.44
11648,March,2021,Montgomery,PA,Passenger,1,0,1,24,25,4.0
11649,March,2021,Jefferson,WA,Passenger,302,174,476,24829,25305,1.88
11650,March,2021,Ramsey,MN,Passenger,1,0,1,32,33,3.03
11651,March,2021,Hamilton,IN,Passenger,2,0,2,35,37,5.41
11652,March,2021,Hudson,NJ,Passenger,1,0,1,41,42,2.38
11653,March,2021,Placer,CA,Passenger,2,0,2,79,81,2.47
11654,March,2021,Wahkiakum,WA,Truck,0,0,0,1788,1788,0.0
11655,March,2021,Nassau,FL,Passenger,1,0,1,32,33,3.03
11656,March,2021,Franklin,WA,Passenger,100,88,188,61668,61856,0.3
11657,March,2021,Boulder,CO,Passenger,0,1,1,46,47,2.13
11658,March,2021,Douglas,WA,Passenger,86,47,133,28378,28511,0.47
11659,March,2021,Morris,NJ,Passenger,1,0,1,16,17,5.88
11660,March,2021,San Joaquin,CA,Passenger,1,0,1,104,105,0.95
11661,March,2021,RÃ­o Grande,PR,Passenger,1,0,1,1,2,50.0
11662,March,2021,Pinellas,FL,Passenger,1,1,2,95,97,2.06
11663,March,2021,Putnam,TN,Passenger,0,1,1,0,1,100.0
11664,March,2021,Norfolk,VA,Passenger,2,3,5,327,332,1.51
11665,March,2021,Sumter,FL,Passenger,0,1,1,10,11,9.09
11666,March,2021,Denver,CO,Passenger,1,0,1,112,113,0.88
11667,March,2021,San Juan,WA,Truck,0,0,0,5885,5885,0.0
11668,March,2021,New Haven,CT,Passenger,0,2,2,32,34,5.88
11669,March,2021,Stevens,WA,Truck,0,0,0,18796,18796,0.0
11670,March,2021,King,WA,Truck,6,1,7,184559,184566,0.0
11671,March,2021,Duval,FL,Passenger,0,2,2,346,348,0.57
11672,March,2021,Sarasota,FL,Passenger,2,0,2,26,28,7.14
11673,March,2021,Contra Costa,CA,Passenger,3,4,7,273,280,2.5
11674,March,2021,Santa Clara,CA,Passenger,8,2,10,261,271,3.69
11675,March,2021,Whatcom,WA,Passenger,1298,576,1874,150446,152320,1.23
11676,March,2021,Flathead,MT,Passenger,1,0,1,45,46,2.17
11677,March,2021,Grant,WA,Passenger,93,87,180,66441,66621,0.27
11678,March,2021,Camden,NJ,Passenger,0,1,1,14,15,6.67
11679,March,2021,Fresno,CA,Passenger,1,0,1,167,168,0.6
11680,March,2021,Howard,IN,Passenger,0,1,1,3,4,25.0
11681,March,2021,Thurston,WA,Truck,0,0,0,56530,56530,0.0
11682,March,2021,Wahkiakum,WA,Passenger,9,7,16,3083,3099,0.52
11683,March,2021,Pierce,WA,Passenger,3126,1845,4971,556748,561719,0.88
11684,March,2021,Mason,WA,Passenger,185,137,322,47894,48216,0.67
11685,March,2021,Okanogan,WA,Passenger,57,35,92,26225,26317,0.35
11686,March,2021,Chesapeake,VA,Passenger,0,3,3,397,400,0.75
11687,March,2021,New York,NY,Passenger,1,0,1,49,50,2.0
11688,March,2021,Harnett,NC,Passenger,1,1,2,176,178,1.12
11689,March,2021,Pierce,WA,Truck,0,0,0,145348,145348,0.0
11690,March,2021,Fort Bend,TX,Passenger,1,0,1,39,40,2.5
11691,March,2021,Oldham,KY,Passenger,0,1,1,4,5,20.0
11692,March,2021,Spokane,WA,Passenger,952,584,1536,322674,324210,0.47
11693,March,2021,Clark,WA,Passenger,2578,1276,3854,320028,323882,1.19
11694,March,2021,Chelan,WA,Truck,0,0,0,22987,22987,0.0
11695,March,2021,Loudoun,VA,Passenger,1,0,1,72,73,1.37
11696,March,2021,Arapahoe,CO,Passenger,1,0,1,115,116,0.86
11697,March,2021,Miami-Dade,FL,Passenger,1,0,1,97,98,1.02
11698,March,2021,Vigo,IN,Passenger,1,0,1,5,6,16.67
11699,March,2021,Columbia,WA,Passenger,5,4,9,2466,2475,0.36
11700,March,2021,Los Angeles,CA,Passenger,10,10,20,910,930,2.15
11701,March,2021,Missoula,MT,Passenger,1,0,1,64,65,1.54
11702,March,2021,Saginaw,MI,Passenger,2,0,2,10,12,16.67
11703,March,2021,Utah,UT,Passenger,0,1,1,119,120,0.83
11704,March,2021,Rockingham,NH,Passenger,1,0,1,23,24,4.17
11705,March,2021,Benton,WA,Passenger,466,369,835,135501,136336,0.61
11706,March,2021,Harris,TX,Passenger,1,1,2,202,204,0.98
11707,March,2021,Monterey,CA,Passenger,0,1,1,147,148,0.68
11708,March,2021,Collin,TX,Passenger,1,1,2,114,116,1.72
11709,March,2021,Klamath,OR,Passenger,1,0,1,29,30,3.33
11710,March,2021,Powhatan,VA,Passenger,1,0,1,1,2,50.0
11711,March,2021,Pend Oreille,WA,Truck,0,0,0,5724,5724,0.0
11712,March,2021,Washington,MD,Passenger,1,0,1,12,13,7.69
11713,March,2021,Charles,MD,Passenger,1,1,2,70,72,2.78
11714,March,2021,Cowlitz,WA,Passenger,197,133,330,72161,72491,0.46
11715,March,2021,Alexandria,VA,Passenger,2,0,2,131,133,1.5
11716,March,2021,Penobscot,ME,Passenger,0,1,1,9,10,10.0
11717,March,2021,Randolph,NC,Passenger,1,0,1,7,8,12.5
11718,March,2021,Suffolk,MA,Passenger,0,2,2,33,35,5.71
11719,March,2021,Williamson,TX,Passenger,0,2,2,113,115,1.74
11720,March,2021,Travis,TX,Passenger,2,3,5,163,168,2.98
11721,March,2021,Skamania,WA,Passenger,38,25,63,8308,8371,0.75
11722,March,2021,Deschutes,OR,Passenger,1,0,1,119,120,0.83
11723,March,2021,Asotin,WA,Truck,0,0,0,6725,6725,0.0
11724,March,2021,Anne Arundel,MD,Passenger,4,1,5,395,400,1.25
11725,March,2021,Jefferson,NY,Passenger,0,1,1,211,212,0.47
11726,March,2021,Bradley,TN,Passenger,1,0,1,0,1,100.0
11727,March,2021,Solano,CA,Passenger,1,0,1,195,196,0.51
11728,March,2021,Juneau,AK,Passenger,0,1,1,26,27,3.7
11729,March,2021,Lincoln,WA,Truck,0,0,0,4733,4733,0.0
11730,March,2021,Columbia,WA,Truck,0,0,0,1549,1549,0.0
11731,March,2021,Ulster,NY,Passenger,1,0,1,7,8,12.5
11732,March,2021,Lake,FL,Passenger,1,0,1,21,22,4.55
11733,March,2021,Benton,WA,Truck,0,0,0,43534,43534,0.0
11734,March,2021,Gwinnett,GA,Passenger,1,0,1,66,67,1.49
11735,March,2021,Stevens,WA,Passenger,38,43,81,30317,30398,0.27
11736,March,2021,Pend Oreille,WA,Passenger,12,6,18,9281,9299,0.19
11737,March,2021,Hennepin,MN,Passenger,2,0,2,79,81,2.47
11738,March,2021,Kern,CA,Passenger,0,1,1,213,214,0.47
11739,March,2021,Rogers,OK,Passenger,1,0,1,4,5,20.0
11740,March,2021,Ventura,CA,Passenger,1,1,2,265,267,0.75
11741,March,2021,Milwaukee,WI,Passenger,1,0,1,38,39,2.56
11742,March,2021,Twin Falls,ID,Passenger,0,1,1,21,22,4.55
11743,March,2021,Dallas,TX,Passenger,1,0,1,163,164,0.61
11744,March,2021,Carson City,NV,Passenger,1,0,1,12,13,7.69
11745,March,2021,Wilson,TX,Passenger,0,1,1,4,5,20.0
11746,March,2021,Whitman,WA,Passenger,54,44,98,21932,22030,0.44
11747,March,2021,Garfield,WA,Passenger,0,2,2,1365,1367,0.15
11748,March,2021,Richland,SC,Passenger,0,1,1,137,138,0.72
11749,March,2021,Adams,WA,Passenger,10,7,17,12997,13014,0.13
11750,March,2021,Broward,FL,Passenger,1,0,1,109,110,0.91
11751,March,2021,El Paso,TX,Passenger,3,0,3,382,385,0.78
11752,March,2021,Erie,NY,Passenger,1,0,1,41,42,2.38
11753,March,2021,Klickitat,WA,Passenger,65,46,111,15028,15139,0.73
11754,March,2021,Asotin,WA,Passenger,17,14,31,12569,12600,0.25
11755,March,2021,Lake,IL,Passenger,2,0,2,151,153,1.31
11756,March,2021,Virginia Beach,VA,Passenger,3,0,3,625,628,0.48
11757,March,2021,Grays Harbor,WA,Truck,0,0,0,21269,21269,0.0
11758,March,2021,Calvert,MD,Passenger,0,2,2,85,87,2.3
11759,March,2021,Plaquemines,LA,Passenger,0,1,1,15,16,6.25
11760,March,2021,Albemarle,VA,Passenger,1,0,1,21,22,4.55
11761,March,2021,New London,CT,Passenger,1,2,3,223,226,1.33
11763,March,2022,Wood,OH,Passenger,0,1,1,4,5,20.0
11764,March,2022,Whatcom,WA,Truck,4,0,4,43546,43550,0.01
11765,March,2022,Powhatan,VA,Passenger,1,0,1,1,2,50.0
11766,March,2022,Cowlitz,WA,Passenger,293,172,465,71084,71549,0.65
11767,March,2022,Wake,NC,Passenger,1,0,1,93,94,1.06
11768,March,2022,Tarrant,TX,Passenger,1,0,1,122,123,0.81
11769,March,2022,Collin,TX,Passenger,2,0,2,95,97,2.06
11770,March,2022,Platte,MO,Passenger,1,0,1,18,19,5.26
11771,March,2022,Nassau,NY,Passenger,2,0,2,24,26,7.69
11772,March,2022,Okanogan,WA,Passenger,77,46,123,26522,26645,0.46
11773,March,2022,Leavenworth,KS,Passenger,0,1,1,101,102,0.98
11774,March,2022,San Bernardino,CA,Passenger,1,1,2,337,339,0.59
11775,March,2022,Columbia,WA,Passenger,6,0,6,2448,2454,0.24
11776,March,2022,El Paso,CO,Passenger,3,1,4,617,621,0.64
11777,March,2022,Howard,IN,Passenger,0,1,1,6,7,14.29
11778,March,2022,El Paso,TX,Passenger,2,0,2,343,345,0.58
11779,March,2022,RÃ­o Grande,PR,Passenger,1,0,1,0,1,100.0
11780,March,2022,Skagit,WA,Passenger,731,326,1057,90496,91553,1.15
11781,March,2022,Sedgwick,KS,Passenger,1,1,2,81,83,2.41
11782,March,2022,Kings,NY,Passenger,1,0,1,63,64,1.56
11783,March,2022,Sarpy,NE,Passenger,1,0,1,52,53,1.89
11784,March,2022,Kern,CA,Passenger,0,1,1,190,191,0.52
11785,March,2022,Alexandria,VA,Passenger,3,0,3,107,110,2.73
11786,March,2022,Maricopa,AZ,Passenger,7,2,9,960,969,0.93
11787,March,2022,Kittitas,WA,Passenger,225,74,299,29794,30093,0.99
11788,March,2022,Hillsborough,FL,Passenger,0,2,2,122,124,1.61
11789,March,2022,San Mateo,CA,Passenger,2,0,2,76,78,2.56
11790,March,2022,Hennepin,MN,Passenger,3,0,3,61,64,4.69
11791,March,2022,Pennington,SD,Passenger,2,0,2,28,30,6.67
11792,March,2022,Orange,CA,Passenger,4,2,6,362,368,1.63
11793,March,2022,Richmond,GA,Passenger,0,1,1,69,70,1.43
11794,March,2022,Burlington,NJ,Passenger,0,1,1,110,111,0.9
11795,March,2022,Pend Oreille,WA,Truck,0,0,0,5689,5689,0.0
11796,March,2022,Frederick,MD,Passenger,1,1,2,67,69,2.9
11797,March,2022,Solano,CA,Passenger,1,0,1,167,168,0.6
11798,March,2022,Albemarle,VA,Passenger,1,0,1,17,18,5.56
11799,March,2022,Ventura,CA,Passenger,2,1,3,234,237,1.27
11800,March,2022,Larimer,CO,Passenger,1,0,1,50,51,1.96
11801,March,2022,Jefferson,WA,Passenger,408,207,615,24697,25312,2.43
11802,March,2022,Fresno,CA,Passenger,1,0,1,146,147,0.68
11803,March,2022,Williamson,TX,Passenger,1,2,3,84,87,3.45
11804,March,2022,Walla Walla,WA,Truck,0,0,0,14031,14031,0.0
11805,March,2022,Montgomery,MD,Passenger,3,2,5,193,198,2.53
11806,March,2022,Norfolk,VA,Passenger,3,3,6,298,304,1.97
11807,March,2022,Cowlitz,WA,Truck,0,1,1,28868,28869,0.0
11808,March,2022,Ferry,WA,Truck,0,0,0,3571,3571,0.0
11809,March,2022,San Diego,CA,Passenger,14,8,22,2332,2354,0.93
11810,March,2022,Jefferson,NY,Passenger,0,1,1,203,204,0.49
11811,March,2022,Wilson,NC,Passenger,1,0,1,0,1,100.0
11812,March,2022,Charleston,SC,Passenger,2,1,3,63,66,4.55
11813,March,2022,Goochland,VA,Passenger,3,2,5,151,156,3.21
11814,March,2022,Adams,WA,Truck,0,0,0,5488,5488,0.0
11815,March,2022,Thurston,WA,Truck,3,0,3,55747,55750,0.01
11816,March,2022,Clark,WA,Passenger,3744,1656,5400,318350,323750,1.67
11817,March,2022,Bartow,GA,Passenger,0,1,1,3,4,25.0
11818,March,2022,Harris,TX,Passenger,1,0,1,145,146,0.68
11819,March,2022,Oldham,KY,Passenger,0,1,1,4,5,20.0
11820,March,2022,Lake,IL,Passenger,3,0,3,143,146,2.05
11821,March,2022,Juneau,AK,Passenger,0,1,1,30,31,3.23
11822,March,2022,Mason,WA,Passenger,286,171,457,47633,48090,0.95
11823,March,2022,Montgomery,PA,Passenger,2,0,2,22,24,8.33
11824,March,2022,Douglas,WA,Truck,0,0,0,12726,12726,0.0
11825,March,2022,DeKalb,GA,Passenger,1,0,1,49,50,2.0
11826,March,2022,Rockingham,NH,Passenger,1,0,1,17,18,5.56
11827,March,2022,Queens,NY,Passenger,1,0,1,45,46,2.17
11828,March,2022,Whitman,WA,Passenger,79,54,133,22044,22177,0.6
11829,March,2022,Richmond,NY,Passenger,1,0,1,6,7,14.29
11830,March,2022,Prince William,VA,Passenger,0,1,1,196,197,0.51
11831,March,2022,Pierce,WA,Passenger,4629,2234,6863,550172,557035,1.23
11832,March,2022,Travis,TX,Passenger,1,0,1,113,114,0.88
11833,March,2022,Clallam,WA,Truck,1,0,1,22058,22059,0.0
11834,March,2022,Fairfax,VA,Passenger,3,3,6,614,620,0.97
11835,March,2022,Baltimore,MD,Passenger,1,0,1,76,77,1.3
11836,March,2022,Wilson,TX,Passenger,0,1,1,2,3,33.33
11837,March,2022,Carroll,MD,Passenger,0,1,1,15,16,6.25
11838,March,2022,Boulder,CO,Passenger,1,0,1,35,36,2.78
11839,March,2022,Danville,VA,Passenger,1,0,1,0,1,100.0
11840,March,2022,Boone,MO,Passenger,0,1,1,9,10,10.0
11841,March,2022,Arlington,VA,Passenger,1,0,1,128,129,0.78
11842,March,2022,Riverside,CA,Passenger,7,1,8,467,475,1.68
11843,March,2022,Asotin,WA,Truck,0,0,0,6757,6757,0.0
11844,March,2022,St. Mary's,MD,Passenger,1,0,1,198,199,0.5
11845,March,2022,Stafford,VA,Passenger,2,1,3,88,91,3.3
11846,March,2022,Hamilton,OH,Passenger,1,0,1,30,31,3.23
11847,March,2022,Houston,GA,Passenger,1,0,1,38,39,2.56
11848,March,2022,Benton,WA,Truck,1,0,1,43613,43614,0.0
11849,March,2022,Allegheny,PA,Passenger,1,1,2,53,55,3.64
11850,March,2022,Benton,WA,Passenger,698,444,1142,135765,136907,0.83
11851,March,2022,Williams,ND,Passenger,0,1,1,7,8,12.5
11852,March,2022,Bell,TX,Passenger,1,0,1,328,329,0.3
11853,March,2022,Chesapeake,VA,Passenger,2,3,5,352,357,1.4
11854,March,2022,Gwinnett,GA,Passenger,1,0,1,54,55,1.82
11855,March,2022,Essex,NJ,Passenger,2,0,2,9,11,18.18
11856,March,2022,Lake,FL,Passenger,1,0,1,21,22,4.55
11857,March,2022,Harnett,NC,Passenger,2,0,2,139,141,1.42
11858,March,2022,Walla Walla,WA,Passenger,157,91,248,36119,36367,0.68
11859,March,2022,Jefferson,WA,Truck,0,0,0,9544,9544,0.0
11860,March,2022,Orange,FL,Passenger,1,0,1,94,95,1.05
11861,March,2022,Fairbanks North Star,AK,Passenger,0,1,1,76,77,1.3
11862,March,2022,Grays Harbor,WA,Truck,0,0,0,21365,21365,0.0
11863,March,2022,Loudoun,VA,Passenger,1,1,2,66,68,2.94
11864,March,2022,Yellowstone,MT,Passenger,0,1,1,28,29,3.45
11865,March,2022,Skamania,WA,Truck,0,0,0,3973,3973,0.0
11866,March,2022,Dallas,TX,Passenger,1,0,1,117,118,0.85
11867,March,2022,Greene,MO,Passenger,0,1,1,23,24,4.17
11868,March,2022,Los Angeles,CA,Passenger,8,7,15,793,808,1.86
11869,March,2022,Onslow,NC,Passenger,0,1,1,164,165,0.61
11870,March,2022,Carroll,NH,Passenger,0,1,1,5,6,16.67
11871,March,2022,Denton,TX,Passenger,1,0,1,68,69,1.45
11872,March,2022,Cape May,NJ,Passenger,0,1,1,8,9,11.11
11873,March,2022,Garfield,WA,Passenger,0,3,3,1332,1335,0.22
11874,March,2022,Elmore,ID,Passenger,1,0,1,14,15,6.67
11875,March,2022,Duval,FL,Passenger,0,2,2,286,288,0.69
11876,March,2022,San Juan,WA,Passenger,492,152,644,14129,14773,4.36
11877,March,2022,Multnomah,OR,Passenger,1,4,5,564,569,0.88
11878,March,2022,Randolph,NC,Passenger,1,0,1,4,5,20.0
11879,March,2022,Rock Island,IL,Passenger,0,1,1,15,16,6.25
11880,March,2022,Suffolk,VA,Passenger,1,0,1,119,120,0.83
11881,March,2022,Owyhee,ID,Passenger,1,0,1,2,3,33.33
11882,March,2022,Kittitas,WA,Truck,0,0,0,14720,14720,0.0
11883,March,2022,Cumberland,NC,Passenger,1,2,3,372,375,0.8
11884,March,2022,Camden,NJ,Passenger,0,1,1,13,14,7.14
11885,March,2022,Pima,AZ,Passenger,1,1,2,235,237,0.84
11886,March,2022,Lewis,WA,Passenger,226,164,390,59495,59885,0.65
11887,March,2022,Howard,MD,Passenger,0,1,1,57,58,1.72
11888,March,2022,Mason,WA,Truck,0,0,0,21168,21168,0.0
11889,March,2022,Montgomery,AL,Passenger,0,1,1,34,35,2.86
11890,March,2022,Sonoma,CA,Passenger,0,1,1,74,75,1.33
11891,March,2022,Miami-Dade,FL,Passenger,1,0,1,84,85,1.18
11892,March,2022,Kings,CA,Passenger,2,1,3,305,308,0.97
11893,March,2022,Shelby,OH,Passenger,0,1,1,2,3,33.33
11894,March,2022,Columbia,WA,Truck,0,0,0,1589,1589,0.0
11895,March,2022,Placer,CA,Passenger,2,0,2,69,71,2.82
11896,March,2022,Contra Costa,CA,Passenger,0,3,3,252,255,1.18
11897,March,2022,St. Tammany,LA,Passenger,1,0,1,35,36,2.78
11898,March,2022,New London,CT,Passenger,1,5,6,202,208,2.88
11899,March,2022,New York,NY,Passenger,1,0,1,35,36,2.78
11900,March,2022,Harrison,MS,Passenger,2,0,2,44,46,4.35
11901,March,2022,Stevens,WA,Truck,0,0,0,19002,19002,0.0
11902,March,2022,Broward,FL,Passenger,2,0,2,83,85,2.35
11903,March,2022,Washington,MD,Passenger,2,0,2,14,16,12.5
11904,March,2022,Richland,SC,Passenger,0,1,1,128,129,0.78
11905,March,2022,Allen,IN,Passenger,1,0,1,14,15,6.67
11906,March,2022,Alameda,CA,Passenger,4,0,4,196,200,2.0
11907,March,2022,Plaquemines,LA,Passenger,0,1,1,17,18,5.56
11908,March,2022,King,WA,Passenger,37937,10707,48644,1352308,1400952,3.47
11909,March,2022,Geary,KS,Passenger,1,0,1,88,89,1.12
11910,March,2022,Snohomish,WA,Passenger,7665,2362,10027,534917,544944,1.84
11911,March,2022,Lincoln,WA,Passenger,7,18,25,7668,7693,0.32
11912,March,2022,St. Louis,MO,Passenger,1,0,1,68,69,1.45
11913,March,2022,Island,WA,Passenger,758,360,1118,62387,63505,1.76
11914,March,2022,Ferry,WA,Passenger,17,3,20,4431,4451,0.45
11915,March,2022,Hawaii,HI,Passenger,1,0,1,37,38,2.63
11916,March,2022,Clallam,WA,Passenger,402,240,642,49973,50615,1.27
11917,March,2022,District of Columbia,DC,Passenger,4,0,4,184,188,2.13
11918,March,2022,Penobscot,ME,Passenger,0,1,1,6,7,14.29
11919,March,2022,Escambia,FL,Passenger,0,1,1,134,135,0.74
11920,March,2022,Prince George's,MD,Passenger,2,1,3,130,133,2.26
11921,March,2022,Rogers,OK,Passenger,1,0,1,2,3,33.33
11922,March,2022,Lane,OR,Passenger,0,1,1,102,103,0.97
11923,March,2022,Klickitat,WA,Truck,0,0,0,8311,8311,0.0
11924,March,2022,Middlesex,MA,Passenger,1,1,2,80,82,2.44
11925,March,2022,Carson City,NV,Passenger,1,0,1,7,8,12.5
11926,March,2022,Santa Cruz,CA,Passenger,1,0,1,24,25,4.0
11927,March,2022,Spartanburg,SC,Passenger,0,1,1,43,44,2.27
11928,March,2022,Skagit,WA,Truck,1,0,1,32552,32553,0.0
11929,March,2022,Montgomery,TX,Passenger,1,0,1,31,32,3.12
11930,March,2022,San Juan,WA,Truck,1,0,1,5995,5996,0.02
11931,March,2022,Lincoln,OR,Passenger,0,1,1,30,31,3.23
11932,March,2022,Chelan,WA,Passenger,437,122,559,54596,55155,1.01
11933,March,2022,Grays Harbor,WA,Passenger,205,157,362,49309,49671,0.73
11934,March,2022,Klickitat,WA,Passenger,96,54,150,15336,15486,0.97
11935,March,2022,Manassas,VA,Passenger,0,1,1,7,8,12.5
11936,March,2022,Pend Oreille,WA,Passenger,16,10,26,9051,9077,0.29
11937,March,2022,Louisa,VA,Passenger,0,1,1,1,2,50.0
11938,March,2022,Marin,CA,Passenger,0,1,1,30,31,3.23
11939,March,2022,Sumter,SC,Passenger,0,1,1,32,33,3.03
11940,March,2022,Franklin,WA,Passenger,179,106,285,62085,62370,0.46
11941,March,2022,Douglas,WA,Passenger,125,56,181,28528,28709,0.63
11942,March,2022,Fort Bend,TX,Passenger,1,0,1,32,33,3.03
11943,March,2022,Kauai,HI,Passenger,1,0,1,18,19,5.26
11944,March,2022,Clark,WA,Truck,2,0,2,83493,83495,0.0
11945,March,2022,Rockdale,GA,Passenger,1,0,1,7,8,12.5
11946,March,2022,Clackamas,OR,Passenger,2,0,2,149,151,1.32
11947,March,2022,Island,WA,Truck,1,0,1,21479,21480,0.0
11948,March,2022,Salt Lake,UT,Passenger,1,1,2,141,143,1.4
11949,March,2022,Adams,WA,Passenger,16,11,27,12982,13009,0.21
11950,March,2022,Pacific,WA,Truck,0,0,0,8008,8008,0.0
11951,March,2022,Santa Clara,CA,Passenger,9,1,10,225,235,4.26
11952,March,2022,Bexar,TX,Passenger,4,4,8,461,469,1.71
11953,March,2022,Hidalgo,TX,Passenger,0,1,1,50,51,1.96
11954,March,2022,Snohomish,WA,Truck,4,0,4,124827,124831,0.0
11955,March,2022,Douglas,NE,Passenger,1,2,3,46,49,6.12
11956,March,2022,Sacramento,CA,Passenger,2,0,2,202,204,0.98
11957,March,2022,Okaloosa,FL,Passenger,0,1,1,102,103,0.97
11958,March,2022,Lee,FL,Passenger,1,0,1,28,29,3.45
11959,March,2022,Wahkiakum,WA,Passenger,18,11,29,3077,3106,0.93
11960,March,2022,Hamilton,IN,Passenger,1,0,1,21,22,4.55
11961,March,2022,Whatcom,WA,Passenger,1735,695,2430,149237,151667,1.6
11962,March,2022,New Haven,CT,Passenger,0,2,2,28,30,6.67
11963,March,2022,Virginia Beach,VA,Passenger,2,0,2,540,542,0.37
11964,March,2022,Garfield,WA,Truck,0,0,0,999,999,0.0
11965,March,2022,Sevier,AR,Passenger,0,1,1,0,1,100.0
11966,March,2022,Grant,WA,Truck,0,0,0,28046,28046,0.0
11967,March,2022,Pinellas,FL,Passenger,0,1,1,80,81,1.23
11968,March,2022,Nueces,TX,Passenger,1,1,2,58,60,3.33
11969,March,2022,Douglas,CO,Passenger,0,1,1,74,75,1.33
11970,March,2022,Dorchester,SC,Passenger,1,0,1,58,59,1.69
11971,March,2022,Franklin,WA,Truck,0,0,0,20940,20940,0.0
11972,March,2022,Suffolk,MA,Passenger,0,1,1,23,24,4.17
11973,March,2022,Philadelphia,PA,Passenger,1,0,1,35,36,2.78
11974,March,2022,Galveston,TX,Passenger,0,1,1,19,20,5.0
11975,March,2022,Yakima,WA,Passenger,312,181,493,167703,168196,0.29
11976,March,2022,Portsmouth,VA,Passenger,0,1,1,75,76,1.32
11977,March,2022,Spokane,WA,Truck,0,0,0,102463,102463,0.0
11978,March,2022,Moore,NC,Passenger,0,1,1,121,122,0.82
11979,March,2022,St. Clair,IL,Passenger,2,0,2,122,124,1.61
11980,March,2022,Adams,CO,Passenger,1,0,1,39,40,2.5
11981,March,2022,Ulster,NY,Passenger,1,0,1,9,10,10.0
11982,March,2022,DuPage,IL,Passenger,1,0,1,47,48,2.08
11983,March,2022,Pacific,WA,Passenger,61,68,129,15997,16126,0.8
11984,March,2022,Cook,IL,Passenger,3,0,3,190,193,1.55
11985,March,2022,San Luis Obispo,CA,Passenger,1,0,1,55,56,1.79
11986,March,2022,Yakima,WA,Truck,0,0,0,61589,61589,0.0
11987,March,2022,Asotin,WA,Passenger,22,18,40,12658,12698,0.32
11988,March,2022,Hudson,NJ,Passenger,2,0,2,34,36,5.56
11989,March,2022,Wichita,TX,Passenger,1,0,1,39,40,2.5
11990,March,2022,Kitsap,WA,Passenger,2274,1006,3280,179292,182572,1.8
11991,March,2022,Sarasota,FL,Passenger,2,0,2,25,27,7.41
11992,March,2022,Lewis,WA,Truck,0,0,0,26519,26519,0.0
11993,March,2022,Wahkiakum,WA,Truck,0,0,0,1814,1814,0.0
11994,March,2022,Skamania,WA,Passenger,65,45,110,8278,8388,1.31
11995,March,2022,Stevens,WA,Passenger,60,50,110,30089,30199,0.36
11996,March,2022,Thurston,WA,Passenger,2028,1000,3028,195451,198479,1.53
11997,March,2022,Saratoga,NY,Passenger,1,0,1,40,41,2.44
11998,March,2022,Whitman,WA,Truck,0,0,0,8588,8588,0.0
11999,March,2022,Coryell,TX,Passenger,1,0,1,101,102,0.98
12000,March,2022,Chelan,WA,Truck,0,0,0,23048,23048,0.0
12001,March,2022,Calvert,MD,Passenger,0,2,2,76,78,2.56
12002,March,2022,Anchorage,AK,Passenger,1,0,1,120,121,0.83
12003,March,2022,King,WA,Truck,25,1,26,182051,182077,0.01
12004,March,2022,Clark,NV,Passenger,4,2,6,532,538,1.12
12005,March,2022,Monterey,CA,Passenger,1,1,2,129,131,1.53
12007,March,2022,Flathead,MT,Passenger,1,0,1,31,32,3.12
12008,March,2022,Charles,MD,Passenger,0,1,1,59,60,1.67
12009,March,2022,San Joaquin,CA,Passenger,1,1,2,88,90,2.22
12010,March,2022,Honolulu,HI,Passenger,5,4,9,328,337,2.67
12011,March,2022,Spokane,WA,Passenger,1443,799,2242,325888,328130,0.68
12012,March,2022,Anne Arundel,MD,Passenger,4,3,7,353,360,1.94
12013,March,2022,Grant,WA,Passenger,151,100,251,66866,67117,0.37
12014,March,2022,Lincoln,WA,Truck,0,0,0,4834,4834,0.0
12015,March,2022,Ray,MO,Passenger,0,1,1,1,2,50.0
12016,March,2022,Okanogan,WA,Truck,0,0,0,16693,16693,0.0
12017,March,2022,Las Animas,CO,Passenger,1,0,1,1,2,50.0
12018,March,2022,Pierce,WA,Truck,2,0,2,143506,143508,0.0
12019,March,2022,Kitsap,WA,Truck,1,0,1,53996,53997,0.0
12020,March,2023,Beaufort,SC,Passenger,1,0,1,17,18,5.56
12021,March,2023,St. Tammany,LA,Passenger,1,0,1,30,31,3.23
12022,March,2023,El Paso,TX,Passenger,2,0,2,262,264,0.76
12023,March,2023,Benton,WA,Passenger,1041,531,1572,135436,137008,1.15
12024,March,2023,Frederick,MD,Passenger,1,0,1,53,54,1.85
12025,March,2023,Okanogan,WA,Passenger,114,58,172,26014,26186,0.66
12026,March,2023,Moore,NC,Passenger,0,1,1,101,102,0.98
12027,March,2023,Madison,IL,Passenger,1,0,1,16,17,5.88
12028,March,2023,Travis,TX,Passenger,1,0,1,76,77,1.3
12029,March,2023,Lee,AL,Passenger,1,0,1,11,12,8.33
12030,March,2023,Yavapai,AZ,Passenger,1,0,1,22,23,4.35
12031,March,2023,Riverside,CA,Passenger,6,0,6,375,381,1.57
12032,March,2023,Los Angeles,CA,Passenger,4,5,9,602,611,1.47
12033,March,2023,Norfolk,VA,Passenger,3,2,5,258,263,1.9
12034,March,2023,Escambia,FL,Passenger,0,1,1,107,108,0.93
12035,March,2023,Anne Arundel,MD,Passenger,4,4,8,288,296,2.7
12036,March,2023,Grant,WA,Truck,8,0,8,28019,28027,0.03
12037,March,2023,Lake,IL,Passenger,1,0,1,113,114,0.88
12038,March,2023,Kittitas,WA,Passenger,325,94,419,29410,29829,1.4
12039,March,2023,Plaquemines,LA,Passenger,1,1,2,14,16,12.5
12040,March,2023,Nueces,TX,Passenger,0,1,1,49,50,2.0
12041,March,2023,Sumter,SC,Passenger,0,1,1,33,34,2.94
12042,March,2023,Rock Island,IL,Passenger,0,1,1,14,15,6.67
12043,March,2023,Denton,TX,Passenger,1,0,1,43,44,2.27
12044,March,2023,Lewis,WA,Passenger,295,191,486,58567,59053,0.82
12045,March,2023,Klickitat,WA,Truck,6,0,6,8273,8279,0.07
12047,March,2023,Snohomish,WA,Truck,134,0,134,121787,121921,0.11
12048,March,2023,Columbia,WA,Passenger,8,1,9,2416,2425,0.37
12049,March,2023,Geary,KS,Passenger,1,0,1,70,71,1.41
12050,March,2023,Walla Walla,WA,Passenger,209,112,321,35444,35765,0.9
12051,March,2023,Grant,WA,Passenger,253,113,366,66819,67185,0.54
12052,March,2023,Arlington,VA,Passenger,1,0,1,102,103,0.97
12053,March,2023,New Haven,CT,Passenger,0,2,2,22,24,8.33
12054,March,2023,Cape May,NJ,Passenger,0,1,1,7,8,12.5
12055,March,2023,Boulder,CO,Passenger,1,0,1,25,26,3.85
12056,March,2023,Newport News,VA,Passenger,1,0,1,91,92,1.09
12057,March,2023,Ferry,WA,Truck,0,0,0,3563,3563,0.0
12058,March,2023,Harrison,MS,Passenger,1,0,1,30,31,3.23
12059,March,2023,Ventura,CA,Passenger,2,1,3,196,199,1.51
12060,March,2023,Loudoun,VA,Passenger,3,0,3,56,59,5.08
12061,March,2023,Dallas,TX,Passenger,1,0,1,74,75,1.33
12062,March,2023,Clallam,WA,Truck,17,0,17,21712,21729,0.08
12063,March,2023,Kern,CA,Passenger,1,1,2,178,180,1.11
12064,March,2023,Island,WA,Passenger,987,421,1408,61377,62785,2.24
12065,March,2023,Allen,IN,Passenger,1,0,1,10,11,9.09
12066,March,2023,Hudson,NJ,Passenger,1,0,1,18,19,5.26
12067,March,2023,Nassau,NY,Passenger,1,0,1,21,22,4.55
12068,March,2023,Sheridan,WY,Passenger,1,0,1,5,6,16.67
12069,March,2023,Goochland,VA,Passenger,0,1,1,48,49,2.04
12070,March,2023,Virginia Beach,VA,Passenger,2,0,2,432,434,0.46
12071,March,2023,Hamilton,OH,Truck,1,0,1,2,3,33.33
12072,March,2023,Hillsborough,FL,Passenger,0,1,1,102,103,0.97
12073,March,2023,Stevens,WA,Truck,2,0,2,18741,18743,0.01
12074,March,2023,El Paso,CO,Passenger,3,1,4,481,485,0.82
12075,March,2023,Cowlitz,WA,Truck,7,0,7,28202,28209,0.02
12076,March,2023,Bartow,GA,Passenger,0,1,1,3,4,25.0
12077,March,2023,King,WA,Truck,566,2,568,176388,176956,0.32
12078,March,2023,Sedgwick,KS,Passenger,1,1,2,56,58,3.45
12079,March,2023,Randolph,NC,Passenger,1,0,1,3,4,25.0
12080,March,2023,Chelan,WA,Truck,23,0,23,23105,23128,0.1
12081,March,2023,San Bernardino,CA,Passenger,2,1,3,260,263,1.14
12082,March,2023,Camden,NJ,Passenger,0,1,1,12,13,7.69
12083,March,2023,Adams,WA,Passenger,23,11,34,13010,13044,0.26
12084,March,2023,Lane,OR,Passenger,0,1,1,65,66,1.52
12085,March,2023,Sacramento,CA,Passenger,4,0,4,144,148,2.7
12086,March,2023,Richmond,GA,Passenger,0,1,1,55,56,1.79
12087,March,2023,Cowlitz,WA,Passenger,433,195,628,69990,70618,0.89
12088,March,2023,Columbia,WA,Truck,0,0,0,1572,1572,0.0
12089,March,2023,Bexar,TX,Passenger,3,3,6,350,356,1.69
12090,March,2023,San Diego,CA,Passenger,17,9,26,1922,1948,1.33
12091,March,2023,Wahkiakum,WA,Passenger,25,16,41,3059,3100,1.32
12092,March,2023,Multnomah,OR,Passenger,0,2,2,413,415,0.48
12093,March,2023,Harnett,NC,Passenger,3,0,3,122,125,2.4
12094,March,2023,Grays Harbor,WA,Truck,2,0,2,20979,20981,0.01
12095,March,2023,Franklin,WA,Truck,5,0,5,20848,20853,0.02
12096,March,2023,Douglas,WA,Passenger,181,59,240,28627,28867,0.83
12097,March,2023,Kittitas,WA,Truck,7,0,7,14530,14537,0.05
12098,March,2023,Skagit,WA,Truck,17,0,17,31985,32002,0.05
12099,March,2023,Kauai,HI,Passenger,1,1,2,13,15,13.33
12100,March,2023,Grays Harbor,WA,Passenger,278,179,457,48396,48853,0.94
12101,March,2023,Skagit,WA,Passenger,1026,382,1408,88921,90329,1.56
12102,March,2023,Kitsap,WA,Truck,58,0,58,52601,52659,0.11
12103,March,2023,Garfield,WA,Truck,0,0,0,977,977,0.0
12104,March,2023,Pierce,WA,Passenger,6832,2624,9456,533215,542671,1.74
12105,March,2023,Wichita,TX,Passenger,2,0,2,32,34,5.88
12106,March,2023,Cumberland,PA,Passenger,1,0,1,32,33,3.03
12107,March,2023,Yellowstone,MT,Passenger,0,1,1,15,16,6.25
12108,March,2023,Spokane,WA,Passenger,2099,1005,3104,322078,325182,0.95
12109,March,2023,Coryell,TX,Passenger,1,0,1,75,76,1.32
12110,March,2023,Adams,WA,Truck,2,0,2,5333,5335,0.04
12111,March,2023,Hennepin,MN,Passenger,1,0,1,30,31,3.23
12112,March,2023,Asotin,WA,Passenger,31,21,52,12420,12472,0.42
12113,March,2023,Howard,MD,Passenger,0,1,1,41,42,2.38
12114,March,2023,Whatcom,WA,Truck,48,0,48,42816,42864,0.11
12115,March,2023,Cook,IL,Passenger,2,0,2,145,147,1.36
12116,March,2023,Sarasota,FL,Passenger,1,0,1,15,16,6.25
12117,March,2023,Lincoln,WA,Truck,0,0,0,4848,4848,0.0
12118,March,2023,Clark,WA,Passenger,5285,2161,7446,313218,320664,2.32
12119,March,2023,Clark,NV,Passenger,3,2,5,388,393,1.27
12120,March,2023,Stafford,VA,Passenger,3,1,4,74,78,5.13
12121,March,2023,Placer,CA,Passenger,1,0,1,52,53,1.89
12122,March,2023,Pacific,WA,Passenger,74,84,158,15627,15785,1.0
12123,March,2023,Harris,TX,Passenger,1,0,1,112,113,0.88
12124,March,2023,Skamania,WA,Passenger,95,53,148,8092,8240,1.8
12125,March,2023,Ulster,NY,Passenger,1,0,1,4,5,20.0
12126,March,2023,Cumberland,NC,Passenger,1,2,3,293,296,1.01
12127,March,2023,Benton,OR,Passenger,1,0,1,34,35,2.86
12128,March,2023,Rockingham,NH,Passenger,1,0,1,10,11,9.09
12129,March,2023,Okanogan,WA,Truck,3,0,3,16460,16463,0.02
12130,March,2023,Charleston,SC,Passenger,2,2,4,52,56,7.14
12131,March,2023,Hidalgo,TX,Passenger,0,1,1,46,47,2.13
12132,March,2023,Mason,WA,Passenger,403,200,603,46356,46959,1.28
12133,March,2023,Pulaski,AR,Passenger,3,0,3,21,24,12.5
12134,March,2023,St. Louis,MO,Passenger,1,0,1,50,51,1.96
12135,March,2023,Platte,MO,Passenger,1,0,1,16,17,5.88
12136,March,2023,Marin,CA,Passenger,0,1,1,27,28,3.57
12137,March,2023,Prince George's,MD,Passenger,2,1,3,108,111,2.7
12138,March,2023,Orange,CA,Passenger,7,2,9,276,285,3.16
12139,March,2023,Miami-Dade,FL,Passenger,1,0,1,57,58,1.72
12140,March,2023,Jefferson,NY,Passenger,1,1,2,175,177,1.13
12141,March,2023,Leavenworth,KS,Passenger,0,1,1,89,90,1.11
12142,March,2023,Honolulu,HI,Passenger,2,3,5,251,256,1.95
12143,March,2023,Pacific,WA,Truck,3,0,3,7805,7808,0.04
12144,March,2023,San Juan,WA,Passenger,596,172,768,13839,14607,5.26
12145,March,2023,Ray,MO,Passenger,0,1,1,0,1,100.0
12146,March,2023,Burlington,NJ,Passenger,0,2,2,90,92,2.17
12147,March,2023,Fairbanks North Star,AK,Passenger,0,1,1,54,55,1.82
12148,March,2023,Collin,TX,Passenger,2,0,2,41,43,4.65
12149,March,2023,Polk,OR,Passenger,0,1,1,16,17,5.88
12150,March,2023,Okaloosa,FL,Passenger,0,1,1,88,89,1.12
12151,March,2023,Chelan,WA,Passenger,582,150,732,54135,54867,1.33
12152,March,2023,Garfield,WA,Passenger,1,3,4,1323,1327,0.3
12153,March,2023,Louisa,VA,Passenger,0,1,1,1,2,50.0
12154,March,2023,Santa Clara,CA,Passenger,8,2,10,151,161,6.21
12155,March,2023,Elmore,ID,Passenger,1,0,1,9,10,10.0
12156,March,2023,Lewis,WA,Truck,5,0,5,26061,26066,0.02
12157,March,2023,Champaign,IL,Passenger,1,0,1,8,9,11.11
12158,March,2023,Maricopa,AZ,Passenger,7,3,10,610,620,1.61
12159,March,2023,Alameda,CA,Passenger,3,0,3,152,155,1.94
12160,March,2023,Clark,WA,Truck,77,0,77,81356,81433,0.09
12161,March,2023,Island,WA,Truck,24,0,24,21070,21094,0.11
12162,March,2023,Saratoga,NY,Passenger,1,1,2,31,33,6.06
12163,March,2023,Hawaii,HI,Passenger,1,0,1,23,24,4.17
12164,March,2023,Salt Lake,UT,Passenger,0,1,1,92,93,1.08
12165,March,2023,Emmet,MI,Passenger,0,1,1,0,1,100.0
12166,March,2023,Sonoma,CA,Passenger,1,1,2,53,55,3.64
12167,March,2023,Yakima,WA,Truck,9,0,9,60996,61005,0.01
12168,March,2023,Berkeley,SC,Passenger,0,1,1,101,102,0.98
12169,March,2023,San Juan,WA,Truck,10,0,10,5884,5894,0.17
12170,March,2023,Thurston,WA,Passenger,2830,1176,4006,190713,194719,2.06
12171,March,2023,Ferry,WA,Passenger,19,4,23,4330,4353,0.53
12172,March,2023,Douglas,NE,Passenger,2,1,3,26,29,10.34
12173,March,2023,St. Clair,IL,Passenger,2,0,2,102,104,1.92
12174,March,2023,Adams,CO,Passenger,1,0,1,27,28,3.57
12175,March,2023,Pend Oreille,WA,Passenger,28,13,41,8917,8958,0.46
12176,March,2023,Houston,GA,Passenger,1,0,1,25,26,3.85
12177,March,2023,Montgomery,MD,Passenger,3,3,6,171,177,3.39
12178,March,2023,Skamania,WA,Truck,1,0,1,3842,3843,0.03
12179,March,2023,Stevens,WA,Passenger,103,60,163,29814,29977,0.54
12180,March,2023,Klickitat,WA,Passenger,133,59,192,15155,15347,1.25
12181,March,2023,Vernon,LA,Passenger,1,0,1,68,69,1.45
12182,March,2023,Sarpy,NE,Passenger,1,0,1,46,47,2.13
12183,March,2023,Kootenai,ID,Truck,1,0,1,27,28,3.57
12184,March,2023,Mason,WA,Truck,11,0,11,20792,20803,0.05
12185,March,2023,Whitman,WA,Passenger,131,72,203,21998,22201,0.91
12186,March,2023,Snohomish,WA,Passenger,11288,2890,14178,528298,542476,2.61
12187,March,2023,Broward,FL,Passenger,1,0,1,56,57,1.75
12188,March,2023,Yakima,WA,Passenger,458,238,696,165666,166362,0.42
12189,March,2023,DeKalb,GA,Passenger,1,0,1,38,39,2.56
12190,March,2023,Calvert,MD,Passenger,0,2,2,72,74,2.7
12191,March,2023,Santa Cruz,CA,Passenger,1,0,1,13,14,7.14
12192,March,2023,Middlesex,MA,Passenger,2,1,3,57,60,5.0
12193,March,2023,Napa,CA,Passenger,0,1,1,10,11,9.09
12194,March,2023,Benton,WA,Truck,16,0,16,43262,43278,0.04
12195,March,2023,Hoke,NC,Passenger,1,0,1,57,58,1.72
12196,March,2023,Jefferson,WA,Passenger,522,247,769,24231,25000,3.08
12197,March,2023,Jackson,OK,Passenger,0,1,1,30,31,3.23
12198,March,2023,Fairfax,VA,Passenger,5,3,8,533,541,1.48
12199,March,2023,Franklin,WA,Passenger,284,129,413,61766,62179,0.66
12200,March,2023,Contra Costa,CA,Passenger,0,3,3,196,199,1.51
12201,March,2023,New London,CT,Passenger,1,4,5,171,176,2.84
12202,March,2023,Clallam,WA,Passenger,507,275,782,49127,49909,1.57
12203,March,2023,Richmond,NY,Passenger,1,0,1,6,7,14.29
12204,March,2023,Arapahoe,CO,Passenger,1,1,2,66,68,2.94
12205,March,2023,Galveston,TX,Passenger,0,1,1,16,17,5.88
12206,March,2023,Washington,MD,Passenger,2,0,2,13,15,13.33
12207,March,2023,Thurston,WA,Truck,52,0,52,54221,54273,0.1
12208,March,2023,Larimer,CO,Passenger,1,0,1,37,38,2.63
12209,March,2023,District of Columbia,DC,Passenger,4,0,4,149,153,2.61
12210,March,2023,Kent,DE,Passenger,1,0,1,45,46,2.17
12211,March,2023,Wahkiakum,WA,Truck,2,0,2,1779,1781,0.11
12212,March,2023,Carroll,MD,Passenger,0,1,1,17,18,5.56
12213,March,2023,Rockdale,GA,Passenger,1,0,1,3,4,25.0
12214,March,2023,Las Animas,CO,Passenger,1,0,1,0,1,100.0
12215,March,2023,Asotin,WA,Truck,0,0,0,6642,6642,0.0
12216,March,2023,Santa Barbara,CA,Passenger,1,0,1,62,63,1.59
12217,March,2023,Onslow,NC,Passenger,0,1,1,138,139,0.72
12218,March,2023,Whatcom,WA,Passenger,2264,837,3101,147416,150517,2.06
12219,March,2023,Williamson,TX,Passenger,0,1,1,54,55,1.82
12220,March,2023,Wilson,TX,Passenger,0,1,1,2,3,33.33
12221,March,2023,Chesapeake,VA,Passenger,2,3,5,279,284,1.76
12222,March,2023,Lincoln,OR,Passenger,0,1,1,13,14,7.14
12223,March,2023,Portsmouth,VA,Passenger,0,1,1,62,63,1.59
12224,March,2023,Lincoln,WA,Passenger,18,16,34,7696,7730,0.44
12225,March,2023,Spokane,WA,Truck,30,0,30,101755,101785,0.03
12226,March,2023,Pierce,WA,Truck,126,0,126,137873,137999,0.09
12227,March,2023,Bell,TX,Passenger,1,0,1,248,249,0.4
12228,March,2023,Dorchester,SC,Passenger,1,0,1,40,41,2.44
12229,March,2023,Monterey,CA,Passenger,1,1,2,110,112,1.79
12230,March,2023,Alexandria,VA,Passenger,3,1,4,87,91,4.4
12231,March,2023,St. Mary's,MD,Passenger,1,0,1,166,167,0.6
12232,March,2023,Fairfax,VA,Truck,1,0,1,92,93,1.08
12233,March,2023,Kitsap,WA,Passenger,2952,1199,4151,176394,180545,2.3
12234,March,2023,Jefferson,WA,Truck,9,0,9,9314,9323,0.1
12235,March,2023,Oldham,KY,Passenger,0,1,1,4,5,20.0
12236,March,2023,Hamilton,OH,Passenger,1,0,1,24,25,4.0
12237,March,2023,Pend Oreille,WA,Truck,0,0,0,5572,5572,0.0
12238,March,2023,Charles,MD,Passenger,1,1,2,49,51,3.92
12239,March,2023,Montgomery,PA,Passenger,1,0,1,15,16,6.25
12240,March,2023,Duval,FL,Passenger,1,0,1,229,230,0.43
12241,March,2023,Suffolk,VA,Passenger,1,0,1,106,107,0.93
12242,March,2023,King,WA,Passenger,51947,13141,65088,1321285,1386373,4.69
12243,March,2023,Douglas,CO,Passenger,0,1,1,54,55,1.82
12244,March,2023,Essex,NJ,Passenger,2,0,2,5,7,28.57
12245,March,2023,Kings,CA,Passenger,2,1,3,268,271,1.11
12246,March,2023,Gwinnett,GA,Passenger,1,0,1,42,43,2.33
12247,March,2023,Whitman,WA,Truck,4,0,4,8597,8601,0.05
12248,March,2023,Solano,CA,Passenger,4,0,4,134,138,2.9
12249,March,2023,Walla Walla,WA,Truck,5,0,5,13756,13761,0.04
12250,March,2023,Douglas,WA,Truck,6,0,6,12871,12877,0.05
12251,May,2017,Thurston,WA,Passenger,390,334,724,186064,186788,0.39
12252,May,2017,Klickitat,WA,Passenger,22,24,46,14787,14833,0.31
12253,May,2017,Dallas,TX,Passenger,0,1,1,187,188,0.53
12254,May,2017,Skamania,WA,Truck,0,0,0,3863,3863,0.0
12255,May,2017,King,WA,Passenger,9796,3990,13786,1377129,1390915,0.99
12256,May,2017,Lane,OR,Passenger,0,1,1,244,245,0.41
12257,May,2017,Alameda,CA,Passenger,1,1,2,372,374,0.53
12258,May,2017,Walla Walla,WA,Truck,0,0,0,13189,13189,0.0
12259,May,2017,Franklin,MA,Passenger,0,1,1,4,5,20.0
12260,May,2017,Chelan,WA,Truck,0,0,0,21248,21248,0.0
12261,May,2017,Sumter,FL,Passenger,0,1,1,10,11,9.09
12262,May,2017,Garfield,WA,Passenger,0,0,0,1287,1287,0.0
12263,May,2017,Pacific,WA,Passenger,9,7,16,15138,15154,0.11
12264,May,2017,Pend Oreille,WA,Truck,0,0,0,5564,5564,0.0
12265,May,2017,Latah,ID,Passenger,0,1,1,110,111,0.9
12266,May,2017,Grays Harbor,WA,Truck,0,0,0,19898,19898,0.0
12267,May,2017,Grays Harbor,WA,Passenger,31,30,61,44516,44577,0.14
12268,May,2017,Montgomery,TN,Passenger,1,0,1,283,284,0.35
12269,May,2017,Northampton,PA,Passenger,1,0,1,168,169,0.59
12270,May,2017,Polk,FL,Passenger,1,0,1,66,67,1.49
12271,May,2017,Adams,WA,Truck,0,0,0,5079,5079,0.0
12272,May,2017,Snohomish,WA,Passenger,1739,867,2606,512625,515231,0.51
12273,May,2017,Bergen,NJ,Passenger,0,2,2,31,33,6.06
12274,May,2017,Kitsap,WA,Passenger,595,302,897,172845,173742,0.52
12275,May,2017,Pacific,WA,Truck,0,0,0,7463,7463,0.0
12276,May,2017,Dakota,MN,Passenger,0,1,1,40,41,2.44
12277,May,2017,Maricopa,AZ,Passenger,2,0,2,1783,1785,0.11
12278,May,2017,Wahkiakum,WA,Passenger,0,2,2,2837,2839,0.07
12279,May,2017,Canyon,ID,Passenger,0,1,1,102,103,0.97
12280,May,2017,Virginia Beach,VA,Passenger,2,1,3,655,658,0.46
12281,May,2017,Hardin,KY,Passenger,0,1,1,122,123,0.81
12282,May,2017,Essex,NJ,Passenger,1,0,1,15,16,6.25
12283,May,2017,Twin Falls,ID,Passenger,0,1,1,22,23,4.35
12284,May,2017,Montgomery,MD,Passenger,1,0,1,304,305,0.33
12285,May,2017,Wahkiakum,WA,Truck,0,0,0,1643,1643,0.0
12286,May,2017,Shelby,TN,Passenger,0,1,1,109,110,0.91
12287,May,2017,San Juan,WA,Truck,0,0,0,5541,5541,0.0
12288,May,2017,Lewis,WA,Passenger,49,33,82,55363,55445,0.15
12289,May,2017,Ramsey,MN,Passenger,1,0,1,42,43,2.33
12290,May,2017,Anne Arundel,MD,Passenger,0,1,1,503,504,0.2
12291,May,2017,Missoula,MT,Passenger,1,0,1,74,75,1.33
12292,May,2017,Prince George's,MD,Passenger,0,1,1,185,186,0.54
12293,May,2017,Thurston,WA,Truck,0,0,0,53243,53243,0.0
12294,May,2017,Franklin,WA,Passenger,28,44,72,55459,55531,0.13
12295,May,2017,Carroll,NH,Passenger,0,1,1,0,1,100.0
12296,May,2017,Albemarle,VA,Passenger,0,1,1,31,32,3.12
12297,May,2017,Clark,WA,Truck,0,0,0,77598,77598,0.0
12298,May,2017,Benton,WA,Passenger,146,142,288,128293,128581,0.22
12299,May,2017,DeKalb,IN,Passenger,1,0,1,1,2,50.0
12300,May,2017,Salt Lake,UT,Passenger,0,1,1,275,276,0.36
12301,May,2017,Juneau,AK,Passenger,0,1,1,49,50,2.0
12302,May,2017,Asotin,WA,Passenger,6,3,9,12376,12385,0.07
12303,May,2017,Cobb,GA,Passenger,0,1,1,77,78,1.28
12304,May,2017,Stevens,WA,Truck,0,0,0,18254,18254,0.0
12305,May,2017,Harnett,NC,Passenger,1,0,1,263,264,0.38
12306,May,2017,Ferry,WA,Truck,0,0,0,3544,3544,0.0
12307,May,2017,Charles,MD,Passenger,0,1,1,89,90,1.11
12308,May,2017,Skagit,WA,Passenger,134,102,236,87854,88090,0.27
12309,May,2017,Cascade,MT,Passenger,0,1,1,61,62,1.61
12310,May,2017,Stevens,WA,Passenger,8,23,31,31329,31360,0.1
12311,May,2017,Columbia,WA,Passenger,0,1,1,2359,2360,0.04
12312,May,2017,Norfolk,VA,Passenger,1,1,2,308,310,0.65
12313,May,2017,Gwinnett,GA,Passenger,0,1,1,86,87,1.15
12314,May,2017,Dane,WI,Passenger,1,0,1,121,122,0.82
12315,May,2017,Prince William,VA,Passenger,0,3,3,275,278,1.08
12316,May,2017,Yakima,WA,Passenger,42,55,97,159375,159472,0.06
12317,May,2017,Morris,NJ,Passenger,1,0,1,24,25,4.0
12318,May,2017,Lincoln,WA,Truck,0,0,0,4459,4459,0.0
12319,May,2017,New Haven,CT,Passenger,0,1,1,60,61,1.64
12320,May,2017,Okanogan,WA,Truck,0,0,0,16215,16215,0.0
12321,May,2017,Lee,AL,Passenger,1,0,1,36,37,2.7
12322,May,2017,Madison,ID,Passenger,1,0,1,41,42,2.38
12323,May,2017,Arlington,VA,Passenger,1,1,2,167,169,1.18
12324,May,2017,Pierce,WA,Truck,0,0,0,137682,137682,0.0
12325,May,2017,Benton,WA,Truck,0,0,0,39974,39974,0.0
12326,May,2017,Allegheny,PA,Passenger,1,0,1,93,94,1.06
12327,May,2017,San Diego,CA,Passenger,5,1,6,2743,2749,0.22
12328,May,2017,Santa Rosa,FL,Passenger,1,0,1,110,111,0.9
12329,May,2017,Multnomah,OR,Passenger,1,3,4,1032,1036,0.39
12330,May,2017,Yakima,WA,Truck,0,0,0,57281,57281,0.0
12331,May,2017,Douglas,WA,Truck,0,0,0,11484,11484,0.0
12332,May,2017,Richmond,GA,Passenger,0,1,1,93,94,1.06
12333,May,2017,Los Angeles,CA,Passenger,3,1,4,1325,1329,0.3
12334,May,2017,Nassau,NY,Passenger,0,1,1,39,40,2.5
12335,May,2017,Pend Oreille,WA,Passenger,2,4,6,9313,9319,0.06
12336,May,2017,Pierce,WA,Passenger,933,823,1756,525215,526971,0.33
12337,May,2017,Orange,FL,Passenger,1,1,2,144,146,1.37
12338,May,2017,Pinal,AZ,Passenger,2,0,2,253,255,0.78
12340,May,2017,Columbia,WA,Truck,0,0,0,1537,1537,0.0
12341,May,2017,Hamilton,TN,Passenger,1,0,1,22,23,4.35
12342,May,2017,Skamania,WA,Passenger,9,7,16,8532,8548,0.19
12343,May,2017,Mason,WA,Passenger,51,66,117,43298,43415,0.27
12344,May,2017,Franklin,OH,Passenger,0,1,1,123,124,0.81
12345,May,2017,Portsmouth,VA,Passenger,0,1,1,68,69,1.45
12346,May,2017,Kitsap,WA,Truck,1,0,1,52377,52378,0.0
12347,May,2017,Grant,WA,Truck,0,0,0,25222,25222,0.0
12348,May,2017,Klickitat,WA,Truck,0,0,0,7967,7967,0.0
12349,May,2017,Norfolk,MA,Passenger,1,0,1,39,40,2.5
12350,May,2017,Adams,WA,Passenger,2,3,5,12197,12202,0.04
12351,May,2017,Santa Clara,CA,Passenger,5,2,7,402,409,1.71
12352,May,2017,Chelan,WA,Passenger,60,36,96,51875,51971,0.18
12353,May,2017,Duval,FL,Passenger,1,1,2,379,381,0.52
12354,May,2017,New London,CT,Passenger,1,1,2,252,254,0.79
12355,May,2017,Utah,UT,Passenger,0,1,1,162,163,0.61
12356,May,2017,San Juan,WA,Passenger,104,38,142,13498,13640,1.04
12357,May,2017,Montgomery,PA,Passenger,1,0,1,39,40,2.5
12358,May,2017,Spokane,WA,Truck,1,0,1,90329,90330,0.0
12359,May,2017,Walla Walla,WA,Passenger,23,24,47,34853,34900,0.13
12360,May,2017,Cowlitz,WA,Truck,0,0,0,27873,27873,0.0
12361,May,2017,Whitman,WA,Passenger,10,20,30,21988,22018,0.14
12362,May,2017,San Mateo,CA,Passenger,0,1,1,157,158,0.63
12363,May,2017,Riverside,CA,Passenger,1,1,2,821,823,0.24
12364,May,2017,Cape May,NJ,Passenger,0,1,1,19,20,5.0
12365,May,2017,Manassas,VA,Passenger,0,1,1,9,10,10.0
12366,May,2017,Fairfax,VA,Passenger,2,2,4,861,865,0.46
12367,May,2017,Hamilton,IN,Passenger,1,0,1,62,63,1.59
12368,May,2017,Jackson,MO,Passenger,1,0,1,63,64,1.56
12369,May,2017,Moore,NC,Passenger,0,1,1,201,202,0.5
12370,May,2017,Monroe,NY,Passenger,1,0,1,26,27,3.7
12371,May,2017,Franklin,WA,Truck,0,0,0,18090,18090,0.0
12372,May,2017,Clark,WA,Passenger,770,489,1259,298797,300056,0.42
12373,May,2017,Orleans,LA,Passenger,0,1,1,49,50,2.0
12374,May,2017,Kittitas,WA,Truck,0,0,0,13532,13532,0.0
12375,May,2017,Dale,AL,Passenger,0,1,1,64,65,1.54
12376,May,2017,Grant,WA,Passenger,20,25,45,60675,60720,0.07
12377,May,2017,Muscogee,GA,Passenger,0,1,1,244,245,0.41
12378,May,2017,Lewis,WA,Truck,0,0,0,24822,24822,0.0
12379,May,2017,Snohomish,WA,Truck,1,0,1,121865,121866,0.0
12380,May,2017,Jefferson,WA,Passenger,103,59,162,23819,23981,0.68
12381,May,2017,Monterey,CA,Passenger,0,1,1,209,210,0.48
12382,May,2017,Volusia,FL,Passenger,0,1,1,45,46,2.17
12383,May,2017,Okaloosa,FL,Passenger,1,0,1,185,186,0.54
12384,May,2017,DeKalb,GA,Passenger,1,0,1,83,84,1.19
12385,May,2017,Skagit,WA,Truck,1,0,1,31389,31390,0.0
12386,May,2017,Island,WA,Passenger,113,129,242,59919,60161,0.4
12387,May,2017,Okanogan,WA,Passenger,3,16,19,25686,25705,0.07
12388,May,2017,Flathead,MT,Passenger,1,0,1,63,64,1.56
12389,May,2017,Whatcom,WA,Truck,2,0,2,41518,41520,0.0
12390,May,2017,Middlesex,MA,Passenger,1,0,1,146,147,0.68
12391,May,2017,Saratoga,NY,Passenger,1,1,2,73,75,2.67
12392,May,2017,Hawaii,HI,Passenger,1,0,1,86,87,1.15
12393,May,2017,Whitman,WA,Truck,0,0,0,8394,8394,0.0
12394,May,2017,Cumberland,NC,Passenger,1,0,1,591,592,0.17
12395,May,2017,Kent,MI,Passenger,0,1,1,35,36,2.78
12396,May,2017,Nantucket,MA,Passenger,1,0,1,3,4,25.0
12397,May,2017,Kittitas,WA,Passenger,22,17,39,27357,27396,0.14
12398,May,2017,Marin,CA,Passenger,1,0,1,58,59,1.69
12399,May,2017,Tulare,CA,Passenger,1,0,1,193,194,0.52
12400,May,2017,Lincoln,WA,Passenger,2,5,7,7507,7514,0.09
12401,May,2017,Honolulu,HI,Passenger,3,2,5,600,605,0.83
12402,May,2017,Douglas,WA,Passenger,32,23,55,26684,26739,0.21
12403,May,2017,Clackamas,OR,Passenger,1,1,2,306,308,0.65
12404,May,2017,St. Lucie,FL,Passenger,1,0,1,32,33,3.03
12405,May,2017,Marion,OR,Passenger,1,0,1,173,174,0.57
12406,May,2017,Mason,WA,Truck,0,0,0,19265,19265,0.0
12407,May,2017,Sedgwick,KS,Passenger,0,1,1,108,109,0.92
12408,May,2017,Palm Beach,FL,Passenger,0,1,1,98,99,1.01
12409,May,2017,Cowlitz,WA,Passenger,52,50,102,69536,69638,0.15
12410,May,2017,Manatee,FL,Passenger,1,0,1,47,48,2.08
12411,May,2017,Nueces,TX,Passenger,0,1,1,98,99,1.01
12412,May,2017,Pima,AZ,Passenger,0,2,2,444,446,0.45
12413,May,2017,Travis,TX,Passenger,0,1,1,192,193,0.52
12414,May,2017,King,WA,Truck,8,1,9,188266,188275,0.0
12415,May,2017,Asotin,WA,Truck,0,0,0,6491,6491,0.0
12416,May,2017,Jefferson,WA,Truck,0,0,0,9440,9440,0.0
12417,May,2017,Jefferson,NY,Passenger,1,1,2,254,256,0.78
12418,May,2017,District of Columbia,DC,Passenger,0,3,3,222,225,1.33
12419,May,2017,Maui,HI,Passenger,1,0,1,73,74,1.35
12420,May,2017,Whatcom,WA,Passenger,455,167,622,142686,143308,0.43
12421,May,2017,Ferry,WA,Passenger,1,1,2,4409,4411,0.05
12422,May,2017,Ventura,CA,Passenger,0,1,1,360,361,0.28
12423,May,2017,Santa Fe,NM,Passenger,0,1,1,46,47,2.13
12424,May,2017,Fulton,GA,Passenger,1,0,1,117,118,0.85
12425,May,2017,Spokane,WA,Passenger,245,211,456,296382,296838,0.15
12426,May,2017,Clallam,WA,Passenger,84,74,158,48203,48361,0.33
12427,May,2017,Wayne,MI,Passenger,0,1,1,68,69,1.45
12428,May,2017,Island,WA,Truck,0,0,0,20531,20531,0.0
12429,May,2017,Clallam,WA,Truck,0,0,0,20959,20959,0.0
12430,May,2017,El Paso,CO,Passenger,2,1,3,808,811,0.37
12431,May,2017,Clark,NV,Passenger,1,2,3,848,851,0.35
12432,May,2017,Deschutes,OR,Passenger,1,0,1,194,195,0.51
12433,May,2017,Howard,MD,Passenger,0,2,2,90,92,2.17
12434,May,2017,Hidalgo,TX,Passenger,0,1,1,99,100,1.0
12435,May,2017,Bexar,TX,Passenger,1,0,1,973,974,0.1
12436,May,2017,Garfield,WA,Truck,0,0,0,932,932,0.0
12437,May,2017,Orange,CA,Passenger,3,1,4,644,648,0.62
12438,May,2018,Canyon,ID,Passenger,0,1,1,87,88,1.14
12439,May,2018,Wahkiakum,WA,Truck,0,0,0,1674,1674,0.0
12440,May,2018,Whitman,WA,Truck,0,0,0,8470,8470,0.0
12441,May,2018,Duval,FL,Passenger,1,2,3,382,385,0.78
12442,May,2018,Skagit,WA,Passenger,198,163,361,90254,90615,0.4
12443,May,2018,Nassau,NY,Passenger,1,0,1,36,37,2.7
12444,May,2018,Lane,OR,Passenger,0,1,1,188,189,0.53
12445,May,2018,Clackamas,OR,Passenger,0,1,1,227,228,0.44
12446,May,2018,Montgomery,PA,Passenger,2,0,2,36,38,5.26
12447,May,2018,Douglas,WA,Truck,0,0,0,11900,11900,0.0
12448,May,2018,Maui,HI,Passenger,1,0,1,58,59,1.69
12449,May,2018,Monterey,CA,Passenger,0,1,1,187,188,0.53
12450,May,2018,Tarrant,TX,Passenger,1,0,1,215,216,0.46
12451,May,2018,El Paso,TX,Passenger,1,0,1,522,523,0.19
12452,May,2018,Pend Oreille,WA,Passenger,4,5,9,9508,9517,0.09
12453,May,2018,Brevard,FL,Passenger,0,1,1,98,99,1.01
12454,May,2018,Howard,MD,Passenger,0,1,1,86,87,1.15
12455,May,2018,San Mateo,CA,Passenger,1,1,2,134,136,1.47
12456,May,2018,Essex,NJ,Passenger,1,0,1,10,11,9.09
12457,May,2018,Mason,WA,Passenger,77,93,170,45592,45762,0.37
12458,May,2018,Whatcom,WA,Passenger,612,281,893,147196,148089,0.6
12459,May,2018,Kittitas,WA,Truck,0,0,0,14024,14024,0.0
12460,May,2018,Nantucket,MA,Passenger,1,0,1,4,5,20.0
12461,May,2018,El Paso,CO,Passenger,2,1,3,751,754,0.4
12462,May,2018,Norfolk,VA,Passenger,1,2,3,328,331,0.91
12463,May,2018,Morris,NJ,Passenger,1,0,1,18,19,5.26
12464,May,2018,Volusia,FL,Passenger,0,1,1,34,35,2.86
12465,May,2018,Moore,NC,Passenger,0,1,1,196,197,0.51
12466,May,2018,Okanogan,WA,Truck,0,0,0,16409,16409,0.0
12467,May,2018,Whitman,WA,Passenger,19,27,46,22578,22624,0.2
12468,May,2018,Okanogan,WA,Passenger,8,19,27,25886,25913,0.1
12470,May,2018,Beaufort,SC,Passenger,1,0,1,37,38,2.63
12471,May,2018,Wahkiakum,WA,Passenger,1,2,3,2901,2904,0.1
12472,May,2018,Fulton,GA,Passenger,1,1,2,98,100,2.0
12473,May,2018,Santa Clara,CA,Passenger,7,0,7,381,388,1.8
12474,May,2018,Clark,WA,Passenger,963,696,1659,307153,308812,0.54
12475,May,2018,Cook,IL,Passenger,1,0,1,269,270,0.37
12476,May,2018,New London,CT,Passenger,0,1,1,252,253,0.4
12477,May,2018,Manassas,VA,Passenger,0,1,1,9,10,10.0
12478,May,2018,Nueces,TX,Passenger,1,1,2,92,94,2.13
12479,May,2018,Juneau,AK,Passenger,0,1,1,47,48,2.08
12480,May,2018,Cowlitz,WA,Truck,0,0,0,28359,28359,0.0
12481,May,2018,Snohomish,WA,Truck,1,0,1,121479,121480,0.0
12482,May,2018,Washington,OR,Passenger,0,1,1,476,477,0.21
12483,May,2018,Grays Harbor,WA,Passenger,50,55,105,46409,46514,0.23
12484,May,2018,Island,WA,Truck,0,0,0,20885,20885,0.0
12485,May,2018,Santa Rosa,FL,Passenger,1,0,1,97,98,1.02
12486,May,2018,Columbia,WA,Passenger,2,1,3,2412,2415,0.12
12487,May,2018,Sumter,FL,Passenger,0,1,1,9,10,10.0
12488,May,2018,Riverside,CA,Passenger,2,2,4,703,707,0.57
12489,May,2018,Clark,NV,Passenger,1,2,3,744,747,0.4
12490,May,2018,Hamilton,IN,Passenger,1,0,1,46,47,2.13
12491,May,2018,New Haven,CT,Passenger,0,1,1,50,51,1.96
12492,May,2018,Clark,WA,Truck,0,0,0,78917,78917,0.0
12493,May,2018,Ramsey,MN,Passenger,1,0,1,40,41,2.44
12494,May,2018,Walla Walla,WA,Passenger,34,42,76,35569,35645,0.21
12495,May,2018,Kitsap,WA,Passenger,780,453,1233,177900,179133,0.69
12496,May,2018,Lincoln,WA,Passenger,2,6,8,7644,7652,0.1
12497,May,2018,Caddo,LA,Passenger,0,1,1,22,23,4.35
12498,May,2018,Ferry,WA,Truck,0,0,0,3503,3503,0.0
12499,May,2018,Stevens,WA,Passenger,11,25,36,31564,31600,0.11
12500,May,2018,Washtenaw,MI,Passenger,1,0,1,38,39,2.56
12501,May,2018,Thurston,WA,Passenger,548,468,1016,192389,193405,0.53
12502,May,2018,Pinal,AZ,Passenger,2,0,2,205,207,0.97
12503,May,2018,Sacramento,CA,Passenger,1,0,1,301,302,0.33
12504,May,2018,Arlington,VA,Passenger,1,2,3,171,174,1.72
12505,May,2018,Lewis,WA,Passenger,78,54,132,57567,57699,0.23
12506,May,2018,Bexar,TX,Passenger,2,3,5,767,772,0.65
12507,May,2018,Lincoln,WA,Truck,0,0,0,4537,4537,0.0
12508,May,2018,Prince George's,MD,Passenger,1,1,2,183,185,1.08
12509,May,2018,Skagit,WA,Truck,1,0,1,32044,32045,0.0
12510,May,2018,Kootenai,ID,Passenger,0,1,1,220,221,0.45
12511,May,2018,Monroe,IL,Passenger,1,0,1,5,6,16.67
12512,May,2018,Charles,MD,Passenger,0,1,1,84,85,1.18
12513,May,2018,Gwinnett,GA,Passenger,0,1,1,82,83,1.2
12514,May,2018,Mason,WA,Truck,0,0,0,19874,19874,0.0
12515,May,2018,Grays Harbor,WA,Truck,0,0,0,20185,20185,0.0
12516,May,2018,Garfield,WA,Truck,0,0,0,956,956,0.0
12517,May,2018,Thurston,WA,Truck,0,0,0,54199,54199,0.0
12518,May,2018,Jefferson,NY,Passenger,1,1,2,226,228,0.88
12519,May,2018,Ferry,WA,Passenger,2,3,5,4417,4422,0.11
12520,May,2018,Pierce,WA,Passenger,1185,1125,2310,530476,532786,0.43
12521,May,2018,Grant,WA,Truck,0,0,0,25863,25863,0.0
12522,May,2018,Allegheny,PA,Passenger,1,0,1,75,76,1.32
12523,May,2018,Clallam,WA,Passenger,119,110,229,49783,50012,0.46
12524,May,2018,Portsmouth,VA,Passenger,0,1,1,72,73,1.37
12525,May,2018,Jefferson,CO,Passenger,0,1,1,70,71,1.41
12526,May,2018,Klickitat,WA,Truck,0,0,0,8084,8084,0.0
12527,May,2018,Ada,ID,Passenger,0,2,2,331,333,0.6
12528,May,2018,Klickitat,WA,Passenger,25,30,55,15106,15161,0.36
12529,May,2018,Pima,AZ,Passenger,1,1,2,412,414,0.48
12530,May,2018,Santa Fe,NM,Passenger,0,1,1,42,43,2.33
12531,May,2018,Hawaii,HI,Passenger,1,0,1,74,75,1.33
12532,May,2018,Snohomish,WA,Passenger,2281,1223,3504,520051,523555,0.67
12533,May,2018,Ventura,CA,Passenger,0,1,1,315,316,0.32
12534,May,2018,Skamania,WA,Passenger,12,9,21,8704,8725,0.24
12535,May,2018,District of Columbia,DC,Passenger,0,3,3,190,193,1.55
12536,May,2018,Pend Oreille,WA,Truck,0,0,0,5671,5671,0.0
12537,May,2018,Williamson,TX,Passenger,0,1,1,163,164,0.61
12538,May,2018,Latah,ID,Passenger,0,1,1,76,77,1.3
12539,May,2018,Lumpkin,GA,Passenger,1,0,1,7,8,12.5
12540,May,2018,Multnomah,OR,Passenger,3,4,7,807,814,0.86
12541,May,2018,Cowlitz,WA,Passenger,58,75,133,71515,71648,0.19
12542,May,2018,DeKalb,IN,Passenger,1,0,1,1,2,50.0
12543,May,2018,Frederick,MD,Passenger,0,1,1,86,87,1.15
12544,May,2018,Garfield,WA,Passenger,1,1,2,1326,1328,0.15
12545,May,2018,Jefferson,WA,Passenger,138,91,229,24389,24618,0.93
12546,May,2018,Madison,ID,Passenger,1,0,1,38,39,2.56
12547,May,2018,Broward,FL,Passenger,1,1,2,130,132,1.52
12548,May,2018,Marin,CA,Passenger,1,0,1,56,57,1.75
12549,May,2018,San Juan,WA,Truck,0,0,0,5702,5702,0.0
12550,May,2018,Franklin,MA,Passenger,0,1,1,2,3,33.33
12551,May,2018,St. Lucie,FL,Passenger,1,0,1,28,29,3.45
12552,May,2018,Spokane,WA,Truck,1,0,1,92371,92372,0.0
12553,May,2018,Hamilton,TN,Passenger,1,0,1,23,24,4.17
12554,May,2018,Jefferson,WA,Truck,0,0,0,9539,9539,0.0
12555,May,2018,Asotin,WA,Passenger,8,6,14,12602,12616,0.11
12556,May,2018,Clallam,WA,Truck,0,0,0,21412,21412,0.0
12557,May,2018,Pacific,WA,Truck,0,0,0,7588,7588,0.0
12558,May,2018,Dallas,TX,Passenger,0,1,1,190,191,0.52
12559,May,2018,Grant,WA,Passenger,30,44,74,63010,63084,0.12
12560,May,2018,Manatee,FL,Passenger,1,0,1,37,38,2.63
12561,May,2018,Chelan,WA,Truck,0,0,0,21823,21823,0.0
12562,May,2018,Island,WA,Passenger,187,177,364,62446,62810,0.58
12563,May,2018,Saratoga,NY,Passenger,1,1,2,64,66,3.03
12564,May,2018,Okaloosa,FL,Passenger,1,0,1,171,172,0.58
12565,May,2018,Hardin,KY,Passenger,0,1,1,119,120,0.83
12566,May,2018,Prince George,VA,Passenger,0,1,1,73,74,1.35
12567,May,2018,Adams,WA,Truck,0,0,0,5158,5158,0.0
12568,May,2018,Garfield,OK,Passenger,1,0,1,18,19,5.26
12569,May,2018,DuPage,IL,Passenger,1,0,1,64,65,1.54
12570,May,2018,Kittitas,WA,Passenger,44,32,76,28906,28982,0.26
12571,May,2018,Benton,WA,Truck,0,0,0,40984,40984,0.0
12572,May,2018,Franklin,WA,Truck,0,0,0,18644,18644,0.0
12573,May,2018,Northampton,PA,Passenger,0,1,1,64,65,1.54
12574,May,2018,Yakima,WA,Passenger,62,84,146,163646,163792,0.09
12575,May,2018,Pacific,WA,Passenger,16,19,35,15552,15587,0.22
12576,May,2018,Utah,UT,Passenger,0,1,1,133,134,0.75
12577,May,2018,King,WA,Passenger,12744,5480,18224,1369589,1387813,1.31
12578,May,2018,Montgomery,TX,Passenger,1,0,1,64,65,1.54
12579,May,2018,St. Clair,IL,Passenger,0,1,1,152,153,0.65
12580,May,2018,Palm Beach,FL,Passenger,0,1,1,83,84,1.19
12581,May,2018,San Francisco,CA,Passenger,0,1,1,128,129,0.78
12582,May,2018,Skamania,WA,Truck,0,0,0,3917,3917,0.0
12583,May,2018,San Diego,CA,Passenger,7,1,8,2576,2584,0.31
12584,May,2018,Marion,IN,Passenger,1,0,1,117,118,0.85
12585,May,2018,Benton,WA,Passenger,188,195,383,131301,131684,0.29
12586,May,2018,Deschutes,OR,Passenger,1,0,1,169,170,0.59
12587,May,2018,Twin Falls,ID,Passenger,0,1,1,23,24,4.17
12588,May,2018,Contra Costa,CA,Passenger,0,1,1,451,452,0.22
12589,May,2018,Queens,NY,Passenger,1,0,1,63,64,1.56
12590,May,2018,Orange,FL,Passenger,2,1,3,171,174,1.72
12591,May,2018,Sedgwick,KS,Passenger,0,1,1,97,98,1.02
12592,May,2018,Kent,MI,Passenger,0,1,1,30,31,3.23
12593,May,2018,Fairfax,VA,Passenger,2,2,4,834,838,0.48
12594,May,2018,Franklin,WA,Passenger,38,63,101,57692,57793,0.17
12595,May,2018,Collin,TX,Passenger,1,0,1,152,153,0.65
12596,May,2018,Spokane,WA,Passenger,324,302,626,302459,303085,0.21
12597,May,2018,Shelby,TN,Passenger,0,1,1,103,104,0.96
12598,May,2018,Travis,TX,Passenger,0,1,1,191,192,0.52
12599,May,2018,DeKalb,GA,Passenger,1,0,1,81,82,1.22
12600,May,2018,Pierce,WA,Truck,0,0,0,137544,137544,0.0
12601,May,2018,King,WA,Truck,7,1,8,183157,183165,0.0
12602,May,2018,Prince William,VA,Passenger,0,4,4,266,270,1.48
12603,May,2018,Carroll,NH,Passenger,0,1,1,1,2,50.0
12604,May,2018,Dale,AL,Passenger,0,1,1,59,60,1.67
12605,May,2018,Orange,CA,Passenger,4,1,5,562,567,0.88
12606,May,2018,Montgomery,MD,Passenger,1,0,1,288,289,0.35
12607,May,2018,Alameda,CA,Passenger,0,1,1,348,349,0.29
12608,May,2018,Sangamon,IL,Passenger,1,0,1,11,12,8.33
12609,May,2018,Cape May,NJ,Passenger,0,1,1,21,22,4.55
12610,May,2018,Stevens,WA,Truck,0,0,0,18590,18590,0.0
12611,May,2018,Virginia Beach,VA,Passenger,2,1,3,688,691,0.43
12612,May,2018,Tulsa,OK,Passenger,0,1,1,48,49,2.04
12613,May,2018,Chelan,WA,Passenger,103,49,152,53497,53649,0.28
12614,May,2018,Klamath,OR,Passenger,1,0,1,34,35,2.86
12615,May,2018,Tuolumne,CA,Passenger,0,1,1,12,13,7.69
12616,May,2018,Whatcom,WA,Truck,2,0,2,42191,42193,0.0
12617,May,2018,Flathead,MT,Passenger,1,0,1,50,51,1.96
12618,May,2018,Walla Walla,WA,Truck,0,0,0,13389,13389,0.0
12619,May,2018,San Juan,WA,Passenger,141,56,197,14046,14243,1.38
12620,May,2018,Polk,FL,Passenger,1,0,1,64,65,1.54
12621,May,2018,Lee,FL,Passenger,1,0,1,57,58,1.72
12622,May,2018,Douglas,WA,Passenger,44,31,75,27541,27616,0.27
12623,May,2018,Norfolk,MA,Passenger,1,0,1,37,38,2.63
12624,May,2018,Los Angeles,CA,Passenger,7,4,11,1157,1168,0.94
12625,May,2018,Columbia,WA,Truck,0,0,0,1526,1526,0.0
12626,May,2018,Dakota,MN,Passenger,0,2,2,37,39,5.13
12627,May,2018,Anne Arundel,MD,Passenger,0,2,2,445,447,0.45
12628,May,2018,Richmond,GA,Passenger,0,1,1,91,92,1.09
12629,May,2018,Yakima,WA,Truck,0,0,0,58338,58338,0.0
12630,May,2018,Orleans,LA,Passenger,0,1,1,46,47,2.13
12631,May,2018,Asotin,WA,Truck,0,0,0,6631,6631,0.0
12632,May,2018,Richland,SC,Passenger,0,1,1,171,172,0.58
12633,May,2018,Clay,FL,Passenger,0,1,1,94,95,1.05
12634,May,2018,Kitsap,WA,Truck,1,0,1,53093,53094,0.0
12635,May,2018,Lee,AL,Passenger,1,0,1,33,34,2.94
12636,May,2018,Adams,WA,Passenger,5,5,10,12597,12607,0.08
12637,May,2018,Charleston,SC,Passenger,1,0,1,127,128,0.78
12638,May,2018,Maricopa,AZ,Passenger,2,1,3,1575,1578,0.19
12639,May,2018,Honolulu,HI,Passenger,2,2,4,529,533,0.75
12640,May,2018,Lewis,WA,Truck,0,0,0,25406,25406,0.0
12641,May,2019,Albemarle,VA,Passenger,1,0,1,24,25,4.0
12642,May,2019,Skagit,WA,Passenger,292,200,492,91700,92192,0.53
12643,May,2019,Cochise,AZ,Passenger,0,1,1,113,114,0.88
12644,May,2019,Santa Clara,CA,Passenger,7,1,8,366,374,2.14
12645,May,2019,Skamania,WA,Truck,0,0,0,4052,4052,0.0
12646,May,2019,Snohomish,WA,Passenger,3372,1572,4944,530335,535279,0.92
12647,May,2019,Sangamon,IL,Passenger,1,0,1,7,8,12.5
12648,May,2019,Calvert,MD,Passenger,0,2,2,88,90,2.22
12649,May,2019,Asotin,WA,Passenger,12,8,20,12675,12695,0.16
12650,May,2019,Ada,ID,Passenger,0,2,2,309,311,0.64
12651,May,2019,Grant,WA,Passenger,39,59,98,64561,64659,0.15
12652,May,2019,Kent,MI,Passenger,0,1,1,21,22,4.55
12653,May,2019,Ramsey,MN,Passenger,1,0,1,42,43,2.33
12654,May,2019,Monroe,IL,Passenger,1,0,1,5,6,16.67
12655,May,2019,Orange,CA,Passenger,6,1,7,527,534,1.31
12656,May,2019,St. Lucie,FL,Passenger,1,0,1,29,30,3.33
12657,May,2019,Denver,CO,Passenger,1,0,1,131,132,0.76
12658,May,2019,Shasta,CA,Passenger,1,0,1,42,43,2.33
12659,May,2019,Yakima,WA,Passenger,94,104,198,165012,165210,0.12
12660,May,2019,Placer,CA,Passenger,1,0,1,105,106,0.94
12661,May,2019,Washoe,NV,Passenger,2,0,2,110,112,1.79
12662,May,2019,Clay,FL,Passenger,0,1,1,87,88,1.14
12663,May,2019,San Juan,WA,Passenger,207,71,278,14357,14635,1.9
12664,May,2019,District of Columbia,DC,Passenger,1,1,2,207,209,0.96
12665,May,2019,Garfield,WA,Passenger,1,1,2,1293,1295,0.15
12666,May,2019,Duval,FL,Passenger,1,2,3,371,374,0.8
12667,May,2019,Nassau,NY,Passenger,3,0,3,38,41,7.32
12668,May,2019,Berkshire,MA,Passenger,0,1,1,4,5,20.0
12669,May,2019,Caddo,LA,Passenger,0,1,1,24,25,4.0
12670,May,2019,Santa Rosa,FL,Passenger,1,0,1,88,89,1.12
12671,May,2019,Polk,FL,Passenger,1,0,1,66,67,1.49
12672,May,2019,Montgomery,AL,Passenger,0,1,1,43,44,2.27
12673,May,2019,Prince George's,MD,Passenger,1,1,2,181,183,1.09
12674,May,2019,Cumberland,NC,Passenger,0,2,2,501,503,0.4
12675,May,2019,Carroll,NH,Passenger,0,1,1,3,4,25.0
12676,May,2019,Harris,TX,Passenger,0,1,1,245,246,0.41
12677,May,2019,Hawaii,HI,Passenger,1,0,1,62,63,1.59
12678,May,2019,Walla Walla,WA,Truck,0,0,0,13613,13613,0.0
12679,May,2019,Multnomah,OR,Passenger,5,5,10,746,756,1.32
12680,May,2019,Lewis,WA,Passenger,97,93,190,59034,59224,0.32
12681,May,2019,Portsmouth,VA,Passenger,0,1,1,74,75,1.33
12682,May,2019,Riverside,CA,Passenger,2,2,4,658,662,0.6
12683,May,2019,Jefferson,NY,Passenger,0,2,2,216,218,0.92
12684,May,2019,Dallas,TX,Passenger,1,0,1,203,204,0.49
12685,May,2019,Wahkiakum,WA,Passenger,2,2,4,3017,3021,0.13
12686,May,2019,Carson City,NV,Passenger,1,0,1,13,14,7.14
12687,May,2019,Skamania,WA,Passenger,23,17,40,8719,8759,0.46
12688,May,2019,Marion,OR,Passenger,1,0,1,114,115,0.87
12689,May,2019,Thurston,WA,Truck,0,0,0,55085,55085,0.0
12690,May,2019,Alexandria,VA,Passenger,1,0,1,147,148,0.68
12691,May,2019,Grant,WA,Truck,0,0,0,26531,26531,0.0
12692,May,2019,Kittitas,WA,Passenger,72,35,107,29555,29662,0.36
12693,May,2019,Juneau,AK,Passenger,0,2,2,31,33,6.06
12694,May,2019,Pima,AZ,Passenger,0,1,1,397,398,0.25
12695,May,2019,Island,WA,Truck,0,0,0,21242,21242,0.0
12696,May,2019,Nueces,TX,Passenger,1,1,2,98,100,2.0
12697,May,2019,Alameda,CA,Passenger,3,2,5,308,313,1.6
12698,May,2019,Larimer,CO,Passenger,1,0,1,58,59,1.69
12699,May,2019,Benton,WA,Passenger,253,272,525,133636,134161,0.39
12700,May,2019,Lumpkin,GA,Passenger,1,0,1,4,5,20.0
12701,May,2019,Charles,MD,Passenger,0,1,1,84,85,1.18
12702,May,2019,Chelan,WA,Truck,0,0,0,22243,22243,0.0
12703,May,2019,Benton,WA,Truck,0,0,0,41850,41850,0.0
12704,May,2019,Wilson,TX,Passenger,0,1,1,6,7,14.29
12705,May,2019,St. Mary's,MD,Passenger,1,0,1,211,212,0.47
12706,May,2019,Deschutes,OR,Passenger,2,0,2,158,160,1.25
12707,May,2019,Sumter,FL,Passenger,0,1,1,10,11,9.09
12708,May,2019,Lee,FL,Passenger,1,0,1,50,51,1.96
12709,May,2019,Montgomery,TX,Passenger,2,0,2,58,60,3.33
12710,May,2019,Brevard,FL,Passenger,0,1,1,85,86,1.16
12711,May,2019,Columbia,WA,Passenger,2,2,4,2443,2447,0.16
12712,May,2019,Franklin,WA,Truck,0,0,0,19251,19251,0.0
12713,May,2019,Collin,TX,Passenger,1,1,2,130,132,1.52
12714,May,2019,Middlesex,MA,Passenger,1,1,2,117,119,1.68
12715,May,2019,Pinellas,FL,Passenger,1,0,1,112,113,0.88
12716,May,2019,Shelby,TN,Passenger,0,1,1,93,94,1.06
12717,May,2019,Cowlitz,WA,Passenger,95,107,202,72910,73112,0.28
12718,May,2019,Lincoln,WA,Truck,0,0,0,4695,4695,0.0
12719,May,2019,Spartanburg,SC,Passenger,0,1,1,35,36,2.78
12720,May,2019,Oldham,KY,Passenger,0,1,1,5,6,16.67
12721,May,2019,Okanogan,WA,Passenger,21,23,44,26072,26116,0.17
12722,May,2019,Pierce,WA,Passenger,1751,1520,3271,542054,545325,0.6
12723,May,2019,Ferry,WA,Passenger,5,2,7,4381,4388,0.16
12724,May,2019,Saratoga,NY,Passenger,1,0,1,55,56,1.79
12725,May,2019,Douglas,WA,Passenger,56,36,92,28005,28097,0.33
12726,May,2019,Stevens,WA,Truck,0,0,0,18677,18677,0.0
12727,May,2019,Ferry,WA,Truck,0,0,0,3589,3589,0.0
12728,May,2019,St. Clair,IL,Passenger,0,1,1,159,160,0.62
12729,May,2019,Snohomish,WA,Truck,1,0,1,122076,122077,0.0
12730,May,2019,Cape May,NJ,Passenger,0,1,1,15,16,6.25
12731,May,2019,Flathead,MT,Passenger,1,0,1,61,62,1.61
12732,May,2019,DeKalb,IN,Passenger,1,0,1,1,2,50.0
12733,May,2019,New London,CT,Passenger,0,2,2,247,249,0.8
12734,May,2019,Guadalupe,TX,Passenger,1,0,1,75,76,1.32
12735,May,2019,Loudoun,VA,Passenger,1,0,1,96,97,1.03
12736,May,2019,Hennepin,MN,Passenger,2,0,2,103,105,1.9
12737,May,2019,Nantucket,MA,Passenger,1,0,1,2,3,33.33
12738,May,2019,Adams,WA,Truck,0,0,0,5127,5127,0.0
12739,May,2019,Ventura,CA,Passenger,0,2,2,313,315,0.63
12740,May,2019,Charleston,SC,Passenger,1,0,1,117,118,0.85
12741,May,2019,Maui,HI,Passenger,1,0,1,46,47,2.13
12742,May,2019,Santa Cruz,CA,Passenger,1,0,1,40,41,2.44
12743,May,2019,Camden,NJ,Passenger,0,1,1,23,24,4.17
12744,May,2019,Owyhee,ID,Passenger,1,0,1,5,6,16.67
12745,May,2019,Palm Beach,FL,Passenger,0,1,1,89,90,1.11
12746,May,2019,Cascade,MT,Passenger,0,1,1,59,60,1.67
12747,May,2019,Los Angeles,CA,Passenger,8,5,13,1098,1111,1.17
12748,May,2019,Lincoln,WA,Passenger,3,8,11,7772,7783,0.14
12749,May,2019,Manatee,FL,Passenger,1,0,1,31,32,3.12
12750,May,2019,Cook,IL,Passenger,1,0,1,242,243,0.41
12751,May,2019,Thurston,WA,Passenger,844,630,1474,197138,198612,0.74
12752,May,2019,Allegheny,PA,Passenger,1,0,1,83,84,1.19
12753,May,2019,Klamath,OR,Passenger,1,0,1,38,39,2.56
12754,May,2019,Adams,WA,Passenger,5,6,11,12714,12725,0.09
12755,May,2019,Mason,WA,Passenger,121,120,241,47012,47253,0.51
12756,May,2019,Jefferson,WA,Truck,0,0,0,9668,9668,0.0
12757,May,2019,Whatcom,WA,Passenger,837,413,1250,150441,151691,0.82
12758,May,2019,Pacific,WA,Passenger,24,28,52,15952,16004,0.32
12759,May,2019,Arlington,VA,Passenger,1,2,3,158,161,1.86
12760,May,2019,Klickitat,WA,Truck,0,0,0,8237,8237,0.0
12761,May,2019,Williamson,TX,Passenger,0,1,1,142,143,0.7
12762,May,2019,Clallam,WA,Truck,0,0,0,21746,21746,0.0
12763,May,2019,Anne Arundel,MD,Passenger,1,2,3,446,449,0.67
12764,May,2019,Cowlitz,WA,Truck,0,0,0,28843,28843,0.0
12765,May,2019,Grays Harbor,WA,Truck,0,0,0,20457,20457,0.0
12766,May,2019,Asotin,WA,Truck,0,0,0,6652,6652,0.0
12767,May,2019,Clark,NV,Passenger,3,2,5,690,695,0.72
12768,May,2019,Garfield,WA,Truck,0,0,0,954,954,0.0
12769,May,2019,Oklahoma,OK,Passenger,0,1,1,120,121,0.83
12770,May,2019,Dakota,MN,Passenger,0,2,2,37,39,5.13
12771,May,2019,Travis,TX,Passenger,2,1,3,201,204,1.47
12772,May,2019,Clackamas,OR,Passenger,1,1,2,212,214,0.93
12773,May,2019,Columbia,WA,Truck,0,0,0,1532,1532,0.0
12774,May,2019,San Mateo,CA,Passenger,2,1,3,123,126,2.38
12775,May,2019,Twin Falls,ID,Passenger,0,1,1,22,23,4.35
12776,May,2019,Maricopa,AZ,Passenger,6,2,8,1536,1544,0.52
12777,May,2019,Harnett,NC,Passenger,1,1,2,216,218,0.92
12778,May,2019,Rogers,OK,Passenger,1,0,1,5,6,16.67
12779,May,2019,Frederick,MD,Passenger,1,1,2,80,82,2.44
12780,May,2019,Contra Costa,CA,Passenger,2,2,4,383,387,1.03
12782,May,2019,Whitman,WA,Passenger,31,45,76,22710,22786,0.33
12783,May,2019,Manassas,VA,Passenger,0,1,1,8,9,11.11
12784,May,2019,Vigo,IN,Passenger,1,0,1,6,7,14.29
12785,May,2019,Lewis,WA,Truck,0,0,0,25915,25915,0.0
12786,May,2019,Honolulu,HI,Passenger,2,3,5,500,505,0.99
12787,May,2019,Skagit,WA,Truck,1,0,1,32417,32418,0.0
12788,May,2019,Yakima,WA,Truck,0,0,0,59084,59084,0.0
12789,May,2019,Penobscot,ME,Passenger,0,1,1,13,14,7.14
12790,May,2019,Tulsa,OK,Passenger,1,1,2,44,46,4.35
12791,May,2019,Wahkiakum,WA,Truck,0,0,0,1743,1743,0.0
12792,May,2019,Stevens,WA,Passenger,20,29,49,31678,31727,0.15
12793,May,2019,Spokane,WA,Passenger,529,422,951,310923,311874,0.3
12794,May,2019,Douglas,NE,Passenger,0,1,1,63,64,1.56
12795,May,2019,Pend Oreille,WA,Truck,0,0,0,5743,5743,0.0
12796,May,2019,Lake,FL,Passenger,1,0,1,19,20,5.0
12797,May,2019,Whatcom,WA,Truck,2,0,2,42822,42824,0.0
12798,May,2019,El Paso,TX,Passenger,3,0,3,481,484,0.62
12799,May,2019,DuPage,IL,Passenger,1,0,1,62,63,1.59
12800,May,2019,Clark,WA,Passenger,1475,913,2388,313255,315643,0.76
12801,May,2019,Norfolk,MA,Passenger,1,0,1,35,36,2.78
12802,May,2019,Saginaw,MI,Passenger,1,0,1,10,11,9.09
12803,May,2019,Santa Fe,NM,Passenger,0,1,1,40,41,2.44
12804,May,2019,Pinal,AZ,Passenger,2,0,2,194,196,1.02
12805,May,2019,Dale,AL,Passenger,0,1,1,58,59,1.69
12806,May,2019,Grays Harbor,WA,Passenger,73,84,157,47839,47996,0.33
12807,May,2019,Norfolk,VA,Passenger,2,2,4,346,350,1.14
12808,May,2019,Chelan,WA,Passenger,153,67,220,54336,54556,0.4
12809,May,2019,San Diego,CA,Passenger,10,3,13,2672,2685,0.48
12810,May,2019,San Francisco,CA,Passenger,2,1,3,107,110,2.73
12811,May,2019,Richland,SC,Passenger,0,1,1,159,160,0.62
12812,May,2019,Tarrant,TX,Passenger,2,0,2,203,205,0.98
12813,May,2019,Fairfax,VA,Passenger,3,2,5,779,784,0.64
12814,May,2019,El Paso,CO,Passenger,2,1,3,741,744,0.4
12815,May,2019,Okanogan,WA,Truck,0,0,0,16506,16506,0.0
12816,May,2019,Franklin,WA,Passenger,52,70,122,59788,59910,0.2
12817,May,2019,Richmond,GA,Passenger,0,1,1,93,94,1.06
12818,May,2019,Kitsap,WA,Truck,1,0,1,54018,54019,0.0
12819,May,2019,Island,WA,Passenger,315,234,549,63346,63895,0.86
12820,May,2019,Houston,GA,Passenger,1,0,1,54,55,1.82
12821,May,2019,Pacific,WA,Truck,0,0,0,7661,7661,0.0
12822,May,2019,Moore,NC,Passenger,0,1,1,186,187,0.53
12823,May,2019,Pierce,WA,Truck,0,0,0,139646,139646,0.0
12824,May,2019,Broward,FL,Passenger,2,1,3,125,128,2.34
12825,May,2019,Washtenaw,MI,Passenger,1,0,1,38,39,2.56
12826,May,2019,King,WA,Truck,5,1,6,181939,181945,0.0
12827,May,2019,Wayne,MI,Passenger,0,1,1,68,69,1.45
12828,May,2019,Jefferson,CO,Passenger,0,2,2,58,60,3.33
12829,May,2019,Tuolumne,CA,Passenger,0,1,1,12,13,7.69
12830,May,2019,Pend Oreille,WA,Passenger,4,5,9,9537,9546,0.09
12831,May,2019,Spokane,WA,Truck,1,0,1,94607,94608,0.0
12832,May,2019,Sedgwick,KS,Passenger,0,1,1,102,103,0.97
12833,May,2019,Clark,WA,Truck,0,0,0,80186,80186,0.0
12834,May,2019,Walla Walla,WA,Passenger,46,57,103,36164,36267,0.28
12835,May,2019,Fulton,GA,Passenger,1,2,3,107,110,2.73
12836,May,2019,Bucks,PA,Passenger,1,0,1,18,19,5.26
12837,May,2019,Lee,AL,Passenger,1,0,1,34,35,2.86
12838,May,2019,Montgomery,PA,Passenger,2,0,2,37,39,5.13
12839,May,2019,Goochland,VA,Passenger,1,1,2,257,259,0.77
12840,May,2019,Prince William,VA,Passenger,1,4,5,250,255,1.96
12841,May,2019,Suffolk,MA,Passenger,0,1,1,39,40,2.5
12842,May,2019,San Juan,WA,Truck,0,0,0,5850,5850,0.0
12843,May,2019,Mason,WA,Truck,0,0,0,20364,20364,0.0
12844,May,2019,Valencia,NM,Passenger,1,0,1,7,8,12.5
12845,May,2019,Bexar,TX,Passenger,3,5,8,671,679,1.18
12846,May,2019,Fresno,CA,Passenger,1,0,1,188,189,0.53
12847,May,2019,Howard,MD,Passenger,0,1,1,76,77,1.3
12848,May,2019,Randolph,NC,Passenger,1,0,1,6,7,14.29
12849,May,2019,Kittitas,WA,Truck,0,0,0,14377,14377,0.0
12850,May,2019,Kern,CA,Passenger,0,1,1,224,225,0.44
12851,May,2019,Kitsap,WA,Passenger,1036,588,1624,180694,182318,0.89
12852,May,2019,Solano,CA,Passenger,1,0,1,215,216,0.46
12853,May,2019,Jefferson,WA,Passenger,191,119,310,25001,25311,1.22
12854,May,2019,Franklin,MA,Passenger,0,1,1,1,2,50.0
12855,May,2019,Volusia,FL,Passenger,0,1,1,38,39,2.56
12856,May,2019,Bergen,NJ,Passenger,1,0,1,27,28,3.57
12857,May,2019,Klickitat,WA,Passenger,35,33,68,15550,15618,0.44
12858,May,2019,DeKalb,GA,Passenger,1,0,1,79,80,1.25
12859,May,2019,King,WA,Passenger,18616,6948,25564,1387314,1412878,1.81
12860,May,2019,San Joaquin,CA,Passenger,1,0,1,131,132,0.76
12861,May,2019,Kootenai,ID,Passenger,1,1,2,217,219,0.91
12862,May,2019,New Haven,CT,Passenger,0,2,2,48,50,4.0
12863,May,2019,Clallam,WA,Passenger,167,137,304,50565,50869,0.6
12864,May,2019,Montgomery,MD,Passenger,1,0,1,277,278,0.36
12865,May,2019,Whitman,WA,Truck,0,0,0,8549,8549,0.0
12866,May,2019,Douglas,WA,Truck,0,0,0,12182,12182,0.0
12867,May,2019,Virginia Beach,VA,Passenger,1,1,2,709,711,0.28
12868,May,2019,Mecklenburg,NC,Passenger,1,0,1,82,83,1.2
12869,May,2019,San Juan,PR,Passenger,0,1,1,3,4,25.0
12870,May,2020,Chelan,WA,Passenger,228,78,306,54111,54417,0.56
12871,May,2020,Contra Costa,CA,Passenger,3,2,5,318,323,1.55
12872,May,2020,Spokane,WA,Truck,1,0,1,97688,97689,0.0
12873,May,2020,Erie,NY,Passenger,1,0,1,44,45,2.22
12874,May,2020,Williams,ND,Passenger,0,1,1,11,12,8.33
12875,May,2020,Pacific,WA,Truck,0,0,0,7625,7625,0.0
12876,May,2020,Arlington,VA,Passenger,0,2,2,148,150,1.33
12877,May,2020,Wahkiakum,WA,Passenger,6,6,12,2965,2977,0.4
12878,May,2020,Washoe,NV,Passenger,1,0,1,105,106,0.94
12879,May,2020,Columbia,WA,Passenger,4,3,7,2405,2412,0.29
12880,May,2020,Calvert,MD,Passenger,0,2,2,88,90,2.22
12881,May,2020,Hennepin,MN,Passenger,3,0,3,88,91,3.3
12882,May,2020,San Diego,CA,Passenger,14,5,19,2741,2760,0.69
12883,May,2020,Monroe,IL,Passenger,1,0,1,4,5,20.0
12884,May,2020,Cascade,MT,Passenger,0,1,1,55,56,1.79
12885,May,2020,Sedgwick,KS,Passenger,1,1,2,92,94,2.13
12886,May,2020,Sarasota,FL,Passenger,2,0,2,24,26,7.69
12887,May,2020,Ramsey,MN,Passenger,1,0,1,39,40,2.5
12888,May,2020,Klamath,OR,Passenger,1,0,1,33,34,2.94
12889,May,2020,Whatcom,WA,Passenger,1060,496,1556,149298,150854,1.03
12890,May,2020,Yakima,WA,Truck,0,0,0,59572,59572,0.0
12891,May,2020,Juneau,AK,Passenger,0,2,2,29,31,6.45
12892,May,2020,Clark,NV,Passenger,3,2,5,674,679,0.74
12893,May,2020,Hamilton,IN,Passenger,1,0,1,39,40,2.5
12894,May,2020,Pierce,WA,Truck,0,0,0,141318,141318,0.0
12895,May,2020,Kern,CA,Passenger,0,1,1,225,226,0.44
12896,May,2020,Pinal,AZ,Passenger,1,0,1,184,185,0.54
12897,May,2020,Powhatan,VA,Passenger,1,0,1,0,1,100.0
12898,May,2020,Snohomish,WA,Truck,0,0,0,123364,123364,0.0
12899,May,2020,Chelan,WA,Truck,0,0,0,22434,22434,0.0
12900,May,2020,Grant,WA,Passenger,59,70,129,65207,65336,0.2
12901,May,2020,Okanogan,WA,Truck,0,0,0,16391,16391,0.0
12902,May,2020,Suffolk,MA,Passenger,0,2,2,35,37,5.41
12903,May,2020,Grays Harbor,WA,Passenger,106,111,217,48015,48232,0.45
12904,May,2020,Franklin,WA,Truck,0,0,0,19869,19869,0.0
12905,May,2020,Camden,NJ,Passenger,0,1,1,22,23,4.35
12906,May,2020,Saginaw,MI,Passenger,1,0,1,10,11,9.09
12907,May,2020,Houston,GA,Passenger,1,0,1,55,56,1.79
12908,May,2020,Lewis,WA,Truck,0,0,0,26001,26001,0.0
12909,May,2020,Clark,WA,Passenger,2003,1055,3058,317495,320553,0.95
12910,May,2020,Randolph,NC,Passenger,1,0,1,7,8,12.5
12911,May,2020,Larimer,CO,Passenger,1,0,1,51,52,1.92
12912,May,2020,Denton,TX,Passenger,1,0,1,89,90,1.11
12913,May,2020,Prince George's,MD,Passenger,1,1,2,161,163,1.23
12914,May,2020,Ada,ID,Passenger,0,1,1,273,274,0.36
12915,May,2020,DeKalb,IN,Passenger,1,0,1,1,2,50.0
12916,May,2020,Hudson,NJ,Passenger,1,0,1,38,39,2.56
12917,May,2020,San Mateo,CA,Passenger,0,1,1,113,114,0.88
12918,May,2020,Kittitas,WA,Passenger,102,48,150,29778,29928,0.5
12919,May,2020,Franklin,WA,Passenger,58,75,133,60574,60707,0.22
12920,May,2020,Skamania,WA,Truck,0,0,0,4029,4029,0.0
12921,May,2020,Deschutes,OR,Passenger,3,0,3,134,137,2.19
12922,May,2020,Frederick,MD,Passenger,1,1,2,75,77,2.6
12923,May,2020,St. Louis,MO,Passenger,1,0,1,99,100,1.0
12924,May,2020,Whatcom,WA,Truck,3,0,3,42847,42850,0.01
12925,May,2020,Maui,HI,Passenger,1,0,1,32,33,3.03
12926,May,2020,Gwinnett,GA,Passenger,1,0,1,73,74,1.35
12927,May,2020,Howard,MD,Passenger,0,1,1,71,72,1.39
12928,May,2020,Polk,FL,Passenger,1,0,1,65,66,1.52
12929,May,2020,RÃ­o Grande,PR,Passenger,1,0,1,1,2,50.0
12930,May,2020,Douglas,NE,Passenger,0,1,1,54,55,1.82
12931,May,2020,Shelby,OH,Passenger,0,1,1,1,2,50.0
12932,May,2020,San Juan,WA,Passenger,298,91,389,14062,14451,2.69
12933,May,2020,Vigo,IN,Passenger,1,0,1,5,6,16.67
12934,May,2020,Skagit,WA,Truck,1,0,1,32389,32390,0.0
12935,May,2020,Bexar,TX,Passenger,2,5,7,605,612,1.14
12936,May,2020,Travis,TX,Passenger,2,1,3,180,183,1.64
12937,May,2020,Montgomery,TX,Passenger,1,0,1,52,53,1.89
12938,May,2020,Utah,UT,Passenger,0,1,1,132,133,0.75
12939,May,2020,Prince William,VA,Passenger,2,3,5,218,223,2.24
12940,May,2020,Stevens,WA,Truck,0,0,0,18598,18598,0.0
12941,May,2020,Douglas,WA,Truck,0,0,0,12279,12279,0.0
12943,May,2020,Washtenaw,MI,Passenger,1,0,1,34,35,2.86
12944,May,2020,DuPage,IL,Passenger,3,0,3,57,60,5.0
12945,May,2020,Sacramento,CA,Passenger,1,0,1,267,268,0.37
12946,May,2020,Lake,IL,Passenger,1,0,1,163,164,0.61
12947,May,2020,Cape May,NJ,Passenger,0,1,1,13,14,7.14
12948,May,2020,Broward,FL,Passenger,2,1,3,113,116,2.59
12949,May,2020,Grays Harbor,WA,Truck,0,0,0,20770,20770,0.0
12950,May,2020,Collin,TX,Passenger,1,1,2,119,121,1.65
12951,May,2020,Pinellas,FL,Passenger,1,1,2,108,110,1.82
12952,May,2020,Harnett,NC,Passenger,1,0,1,201,202,0.5
12953,May,2020,Solano,CA,Passenger,1,0,1,206,207,0.48
12954,May,2020,Spartanburg,SC,Passenger,0,1,1,47,48,2.08
12955,May,2020,St. Clair,IL,Passenger,1,0,1,137,138,0.72
12956,May,2020,Fairfax,VA,Passenger,4,3,7,737,744,0.94
12957,May,2020,New London,CT,Passenger,1,2,3,244,247,1.21
12958,May,2020,Yakima,WA,Passenger,131,117,248,165018,165266,0.15
12959,May,2020,Tulsa,OK,Passenger,1,1,2,44,46,4.35
12960,May,2020,Grant,WA,Truck,0,0,0,26982,26982,0.0
12961,May,2020,Allegheny,PA,Passenger,1,0,1,72,73,1.37
12962,May,2020,Dallas,TX,Passenger,1,0,1,197,198,0.51
12963,May,2020,El Paso,TX,Passenger,3,0,3,431,434,0.69
12964,May,2020,Wilson,TX,Passenger,0,1,1,6,7,14.29
12965,May,2020,Oldham,KY,Passenger,0,1,1,4,5,20.0
12966,May,2020,Jefferson,WA,Passenger,233,141,374,24824,25198,1.48
12967,May,2020,Flathead,MT,Passenger,1,0,1,62,63,1.59
12968,May,2020,Bartow,GA,Passenger,0,1,1,3,4,25.0
12969,May,2020,Okanogan,WA,Passenger,34,33,67,25879,25946,0.26
12970,May,2020,Mason,WA,Passenger,157,137,294,47178,47472,0.62
12971,May,2020,Island,WA,Passenger,409,270,679,62803,63482,1.07
12972,May,2020,Guadalupe,TX,Passenger,1,0,1,65,66,1.52
12973,May,2020,Ulster,NY,Passenger,1,0,1,7,8,12.5
12974,May,2020,New Haven,CT,Passenger,0,2,2,39,41,4.88
12975,May,2020,Lake,FL,Passenger,1,0,1,20,21,4.76
12976,May,2020,Clallam,WA,Truck,1,0,1,21671,21672,0.0
12977,May,2020,Jefferson,NY,Passenger,0,1,1,210,211,0.47
12978,May,2020,Shasta,CA,Passenger,1,0,1,36,37,2.7
12979,May,2020,Harris,TX,Passenger,1,0,1,230,231,0.43
12980,May,2020,Nueces,TX,Passenger,1,0,1,81,82,1.22
12981,May,2020,Douglas,WA,Passenger,69,40,109,27964,28073,0.39
12982,May,2020,Rockingham,NH,Passenger,1,0,1,26,27,3.7
12983,May,2020,Denver,CO,Passenger,1,0,1,119,120,0.83
12984,May,2020,Fort Bend,TX,Passenger,1,0,1,46,47,2.13
12985,May,2020,Carson City,NV,Passenger,1,0,1,10,11,9.09
12986,May,2020,Asotin,WA,Truck,0,0,0,6587,6587,0.0
12987,May,2020,Stafford,VA,Passenger,1,1,2,92,94,2.13
12988,May,2020,Alexandria,VA,Passenger,1,0,1,140,141,0.71
12989,May,2020,Multnomah,OR,Passenger,4,7,11,717,728,1.51
12990,May,2020,Manassas,VA,Passenger,0,1,1,5,6,16.67
12991,May,2020,Fulton,GA,Passenger,1,2,3,103,106,2.83
12992,May,2020,Montgomery,OH,Passenger,0,1,1,47,48,2.08
12993,May,2020,Mason,WA,Truck,0,0,0,20508,20508,0.0
12994,May,2020,Suffolk,VA,Passenger,1,0,1,122,123,0.81
12995,May,2020,Ventura,CA,Passenger,1,2,3,283,286,1.05
12996,May,2020,San Juan,WA,Truck,0,0,0,5860,5860,0.0
12997,May,2020,Whitman,WA,Truck,0,0,0,8514,8514,0.0
12998,May,2020,Garfield,WA,Passenger,0,1,1,1347,1348,0.07
12999,May,2020,Kootenai,ID,Passenger,1,0,1,223,224,0.45
13000,May,2020,Orange,CA,Passenger,7,2,9,490,499,1.8
13001,May,2020,Clay,FL,Passenger,0,1,1,80,81,1.23
13002,May,2020,Cowlitz,WA,Passenger,136,115,251,72360,72611,0.35
13003,May,2020,Charleston,SC,Passenger,1,0,1,105,106,0.94
13004,May,2020,Anne Arundel,MD,Passenger,0,1,1,411,412,0.24
13005,May,2020,Klickitat,WA,Truck,0,0,0,8121,8121,0.0
13006,May,2020,Columbia,WA,Truck,0,0,0,1523,1523,0.0
13007,May,2020,Montgomery,PA,Passenger,1,0,1,30,31,3.23
13008,May,2020,Hawaii,HI,Passenger,1,0,1,56,57,1.75
13009,May,2020,Duval,FL,Passenger,0,2,2,356,358,0.56
13010,May,2020,Dakota,MN,Passenger,0,1,1,32,33,3.03
13011,May,2020,Jefferson,CO,Passenger,0,1,1,58,59,1.69
13012,May,2020,Penobscot,ME,Passenger,0,1,1,15,16,6.25
13013,May,2020,Santa Cruz,CA,Passenger,1,0,1,34,35,2.86
13014,May,2020,Garfield,WA,Truck,0,0,0,967,967,0.0
13015,May,2020,Queens,NY,Passenger,1,0,1,51,52,1.92
13016,May,2020,Brevard,FL,Passenger,0,1,1,84,85,1.18
13017,May,2020,Whitman,WA,Passenger,45,48,93,22175,22268,0.42
13018,May,2020,Clark,WA,Truck,0,0,0,81892,81892,0.0
13019,May,2020,Valencia,NM,Passenger,1,0,1,5,6,16.67
13020,May,2020,DeKalb,GA,Passenger,1,0,1,79,80,1.25
13021,May,2020,Moore,NC,Passenger,0,1,1,161,162,0.62
13022,May,2020,Montgomery,AL,Passenger,0,1,1,39,40,2.5
13023,May,2020,Clallam,WA,Passenger,222,165,387,50115,50502,0.77
13024,May,2020,Virginia Beach,VA,Passenger,1,0,1,669,670,0.15
13025,May,2020,Maricopa,AZ,Passenger,5,6,11,1418,1429,0.77
13026,May,2020,Boone,MO,Passenger,0,1,1,10,11,9.09
13027,May,2020,Spokane,WA,Passenger,721,479,1200,315019,316219,0.38
13028,May,2020,Rogers,OK,Passenger,1,0,1,5,6,16.67
13029,May,2020,Thurston,WA,Truck,0,0,0,55495,55495,0.0
13030,May,2020,Kitsap,WA,Passenger,1312,678,1990,179656,181646,1.1
13031,May,2020,Adams,WA,Passenger,8,7,15,12719,12734,0.12
13032,May,2020,Snohomish,WA,Passenger,4402,1748,6150,533885,540035,1.14
13033,May,2020,Carroll,NH,Passenger,0,1,1,4,5,20.0
13034,May,2020,Riverside,CA,Passenger,3,1,4,625,629,0.64
13035,May,2020,Skamania,WA,Passenger,30,17,47,8525,8572,0.55
13036,May,2020,Lee,FL,Passenger,1,0,1,50,51,1.96
13037,May,2020,Washington,OR,Passenger,1,0,1,442,443,0.23
13038,May,2020,Nassau,NY,Passenger,4,0,4,33,37,10.81
13039,May,2020,St. Mary's,MD,Passenger,1,0,1,216,217,0.46
13040,May,2020,Owyhee,ID,Passenger,1,0,1,3,4,25.0
13041,May,2020,Loudoun,VA,Passenger,1,0,1,88,89,1.12
13042,May,2020,Cowlitz,WA,Truck,0,0,0,28759,28759,0.0
13043,May,2020,Lewis,WA,Passenger,99,108,207,58242,58449,0.35
13044,May,2020,Putnam,TN,Passenger,0,1,1,3,4,25.0
13045,May,2020,Bucks,PA,Passenger,1,0,1,20,21,4.76
13046,May,2020,Charles,MD,Passenger,1,1,2,73,75,2.67
13047,May,2020,Jefferson,WA,Truck,0,0,0,9510,9510,0.0
13048,May,2020,King,WA,Truck,5,1,6,181412,181418,0.0
13049,May,2020,Richland,SC,Passenger,0,1,1,154,155,0.65
13050,May,2020,Stevens,WA,Passenger,34,33,67,30736,30803,0.22
13051,May,2020,Kitsap,WA,Truck,0,0,0,53864,53864,0.0
13052,May,2020,District of Columbia,DC,Passenger,2,1,3,201,204,1.47
13053,May,2020,Cumberland,NC,Passenger,0,3,3,466,469,0.64
13054,May,2020,Clackamas,OR,Passenger,2,0,2,197,199,1.01
13055,May,2020,Ferry,WA,Truck,0,0,0,3540,3540,0.0
13056,May,2020,Placer,CA,Passenger,2,0,2,87,89,2.25
13057,May,2020,Richmond,GA,Passenger,0,1,1,86,87,1.15
13058,May,2020,Harrison,MS,Passenger,1,0,1,55,56,1.79
13059,May,2020,Kent,MI,Passenger,0,1,1,23,24,4.17
13060,May,2020,Adams,WA,Truck,0,0,0,5217,5217,0.0
13061,May,2020,Jones,GA,Passenger,1,0,1,1,2,50.0
13062,May,2020,Kittitas,WA,Truck,0,0,0,14554,14554,0.0
13063,May,2020,San Francisco,CA,Passenger,1,1,2,96,98,2.04
13064,May,2020,Island,WA,Truck,1,0,1,21136,21137,0.0
13065,May,2020,Middlesex,MA,Passenger,1,1,2,96,98,2.04
13066,May,2020,Lincoln,WA,Truck,0,0,0,4618,4618,0.0
13067,May,2020,Fresno,CA,Passenger,1,0,1,183,184,0.54
13068,May,2020,Pend Oreille,WA,Passenger,7,6,13,9217,9230,0.14
13069,May,2020,Honolulu,HI,Passenger,4,2,6,448,454,1.32
13070,May,2020,Pima,AZ,Passenger,3,1,4,343,347,1.15
13071,May,2020,Albemarle,VA,Passenger,1,0,1,20,21,4.76
13072,May,2020,Pierce,WA,Passenger,2351,1675,4026,547592,551618,0.73
13073,May,2020,Portsmouth,VA,Passenger,0,1,1,76,77,1.3
13074,May,2020,Thurston,WA,Passenger,1136,733,1869,196825,198694,0.94
13075,May,2020,King,WA,Passenger,24017,7688,31705,1374959,1406664,2.25
13076,May,2020,El Paso,CO,Passenger,2,0,2,717,719,0.28
13077,May,2020,Benton,WA,Truck,0,0,0,42474,42474,0.0
13078,May,2020,Twin Falls,ID,Passenger,0,1,1,26,27,3.7
13079,May,2020,San Joaquin,CA,Passenger,1,0,1,127,128,0.78
13080,May,2020,Fairbanks North Star,AK,Passenger,0,1,1,99,100,1.0
13081,May,2020,Shelby,TN,Passenger,0,1,1,86,87,1.15
13082,May,2020,Pend Oreille,WA,Truck,0,0,0,5741,5741,0.0
13083,May,2020,Santa Clara,CA,Passenger,7,2,9,304,313,2.88
13084,May,2020,Boulder,CO,Passenger,0,1,1,45,46,2.17
13085,May,2020,Lincoln,WA,Passenger,4,12,16,7640,7656,0.21
13086,May,2020,Greene,MO,Passenger,0,1,1,30,31,3.23
13087,May,2020,Wahkiakum,WA,Truck,0,0,0,1759,1759,0.0
13088,May,2020,Alameda,CA,Passenger,2,1,3,271,274,1.09
13089,May,2020,Sumter,FL,Passenger,0,1,1,9,10,10.0
13090,May,2020,Williamson,TX,Passenger,0,2,2,137,139,1.44
13091,May,2020,Osceola,FL,Passenger,1,0,1,39,40,2.5
13092,May,2020,Goochland,VA,Passenger,2,1,3,258,261,1.15
13093,May,2020,Chesapeake,VA,Passenger,0,2,2,420,422,0.47
13094,May,2020,Palm Beach,FL,Passenger,0,1,1,80,81,1.23
13095,May,2020,Walla Walla,WA,Passenger,70,62,132,35820,35952,0.37
13096,May,2020,Asotin,WA,Passenger,16,12,28,12338,12366,0.23
13097,May,2020,Benton,WA,Passenger,354,321,675,134165,134840,0.5
13098,May,2020,Skagit,WA,Passenger,400,216,616,91169,91785,0.67
13099,May,2020,Norfolk,VA,Passenger,2,2,4,345,349,1.15
13100,May,2020,Arapahoe,CO,Passenger,1,0,1,132,133,0.75
13101,May,2020,Klickitat,WA,Passenger,53,40,93,15273,15366,0.61
13102,May,2020,Pacific,WA,Passenger,31,33,64,15703,15767,0.41
13103,May,2020,Walla Walla,WA,Truck,0,0,0,13670,13670,0.0
13104,May,2020,Los Angeles,CA,Passenger,7,11,18,991,1009,1.78
13105,May,2020,Ferry,WA,Passenger,5,3,8,4331,4339,0.18
13106,May,2021,Erie,NY,Passenger,1,0,1,39,40,2.5
13107,May,2021,Adams,WA,Truck,0,0,0,5374,5374,0.0
13108,May,2021,Ferry,WA,Passenger,9,3,12,4373,4385,0.27
13109,May,2021,Adams,WA,Passenger,11,9,20,13043,13063,0.15
13110,May,2021,Lincoln,WA,Passenger,5,13,18,7733,7751,0.23
13111,May,2021,Whatcom,WA,Passenger,1386,596,1982,150988,152970,1.3
13112,May,2021,San Joaquin,CA,Passenger,1,0,1,105,106,0.94
13113,May,2021,Howard,IN,Passenger,0,1,1,3,4,25.0
13114,May,2021,El Paso,TX,Passenger,3,0,3,375,378,0.79
13115,May,2021,Pend Oreille,WA,Truck,0,0,0,5748,5748,0.0
13116,May,2021,Kitsap,WA,Truck,0,0,0,54547,54547,0.0
13117,May,2021,Hamilton,IN,Passenger,2,0,2,33,35,5.71
13118,May,2021,Richland,SC,Passenger,0,1,1,139,140,0.71
13119,May,2021,Sarasota,FL,Passenger,2,0,2,27,29,6.9
13120,May,2021,Clallam,WA,Truck,1,0,1,22005,22006,0.0
13121,May,2021,Platte,MO,Passenger,1,0,1,18,19,5.26
13122,May,2021,Missoula,MT,Passenger,1,0,1,61,62,1.61
13123,May,2021,Howard,MD,Passenger,0,1,1,61,62,1.61
13124,May,2021,Multnomah,OR,Passenger,2,5,7,649,656,1.07
13125,May,2021,Asotin,WA,Truck,0,0,0,6783,6783,0.0
13126,May,2021,Hampshire,MA,Passenger,1,0,1,6,7,14.29
13127,May,2021,Jefferson,NY,Passenger,0,1,1,210,211,0.47
13128,May,2021,Klamath,OR,Passenger,1,0,1,31,32,3.12
13129,May,2021,Pennington,SD,Passenger,1,0,1,31,32,3.12
13130,May,2021,Benton,WA,Passenger,504,385,889,136106,136995,0.65
13131,May,2021,Montgomery,MD,Passenger,2,1,3,226,229,1.31
13132,May,2021,Ray,MO,Passenger,0,1,1,1,2,50.0
13133,May,2021,Portsmouth,VA,Passenger,0,1,1,77,78,1.28
13134,May,2021,Owyhee,ID,Passenger,1,0,1,3,4,25.0
13135,May,2021,Columbia,WA,Passenger,6,3,9,2476,2485,0.36
13136,May,2021,Kittitas,WA,Truck,0,0,0,14768,14768,0.0
13137,May,2021,Lewis,WA,Passenger,157,135,292,59809,60101,0.49
13138,May,2021,Pierce,WA,Passenger,3382,1941,5323,559989,565312,0.94
13139,May,2021,San Juan,WA,Passenger,423,131,554,14216,14770,3.75
13140,May,2021,Flathead,MT,Passenger,1,0,1,44,45,2.22
13141,May,2021,Sumter,FL,Passenger,0,1,1,10,11,9.09
13142,May,2021,Arapahoe,CO,Passenger,1,0,1,112,113,0.88
13143,May,2021,Klickitat,WA,Truck,0,0,0,8263,8263,0.0
13144,May,2021,Sumter,SC,Passenger,0,1,1,39,40,2.5
13145,May,2021,Skamania,WA,Truck,0,0,0,4030,4030,0.0
13146,May,2021,Lake,FL,Passenger,1,0,1,22,23,4.35
13147,May,2021,Bexar,TX,Passenger,3,4,7,530,537,1.3
13148,May,2021,New York,NY,Passenger,1,0,1,47,48,2.08
13149,May,2021,Carroll,MD,Passenger,0,1,1,18,19,5.26
13150,May,2021,Clackamas,OR,Passenger,2,0,2,172,174,1.15
13151,May,2021,Milwaukee,WI,Passenger,1,0,1,38,39,2.56
13152,May,2021,Pinellas,FL,Passenger,0,1,1,94,95,1.05
13153,May,2021,Denver,CO,Passenger,1,0,1,110,111,0.9
13154,May,2021,Harnett,NC,Passenger,1,1,2,172,174,1.15
13155,May,2021,El Dorado,CA,Passenger,1,0,1,29,30,3.33
13156,May,2021,Nassau,NY,Passenger,3,0,3,25,28,10.71
13157,May,2021,San Francisco,CA,Passenger,1,1,2,87,89,2.25
13158,May,2021,Montgomery,PA,Passenger,1,0,1,24,25,4.0
13159,May,2021,Chelan,WA,Passenger,322,98,420,54729,55149,0.76
13160,May,2021,Montgomery,OH,Passenger,0,1,1,57,58,1.72
13161,May,2021,Wilson,NC,Passenger,1,0,1,0,1,100.0
13162,May,2021,Asotin,WA,Passenger,19,14,33,12700,12733,0.26
13163,May,2021,St. Clair,IL,Passenger,1,0,1,135,136,0.74
13164,May,2021,Cowlitz,WA,Passenger,218,136,354,72447,72801,0.49
13165,May,2021,Klickitat,WA,Passenger,66,47,113,15237,15350,0.74
13166,May,2021,Skagit,WA,Passenger,577,265,842,91964,92806,0.91
13167,May,2021,Walla Walla,WA,Passenger,110,72,182,36556,36738,0.5
13168,May,2021,Jones,GA,Passenger,1,0,1,1,2,50.0
13169,May,2021,Nueces,TX,Passenger,1,0,1,77,78,1.28
13170,May,2021,Allen,IN,Passenger,1,0,1,16,17,5.88
13171,May,2021,Clark,WA,Truck,0,0,0,84190,84190,0.0
13172,May,2021,Duval,FL,Passenger,0,2,2,334,336,0.6
13173,May,2021,Williamson,TX,Passenger,0,2,2,106,108,1.85
13174,May,2021,Rogers,OK,Passenger,1,0,1,3,4,25.0
13175,May,2021,Powhatan,VA,Passenger,1,0,1,1,2,50.0
13176,May,2021,Goochland,VA,Passenger,4,2,6,226,232,2.59
13177,May,2021,Contra Costa,CA,Passenger,3,3,6,267,273,2.2
13178,May,2021,Fresno,CA,Passenger,1,0,1,168,169,0.59
13179,May,2021,Morris,NJ,Passenger,1,0,1,14,15,6.67
13180,May,2021,Lincoln,WA,Truck,0,0,0,4754,4754,0.0
13181,May,2021,Columbia,WA,Truck,0,0,0,1552,1552,0.0
13182,May,2021,Arlington,VA,Passenger,0,1,1,137,138,0.72
13183,May,2021,Thurston,WA,Truck,0,0,0,56635,56635,0.0
13184,May,2021,Yakima,WA,Passenger,211,145,356,169299,169655,0.21
13185,May,2021,Benton,WA,Truck,0,0,0,43665,43665,0.0
13186,May,2021,Ventura,CA,Passenger,1,1,2,262,264,0.76
13187,May,2021,Hennepin,MN,Passenger,2,0,2,75,77,2.6
13188,May,2021,Stevens,WA,Passenger,42,45,87,30559,30646,0.28
13189,May,2021,Juneau,AK,Passenger,0,1,1,25,26,3.85
13190,May,2021,Wahkiakum,WA,Passenger,13,7,20,3113,3133,0.64
13191,May,2021,Fairfax,VA,Passenger,4,4,8,687,695,1.15
13192,May,2021,Garfield,WA,Passenger,0,2,2,1370,1372,0.15
13193,May,2021,Oldham,KY,Passenger,0,1,1,4,5,20.0
13194,May,2021,Thurston,WA,Passenger,1543,852,2395,198108,200503,1.19
13195,May,2021,Philadelphia,PA,Passenger,1,0,1,48,49,2.04
13196,May,2021,Kittitas,WA,Passenger,155,62,217,29978,30195,0.72
13197,May,2021,Santa Cruz,CA,Passenger,1,0,1,26,27,3.7
13198,May,2021,Vigo,IN,Passenger,1,0,1,5,6,16.67
13199,May,2021,Moore,NC,Passenger,0,1,1,132,133,0.75
13200,May,2021,Riverside,CA,Passenger,5,1,6,551,557,1.08
13201,May,2021,Lake,IL,Passenger,2,0,2,154,156,1.28
13202,May,2021,Harris,TX,Passenger,1,1,2,195,197,1.02
13203,May,2021,Skagit,WA,Truck,1,0,1,33056,33057,0.0
13204,May,2021,Middlesex,MA,Passenger,1,1,2,93,95,2.11
13205,May,2021,Harrison,MS,Passenger,2,0,2,49,51,3.92
13206,May,2021,Charles,MD,Passenger,1,1,2,68,70,2.86
13207,May,2021,New Haven,CT,Passenger,0,2,2,29,31,6.45
13208,May,2021,Honolulu,HI,Passenger,5,2,7,397,404,1.73
13209,May,2021,District of Columbia,DC,Passenger,5,1,6,196,202,2.97
13210,May,2021,Maui,HI,Passenger,1,0,1,26,27,3.7
13211,May,2021,Dallas,TX,Passenger,1,0,1,158,159,0.63
13212,May,2021,Deschutes,OR,Passenger,1,0,1,112,113,0.88
13213,May,2021,Williams,ND,Passenger,0,1,1,7,8,12.5
13214,May,2021,Anchorage,AK,Passenger,1,0,1,137,138,0.72
13215,May,2021,Allegheny,PA,Passenger,1,1,2,64,66,3.03
13216,May,2021,Mason,WA,Passenger,207,136,343,48113,48456,0.71
13217,May,2021,San Diego,CA,Passenger,16,6,22,2601,2623,0.84
13218,May,2021,Lee,FL,Passenger,1,0,1,36,37,2.7
13219,May,2021,Prince George's,MD,Passenger,2,1,3,139,142,2.11
13220,May,2021,Carson City,NV,Passenger,1,0,1,10,11,9.09
13221,May,2021,Lane,OR,Passenger,0,1,1,126,127,0.79
13222,May,2021,Pierce,WA,Truck,0,0,0,145896,145896,0.0
13223,May,2021,Okanogan,WA,Truck,0,0,0,16755,16755,0.0
13224,May,2021,Kings,NY,Passenger,1,0,1,66,67,1.49
13225,May,2021,Kern,CA,Passenger,0,1,1,211,212,0.47
13226,May,2021,Monterey,CA,Passenger,0,1,1,148,149,0.67
13227,May,2021,Yakima,WA,Truck,0,0,0,61680,61680,0.0
13228,May,2021,Spokane,WA,Passenger,1030,624,1654,325579,327233,0.51
13229,May,2021,Placer,CA,Passenger,2,0,2,80,82,2.44
13230,May,2021,Queens,NY,Passenger,2,0,2,48,50,4.0
13231,May,2021,Suffolk,VA,Passenger,1,0,1,126,127,0.79
13232,May,2021,Cumberland,NC,Passenger,0,2,2,427,429,0.47
13233,May,2021,Boone,MO,Passenger,0,1,1,8,9,11.11
13234,May,2021,Virginia Beach,VA,Passenger,3,0,3,619,622,0.48
13235,May,2021,Sacramento,CA,Passenger,2,0,2,221,223,0.9
13236,May,2021,Franklin,WA,Passenger,117,95,212,61959,62171,0.34
13237,May,2021,Santa Clara,CA,Passenger,8,3,11,255,266,4.14
13238,May,2021,Miami-Dade,FL,Passenger,1,0,1,96,97,1.03
13239,May,2021,Bartow,GA,Passenger,0,1,1,4,5,20.0
13240,May,2021,Calvert,MD,Passenger,0,2,2,89,91,2.2
13241,May,2021,Jefferson,WA,Truck,0,0,0,9616,9616,0.0
13242,May,2021,Albemarle,VA,Passenger,1,0,1,19,20,5.0
13243,May,2021,Burlington,NJ,Passenger,0,1,1,129,130,0.77
13244,May,2021,Grays Harbor,WA,Truck,0,0,0,21430,21430,0.0
13245,May,2021,Cowlitz,WA,Truck,0,0,0,29142,29142,0.0
13246,May,2021,San Mateo,CA,Passenger,1,0,1,102,103,0.97
13247,May,2021,Pend Oreille,WA,Passenger,14,6,20,9275,9295,0.22
13248,May,2021,Douglas,NE,Passenger,1,1,2,49,51,3.92
13249,May,2021,Clark,NV,Passenger,4,2,6,618,624,0.96
13250,May,2021,Washington,MD,Passenger,1,0,1,13,14,7.14
13251,May,2021,Fort Bend,TX,Passenger,1,0,1,36,37,2.7
13252,May,2021,Charleston,SC,Passenger,2,0,2,83,85,2.35
13253,May,2021,Broward,FL,Passenger,1,0,1,103,104,0.96
13254,May,2021,Ferry,WA,Truck,0,0,0,3661,3661,0.0
13255,May,2021,RÃ­o Grande,PR,Passenger,1,0,1,1,2,50.0
13256,May,2021,Los Angeles,CA,Passenger,10,11,21,891,912,2.3
13257,May,2021,Greene,MO,Passenger,0,1,1,30,31,3.23
13258,May,2021,Camden,NJ,Passenger,0,1,1,15,16,6.25
13259,May,2021,Garfield,WA,Truck,0,0,0,999,999,0.0
13260,May,2021,Cape May,NJ,Passenger,0,1,1,8,9,11.11
13261,May,2021,Champaign,IL,Passenger,1,0,1,12,13,7.69
13262,May,2021,Nassau,FL,Passenger,1,0,1,30,31,3.23
13263,May,2021,El Paso,CO,Passenger,3,0,3,675,678,0.44
13264,May,2021,Penobscot,ME,Passenger,0,1,1,9,10,10.0
13265,May,2021,DeKalb,GA,Passenger,1,0,1,57,58,1.72
13266,May,2021,Franklin,WA,Truck,0,0,0,20653,20653,0.0
13267,May,2021,Lewis,WA,Truck,0,0,0,26895,26895,0.0
13268,May,2021,Wichita,TX,Passenger,1,0,1,39,40,2.5
13269,May,2021,Salt Lake,UT,Passenger,0,1,1,173,174,0.57
13270,May,2021,Douglas,WA,Truck,0,0,0,12664,12664,0.0
13271,May,2021,Wahkiakum,WA,Truck,0,0,0,1799,1799,0.0
13272,May,2021,DuPage,IL,Passenger,1,0,1,52,53,1.89
13273,May,2021,Plaquemines,LA,Passenger,0,1,1,16,17,5.88
13274,May,2021,Orange,CA,Passenger,4,3,7,425,432,1.62
13275,May,2021,Prince William,VA,Passenger,1,1,2,212,214,0.93
13276,May,2021,Norfolk,VA,Passenger,2,3,5,324,329,1.52
13277,May,2021,Mason,WA,Truck,0,0,0,21339,21339,0.0
13278,May,2021,Polk,FL,Passenger,1,0,1,54,55,1.82
13279,May,2021,Randolph,NC,Passenger,1,0,1,7,8,12.5
13280,May,2021,Whitman,WA,Truck,0,0,0,8571,8571,0.0
13281,May,2021,New London,CT,Passenger,1,2,3,223,226,1.33
13282,May,2021,King,WA,Truck,6,1,7,184688,184695,0.0
13283,May,2021,Stafford,VA,Passenger,2,1,3,98,101,2.97
13284,May,2021,Island,WA,Passenger,599,310,909,63247,64156,1.42
13285,May,2021,Danville,VA,Passenger,1,0,1,0,1,100.0
13286,May,2021,Houston,GA,Passenger,1,0,1,49,50,2.0
13287,May,2021,Island,WA,Truck,0,0,0,21611,21611,0.0
13288,May,2021,Manassas,VA,Passenger,0,1,1,7,8,12.5
13289,May,2021,Snohomish,WA,Passenger,5729,2002,7731,540294,548025,1.41
13290,May,2021,Alameda,CA,Passenger,3,0,3,237,240,1.25
13291,May,2021,Bucks,PA,Passenger,1,0,1,16,17,5.88
13292,May,2021,St. Mary's,MD,Passenger,1,0,1,208,209,0.48
13293,May,2021,Louisa,VA,Passenger,0,1,1,1,2,50.0
13294,May,2021,Maricopa,AZ,Passenger,5,4,9,1182,1191,0.76
13296,May,2021,Saginaw,MI,Passenger,1,0,1,8,9,11.11
13297,May,2021,Loudoun,VA,Passenger,1,0,1,74,75,1.33
13298,May,2021,Douglas,WA,Passenger,92,47,139,28516,28655,0.49
13299,May,2021,Travis,TX,Passenger,3,3,6,160,166,3.61
13300,May,2021,Kitsap,WA,Passenger,1796,833,2629,180423,183052,1.44
13301,May,2021,Richmond,GA,Passenger,0,1,1,77,78,1.28
13302,May,2021,Dakota,MN,Passenger,0,1,1,25,26,3.85
13303,May,2021,Rockingham,NH,Passenger,1,0,1,23,24,4.17
13304,May,2021,Walla Walla,WA,Truck,0,0,0,14041,14041,0.0
13305,May,2021,Grant,WA,Truck,0,0,0,27874,27874,0.0
13306,May,2021,Washington,OR,Passenger,1,0,1,387,388,0.26
13307,May,2021,Clallam,WA,Passenger,321,208,529,50426,50955,1.04
13308,May,2021,Boulder,CO,Passenger,0,1,1,45,46,2.17
13309,May,2021,Okaloosa,FL,Passenger,0,1,1,119,120,0.83
13310,May,2021,Okanogan,WA,Passenger,61,37,98,26414,26512,0.37
13311,May,2021,San Juan,WA,Truck,0,0,0,5926,5926,0.0
13312,May,2021,Jefferson,WA,Passenger,322,181,503,24893,25396,1.98
13313,May,2021,Sevier,AR,Passenger,0,1,1,0,1,100.0
13314,May,2021,Leavenworth,KS,Passenger,0,1,1,118,119,0.84
13315,May,2021,Snohomish,WA,Truck,1,0,1,126365,126366,0.0
13316,May,2021,Grant,WA,Passenger,102,87,189,66863,67052,0.28
13317,May,2021,Ulster,NY,Passenger,1,0,1,8,9,11.11
13318,May,2021,Spokane,WA,Truck,0,0,0,102090,102090,0.0
13319,May,2021,Shelby,OH,Passenger,0,1,1,1,2,50.0
13320,May,2021,Tulsa,OK,Passenger,1,0,1,39,40,2.5
13321,May,2021,Larimer,CO,Passenger,1,0,1,51,52,1.92
13322,May,2021,Chesapeake,VA,Passenger,0,4,4,387,391,1.02
13323,May,2021,Bradley,TN,Passenger,1,0,1,0,1,100.0
13324,May,2021,King,WA,Passenger,30043,8922,38965,1368667,1407632,2.77
13325,May,2021,Skamania,WA,Passenger,43,32,75,8395,8470,0.89
13326,May,2021,Wilson,TX,Passenger,0,1,1,3,4,25.0
13327,May,2021,Yamhill,OR,Passenger,1,0,1,36,37,2.7
13328,May,2021,Pacific,WA,Passenger,43,47,90,16070,16160,0.56
13329,May,2021,Douglas,CO,Passenger,0,1,1,74,75,1.33
13330,May,2021,Hillsborough,FL,Passenger,0,1,1,152,153,0.65
13331,May,2021,Sedgwick,KS,Passenger,0,1,1,86,87,1.15
13332,May,2021,Whitman,WA,Passenger,60,44,104,22016,22120,0.47
13333,May,2021,Kauai,HI,Passenger,1,0,1,16,17,5.88
13334,May,2021,Suffolk,MA,Passenger,0,2,2,33,35,5.71
13335,May,2021,Orange,FL,Passenger,1,0,1,108,109,0.92
13336,May,2021,Fairbanks North Star,AK,Passenger,0,1,1,84,85,1.18
13337,May,2021,Hudson,NJ,Passenger,1,0,1,41,42,2.38
13338,May,2021,Hawaii,HI,Passenger,1,0,1,47,48,2.08
13339,May,2021,Gwinnett,GA,Passenger,1,0,1,63,64,1.56
13340,May,2021,Carroll,NH,Passenger,0,1,1,5,6,16.67
13341,May,2021,Pacific,WA,Truck,0,0,0,7939,7939,0.0
13342,May,2021,Anne Arundel,MD,Passenger,4,2,6,393,399,1.5
13343,May,2021,Spartanburg,SC,Passenger,0,1,1,52,53,1.89
13344,May,2021,St. Louis,MO,Passenger,1,0,1,81,82,1.22
13345,May,2021,Clark,WA,Passenger,2757,1368,4125,321959,326084,1.27
13346,May,2021,Richmond,NY,Passenger,1,0,1,9,10,10.0
13347,May,2021,Collin,TX,Passenger,1,1,2,113,115,1.74
13348,May,2021,Pima,AZ,Passenger,2,1,3,281,284,1.06
13349,May,2021,Chelan,WA,Truck,0,0,0,23102,23102,0.0
13350,May,2021,Grays Harbor,WA,Passenger,161,139,300,49369,49669,0.6
13351,May,2021,Alexandria,VA,Passenger,2,0,2,130,132,1.52
13352,May,2021,Whatcom,WA,Truck,4,0,4,43874,43878,0.01
13353,May,2021,Frederick,MD,Passenger,1,1,2,67,69,2.9
13354,May,2021,Stevens,WA,Truck,0,0,0,18957,18957,0.0
13355,May,2021,Montgomery,TX,Passenger,1,1,2,43,45,4.44
13356,May,2022,Danville,VA,Passenger,1,0,1,0,1,100.0
13357,May,2022,Kittitas,WA,Passenger,248,79,327,29757,30084,1.09
13358,May,2022,Baltimore,MD,Passenger,1,0,1,69,70,1.43
13359,May,2022,Camden,NJ,Passenger,0,1,1,13,14,7.14
13360,May,2022,Tarrant,TX,Passenger,1,0,1,110,111,0.9
13361,May,2022,Bartow,GA,Passenger,0,1,1,3,4,25.0
13362,May,2022,Yellowstone,MT,Passenger,0,1,1,27,28,3.57
13363,May,2022,New London,CT,Passenger,2,5,7,191,198,3.54
13364,May,2022,Frederick,MD,Passenger,1,1,2,63,65,3.08
13365,May,2022,Virginia Beach,VA,Passenger,2,0,2,511,513,0.39
13366,May,2022,Duval,FL,Passenger,0,2,2,276,278,0.72
13367,May,2022,Pima,AZ,Passenger,1,0,1,221,222,0.45
13368,May,2022,Burlington,NJ,Passenger,0,2,2,109,111,1.8
13369,May,2022,Skagit,WA,Passenger,759,332,1091,90123,91214,1.2
13370,May,2022,Spokane,WA,Truck,1,0,1,102240,102241,0.0
13371,May,2022,Maricopa,AZ,Passenger,7,2,9,913,922,0.98
13372,May,2022,Lake,FL,Passenger,1,0,1,19,20,5.0
13373,May,2022,Powhatan,VA,Passenger,1,0,1,1,2,50.0
13374,May,2022,Wahkiakum,WA,Truck,0,0,0,1805,1805,0.0
13375,May,2022,Lee,FL,Passenger,1,0,1,29,30,3.33
13376,May,2022,Boone,MO,Passenger,0,1,1,9,10,10.0
13377,May,2022,Placer,CA,Passenger,2,0,2,64,66,3.03
13378,May,2022,Asotin,WA,Passenger,23,19,42,12730,12772,0.33
13379,May,2022,Montgomery,MD,Passenger,4,2,6,197,203,2.96
13380,May,2022,San Luis Obispo,CA,Passenger,1,0,1,54,55,1.82
13381,May,2022,Kings,NY,Passenger,1,0,1,58,59,1.69
13382,May,2022,Grays Harbor,WA,Passenger,205,158,363,49085,49448,0.73
13383,May,2022,Prince George's,MD,Passenger,2,1,3,119,122,2.46
13384,May,2022,Hidalgo,TX,Passenger,0,1,1,52,53,1.89
13385,May,2022,Fresno,CA,Passenger,1,0,1,137,138,0.72
13386,May,2022,Clark,NV,Passenger,4,2,6,511,517,1.16
13387,May,2022,St. Mary's,MD,Passenger,1,0,1,190,191,0.52
13388,May,2022,Spartanburg,SC,Passenger,0,1,1,40,41,2.44
13389,May,2022,Chesapeake,VA,Passenger,2,3,5,335,340,1.47
13390,May,2022,Multnomah,OR,Passenger,0,4,4,533,537,0.74
13391,May,2022,Oldham,KY,Passenger,0,1,1,4,5,20.0
13392,May,2022,Adams,WA,Passenger,16,10,26,12957,12983,0.2
13393,May,2022,Harnett,NC,Passenger,2,0,2,140,142,1.41
13394,May,2022,Kitsap,WA,Passenger,2354,1031,3385,178653,182038,1.86
13395,May,2022,Wichita,TX,Passenger,1,0,1,38,39,2.56
13396,May,2022,Suffolk,VA,Passenger,1,0,1,119,120,0.83
13397,May,2022,Collin,TX,Passenger,2,0,2,84,86,2.33
13398,May,2022,New Haven,CT,Passenger,0,2,2,27,29,6.9
13399,May,2022,Geary,KS,Passenger,1,0,1,82,83,1.2
13400,May,2022,Owyhee,ID,Passenger,1,0,1,2,3,33.33
13401,May,2022,Pacific,WA,Passenger,60,68,128,15915,16043,0.8
13402,May,2022,El Paso,CO,Passenger,3,1,4,590,594,0.67
13403,May,2022,El Paso,TX,Passenger,2,0,2,330,332,0.6
13404,May,2022,New York,NY,Passenger,1,0,1,33,34,2.94
13405,May,2022,DeKalb,GA,Passenger,1,0,1,46,47,2.13
13406,May,2022,Hudson,NJ,Passenger,2,0,2,34,36,5.56
13407,May,2022,Elmore,ID,Passenger,1,0,1,12,13,7.69
13408,May,2022,Sonoma,CA,Passenger,0,1,1,74,75,1.33
13409,May,2022,Richmond,GA,Passenger,0,1,1,64,65,1.54
13410,May,2022,Middlesex,MA,Passenger,1,1,2,74,76,2.63
13411,May,2022,King,WA,Truck,43,1,44,181226,181270,0.02
13412,May,2022,Spokane,WA,Passenger,1543,832,2375,325374,327749,0.72
13413,May,2022,Rogers,OK,Passenger,1,0,1,1,2,50.0
13414,May,2022,Travis,TX,Passenger,1,0,1,106,107,0.93
13415,May,2022,Louisa,VA,Passenger,0,1,1,1,2,50.0
13416,May,2022,Manassas,VA,Passenger,0,1,1,7,8,12.5
13417,May,2022,Cumberland,NC,Passenger,1,2,3,359,362,0.83
13418,May,2022,Santa Clara,CA,Passenger,10,1,11,216,227,4.85
13419,May,2022,Washington,MD,Passenger,2,0,2,14,16,12.5
13420,May,2022,Pennington,SD,Passenger,2,0,2,27,29,6.9
13421,May,2022,Kauai,HI,Passenger,1,0,1,16,17,5.88
13422,May,2022,Miami-Dade,FL,Passenger,1,0,1,77,78,1.28
13423,May,2022,San Juan,WA,Truck,1,0,1,5979,5980,0.02
13424,May,2022,Douglas,NE,Passenger,1,2,3,42,45,6.67
13425,May,2022,Plaquemines,LA,Passenger,1,1,2,16,18,11.11
13426,May,2022,Kitsap,WA,Truck,3,0,3,53699,53702,0.01
13427,May,2022,District of Columbia,DC,Passenger,5,0,5,177,182,2.75
13428,May,2022,Sarpy,NE,Passenger,1,0,1,51,52,1.92
13429,May,2022,Houston,GA,Passenger,1,0,1,33,34,2.94
13430,May,2022,Harris,TX,Passenger,2,0,2,140,142,1.41
13431,May,2022,Franklin,WA,Truck,0,0,0,20926,20926,0.0
13432,May,2022,Ray,MO,Passenger,0,1,1,1,2,50.0
13433,May,2022,Howard,MD,Passenger,0,1,1,54,55,1.82
13434,May,2022,Columbia,WA,Passenger,7,0,7,2441,2448,0.29
13435,May,2022,Pierce,WA,Truck,5,0,5,142329,142334,0.0
13436,May,2022,Adams,WA,Truck,0,0,0,5475,5475,0.0
13437,May,2022,Walla Walla,WA,Truck,0,0,0,13969,13969,0.0
13438,May,2022,Lincoln,WA,Truck,0,0,0,4839,4839,0.0
13439,May,2022,Clallam,WA,Passenger,410,244,654,49775,50429,1.3
13440,May,2022,Rockdale,GA,Passenger,1,0,1,8,9,11.11
13441,May,2022,Douglas,WA,Truck,0,0,0,12770,12770,0.0
13442,May,2022,Clark,WA,Truck,5,0,5,82915,82920,0.01
13443,May,2022,Howard,IN,Passenger,0,1,1,4,5,20.0
13445,May,2022,Anne Arundel,MD,Passenger,4,4,8,343,351,2.28
13446,May,2022,Stevens,WA,Passenger,64,54,118,30097,30215,0.39
13447,May,2022,Philadelphia,PA,Passenger,1,0,1,34,35,2.86
13448,May,2022,Bell,TX,Passenger,1,0,1,318,319,0.31
13449,May,2022,San Bernardino,CA,Passenger,1,1,2,323,325,0.62
13450,May,2022,Richmond,NY,Passenger,1,0,1,6,7,14.29
13451,May,2022,Jefferson,NY,Passenger,0,1,1,203,204,0.49
13452,May,2022,Douglas,CO,Passenger,0,1,1,71,72,1.39
13453,May,2022,Richland,SC,Passenger,0,1,1,124,125,0.8
13454,May,2022,Jefferson,WA,Truck,0,0,0,9493,9493,0.0
13455,May,2022,Sevier,AR,Passenger,0,1,1,0,1,100.0
13456,May,2022,Kittitas,WA,Truck,1,0,1,14675,14676,0.01
13457,May,2022,Harrison,MS,Passenger,2,0,2,44,46,4.35
13458,May,2022,Honolulu,HI,Passenger,5,4,9,319,328,2.74
13459,May,2022,Contra Costa,CA,Passenger,0,4,4,251,255,1.57
13460,May,2022,Fairbanks North Star,AK,Passenger,0,1,1,75,76,1.32
13461,May,2022,Hawaii,HI,Passenger,1,0,1,35,36,2.78
13462,May,2022,Okanogan,WA,Passenger,82,51,133,26409,26542,0.5
13463,May,2022,Pinellas,FL,Passenger,0,1,1,74,75,1.33
13464,May,2022,Grant,WA,Passenger,166,97,263,66720,66983,0.39
13465,May,2022,Ulster,NY,Passenger,1,0,1,9,10,10.0
13466,May,2022,Cowlitz,WA,Truck,1,1,2,28601,28603,0.01
13467,May,2022,Pend Oreille,WA,Truck,0,0,0,5629,5629,0.0
13468,May,2022,Lane,OR,Passenger,0,1,1,91,92,1.09
13469,May,2022,Lake,IL,Passenger,3,0,3,139,142,2.11
13470,May,2022,Klickitat,WA,Passenger,99,54,153,15249,15402,0.99
13471,May,2022,Lewis,WA,Passenger,231,173,404,59518,59922,0.67
13472,May,2022,Ventura,CA,Passenger,1,1,2,229,231,0.87
13473,May,2022,Moore,NC,Passenger,0,1,1,114,115,0.87
13474,May,2022,Los Angeles,CA,Passenger,8,8,16,763,779,2.05
13475,May,2022,Adams,CO,Passenger,1,0,1,38,39,2.56
13476,May,2022,Okanogan,WA,Truck,0,0,0,16665,16665,0.0
13477,May,2022,Broward,FL,Passenger,2,0,2,76,78,2.56
13478,May,2022,Leavenworth,KS,Passenger,0,1,1,102,103,0.97
13479,May,2022,Orange,FL,Passenger,1,0,1,91,92,1.09
13480,May,2022,Asotin,WA,Truck,0,0,0,6709,6709,0.0
13481,May,2022,Yakima,WA,Passenger,325,189,514,167089,167603,0.31
13482,May,2022,San Diego,CA,Passenger,14,9,23,2265,2288,1.01
13483,May,2022,Onslow,NC,Passenger,0,1,1,158,159,0.63
13484,May,2022,Albemarle,VA,Passenger,1,0,1,16,17,5.88
13485,May,2022,Garfield,WA,Truck,0,0,0,981,981,0.0
13486,May,2022,Nassau,NY,Passenger,2,0,2,26,28,7.14
13487,May,2022,Charleston,SC,Passenger,2,1,3,59,62,4.84
13488,May,2022,Santa Cruz,CA,Passenger,1,0,1,23,24,4.17
13489,May,2022,Bexar,TX,Passenger,4,3,7,434,441,1.59
13490,May,2022,Alameda,CA,Passenger,4,0,4,185,189,2.12
13491,May,2022,Las Animas,CO,Passenger,1,0,1,1,2,50.0
13492,May,2022,St. Louis,MO,Passenger,1,0,1,64,65,1.54
13493,May,2022,Clackamas,OR,Passenger,2,0,2,143,145,1.38
13494,May,2022,Williams,ND,Passenger,0,1,1,6,7,14.29
13495,May,2022,Escambia,FL,Passenger,0,1,1,130,131,0.76
13496,May,2022,Skamania,WA,Truck,0,0,0,3971,3971,0.0
13497,May,2022,Whitman,WA,Truck,0,0,0,8562,8562,0.0
13498,May,2022,Sumter,SC,Passenger,0,1,1,32,33,3.03
13499,May,2022,Wahkiakum,WA,Passenger,22,10,32,3085,3117,1.03
13500,May,2022,Fairfax,VA,Passenger,6,3,9,607,616,1.46
13501,May,2022,Arapahoe,CO,Passenger,0,1,1,77,78,1.28
13502,May,2022,Galveston,TX,Passenger,0,1,1,17,18,5.56
13503,May,2022,Portsmouth,VA,Passenger,0,1,1,74,75,1.33
13504,May,2022,Orange,CA,Passenger,5,2,7,351,358,1.96
13505,May,2022,Monterey,CA,Passenger,1,1,2,126,128,1.56
13506,May,2022,Platte,MO,Passenger,1,0,1,21,22,4.55
13507,May,2022,Nueces,TX,Passenger,1,1,2,54,56,3.57
13508,May,2022,Hillsborough,FL,Passenger,0,1,1,120,121,0.83
13509,May,2022,Rockingham,NH,Passenger,1,0,1,15,16,6.25
13510,May,2022,Kern,CA,Passenger,0,1,1,188,189,0.53
13511,May,2022,San Mateo,CA,Passenger,2,0,2,79,81,2.47
13512,May,2022,Rock Island,IL,Passenger,0,1,1,15,16,6.25
13513,May,2022,Coryell,TX,Passenger,1,0,1,98,99,1.01
13514,May,2022,Stafford,VA,Passenger,2,1,3,89,92,3.26
13515,May,2022,Dorchester,SC,Passenger,1,0,1,55,56,1.79
13516,May,2022,St. Tammany,LA,Passenger,1,0,1,34,35,2.86
13517,May,2022,Whatcom,WA,Passenger,1799,729,2528,148935,151463,1.67
13518,May,2022,Riverside,CA,Passenger,8,1,9,462,471,1.91
13519,May,2022,Salt Lake,UT,Passenger,1,1,2,130,132,1.52
13520,May,2022,Thurston,WA,Passenger,2127,1028,3155,194514,197669,1.6
13521,May,2022,Lincoln,OR,Passenger,0,1,1,26,27,3.7
13522,May,2022,Lewis,WA,Truck,0,0,0,26423,26423,0.0
13523,May,2022,Queens,NY,Passenger,1,0,1,41,42,2.38
13524,May,2022,Marin,CA,Passenger,0,1,1,29,30,3.33
13525,May,2022,Snohomish,WA,Truck,6,0,6,124132,124138,0.0
13526,May,2022,Larimer,CO,Passenger,1,0,1,46,47,2.13
13527,May,2022,Pacific,WA,Truck,0,0,0,7950,7950,0.0
13528,May,2022,Douglas,WA,Passenger,131,58,189,28516,28705,0.66
13529,May,2022,Ferry,WA,Truck,0,0,0,3569,3569,0.0
13530,May,2022,Wilson,TX,Passenger,0,1,1,2,3,33.33
13531,May,2022,Randolph,NC,Passenger,1,0,1,5,6,16.67
13532,May,2022,Gwinnett,GA,Passenger,1,0,1,49,50,2.0
13533,May,2022,San Juan,WA,Passenger,499,152,651,14097,14748,4.41
13534,May,2022,Fort Bend,TX,Passenger,1,0,1,26,27,3.7
13535,May,2022,Lincoln,WA,Passenger,8,18,26,7692,7718,0.34
13536,May,2022,Okaloosa,FL,Passenger,0,1,1,96,97,1.03
13537,May,2022,Wood,OH,Passenger,0,1,1,4,5,20.0
13538,May,2022,Loudoun,VA,Passenger,2,1,3,63,66,4.55
13539,May,2022,Pend Oreille,WA,Passenger,16,11,27,9013,9040,0.3
13540,May,2022,Benton,WA,Truck,2,0,2,43549,43551,0.0
13541,May,2022,San Joaquin,CA,Passenger,1,1,2,89,91,2.2
13542,May,2022,Chelan,WA,Truck,2,0,2,23067,23069,0.01
13543,May,2022,Hamilton,IN,Passenger,1,0,1,20,21,4.76
13544,May,2022,Jefferson,WA,Passenger,425,215,640,24617,25257,2.53
13545,May,2022,Denton,TX,Passenger,1,0,1,62,63,1.59
13546,May,2022,Sacramento,CA,Passenger,2,0,2,190,192,1.04
13547,May,2022,DuPage,IL,Passenger,1,0,1,46,47,2.13
13548,May,2022,Chelan,WA,Passenger,450,126,576,54379,54955,1.05
13549,May,2022,Columbia,WA,Truck,0,0,0,1581,1581,0.0
13550,May,2022,Anchorage,AK,Passenger,1,0,1,119,120,0.83
13551,May,2022,Essex,NJ,Passenger,2,0,2,9,11,18.18
13552,May,2022,Thurston,WA,Truck,4,0,4,55452,55456,0.01
13553,May,2022,Pierce,WA,Passenger,4952,2291,7243,546758,554001,1.31
13554,May,2022,Solano,CA,Passenger,1,0,1,162,163,0.61
13555,May,2022,Montgomery,PA,Passenger,2,0,2,20,22,9.09
13556,May,2022,Skamania,WA,Passenger,70,45,115,8209,8324,1.38
13557,May,2022,Grays Harbor,WA,Truck,0,0,0,21307,21307,0.0
13558,May,2022,Whitman,WA,Passenger,84,58,142,22034,22176,0.64
13559,May,2022,Kings,CA,Passenger,2,1,3,298,301,1.0
13560,May,2022,Franklin,WA,Passenger,181,110,291,62027,62318,0.47
13561,May,2022,Skagit,WA,Truck,2,0,2,32401,32403,0.01
13562,May,2022,Klickitat,WA,Truck,1,0,1,8293,8294,0.01
13563,May,2022,Grant,WA,Truck,0,0,0,27995,27995,0.0
13564,May,2022,Norfolk,VA,Passenger,3,3,6,289,295,2.03
13565,May,2022,Cape May,NJ,Passenger,0,1,1,7,8,12.5
13566,May,2022,Island,WA,Truck,1,0,1,21433,21434,0.0
13567,May,2022,Suffolk,MA,Passenger,0,1,1,21,22,4.55
13568,May,2022,Garfield,WA,Passenger,0,3,3,1329,1332,0.23
13569,May,2022,St. Clair,IL,Passenger,2,0,2,118,120,1.67
13570,May,2022,Hennepin,MN,Passenger,2,0,2,53,55,3.64
13571,May,2022,Charles,MD,Passenger,1,1,2,54,56,3.57
13572,May,2022,Snohomish,WA,Passenger,8141,2474,10615,533059,543674,1.95
13573,May,2022,Wake,NC,Passenger,1,0,1,86,87,1.15
13574,May,2022,Allen,IN,Passenger,1,0,1,13,14,7.14
13575,May,2022,Sedgwick,KS,Passenger,1,1,2,74,76,2.63
13576,May,2022,Cook,IL,Passenger,3,0,3,184,187,1.6
13577,May,2022,Ferry,WA,Passenger,20,4,24,4434,4458,0.54
13578,May,2022,Mason,WA,Truck,1,0,1,21058,21059,0.0
13579,May,2022,Montgomery,AL,Passenger,0,1,1,32,33,3.03
13580,May,2022,Boulder,CO,Passenger,1,0,1,34,35,2.86
13581,May,2022,Carson City,NV,Passenger,1,0,1,8,9,11.11
13582,May,2022,Juneau,AK,Passenger,0,1,1,29,30,3.33
13583,May,2022,Island,WA,Passenger,797,373,1170,62040,63210,1.85
13584,May,2022,Prince William,VA,Passenger,0,1,1,191,192,0.52
13585,May,2022,Clallam,WA,Truck,1,0,1,21957,21958,0.0
13586,May,2022,Mason,WA,Passenger,304,179,483,47338,47821,1.01
13587,May,2022,Williamson,TX,Passenger,1,2,3,81,84,3.57
13588,May,2022,Stevens,WA,Truck,0,0,0,18961,18961,0.0
13589,May,2022,Cowlitz,WA,Passenger,322,175,497,70710,71207,0.7
13590,May,2022,Montgomery,TX,Passenger,1,0,1,29,30,3.33
13591,May,2022,Arlington,VA,Passenger,1,0,1,124,125,0.8
13592,May,2022,Penobscot,ME,Passenger,0,1,1,7,8,12.5
13593,May,2022,Hamilton,OH,Passenger,1,0,1,28,29,3.45
13594,May,2022,King,WA,Passenger,40013,11054,51067,1349163,1400230,3.65
13595,May,2022,Saratoga,NY,Passenger,1,0,1,38,39,2.56
13596,May,2022,Goochland,VA,Passenger,3,2,5,130,135,3.7
13597,May,2022,Carroll,MD,Passenger,0,1,1,15,16,6.25
13598,May,2022,Alexandria,VA,Passenger,3,0,3,105,108,2.78
13599,May,2022,Greene,MO,Passenger,0,1,1,23,24,4.17
13600,May,2022,Calvert,MD,Passenger,0,2,2,76,78,2.56
13601,May,2022,Yakima,WA,Truck,0,0,0,61425,61425,0.0
13602,May,2022,Walla Walla,WA,Passenger,171,97,268,35973,36241,0.74
13603,May,2022,Allegheny,PA,Passenger,1,1,2,52,54,3.7
13604,May,2022,Sarasota,FL,Passenger,2,0,2,25,27,7.41
13605,May,2022,Clark,WA,Passenger,3936,1735,5671,316813,322484,1.76
13606,May,2022,Carroll,NH,Passenger,0,1,1,5,6,16.67
13607,May,2022,Benton,WA,Passenger,729,455,1184,135276,136460,0.87
13608,May,2022,Whatcom,WA,Truck,5,0,5,43377,43382,0.01
13609,May,2023,Loudoun,VA,Passenger,2,0,2,55,57,3.51
13610,May,2023,Richmond,GA,Passenger,0,1,1,55,56,1.79
13611,May,2023,Gwinnett,GA,Passenger,1,0,1,38,39,2.56
13612,May,2023,New London,CT,Passenger,1,4,5,165,170,2.94
13613,May,2023,Boulder,CO,Passenger,1,0,1,23,24,4.17
13614,May,2023,Maricopa,AZ,Passenger,7,3,10,551,561,1.78
13615,May,2023,Bexar,TX,Passenger,3,3,6,328,334,1.8
13616,May,2023,Pulaski,AR,Passenger,3,0,3,21,24,12.5
13617,May,2023,King,WA,Truck,684,2,686,174691,175377,0.39
13618,May,2023,Denton,TX,Passenger,1,0,1,44,45,2.22
13619,May,2023,Larimer,CO,Passenger,1,0,1,33,34,2.94
13620,May,2023,Kern,CA,Passenger,1,1,2,164,166,1.2
13621,May,2023,Sarpy,NE,Passenger,1,0,1,45,46,2.17
13622,May,2023,Dorchester,SC,Passenger,1,0,1,35,36,2.78
13623,May,2023,St. Louis,MO,Passenger,1,0,1,47,48,2.08
13624,May,2023,Adams,WA,Truck,2,0,2,5262,5264,0.04
13625,May,2023,Charleston,SC,Passenger,1,2,3,49,52,5.77
13626,May,2023,Garfield,WA,Truck,0,0,0,964,964,0.0
13627,May,2023,Clark,NV,Passenger,4,2,6,361,367,1.63
13628,May,2023,DeKalb,GA,Passenger,1,0,1,37,38,2.63
13629,May,2023,Cumberland,NC,Passenger,1,2,3,280,283,1.06
13630,May,2023,Anne Arundel,MD,Passenger,5,4,9,281,290,3.1
13631,May,2023,Jackson,OK,Passenger,0,1,1,31,32,3.12
13632,May,2023,Walla Walla,WA,Passenger,215,115,330,35196,35526,0.93
13633,May,2023,San Bernardino,CA,Passenger,2,1,3,245,248,1.21
13634,May,2023,Klickitat,WA,Truck,11,0,11,8198,8209,0.13
13635,May,2023,Prince George's,MD,Passenger,2,1,3,100,103,2.91
13636,May,2023,St. Clair,IL,Passenger,1,0,1,95,96,1.04
13637,May,2023,Marin,CA,Passenger,0,1,1,27,28,3.57
13638,May,2023,Wahkiakum,WA,Passenger,26,17,43,3018,3061,1.4
13639,May,2023,District of Columbia,DC,Passenger,5,0,5,144,149,3.36
13640,May,2023,Chelan,WA,Truck,29,0,29,22965,22994,0.13
13641,May,2023,Yellowstone,MT,Passenger,0,1,1,16,17,5.88
13642,May,2023,Beaufort,SC,Passenger,1,0,1,18,19,5.26
13643,May,2023,Kitsap,WA,Truck,70,0,70,52120,52190,0.13
13644,May,2023,Spokane,WA,Truck,39,0,39,101203,101242,0.04
13645,May,2023,Fairfax,VA,Truck,1,0,1,84,85,1.18
13646,May,2023,Arlington,VA,Passenger,1,0,1,96,97,1.03
13647,May,2023,Stevens,WA,Passenger,110,64,174,29562,29736,0.59
13648,May,2023,Kings,CA,Passenger,2,1,3,255,258,1.16
13649,May,2023,San Juan,WA,Passenger,611,173,784,13720,14504,5.41
13650,May,2023,El Paso,CO,Passenger,3,1,4,465,469,0.85
13651,May,2023,Frederick,MD,Passenger,1,1,2,48,50,4.0
13652,May,2023,Harrison,MS,Passenger,1,0,1,28,29,3.45
13653,May,2023,Howard,MD,Passenger,0,1,1,40,41,2.44
13654,May,2023,Wichita,TX,Passenger,2,0,2,29,31,6.45
13655,May,2023,Asotin,WA,Passenger,34,20,54,12351,12405,0.44
13656,May,2023,Carroll,MD,Passenger,0,1,1,16,17,5.88
13657,May,2023,Calvert,MD,Passenger,1,1,2,69,71,2.82
13658,May,2023,Whitman,WA,Truck,4,0,4,8547,8551,0.05
13659,May,2023,Snohomish,WA,Passenger,12139,2974,15113,524703,539816,2.8
13660,May,2023,Virginia Beach,VA,Passenger,2,0,2,409,411,0.49
13661,May,2023,Onslow,NC,Passenger,0,1,1,133,134,0.75
13662,May,2023,Chesapeake,VA,Passenger,2,3,5,263,268,1.87
13663,May,2023,Sedgwick,KS,Passenger,1,0,1,52,53,1.89
13664,May,2023,Mason,WA,Passenger,429,206,635,45953,46588,1.36
13665,May,2023,Yavapai,AZ,Passenger,1,0,1,19,20,5.0
13666,May,2023,Chelan,WA,Passenger,619,159,778,53890,54668,1.42
13667,May,2023,Hudson,NJ,Passenger,1,0,1,15,16,6.25
13668,May,2023,Clark,WA,Truck,90,0,90,80813,80903,0.11
13669,May,2023,Portsmouth,VA,Passenger,0,1,1,57,58,1.72
13670,May,2023,Pierce,WA,Passenger,7397,2707,10104,527950,538054,1.88
13671,May,2023,Franklin,WA,Truck,4,0,4,20695,20699,0.02
13672,May,2023,Kauai,HI,Passenger,1,1,2,13,15,13.33
13673,May,2023,Whatcom,WA,Truck,57,0,57,42393,42450,0.13
13674,May,2023,Randolph,NC,Passenger,1,0,1,3,4,25.0
13675,May,2023,Berkeley,SC,Passenger,0,1,1,93,94,1.06
13676,May,2023,Moore,NC,Passenger,0,1,1,99,100,1.0
13677,May,2023,Cook,IL,Passenger,2,0,2,131,133,1.5
13678,May,2023,Grant,WA,Passenger,275,122,397,66534,66931,0.59
13679,May,2023,Alexandria,VA,Passenger,3,1,4,84,88,4.55
13680,May,2023,Jefferson,WA,Passenger,549,260,809,24141,24950,3.24
13681,May,2023,Whatcom,WA,Passenger,2374,867,3241,146794,150035,2.16
13683,May,2023,Middlesex,MA,Passenger,2,1,3,57,60,5.0
13684,May,2023,Allen,IN,Passenger,1,0,1,8,9,11.11
13685,May,2023,Skagit,WA,Passenger,1081,403,1484,88295,89779,1.65
13686,May,2023,Pend Oreille,WA,Truck,0,0,0,5568,5568,0.0
13687,May,2023,Yakima,WA,Truck,12,0,12,60495,60507,0.02
13688,May,2023,Washington,MD,Passenger,2,0,2,12,14,14.29
13689,May,2023,Santa Cruz,CA,Passenger,1,0,1,12,13,7.69
13690,May,2023,Platte,MO,Passenger,1,0,1,16,17,5.88
13691,May,2023,Okanogan,WA,Truck,7,0,7,16336,16343,0.04
13692,May,2023,Honolulu,HI,Passenger,2,3,5,233,238,2.1
13693,May,2023,Benton,WA,Passenger,1120,555,1675,134506,136181,1.23
13694,May,2023,Polk,OR,Passenger,0,1,1,14,15,6.67
13695,May,2023,Skamania,WA,Truck,1,0,1,3802,3803,0.03
13696,May,2023,St. Mary's,MD,Passenger,1,0,1,161,162,0.62
13697,May,2023,Ferry,WA,Passenger,20,4,24,4292,4316,0.56
13698,May,2023,New Haven,CT,Passenger,0,2,2,21,23,8.7
13699,May,2023,Ray,MO,Passenger,0,1,1,0,1,100.0
13700,May,2023,Galveston,TX,Passenger,0,1,1,15,16,6.25
13701,May,2023,Spokane,WA,Passenger,2227,1062,3289,320686,323975,1.02
13702,May,2023,Santa Barbara,CA,Passenger,1,0,1,60,61,1.64
13703,May,2023,Whitman,WA,Passenger,144,76,220,21873,22093,1.0
13704,May,2023,Fairfax,VA,Passenger,5,3,8,520,528,1.52
13705,May,2023,Jefferson,WA,Truck,12,0,12,9267,9279,0.13
13706,May,2023,Elmore,ID,Passenger,1,0,1,9,10,10.0
13707,May,2023,Madison,IL,Passenger,1,0,1,14,15,6.67
13708,May,2023,Mason,WA,Truck,10,0,10,20553,20563,0.05
13709,May,2023,Newport News,VA,Passenger,1,0,1,89,90,1.11
13710,May,2023,Lincoln,WA,Passenger,16,17,33,7646,7679,0.43
13711,May,2023,Clallam,WA,Passenger,533,280,813,48629,49442,1.64
13712,May,2023,Columbia,WA,Passenger,9,1,10,2407,2417,0.41
13713,May,2023,Arapahoe,CO,Passenger,1,1,2,63,65,3.08
13714,May,2023,St. Tammany,LA,Passenger,1,0,1,28,29,3.45
13715,May,2023,Lewis,WA,Truck,7,0,7,25864,25871,0.03
13716,May,2023,El Paso,TX,Passenger,2,0,2,248,250,0.8
13717,May,2023,Monterey,CA,Passenger,1,0,1,104,105,0.95
13718,May,2023,Dallas,TX,Passenger,1,0,1,70,71,1.41
13719,May,2023,Grays Harbor,WA,Truck,6,0,6,20817,20823,0.03
13720,May,2023,Collin,TX,Passenger,1,0,1,36,37,2.7
13721,May,2023,Camden,NJ,Passenger,0,1,1,12,13,7.69
13722,May,2023,Thurston,WA,Truck,57,0,57,53621,53678,0.11
13723,May,2023,Kootenai,ID,Truck,1,0,1,25,26,3.85
13724,May,2023,Escambia,FL,Passenger,0,1,1,103,104,0.96
13725,May,2023,Nueces,TX,Passenger,0,1,1,49,50,2.0
13726,May,2023,Sonoma,CA,Passenger,1,1,2,50,52,3.85
13727,May,2023,Kent,DE,Passenger,1,0,1,43,44,2.27
13728,May,2023,Pierce,WA,Truck,152,0,152,136292,136444,0.11
13729,May,2023,Franklin,WA,Passenger,300,136,436,61492,61928,0.7
13730,May,2023,Hidalgo,TX,Passenger,0,1,1,42,43,2.33
13731,May,2023,Multnomah,OR,Passenger,0,2,2,398,400,0.5
13732,May,2023,Garfield,WA,Passenger,1,3,4,1303,1307,0.31
13733,May,2023,Los Angeles,CA,Passenger,4,4,8,565,573,1.4
13734,May,2023,Island,WA,Truck,29,0,29,20927,20956,0.14
13735,May,2023,Cowlitz,WA,Truck,8,0,8,28004,28012,0.03
13736,May,2023,Plaquemines,LA,Passenger,1,1,2,12,14,14.29
13737,May,2023,Burlington,NJ,Passenger,0,2,2,87,89,2.25
13738,May,2023,Alameda,CA,Passenger,3,0,3,147,150,2.0
13739,May,2023,Jefferson,NY,Passenger,1,1,2,169,171,1.17
13740,May,2023,Okanogan,WA,Passenger,123,62,185,25949,26134,0.71
13741,May,2023,Snohomish,WA,Truck,162,0,162,120661,120823,0.13
13742,May,2023,Miami-Dade,FL,Passenger,1,0,1,53,54,1.85
13743,May,2023,San Juan,WA,Truck,12,0,12,5866,5878,0.2
13744,May,2023,Thurston,WA,Passenger,3033,1203,4236,189258,193494,2.19
13745,May,2023,Charles,MD,Passenger,1,1,2,47,49,4.08
13746,May,2023,Walla Walla,WA,Truck,5,0,5,13644,13649,0.04
13747,May,2023,Montgomery,MD,Passenger,3,2,5,166,171,2.92
13748,May,2023,Douglas,WA,Passenger,198,61,259,28577,28836,0.9
13749,May,2023,Lee,AL,Passenger,1,0,1,11,12,8.33
13750,May,2023,Adams,WA,Passenger,25,12,37,12934,12971,0.29
13751,May,2023,Stevens,WA,Truck,1,0,1,18642,18643,0.01
13752,May,2023,Sheridan,WY,Passenger,1,0,1,5,6,16.67
13753,May,2023,Hawaii,HI,Passenger,1,0,1,23,24,4.17
13754,May,2023,Hamilton,OH,Truck,1,0,1,2,3,33.33
13755,May,2023,Rock Island,IL,Passenger,0,1,1,13,14,7.14
13756,May,2023,Ferry,WA,Truck,0,0,0,3538,3538,0.0
13757,May,2023,Columbia,WA,Truck,0,0,0,1546,1546,0.0
13758,May,2023,Ulster,NY,Passenger,1,0,1,4,5,20.0
13759,May,2023,Douglas,NE,Passenger,1,1,2,25,27,7.41
13760,May,2023,Clallam,WA,Truck,20,0,20,21594,21614,0.09
13761,May,2023,Nassau,NY,Passenger,1,0,1,21,22,4.55
13762,May,2023,Stafford,VA,Passenger,3,1,4,71,75,5.33
13763,May,2023,Bell,TX,Passenger,1,0,1,233,234,0.43
13764,May,2023,Las Animas,CO,Passenger,1,0,1,0,1,100.0
13765,May,2023,Pacific,WA,Passenger,76,90,166,15521,15687,1.06
13766,May,2023,Champaign,IL,Passenger,1,0,1,7,8,12.5
13767,May,2023,Ventura,CA,Passenger,2,1,3,190,193,1.55
13768,May,2023,Douglas,CO,Passenger,0,1,1,49,50,2.0
13769,May,2023,Douglas,WA,Truck,7,0,7,12885,12892,0.05
13770,May,2023,Essex,NJ,Passenger,2,0,2,4,6,33.33
13771,May,2023,Grays Harbor,WA,Passenger,290,181,471,48014,48485,0.97
13772,May,2023,Benton,OR,Passenger,1,0,1,30,31,3.23
13773,May,2023,Napa,CA,Passenger,0,1,1,10,11,9.09
13774,May,2023,Norfolk,VA,Passenger,3,2,5,249,254,1.97
13775,May,2023,Cowlitz,WA,Passenger,454,206,660,69496,70156,0.94
13776,May,2023,Santa Clara,CA,Passenger,8,1,9,142,151,5.96
13777,May,2023,Goochland,VA,Passenger,0,1,1,36,37,2.7
13778,May,2023,Pend Oreille,WA,Passenger,30,11,41,8845,8886,0.46
13779,May,2023,Placer,CA,Passenger,1,0,1,50,51,1.96
13780,May,2023,King,WA,Passenger,55335,14137,69472,1316224,1385696,5.01
13781,May,2023,Asotin,WA,Truck,0,0,0,6599,6599,0.0
13782,May,2023,Skagit,WA,Truck,19,0,19,31695,31714,0.06
13783,May,2023,Hillsborough,FL,Passenger,0,1,1,95,96,1.04
13784,May,2023,Clark,WA,Passenger,5619,2279,7898,311557,319455,2.47
13785,May,2023,Kittitas,WA,Truck,8,0,8,14448,14456,0.06
13786,May,2023,Fairbanks North Star,AK,Passenger,0,1,1,45,46,2.17
13787,May,2023,Williamson,TX,Passenger,0,1,1,46,47,2.13
13788,May,2023,Rockdale,GA,Passenger,1,0,1,3,4,25.0
13789,May,2023,Richmond,NY,Passenger,1,0,1,6,7,14.29
13790,May,2023,Saratoga,NY,Passenger,1,1,2,27,29,6.9
13791,May,2023,Pacific,WA,Truck,3,0,3,7785,7788,0.04
13792,May,2023,Solano,CA,Passenger,5,0,5,132,137,3.65
13793,May,2023,Geary,KS,Passenger,1,0,1,67,68,1.47
13794,May,2023,Hoke,NC,Passenger,1,0,1,53,54,1.85
13795,May,2023,Cumberland,PA,Passenger,1,0,1,30,31,3.23
13796,May,2023,Kittitas,WA,Passenger,339,102,441,29165,29606,1.49
13797,May,2023,Broward,FL,Passenger,1,0,1,53,54,1.85
13798,May,2023,Sarasota,FL,Passenger,1,0,1,14,15,6.67
13799,May,2023,Kitsap,WA,Passenger,3126,1246,4372,175192,179564,2.43
13800,May,2023,Wahkiakum,WA,Truck,2,0,2,1753,1755,0.11
13801,May,2023,Travis,TX,Passenger,1,0,1,75,76,1.32
13802,May,2023,Coryell,TX,Passenger,1,0,1,70,71,1.41
13803,May,2023,San Diego,CA,Passenger,16,9,25,1823,1848,1.35
13804,May,2023,Leavenworth,KS,Passenger,0,1,1,89,90,1.11
13805,May,2023,Houston,GA,Passenger,1,0,1,26,27,3.7
13806,May,2023,Lincoln,OR,Passenger,0,1,1,12,13,7.69
13807,May,2023,Skamania,WA,Passenger,101,58,159,7977,8136,1.95
13808,May,2023,Hamilton,OH,Passenger,1,0,1,24,25,4.0
13809,May,2023,Suffolk,VA,Passenger,1,0,1,101,102,0.98
13810,May,2023,Cape May,NJ,Passenger,0,1,1,7,8,12.5
13811,May,2023,Orange,CA,Passenger,6,2,8,260,268,2.99
13812,May,2023,Lewis,WA,Passenger,309,203,512,58552,59064,0.87
13813,May,2023,Yakima,WA,Passenger,484,249,733,164633,165366,0.44
13814,May,2023,Hennepin,MN,Passenger,1,0,1,27,28,3.57
13815,May,2023,Harnett,NC,Passenger,4,0,4,116,120,3.33
13816,May,2023,Contra Costa,CA,Passenger,0,3,3,183,186,1.61
13817,May,2023,Riverside,CA,Passenger,6,1,7,348,355,1.97
13818,May,2023,Salt Lake,UT,Passenger,0,1,1,86,87,1.15
13819,May,2023,Emmet,MI,Passenger,0,1,1,0,1,100.0
13820,May,2023,Grant,WA,Truck,10,0,10,27771,27781,0.04
13821,May,2023,Rockingham,NH,Passenger,1,0,1,11,12,8.33
13822,May,2023,Sacramento,CA,Passenger,4,0,4,129,133,3.01
13823,May,2023,Lincoln,WA,Truck,0,0,0,4844,4844,0.0
13824,May,2023,Klickitat,WA,Passenger,145,63,208,15072,15280,1.36
13825,May,2023,Adams,CO,Passenger,1,0,1,25,26,3.85
13826,May,2023,Vernon,LA,Passenger,1,0,1,68,69,1.45
13827,May,2023,Oldham,KY,Passenger,0,1,1,3,4,25.0
13828,May,2023,Lane,OR,Passenger,0,1,1,60,61,1.64
13829,May,2023,Benton,WA,Truck,22,0,22,42823,42845,0.05
13830,May,2023,Island,WA,Passenger,1044,430,1474,60998,62472,2.36
13831,May,2023,Lake,IL,Passenger,2,0,2,104,106,1.89
13832,November,2017,New Haven,CT,Passenger,0,1,1,53,54,1.85
13833,November,2017,District of Columbia,DC,Passenger,0,3,3,206,209,1.44
13834,November,2017,Franklin,OH,Passenger,0,1,1,109,110,0.91
13835,November,2017,Pinal,AZ,Passenger,2,0,2,221,223,0.9
13836,November,2017,Ferry,WA,Passenger,1,3,4,4408,4412,0.09
13837,November,2017,Okanogan,WA,Passenger,5,17,22,25731,25753,0.09
13838,November,2017,Clark,NV,Passenger,1,2,3,760,763,0.39
13839,November,2017,Pacific,WA,Truck,0,0,0,7535,7535,0.0
13840,November,2017,Clallam,WA,Truck,0,0,0,21181,21181,0.0
13841,November,2017,Skagit,WA,Truck,1,0,1,31687,31688,0.0
13842,November,2017,Monterey,CA,Passenger,0,2,2,196,198,1.01
13843,November,2017,Brevard,FL,Passenger,0,1,1,104,105,0.95
13844,November,2017,Lumpkin,GA,Passenger,1,0,1,9,10,10.0
13845,November,2017,Klickitat,WA,Truck,0,0,0,8002,8002,0.0
13846,November,2017,Jefferson,WA,Truck,0,0,0,9461,9461,0.0
13847,November,2017,Franklin,WA,Passenger,31,48,79,56681,56760,0.14
13848,November,2017,Prince William,VA,Passenger,0,3,3,271,274,1.09
13849,November,2017,Sumter,FL,Passenger,0,1,1,10,11,9.09
13850,November,2017,Nantucket,MA,Passenger,1,0,1,3,4,25.0
13851,November,2017,San Juan,WA,Passenger,126,41,167,13785,13952,1.2
13852,November,2017,Spokane,WA,Truck,1,0,1,91421,91422,0.0
13853,November,2017,Clark,WA,Passenger,840,558,1398,303188,304586,0.46
13854,November,2017,Pacific,WA,Passenger,15,11,26,15334,15360,0.17
13855,November,2017,Prince George,VA,Passenger,0,1,1,71,72,1.39
13856,November,2017,Clay,FL,Passenger,0,1,1,108,109,0.92
13857,November,2017,Ramsey,MN,Passenger,1,0,1,39,40,2.5
13858,November,2017,Missoula,MT,Passenger,1,0,1,69,70,1.43
13859,November,2017,Adams,WA,Passenger,3,5,8,12358,12366,0.06
13860,November,2017,Skamania,WA,Passenger,10,7,17,8576,8593,0.2
13861,November,2017,Whitman,WA,Truck,0,0,0,8437,8437,0.0
13862,November,2017,Maricopa,AZ,Passenger,2,0,2,1629,1631,0.12
13863,November,2017,Pend Oreille,WA,Passenger,3,4,7,9428,9435,0.07
13864,November,2017,Essex,NJ,Passenger,1,0,1,10,11,9.09
13865,November,2017,El Paso,TX,Passenger,1,0,1,524,525,0.19
13866,November,2017,Columbia,WA,Truck,0,0,0,1537,1537,0.0
13867,November,2017,Northampton,PA,Passenger,0,1,1,66,67,1.49
13868,November,2017,Thurston,WA,Passenger,457,380,837,189509,190346,0.44
13869,November,2017,Palm Beach,FL,Passenger,0,1,1,92,93,1.08
13870,November,2017,King,WA,Passenger,11131,4614,15745,1371535,1387280,1.13
13871,November,2017,Carroll,NH,Passenger,0,1,1,1,2,50.0
13872,November,2017,Douglas,WA,Passenger,37,33,70,27072,27142,0.26
13873,November,2017,Island,WA,Truck,0,0,0,20694,20694,0.0
13874,November,2017,Wahkiakum,WA,Truck,0,0,0,1661,1661,0.0
13875,November,2017,Maui,HI,Passenger,1,0,1,68,69,1.45
13876,November,2017,Fairfax,VA,Passenger,2,2,4,833,837,0.48
13877,November,2017,Multnomah,OR,Passenger,3,3,6,901,907,0.66
13878,November,2017,Queens,NY,Passenger,1,0,1,61,62,1.61
13879,November,2017,Benton,WA,Truck,0,0,0,40497,40497,0.0
13880,November,2017,Lewis,WA,Truck,0,0,0,25234,25234,0.0
13881,November,2017,Riverside,CA,Passenger,1,2,3,748,751,0.4
13882,November,2017,Thurston,WA,Truck,0,0,0,53689,53689,0.0
13883,November,2017,Norfolk,MA,Passenger,1,0,1,38,39,2.56
13884,November,2017,Klickitat,WA,Passenger,23,26,49,14871,14920,0.33
13885,November,2017,Gwinnett,GA,Passenger,0,1,1,83,84,1.19
13886,November,2017,Whatcom,WA,Truck,1,0,1,41929,41930,0.0
13887,November,2017,Fulton,GA,Passenger,1,0,1,109,110,0.91
13888,November,2017,Yakima,WA,Truck,0,0,0,57917,57917,0.0
13889,November,2017,Kitsap,WA,Passenger,676,367,1043,175388,176431,0.59
13890,November,2017,Anne Arundel,MD,Passenger,0,1,1,488,489,0.2
13891,November,2017,Pima,AZ,Passenger,1,1,2,412,414,0.48
13892,November,2017,Clallam,WA,Passenger,98,86,184,48866,49050,0.38
13893,November,2017,San Diego,CA,Passenger,5,1,6,2584,2590,0.23
13894,November,2017,Mason,WA,Passenger,63,72,135,44603,44738,0.3
13895,November,2017,Walla Walla,WA,Passenger,29,31,60,35239,35299,0.17
13896,November,2017,Frederick,MD,Passenger,0,1,1,87,88,1.14
13897,November,2017,Wahkiakum,WA,Passenger,0,2,2,2868,2870,0.07
13898,November,2017,Columbia,WA,Passenger,2,1,3,2391,2394,0.13
13899,November,2017,Ferry,WA,Truck,0,0,0,3544,3544,0.0
13900,November,2017,Polk,FL,Passenger,1,0,1,62,63,1.59
13901,November,2017,San Mateo,CA,Passenger,0,1,1,147,148,0.68
13902,November,2017,Albemarle,VA,Passenger,0,1,1,32,33,3.03
13903,November,2017,Orleans,LA,Passenger,0,1,1,46,47,2.13
13904,November,2017,Los Angeles,CA,Passenger,5,2,7,1212,1219,0.57
13905,November,2017,Cowlitz,WA,Truck,0,0,0,28144,28144,0.0
13906,November,2017,Virginia Beach,VA,Passenger,2,1,3,661,664,0.45
13907,November,2017,Cowlitz,WA,Passenger,54,65,119,70592,70711,0.17
13908,November,2017,Skagit,WA,Passenger,159,131,290,89317,89607,0.32
13909,November,2017,Dakota,MN,Passenger,0,2,2,37,39,5.13
13910,November,2017,Ventura,CA,Passenger,0,1,1,327,328,0.3
13911,November,2017,Dale,AL,Passenger,0,1,1,63,64,1.56
13912,November,2017,Snohomish,WA,Passenger,1987,1019,3006,516018,519024,0.58
13913,November,2017,Pierce,WA,Passenger,1050,942,1992,526013,528005,0.38
13914,November,2017,Utah,UT,Passenger,0,1,1,136,137,0.73
13915,November,2017,Lane,OR,Passenger,0,1,1,207,208,0.48
13916,November,2017,Morris,NJ,Passenger,1,0,1,22,23,4.35
13917,November,2017,Sedgwick,KS,Passenger,0,1,1,105,106,0.94
13918,November,2017,Chelan,WA,Truck,0,0,0,21519,21519,0.0
13919,November,2017,Dallas,TX,Passenger,0,1,1,181,182,0.55
13920,November,2017,Stevens,WA,Passenger,10,21,31,31554,31585,0.1
13921,November,2017,King,WA,Truck,7,1,8,185511,185519,0.0
13922,November,2017,Nassau,NY,Passenger,1,1,2,38,40,5.0
13923,November,2017,Grays Harbor,WA,Passenger,42,41,83,45582,45665,0.18
13924,November,2017,San Juan,WA,Truck,0,0,0,5574,5574,0.0
13925,November,2017,Juneau,AK,Passenger,0,1,1,45,46,2.17
13926,November,2017,Latah,ID,Passenger,0,1,1,77,78,1.28
13927,November,2017,Island,WA,Passenger,147,156,303,61346,61649,0.49
13928,November,2017,Manassas,VA,Passenger,0,1,1,9,10,10.0
13929,November,2017,Marin,CA,Passenger,1,0,1,57,58,1.72
13930,November,2017,Contra Costa,CA,Passenger,0,1,1,470,471,0.21
13931,November,2017,Montgomery,MD,Passenger,1,0,1,300,301,0.33
13932,November,2017,Duval,FL,Passenger,1,1,2,365,367,0.54
13933,November,2017,Garfield,WA,Passenger,1,0,1,1313,1314,0.08
13935,November,2017,Travis,TX,Passenger,0,1,1,186,187,0.53
13936,November,2017,Benton,WA,Passenger,165,160,325,129883,130208,0.25
13937,November,2017,Lincoln,WA,Passenger,2,5,7,7552,7559,0.09
13938,November,2017,Allegheny,PA,Passenger,1,0,1,91,92,1.09
13939,November,2017,Canyon,ID,Passenger,0,1,1,91,92,1.09
13940,November,2017,Tarrant,TX,Passenger,1,0,1,230,231,0.43
13941,November,2017,Whitman,WA,Passenger,16,19,35,22387,22422,0.16
13942,November,2017,Bexar,TX,Passenger,1,1,2,825,827,0.24
13943,November,2017,Lewis,WA,Passenger,53,39,92,56418,56510,0.16
13944,November,2017,Nueces,TX,Passenger,1,1,2,92,94,2.13
13945,November,2017,Charles,MD,Passenger,0,1,1,84,85,1.18
13946,November,2017,Manatee,FL,Passenger,1,0,1,40,41,2.44
13947,November,2017,Madison,ID,Passenger,1,0,1,39,40,2.5
13948,November,2017,Lincoln,WA,Truck,0,0,0,4484,4484,0.0
13949,November,2017,Lee,AL,Passenger,1,0,1,35,36,2.78
13950,November,2017,Okanogan,WA,Truck,0,0,0,16273,16273,0.0
13951,November,2017,Tulare,CA,Passenger,1,0,1,189,190,0.53
13952,November,2017,St. Clair,IL,Passenger,0,1,1,162,163,0.61
13953,November,2017,Sangamon,IL,Passenger,1,0,1,11,12,8.33
13954,November,2017,Montgomery,TX,Passenger,1,0,1,62,63,1.59
13955,November,2017,Prince George's,MD,Passenger,0,1,1,180,181,0.55
13956,November,2017,Kittitas,WA,Passenger,34,24,58,28271,28329,0.2
13957,November,2017,Twin Falls,ID,Passenger,0,1,1,24,25,4.0
13958,November,2017,Pierce,WA,Truck,0,0,0,137030,137030,0.0
13959,November,2017,Orange,CA,Passenger,3,1,4,584,588,0.68
13960,November,2017,Deschutes,OR,Passenger,1,0,1,180,181,0.55
13961,November,2017,Howard,MD,Passenger,0,2,2,91,93,2.15
13962,November,2017,Grays Harbor,WA,Truck,0,0,0,20019,20019,0.0
13963,November,2017,Flathead,MT,Passenger,1,0,1,55,56,1.79
13964,November,2017,Asotin,WA,Passenger,7,5,12,12514,12526,0.1
13965,November,2017,Cape May,NJ,Passenger,0,1,1,21,22,4.55
13966,November,2017,Chelan,WA,Passenger,83,36,119,52832,52951,0.22
13967,November,2017,Volusia,FL,Passenger,0,1,1,38,39,2.56
13968,November,2017,Hawaii,HI,Passenger,1,0,1,77,78,1.28
13969,November,2017,New London,CT,Passenger,1,1,2,251,253,0.79
13970,November,2017,Hardin,KY,Passenger,0,1,1,119,120,0.83
13971,November,2017,Adams,WA,Truck,0,0,0,5141,5141,0.0
13972,November,2017,Kittitas,WA,Truck,0,0,0,13759,13759,0.0
13973,November,2017,Jefferson,WA,Passenger,116,71,187,24182,24369,0.77
13974,November,2017,Snohomish,WA,Truck,1,0,1,121380,121381,0.0
13975,November,2017,Whatcom,WA,Passenger,524,214,738,144659,145397,0.51
13976,November,2017,Yakima,WA,Passenger,57,73,130,161627,161757,0.08
13977,November,2017,Kent,MI,Passenger,0,1,1,34,35,2.86
13978,November,2017,St. Lucie,FL,Passenger,1,0,1,26,27,3.7
13979,November,2017,Norfolk,VA,Passenger,1,1,2,305,307,0.65
13980,November,2017,Pend Oreille,WA,Truck,0,0,0,5595,5595,0.0
13981,November,2017,Jefferson,NY,Passenger,1,0,1,235,236,0.42
13982,November,2017,Spokane,WA,Passenger,291,239,530,299642,300172,0.18
13983,November,2017,Grant,WA,Passenger,24,33,57,61891,61948,0.09
13984,November,2017,Alameda,CA,Passenger,0,1,1,353,354,0.28
13985,November,2017,Shelby,TN,Passenger,0,1,1,104,105,0.95
13986,November,2017,Richland,SC,Passenger,0,1,1,178,179,0.56
13987,November,2017,Sacramento,CA,Passenger,1,0,1,317,318,0.31
13988,November,2017,Hamilton,TN,Passenger,1,0,1,21,22,4.55
13989,November,2017,Montgomery,PA,Passenger,1,0,1,39,40,2.5
13990,November,2017,Asotin,WA,Truck,0,0,0,6552,6552,0.0
13991,November,2017,Montgomery,TN,Passenger,1,0,1,271,272,0.37
13992,November,2017,Orange,FL,Passenger,1,1,2,144,146,1.37
13993,November,2017,Walla Walla,WA,Truck,0,0,0,13312,13312,0.0
13994,November,2017,Hamilton,IN,Passenger,1,0,1,54,55,1.82
13995,November,2017,Garfield,WA,Truck,0,0,0,937,937,0.0
13996,November,2017,Santa Fe,NM,Passenger,0,1,1,42,43,2.33
13997,November,2017,Franklin,MA,Passenger,0,1,1,4,5,20.0
13998,November,2017,El Paso,CO,Passenger,2,0,2,764,766,0.26
13999,November,2017,Mason,WA,Truck,0,0,0,19540,19540,0.0
14000,November,2017,Douglas,WA,Truck,0,0,0,11702,11702,0.0
14001,November,2017,Moore,NC,Passenger,0,1,1,202,203,0.49
14002,November,2017,Okaloosa,FL,Passenger,1,0,1,186,187,0.53
14003,November,2017,Arlington,VA,Passenger,1,2,3,170,173,1.73
14004,November,2017,DeKalb,GA,Passenger,1,0,1,85,86,1.16
14005,November,2017,Richmond,GA,Passenger,0,1,1,91,92,1.09
14006,November,2017,Saratoga,NY,Passenger,1,1,2,71,73,2.74
14007,November,2017,Clark,WA,Truck,0,0,0,78247,78247,0.0
14008,November,2017,Santa Clara,CA,Passenger,7,1,8,385,393,2.04
14009,November,2017,DeKalb,IN,Passenger,1,0,1,1,2,50.0
14010,November,2017,Tuolumne,CA,Passenger,0,1,1,16,17,5.88
14011,November,2017,Santa Rosa,FL,Passenger,1,0,1,105,106,0.94
14012,November,2017,Stevens,WA,Truck,0,0,0,18334,18334,0.0
14013,November,2017,Kitsap,WA,Truck,1,0,1,52629,52630,0.0
14014,November,2017,Portsmouth,VA,Passenger,0,1,1,67,68,1.47
14015,November,2017,Honolulu,HI,Passenger,2,2,4,557,561,0.71
14016,November,2017,Franklin,WA,Truck,0,0,0,18414,18414,0.0
14017,November,2017,Skamania,WA,Truck,0,0,0,3893,3893,0.0
14018,November,2017,Grant,WA,Truck,0,0,0,25520,25520,0.0
14019,November,2018,Moore,NC,Passenger,0,1,1,193,194,0.52
14020,November,2018,Lee,AL,Passenger,1,0,1,36,37,2.7
14021,November,2018,Richland,SC,Passenger,0,1,1,163,164,0.61
14022,November,2018,Kittitas,WA,Passenger,61,34,95,29286,29381,0.32
14023,November,2018,Polk,FL,Passenger,1,0,1,63,64,1.56
14025,November,2018,Carroll,NH,Passenger,0,1,1,1,2,50.0
14026,November,2018,Albemarle,VA,Passenger,1,0,1,27,28,3.57
14027,November,2018,Williamson,TX,Passenger,0,1,1,148,149,0.67
14028,November,2018,Whatcom,WA,Passenger,730,355,1085,149134,150219,0.72
14029,November,2018,Madison,ID,Passenger,1,0,1,37,38,2.63
14030,November,2018,New London,CT,Passenger,0,1,1,253,254,0.39
14031,November,2018,El Paso,TX,Passenger,1,0,1,496,497,0.2
14032,November,2018,Adams,WA,Truck,0,0,0,5160,5160,0.0
14033,November,2018,Sangamon,IL,Passenger,1,0,1,9,10,10.0
14034,November,2018,Ada,ID,Passenger,0,2,2,314,316,0.63
14035,November,2018,Manatee,FL,Passenger,1,0,1,39,40,2.5
14036,November,2018,Honolulu,HI,Passenger,1,3,4,517,521,0.77
14037,November,2018,Mason,WA,Truck,0,0,0,20190,20190,0.0
14038,November,2018,San Juan,WA,Truck,0,0,0,5805,5805,0.0
14039,November,2018,Lane,OR,Passenger,0,1,1,174,175,0.57
14040,November,2018,Asotin,WA,Truck,0,0,0,6620,6620,0.0
14041,November,2018,Whatcom,WA,Truck,2,0,2,42656,42658,0.0
14042,November,2018,Volusia,FL,Passenger,0,1,1,36,37,2.7
14043,November,2018,Juneau,AK,Passenger,0,1,1,43,44,2.27
14044,November,2018,Cape May,NJ,Passenger,0,1,1,21,22,4.55
14045,November,2018,Garfield,WA,Passenger,1,1,2,1331,1333,0.15
14046,November,2018,Morris,NJ,Passenger,1,0,1,18,19,5.26
14047,November,2018,Rogers,OK,Passenger,1,0,1,6,7,14.29
14048,November,2018,Pierce,WA,Truck,0,0,0,139061,139061,0.0
14049,November,2018,Pend Oreille,WA,Passenger,5,5,10,9557,9567,0.1
14050,November,2018,Camden,NJ,Passenger,0,1,1,26,27,3.7
14051,November,2018,Garfield,OK,Passenger,1,0,1,13,14,7.14
14052,November,2018,Wahkiakum,WA,Truck,0,0,0,1704,1704,0.0
14053,November,2018,Valencia,NM,Passenger,1,0,1,10,11,9.09
14054,November,2018,Montgomery,TX,Passenger,2,0,2,62,64,3.12
14055,November,2018,Hennepin,MN,Passenger,2,0,2,109,111,1.8
14056,November,2018,Whitman,WA,Truck,0,0,0,8531,8531,0.0
14057,November,2018,Chelan,WA,Passenger,135,60,195,54064,54259,0.36
14058,November,2018,Spokane,WA,Passenger,408,358,766,306895,307661,0.25
14059,November,2018,Clallam,WA,Truck,0,0,0,21613,21613,0.0
14060,November,2018,Travis,TX,Passenger,0,1,1,198,199,0.5
14061,November,2018,Skamania,WA,Passenger,18,14,32,8731,8763,0.37
14062,November,2018,King,WA,Passenger,15784,6398,22182,1377200,1399382,1.59
14063,November,2018,Broward,FL,Passenger,2,1,3,133,136,2.21
14064,November,2018,Adams,WA,Passenger,5,5,10,12749,12759,0.08
14065,November,2018,Yakima,WA,Truck,0,0,0,58751,58751,0.0
14066,November,2018,Snohomish,WA,Passenger,2789,1415,4204,526785,530989,0.79
14067,November,2018,Prince George's,MD,Passenger,1,1,2,182,184,1.09
14068,November,2018,Marion,OR,Passenger,1,0,1,119,120,0.83
14069,November,2018,Randolph,NC,Passenger,1,0,1,5,6,16.67
14070,November,2018,San Juan,PR,Passenger,0,1,1,5,6,16.67
14071,November,2018,Clallam,WA,Passenger,147,121,268,50323,50591,0.53
14072,November,2018,Columbia,WA,Truck,0,0,0,1516,1516,0.0
14073,November,2018,Dallas,TX,Passenger,0,1,1,198,199,0.5
14074,November,2018,Clackamas,OR,Passenger,1,1,2,217,219,0.91
14075,November,2018,Anne Arundel,MD,Passenger,0,2,2,451,453,0.44
14076,November,2018,Lewis,WA,Passenger,89,71,160,58211,58371,0.27
14077,November,2018,Charles,MD,Passenger,0,1,1,78,79,1.27
14078,November,2018,Hawaii,HI,Passenger,1,0,1,65,66,1.52
14079,November,2018,Kitsap,WA,Truck,1,0,1,53652,53653,0.0
14080,November,2018,Douglas,WA,Passenger,49,33,82,27967,28049,0.29
14081,November,2018,Spokane,WA,Truck,1,0,1,93666,93667,0.0
14082,November,2018,Franklin,WA,Truck,0,0,0,18987,18987,0.0
14083,November,2018,Deschutes,OR,Passenger,2,0,2,163,165,1.21
14084,November,2018,Richmond,GA,Passenger,0,1,1,92,93,1.08
14085,November,2018,Cook,IL,Passenger,1,0,1,250,251,0.4
14086,November,2018,Lincoln,WA,Truck,0,0,0,4630,4630,0.0
14087,November,2018,Franklin,MA,Passenger,0,1,1,1,2,50.0
14088,November,2018,Santa Clara,CA,Passenger,8,1,9,373,382,2.36
14089,November,2018,Twin Falls,ID,Passenger,0,1,1,23,24,4.17
14090,November,2018,St. Clair,IL,Passenger,0,1,1,164,165,0.61
14091,November,2018,Wahkiakum,WA,Passenger,1,1,2,2984,2986,0.07
14092,November,2018,Charleston,SC,Passenger,1,0,1,125,126,0.79
14093,November,2018,San Diego,CA,Passenger,8,2,10,2565,2575,0.39
14094,November,2018,Monroe,IL,Passenger,1,0,1,4,5,20.0
14095,November,2018,Sedgwick,KS,Passenger,0,1,1,99,100,1.0
14096,November,2018,Santa Cruz,CA,Passenger,1,0,1,40,41,2.44
14097,November,2018,Chelan,WA,Truck,0,0,0,22082,22082,0.0
14098,November,2018,Ferry,WA,Passenger,3,2,5,4383,4388,0.11
14099,November,2018,Montgomery,PA,Passenger,2,0,2,35,37,5.41
14100,November,2018,Okanogan,WA,Passenger,15,22,37,26132,26169,0.14
14101,November,2018,Harnett,NC,Passenger,1,0,1,235,236,0.42
14102,November,2018,Grays Harbor,WA,Passenger,61,68,129,47373,47502,0.27
14103,November,2018,Island,WA,Truck,0,0,0,21178,21178,0.0
14104,November,2018,Benton,WA,Truck,0,0,0,41442,41442,0.0
14105,November,2018,Nueces,TX,Passenger,1,1,2,93,95,2.11
14106,November,2018,New Haven,CT,Passenger,0,1,1,48,49,2.04
14107,November,2018,Portsmouth,VA,Passenger,0,1,1,79,80,1.25
14108,November,2018,Kent,MI,Passenger,0,1,1,23,24,4.17
14109,November,2018,Whitman,WA,Passenger,20,35,55,22795,22850,0.24
14110,November,2018,Lincoln,WA,Passenger,2,6,8,7771,7779,0.1
14111,November,2018,DeKalb,IN,Passenger,1,0,1,1,2,50.0
14112,November,2018,Skagit,WA,Passenger,249,184,433,91187,91620,0.47
14113,November,2018,Carson City,NV,Passenger,1,0,1,15,16,6.25
14114,November,2018,DuPage,IL,Passenger,1,0,1,57,58,1.72
14115,November,2018,Clark,WA,Truck,0,0,0,79742,79742,0.0
14116,November,2018,Thurston,WA,Truck,0,0,0,54923,54923,0.0
14117,November,2018,Dakota,MN,Passenger,0,2,2,34,36,5.56
14118,November,2018,San Mateo,CA,Passenger,2,1,3,128,131,2.29
14119,November,2018,El Paso,CO,Passenger,3,1,4,764,768,0.52
14120,November,2018,King,WA,Truck,6,1,7,182760,182767,0.0
14121,November,2018,Douglas,WA,Truck,0,0,0,12123,12123,0.0
14122,November,2018,Ramsey,MN,Passenger,1,0,1,40,41,2.44
14123,November,2018,Skamania,WA,Truck,0,0,0,4005,4005,0.0
14124,November,2018,Kitsap,WA,Passenger,916,522,1438,180341,181779,0.79
14125,November,2018,Shasta,CA,Passenger,1,0,1,42,43,2.33
14126,November,2018,Manassas,VA,Passenger,0,1,1,9,10,10.0
14127,November,2018,Goochland,VA,Passenger,0,1,1,244,245,0.41
14128,November,2018,Orange,CA,Passenger,5,2,7,544,551,1.27
14129,November,2018,Frederick,MD,Passenger,0,1,1,82,83,1.2
14130,November,2018,Maricopa,AZ,Passenger,3,2,5,1540,1545,0.32
14131,November,2018,Santa Fe,NM,Passenger,0,1,1,43,44,2.27
14132,November,2018,Washington,OR,Passenger,0,1,1,470,471,0.21
14133,November,2018,Bergen,NJ,Passenger,1,0,1,27,28,3.57
14134,November,2018,District of Columbia,DC,Passenger,1,3,4,193,197,2.03
14135,November,2018,Lumpkin,GA,Passenger,1,0,1,7,8,12.5
14136,November,2018,Santa Rosa,FL,Passenger,1,0,1,88,89,1.12
14137,November,2018,Tarrant,TX,Passenger,1,0,1,207,208,0.48
14138,November,2018,Nassau,NY,Passenger,3,0,3,36,39,7.69
14139,November,2018,Bexar,TX,Passenger,3,4,7,719,726,0.96
14140,November,2018,Washtenaw,MI,Passenger,1,0,1,39,40,2.5
14141,November,2018,Mecklenburg,NC,Passenger,1,0,1,79,80,1.25
14142,November,2018,Denver,CO,Passenger,1,0,1,130,131,0.76
14143,November,2018,Stevens,WA,Truck,0,0,0,18731,18731,0.0
14144,November,2018,Beaufort,SC,Passenger,1,0,1,34,35,2.86
14145,November,2018,Pend Oreille,WA,Truck,0,0,0,5742,5742,0.0
14146,November,2018,Skagit,WA,Truck,1,0,1,32338,32339,0.0
14147,November,2018,Fairfax,VA,Passenger,1,2,3,806,809,0.37
14148,November,2018,St. Lucie,FL,Passenger,1,0,1,29,30,3.33
14149,November,2018,Guadalupe,TX,Passenger,1,0,1,80,81,1.23
14150,November,2018,Grays Harbor,WA,Truck,0,0,0,20338,20338,0.0
14151,November,2018,Kootenai,ID,Passenger,1,1,2,220,222,0.9
14152,November,2018,Orange,FL,Passenger,2,1,3,163,166,1.81
14153,November,2018,Caddo,LA,Passenger,0,1,1,23,24,4.17
14154,November,2018,Lee,FL,Passenger,1,0,1,52,53,1.89
14155,November,2018,Jefferson,NY,Passenger,0,1,1,230,231,0.43
14156,November,2018,Norfolk,VA,Passenger,2,2,4,342,346,1.16
14157,November,2018,Yakima,WA,Passenger,78,98,176,164686,164862,0.11
14158,November,2018,Suffolk,MA,Passenger,0,1,1,43,44,2.27
14159,November,2018,Montgomery,MD,Passenger,1,0,1,275,276,0.36
14160,November,2018,Jefferson,CO,Passenger,0,2,2,63,65,3.08
14161,November,2018,Klickitat,WA,Truck,0,0,0,8183,8183,0.0
14162,November,2018,Maui,HI,Passenger,1,0,1,52,53,1.89
14163,November,2018,Fulton,GA,Passenger,1,2,3,107,110,2.73
14164,November,2018,Tuolumne,CA,Passenger,0,1,1,12,13,7.69
14165,November,2018,Riverside,CA,Passenger,2,2,4,683,687,0.58
14166,November,2018,Douglas,NE,Passenger,0,1,1,66,67,1.49
14167,November,2018,Columbia,WA,Passenger,2,2,4,2437,2441,0.16
14168,November,2018,Walla Walla,WA,Passenger,38,52,90,36092,36182,0.25
14169,November,2018,Stevens,WA,Passenger,16,27,43,31791,31834,0.14
14170,November,2018,DeKalb,GA,Passenger,1,0,1,77,78,1.28
14171,November,2018,Multnomah,OR,Passenger,3,5,8,755,763,1.05
14172,November,2018,Thurston,WA,Passenger,707,567,1274,195458,196732,0.65
14173,November,2018,San Juan,WA,Passenger,176,68,244,14214,14458,1.69
14174,November,2018,Monterey,CA,Passenger,0,1,1,190,191,0.52
14175,November,2018,Flathead,MT,Passenger,1,0,1,55,56,1.79
14176,November,2018,Alameda,CA,Passenger,0,2,2,327,329,0.61
14177,November,2018,Howard,MD,Passenger,0,1,1,86,87,1.15
14178,November,2018,Clark,NV,Passenger,2,2,4,721,725,0.55
14179,November,2018,Island,WA,Passenger,266,224,490,63109,63599,0.77
14180,November,2018,Ventura,CA,Passenger,0,2,2,318,320,0.62
14181,November,2018,Benton,WA,Passenger,210,224,434,132792,133226,0.33
14182,November,2018,Franklin,WA,Passenger,38,64,102,58943,59045,0.17
14183,November,2018,Walla Walla,WA,Truck,0,0,0,13518,13518,0.0
14184,November,2018,Pacific,WA,Passenger,20,23,43,15810,15853,0.27
14185,November,2018,Clay,FL,Passenger,0,1,1,88,89,1.12
14186,November,2018,San Francisco,CA,Passenger,2,1,3,118,121,2.48
14187,November,2018,Dale,AL,Passenger,0,1,1,57,58,1.72
14188,November,2018,Jefferson,WA,Passenger,169,104,273,24795,25068,1.09
14189,November,2018,Snohomish,WA,Truck,1,0,1,121952,121953,0.0
14190,November,2018,Collin,TX,Passenger,1,1,2,146,148,1.35
14191,November,2018,Garfield,WA,Truck,0,0,0,964,964,0.0
14192,November,2018,Okanogan,WA,Truck,0,0,0,16492,16492,0.0
14193,November,2018,Pima,AZ,Passenger,1,1,2,399,401,0.5
14194,November,2018,Grant,WA,Passenger,32,52,84,64032,64116,0.13
14195,November,2018,Marion,IN,Passenger,1,0,1,120,121,0.83
14196,November,2018,Middlesex,MA,Passenger,0,1,1,135,136,0.74
14197,November,2018,Brevard,FL,Passenger,0,1,1,95,96,1.04
14198,November,2018,Houston,GA,Passenger,1,0,1,52,53,1.89
14199,November,2018,Contra Costa,CA,Passenger,0,2,2,416,418,0.48
14200,November,2018,Pinal,AZ,Passenger,2,0,2,201,203,0.99
14201,November,2018,Klickitat,WA,Passenger,23,32,55,15421,15476,0.36
14202,November,2018,Bucks,PA,Passenger,1,0,1,16,17,5.88
14203,November,2018,Clark,WA,Passenger,1188,830,2018,310997,313015,0.64
14204,November,2018,Ferry,WA,Truck,0,0,0,3582,3582,0.0
14205,November,2018,Klamath,OR,Passenger,1,0,1,36,37,2.7
14206,November,2018,Oldham,KY,Passenger,0,1,1,5,6,16.67
14207,November,2018,Washoe,NV,Passenger,1,0,1,107,108,0.93
14208,November,2018,Larimer,CO,Passenger,1,0,1,61,62,1.61
14209,November,2018,Cowlitz,WA,Passenger,69,91,160,72372,72532,0.22
14210,November,2018,Los Angeles,CA,Passenger,7,5,12,1126,1138,1.05
14211,November,2018,Norfolk,MA,Passenger,1,0,1,36,37,2.7
14212,November,2018,Hamilton,IN,Passenger,1,0,1,46,47,2.13
14213,November,2018,Kittitas,WA,Truck,0,0,0,14162,14162,0.0
14214,November,2018,Sumter,FL,Passenger,0,1,1,10,11,9.09
14215,November,2018,Mason,WA,Passenger,103,110,213,46427,46640,0.46
14216,November,2018,Cumberland,NC,Passenger,0,1,1,520,521,0.19
14217,November,2018,Duval,FL,Passenger,1,2,3,381,384,0.78
14218,November,2018,Lewis,WA,Truck,0,0,0,25625,25625,0.0
14219,November,2018,Prince William,VA,Passenger,0,4,4,257,261,1.53
14220,November,2018,Grant,WA,Truck,0,0,0,26159,26159,0.0
14221,November,2018,Hardin,KY,Passenger,0,1,1,111,112,0.89
14222,November,2018,Cowlitz,WA,Truck,0,0,0,28723,28723,0.0
14223,November,2018,Allegheny,PA,Passenger,1,0,1,84,85,1.18
14224,November,2018,Shelby,TN,Passenger,0,1,1,102,103,0.97
14225,November,2018,Arlington,VA,Passenger,1,1,2,166,168,1.19
14226,November,2018,Virginia Beach,VA,Passenger,2,1,3,697,700,0.43
14227,November,2018,Gwinnett,GA,Passenger,0,1,1,77,78,1.28
14228,November,2018,Cochise,AZ,Passenger,0,1,1,119,120,0.83
14229,November,2018,Jefferson,WA,Truck,0,0,0,9615,9615,0.0
14230,November,2018,Palm Beach,FL,Passenger,0,1,1,93,94,1.06
14231,November,2018,Pacific,WA,Truck,0,0,0,7611,7611,0.0
14232,November,2018,Asotin,WA,Passenger,12,9,21,12726,12747,0.16
14233,November,2018,Saratoga,NY,Passenger,1,0,1,62,63,1.59
14234,November,2018,Pierce,WA,Passenger,1470,1339,2809,538424,541233,0.52
14235,November,2018,Tulsa,OK,Passenger,1,1,2,47,49,4.08
14236,November,2018,St. Mary's,MD,Passenger,1,0,1,218,219,0.46
14237,November,2018,Fresno,CA,Passenger,1,0,1,189,190,0.53
14238,November,2018,Nantucket,MA,Passenger,1,0,1,4,5,20.0
14239,November,2019,Montgomery,OH,Passenger,0,1,1,48,49,2.04
14240,November,2019,Hennepin,MN,Passenger,3,1,4,99,103,3.88
14241,November,2019,Greene,MO,Passenger,0,1,1,31,32,3.12
14242,November,2019,Broward,FL,Passenger,2,1,3,124,127,2.36
14243,November,2019,Asotin,WA,Passenger,13,8,21,12655,12676,0.17
14244,November,2019,Dallas,TX,Passenger,1,0,1,209,210,0.48
14245,November,2019,Franklin,MA,Passenger,0,1,1,1,2,50.0
14246,November,2019,Kootenai,ID,Passenger,1,1,2,226,228,0.88
14247,November,2019,Richmond,GA,Passenger,0,1,1,93,94,1.06
14248,November,2019,Wahkiakum,WA,Passenger,4,3,7,3037,3044,0.23
14249,November,2019,Montgomery,PA,Passenger,2,0,2,36,38,5.26
14250,November,2019,Grant,WA,Truck,0,0,0,26953,26953,0.0
14251,November,2019,Moore,NC,Passenger,0,1,1,173,174,0.57
14252,November,2019,Skamania,WA,Truck,0,0,0,4096,4096,0.0
14253,November,2019,Ada,ID,Passenger,0,1,1,294,295,0.34
14254,November,2019,Richland,SC,Passenger,0,1,1,158,159,0.63
14255,November,2019,Portsmouth,VA,Passenger,0,1,1,79,80,1.25
14256,November,2019,Shasta,CA,Passenger,1,0,1,38,39,2.56
14257,November,2019,Wilson,TX,Passenger,0,1,1,8,9,11.11
14258,November,2019,Jefferson,WA,Truck,0,0,0,9654,9654,0.0
14259,November,2019,DuPage,IL,Passenger,3,0,3,63,66,4.55
14260,November,2019,Pacific,WA,Passenger,29,30,59,16115,16174,0.36
14261,November,2019,Whatcom,WA,Truck,2,0,2,43148,43150,0.0
14262,November,2019,Pima,AZ,Passenger,2,1,3,372,375,0.8
14263,November,2019,Kern,CA,Passenger,0,1,1,220,221,0.45
14264,November,2019,Pinal,AZ,Passenger,1,0,1,191,192,0.52
14265,November,2019,Polk,FL,Passenger,1,0,1,66,67,1.49
14266,November,2019,Suffolk,VA,Passenger,1,0,1,124,125,0.8
14267,November,2019,Tuolumne,CA,Passenger,0,1,1,11,12,8.33
14268,November,2019,Lake,FL,Passenger,1,0,1,21,22,4.55
14269,November,2019,Bexar,TX,Passenger,1,5,6,648,654,0.92
14270,November,2019,Bucks,PA,Passenger,1,0,1,22,23,4.35
14271,November,2019,Lincoln,WA,Truck,0,0,0,4695,4695,0.0
14272,November,2019,Clallam,WA,Passenger,195,153,348,50908,51256,0.68
14273,November,2019,Lewis,WA,Passenger,109,103,212,59509,59721,0.35
14274,November,2019,El Paso,TX,Passenger,3,0,3,459,462,0.65
14275,November,2019,Duval,FL,Passenger,1,2,3,367,370,0.81
14276,November,2019,Harris,TX,Passenger,1,1,2,240,242,0.83
14277,November,2019,Walla Walla,WA,Truck,0,0,0,13674,13674,0.0
14278,November,2019,Wahkiakum,WA,Truck,0,0,0,1752,1752,0.0
14279,November,2019,Sumter,FL,Passenger,0,1,1,9,10,10.0
14280,November,2019,Boone,MO,Passenger,0,1,1,11,12,8.33
14281,November,2019,Fairbanks North Star,AK,Passenger,0,1,1,98,99,1.01
14282,November,2019,Multnomah,OR,Passenger,4,6,10,726,736,1.36
14283,November,2019,Charleston,SC,Passenger,1,0,1,109,110,0.91
14284,November,2019,Jefferson,WA,Passenger,212,132,344,25183,25527,1.35
14285,November,2019,Hawaii,HI,Passenger,1,0,1,57,58,1.72
14286,November,2019,Island,WA,Passenger,363,251,614,63666,64280,0.96
14287,November,2019,Sedgwick,KS,Passenger,1,1,2,96,98,2.04
14288,November,2019,Alexandria,VA,Passenger,1,0,1,147,148,0.68
14289,November,2019,Cumberland,NC,Passenger,0,2,2,486,488,0.41
14290,November,2019,Honolulu,HI,Passenger,4,2,6,482,488,1.23
14291,November,2019,Santa Rosa,FL,Passenger,1,0,1,88,89,1.12
14292,November,2019,Charles,MD,Passenger,0,1,1,84,85,1.18
14293,November,2019,Nassau,NY,Passenger,4,0,4,39,43,9.3
14294,November,2019,Ferry,WA,Passenger,5,2,7,4414,4421,0.16
14295,November,2019,San Juan,WA,Truck,0,0,0,5929,5929,0.0
14296,November,2019,Benton,WA,Truck,0,0,0,42413,42413,0.0
14297,November,2019,Asotin,WA,Truck,0,0,0,6694,6694,0.0
14298,November,2019,Sangamon,IL,Passenger,1,0,1,5,6,16.67
14299,November,2019,Palm Beach,FL,Passenger,0,1,1,83,84,1.19
14300,November,2019,RÃ­o Grande,PR,Passenger,1,0,1,1,2,50.0
14301,November,2019,Houston,GA,Passenger,1,0,1,59,60,1.67
14302,November,2019,Ventura,CA,Passenger,0,3,3,302,305,0.98
14303,November,2019,Okanogan,WA,Passenger,27,30,57,26234,26291,0.22
14304,November,2019,Kitsap,WA,Passenger,1190,649,1839,182242,184081,1.0
14305,November,2019,Franklin,WA,Passenger,53,75,128,60785,60913,0.21
14306,November,2019,Chelan,WA,Passenger,196,75,271,54642,54913,0.49
14307,November,2019,Tarrant,TX,Passenger,2,0,2,195,197,1.02
14308,November,2019,Skagit,WA,Passenger,347,210,557,92574,93131,0.6
14309,November,2019,Ramsey,MN,Passenger,1,0,1,40,41,2.44
14310,November,2019,Whitman,WA,Truck,0,0,0,8581,8581,0.0
14311,November,2019,Spokane,WA,Truck,1,0,1,96217,96218,0.0
14312,November,2019,Carson City,NV,Passenger,1,0,1,10,11,9.09
14313,November,2019,Kitsap,WA,Truck,1,0,1,54405,54406,0.0
14314,November,2019,Pend Oreille,WA,Truck,0,0,0,5733,5733,0.0
14315,November,2019,Berkshire,MA,Passenger,0,1,1,5,6,16.67
14316,November,2019,Santa Cruz,CA,Passenger,1,0,1,36,37,2.7
14317,November,2019,Norfolk,VA,Passenger,1,2,3,347,350,0.86
14318,November,2019,Middlesex,MA,Passenger,1,1,2,107,109,1.83
14319,November,2019,Cowlitz,WA,Truck,0,0,0,29029,29029,0.0
14321,November,2019,King,WA,Truck,6,1,7,182343,182350,0.0
14322,November,2019,Denver,CO,Passenger,1,0,1,128,129,0.78
14323,November,2019,Arlington,VA,Passenger,0,2,2,153,155,1.29
14324,November,2019,Washtenaw,MI,Passenger,1,0,1,41,42,2.38
14325,November,2019,Manassas,VA,Passenger,0,1,1,7,8,12.5
14326,November,2019,Douglas,WA,Passenger,65,38,103,28288,28391,0.36
14327,November,2019,Montgomery,TX,Passenger,1,0,1,56,57,1.75
14328,November,2019,San Mateo,CA,Passenger,1,1,2,121,123,1.63
14329,November,2019,Goochland,VA,Passenger,3,1,4,264,268,1.49
14330,November,2019,Skamania,WA,Passenger,26,20,46,8789,8835,0.52
14331,November,2019,Stevens,WA,Truck,0,0,0,18795,18795,0.0
14332,November,2019,DeKalb,IN,Passenger,1,0,1,1,2,50.0
14333,November,2019,Stevens,WA,Passenger,31,30,61,31606,31667,0.19
14334,November,2019,Tulsa,OK,Passenger,1,1,2,48,50,4.0
14335,November,2019,Adams,WA,Passenger,6,7,13,12928,12941,0.1
14336,November,2019,Pierce,WA,Passenger,2083,1635,3718,547543,551261,0.67
14337,November,2019,Juneau,AK,Passenger,0,2,2,28,30,6.67
14338,November,2019,Douglas,NE,Passenger,0,1,1,59,60,1.67
14339,November,2019,Frederick,MD,Passenger,1,1,2,83,85,2.35
14340,November,2019,Pinellas,FL,Passenger,1,1,2,108,110,1.82
14341,November,2019,Placer,CA,Passenger,1,0,1,96,97,1.03
14342,November,2019,Osceola,FL,Passenger,1,0,1,43,44,2.27
14343,November,2019,Cascade,MT,Passenger,0,1,1,56,57,1.75
14344,November,2019,Clark,WA,Truck,0,0,0,81279,81279,0.0
14345,November,2019,San Juan,WA,Passenger,243,78,321,14405,14726,2.18
14346,November,2019,San Diego,CA,Passenger,9,3,12,2805,2817,0.43
14347,November,2019,New Haven,CT,Passenger,0,2,2,47,49,4.08
14348,November,2019,San Francisco,CA,Passenger,2,1,3,100,103,2.91
14349,November,2019,Thurston,WA,Truck,0,0,0,55656,55656,0.0
14350,November,2019,Orange,CA,Passenger,7,2,9,505,514,1.75
14351,November,2019,Mason,WA,Passenger,140,130,270,47611,47881,0.56
14352,November,2019,Benton,WA,Passenger,310,308,618,135108,135726,0.46
14353,November,2019,Spartanburg,SC,Passenger,0,1,1,43,44,2.27
14354,November,2019,Whatcom,WA,Passenger,964,470,1434,151593,153027,0.94
14355,November,2019,Flathead,MT,Passenger,1,0,1,64,65,1.54
14356,November,2019,Grays Harbor,WA,Truck,0,0,0,20750,20750,0.0
14357,November,2019,Whitman,WA,Passenger,41,46,87,22704,22791,0.38
14358,November,2019,Travis,TX,Passenger,2,1,3,199,202,1.49
14359,November,2019,Brevard,FL,Passenger,0,1,1,88,89,1.12
14360,November,2019,Vigo,IN,Passenger,1,0,1,6,7,14.29
14361,November,2019,Saginaw,MI,Passenger,1,0,1,11,12,8.33
14362,November,2019,Volusia,FL,Passenger,0,1,1,41,42,2.38
14363,November,2019,Grant,WA,Passenger,53,65,118,65498,65616,0.18
14364,November,2019,Solano,CA,Passenger,1,0,1,204,205,0.49
14365,November,2019,Montgomery,AL,Passenger,0,1,1,39,40,2.5
14366,November,2019,Prince George's,MD,Passenger,1,1,2,174,176,1.14
14367,November,2019,Jones,GA,Passenger,1,0,1,1,2,50.0
14368,November,2019,Fairfax,VA,Passenger,4,2,6,755,761,0.79
14369,November,2019,Garfield,WA,Passenger,0,1,1,1304,1305,0.08
14370,November,2019,Lewis,WA,Truck,0,0,0,26110,26110,0.0
14371,November,2019,Thurston,WA,Passenger,1035,700,1735,199127,200862,0.86
14372,November,2019,King,WA,Passenger,21598,7457,29055,1395552,1424607,2.04
14373,November,2019,Los Angeles,CA,Passenger,8,9,17,1065,1082,1.57
14374,November,2019,Contra Costa,CA,Passenger,3,2,5,349,354,1.41
14375,November,2019,Columbia,WA,Passenger,3,2,5,2443,2448,0.2
14376,November,2019,Wayne,MI,Passenger,0,1,1,61,62,1.61
14377,November,2019,Anne Arundel,MD,Passenger,1,2,3,435,438,0.68
14378,November,2019,Camden,NJ,Passenger,0,1,1,22,23,4.35
14379,November,2019,Clackamas,OR,Passenger,2,1,3,211,214,1.4
14380,November,2019,Garfield,WA,Truck,0,0,0,965,965,0.0
14381,November,2019,Cape May,NJ,Passenger,0,1,1,13,14,7.14
14382,November,2019,Maricopa,AZ,Passenger,6,5,11,1507,1518,0.72
14383,November,2019,Larimer,CO,Passenger,1,0,1,56,57,1.75
14384,November,2019,Clark,WA,Passenger,1806,1025,2831,317525,320356,0.88
14385,November,2019,Shelby,OH,Passenger,0,1,1,1,2,50.0
14386,November,2019,Fresno,CA,Passenger,1,0,1,190,191,0.52
14387,November,2019,Clark,NV,Passenger,4,2,6,683,689,0.87
14388,November,2019,Lincoln,WA,Passenger,1,11,12,7798,7810,0.15
14389,November,2019,Hudson,NJ,Passenger,1,0,1,38,39,2.56
14390,November,2019,Maui,HI,Passenger,1,0,1,42,43,2.33
14391,November,2019,Powhatan,VA,Passenger,1,0,1,0,1,100.0
14392,November,2019,Arapahoe,CO,Passenger,1,0,1,145,146,0.68
14393,November,2019,Queens,NY,Passenger,1,0,1,54,55,1.82
14394,November,2019,Skagit,WA,Truck,1,0,1,32541,32542,0.0
14395,November,2019,Chesapeake,VA,Passenger,0,2,2,439,441,0.45
14396,November,2019,Monroe,IL,Passenger,1,0,1,4,5,20.0
14397,November,2019,Cochise,AZ,Passenger,0,1,1,104,105,0.95
14398,November,2019,Walla Walla,WA,Passenger,64,61,125,36282,36407,0.34
14399,November,2019,Washoe,NV,Passenger,1,0,1,108,109,0.92
14400,November,2019,Island,WA,Truck,1,0,1,21317,21318,0.0
14401,November,2019,Owyhee,ID,Passenger,1,0,1,3,4,25.0
14402,November,2019,Kittitas,WA,Passenger,89,46,135,30012,30147,0.45
14403,November,2019,Harrison,MS,Passenger,1,0,1,58,59,1.69
14404,November,2019,Snohomish,WA,Truck,0,0,0,123166,123166,0.0
14405,November,2019,Yakima,WA,Truck,0,0,0,59589,59589,0.0
14406,November,2019,Jefferson,CO,Passenger,0,2,2,59,61,3.28
14407,November,2019,Cook,IL,Passenger,1,0,1,230,231,0.43
14408,November,2019,Alameda,CA,Passenger,5,1,6,291,297,2.02
14409,November,2019,Pacific,WA,Truck,0,0,0,7740,7740,0.0
14410,November,2019,Dakota,MN,Passenger,0,1,1,34,35,2.86
14411,November,2019,Harnett,NC,Passenger,1,1,2,208,210,0.95
14412,November,2019,Fulton,GA,Passenger,0,2,2,105,107,1.87
14413,November,2019,Klickitat,WA,Passenger,45,38,83,15673,15756,0.53
14414,November,2019,Kittitas,WA,Truck,0,0,0,14619,14619,0.0
14415,November,2019,St. Mary's,MD,Passenger,1,0,1,218,219,0.46
14416,November,2019,Oldham,KY,Passenger,0,1,1,5,6,16.67
14417,November,2019,Riverside,CA,Passenger,4,1,5,636,641,0.78
14418,November,2019,Pend Oreille,WA,Passenger,7,7,14,9516,9530,0.15
14419,November,2019,Lake,IL,Passenger,1,0,1,166,167,0.6
14420,November,2019,District of Columbia,DC,Passenger,1,1,2,212,214,0.93
14421,November,2019,Norfolk,MA,Passenger,1,0,1,36,37,2.7
14422,November,2019,Sarasota,FL,Passenger,2,0,2,25,27,7.41
14423,November,2019,Williamson,TX,Passenger,0,2,2,146,148,1.35
14424,November,2019,Cowlitz,WA,Passenger,114,106,220,73591,73811,0.3
14425,November,2019,Loudoun,VA,Passenger,1,0,1,95,96,1.04
14426,November,2019,Spokane,WA,Passenger,631,470,1101,314632,315733,0.35
14427,November,2019,San Joaquin,CA,Passenger,1,0,1,135,136,0.74
14428,November,2019,Douglas,WA,Truck,0,0,0,12301,12301,0.0
14429,November,2019,Jefferson,NY,Passenger,0,2,2,214,216,0.93
14430,November,2019,Deschutes,OR,Passenger,3,0,3,147,150,2.0
14431,November,2019,Oklahoma,OK,Passenger,0,1,1,126,127,0.79
14432,November,2019,Ferry,WA,Truck,0,0,0,3581,3581,0.0
14433,November,2019,Grays Harbor,WA,Passenger,99,99,198,48351,48549,0.41
14434,November,2019,Howard,MD,Passenger,0,1,1,73,74,1.35
14435,November,2019,Franklin,WA,Truck,0,0,0,19729,19729,0.0
14436,November,2019,Penobscot,ME,Passenger,0,1,1,13,14,7.14
14437,November,2019,Stafford,VA,Passenger,1,1,2,95,97,2.06
14438,November,2019,DeKalb,GA,Passenger,1,0,1,81,82,1.22
14439,November,2019,Suffolk,MA,Passenger,0,1,1,36,37,2.7
14440,November,2019,Chelan,WA,Truck,0,0,0,22517,22517,0.0
14441,November,2019,Klamath,OR,Passenger,1,0,1,37,38,2.63
14442,November,2019,Allegheny,PA,Passenger,1,0,1,77,78,1.28
14443,November,2019,Putnam,TN,Passenger,0,1,1,3,4,25.0
14444,November,2019,Calvert,MD,Passenger,0,2,2,92,94,2.13
14445,November,2019,Albemarle,VA,Passenger,1,0,1,25,26,3.85
14446,November,2019,Columbia,WA,Truck,0,0,0,1535,1535,0.0
14447,November,2019,Snohomish,WA,Passenger,3943,1706,5649,535420,541069,1.04
14448,November,2019,Valencia,NM,Passenger,1,0,1,5,6,16.67
14449,November,2019,Okanogan,WA,Truck,0,0,0,16557,16557,0.0
14450,November,2019,New London,CT,Passenger,0,2,2,244,246,0.81
14451,November,2019,Adams,WA,Truck,0,0,0,5184,5184,0.0
14452,November,2019,Guadalupe,TX,Passenger,1,0,1,67,68,1.47
14453,November,2019,Collin,TX,Passenger,1,1,2,130,132,1.52
14454,November,2019,Clallam,WA,Truck,1,0,1,21847,21848,0.0
14455,November,2019,Pierce,WA,Truck,0,0,0,140707,140707,0.0
14456,November,2019,Kent,MI,Passenger,0,1,1,24,25,4.0
14457,November,2019,Clay,FL,Passenger,0,1,1,87,88,1.14
14458,November,2019,Rogers,OK,Passenger,1,0,1,5,6,16.67
14459,November,2019,Twin Falls,ID,Passenger,0,1,1,28,29,3.45
14460,November,2019,El Paso,CO,Passenger,2,1,3,740,743,0.4
14461,November,2019,Virginia Beach,VA,Passenger,1,0,1,701,702,0.14
14462,November,2019,Randolph,NC,Passenger,1,0,1,7,8,12.5
14463,November,2019,Nueces,TX,Passenger,1,1,2,88,90,2.22
14464,November,2019,Boulder,CO,Passenger,0,1,1,50,51,1.96
14465,November,2019,Yakima,WA,Passenger,117,116,233,166000,166233,0.14
14466,November,2019,Carroll,NH,Passenger,0,1,1,3,4,25.0
14467,November,2019,Klickitat,WA,Truck,0,0,0,8306,8306,0.0
14468,November,2019,Lee,FL,Passenger,1,0,1,53,54,1.85
14469,November,2019,Shelby,TN,Passenger,0,1,1,96,97,1.03
14470,November,2019,Mason,WA,Truck,0,0,0,20508,20508,0.0
14471,November,2019,Santa Clara,CA,Passenger,6,2,8,360,368,2.17
14472,November,2019,Prince William,VA,Passenger,1,3,4,232,236,1.69
14473,November,2020,St. Mary's,MD,Passenger,1,0,1,215,216,0.46
14474,November,2020,Palm Beach,FL,Passenger,0,1,1,73,74,1.35
14475,November,2020,Prince William,VA,Passenger,2,2,4,220,224,1.79
14476,November,2020,Adams,WA,Passenger,10,6,16,12942,12958,0.12
14477,November,2020,Walla Walla,WA,Passenger,95,66,161,36066,36227,0.44
14478,November,2020,Riverside,CA,Passenger,4,1,5,598,603,0.83
14479,November,2020,Loudoun,VA,Passenger,1,0,1,77,78,1.28
14480,November,2020,Pend Oreille,WA,Truck,0,0,0,5718,5718,0.0
14481,November,2020,Santa Cruz,CA,Passenger,1,0,1,29,30,3.33
14482,November,2020,Skamania,WA,Passenger,33,21,54,8305,8359,0.65
14483,November,2020,San Juan,WA,Truck,0,0,0,5866,5866,0.0
14484,November,2020,Cascade,MT,Passenger,0,1,1,52,53,1.89
14485,November,2020,Clallam,WA,Passenger,262,176,438,49872,50310,0.87
14486,November,2020,Williamson,TX,Passenger,0,2,2,122,124,1.61
14487,November,2020,Cape May,NJ,Passenger,0,1,1,10,11,9.09
14488,November,2020,Erie,NY,Passenger,1,0,1,44,45,2.22
14489,November,2020,Goochland,VA,Passenger,4,2,6,243,249,2.41
14490,November,2020,Fresno,CA,Passenger,1,0,1,169,170,0.59
14491,November,2020,Ulster,NY,Passenger,1,0,1,8,9,11.11
14492,November,2020,Frederick,MD,Passenger,1,1,2,73,75,2.67
14493,November,2020,El Dorado,CA,Passenger,1,0,1,33,34,2.94
14494,November,2020,Maricopa,AZ,Passenger,5,6,11,1316,1327,0.83
14495,November,2020,Manassas,VA,Passenger,0,1,1,5,6,16.67
14496,November,2020,Bradley,TN,Passenger,1,0,1,0,1,100.0
14497,November,2020,DuPage,IL,Passenger,3,0,3,53,56,5.36
14498,November,2020,Pierce,WA,Passenger,2759,1756,4515,554918,559433,0.81
14499,November,2020,Whitman,WA,Passenger,51,44,95,21963,22058,0.43
14500,November,2020,Lewis,WA,Truck,0,0,0,26547,26547,0.0
14501,November,2020,Hawaii,HI,Passenger,1,0,1,52,53,1.89
14502,November,2020,Saginaw,MI,Passenger,1,0,1,9,10,10.0
14503,November,2020,Cowlitz,WA,Truck,0,0,0,28871,28871,0.0
14504,November,2020,Yakima,WA,Passenger,166,122,288,167009,167297,0.17
14505,November,2020,Adams,WA,Truck,0,0,0,5325,5325,0.0
14506,November,2020,Mason,WA,Truck,0,0,0,20860,20860,0.0
14507,November,2020,Missoula,MT,Passenger,1,0,1,63,64,1.56
14508,November,2020,Mason,WA,Passenger,169,135,304,47500,47804,0.64
14509,November,2020,Richland,SC,Passenger,0,1,1,139,140,0.71
14510,November,2020,Skagit,WA,Truck,1,0,1,32715,32716,0.0
14511,November,2020,Camden,NJ,Passenger,0,1,1,22,23,4.35
14512,November,2020,Orange,FL,Passenger,1,0,1,115,116,0.86
14513,November,2020,King,WA,Truck,6,1,7,184180,184187,0.0
14514,November,2020,Asotin,WA,Truck,0,0,0,6665,6665,0.0
14515,November,2020,Harris,TX,Passenger,1,0,1,215,216,0.46
14516,November,2020,Pacific,WA,Passenger,36,34,70,15737,15807,0.44
14517,November,2020,Anne Arundel,MD,Passenger,1,1,2,399,401,0.5
14518,November,2020,Montgomery,TX,Passenger,1,0,1,47,48,2.08
14519,November,2020,Kings,NY,Passenger,1,0,1,63,64,1.56
14520,November,2020,Hudson,NJ,Passenger,1,0,1,38,39,2.56
14521,November,2020,Spokane,WA,Passenger,859,542,1401,320275,321676,0.44
14522,November,2020,Nassau,NY,Passenger,4,0,4,28,32,12.5
14523,November,2020,Stevens,WA,Passenger,36,39,75,30275,30350,0.25
14524,November,2020,Fulton,GA,Passenger,1,2,3,89,92,3.26
14525,November,2020,Garfield,WA,Truck,0,0,0,997,997,0.0
14526,November,2020,Suffolk,VA,Passenger,1,0,1,125,126,0.79
14527,November,2020,Okaloosa,FL,Passenger,0,1,1,133,134,0.75
14528,November,2020,Jones,GA,Passenger,1,0,1,1,2,50.0
14529,November,2020,Thurston,WA,Passenger,1290,763,2053,197232,199285,1.03
14530,November,2020,Moore,NC,Passenger,0,1,1,152,153,0.65
14531,November,2020,Randolph,NC,Passenger,1,0,1,6,7,14.29
14532,November,2020,Jefferson,WA,Passenger,276,153,429,24728,25157,1.71
14533,November,2020,Williams,ND,Passenger,0,1,1,10,11,9.09
14534,November,2020,Columbia,WA,Truck,0,0,0,1530,1530,0.0
14535,November,2020,Kittitas,WA,Truck,0,0,0,14645,14645,0.0
14536,November,2020,Carroll,MD,Passenger,0,1,1,21,22,4.55
14537,November,2020,Suffolk,MA,Passenger,0,2,2,33,35,5.71
14538,November,2020,Twin Falls,ID,Passenger,0,1,1,24,25,4.0
14539,November,2020,Bexar,TX,Passenger,4,5,9,567,576,1.56
14540,November,2020,Okanogan,WA,Passenger,51,37,88,25984,26072,0.34
14541,November,2020,San Mateo,CA,Passenger,1,1,2,108,110,1.82
14542,November,2020,St. Clair,IL,Passenger,1,0,1,138,139,0.72
14543,November,2020,Platte,MO,Passenger,1,0,1,17,18,5.56
14544,November,2020,Pinellas,FL,Passenger,1,1,2,98,100,2.0
14545,November,2020,Asotin,WA,Passenger,17,14,31,12411,12442,0.25
14546,November,2020,Jefferson,NY,Passenger,0,1,1,209,210,0.48
14547,November,2020,Howard,MD,Passenger,0,1,1,62,63,1.59
14548,November,2020,Lake,FL,Passenger,1,0,1,22,23,4.35
14549,November,2020,Arapahoe,CO,Passenger,1,0,1,121,122,0.82
14550,November,2020,Gwinnett,GA,Passenger,1,0,1,69,70,1.43
14551,November,2020,Washtenaw,MI,Passenger,1,0,1,31,32,3.12
14552,November,2020,Clark,WA,Passenger,2284,1140,3424,318828,322252,1.06
14553,November,2020,Snohomish,WA,Passenger,4956,1823,6779,538061,544840,1.24
14554,November,2020,Orange,CA,Passenger,4,3,7,451,458,1.53
14555,November,2020,San Juan,WA,Passenger,355,106,461,14017,14478,3.18
14556,November,2020,Prince George's,MD,Passenger,2,1,3,148,151,1.99
14557,November,2020,Kern,CA,Passenger,0,1,1,216,217,0.46
14558,November,2020,Spartanburg,SC,Passenger,0,1,1,48,49,2.04
14559,November,2020,Benton,WA,Passenger,426,348,774,134791,135565,0.57
14560,November,2020,El Paso,TX,Passenger,3,0,3,400,403,0.74
14561,November,2020,Deschutes,OR,Passenger,1,0,1,122,123,0.81
14562,November,2020,Rockingham,NH,Passenger,1,0,1,22,23,4.35
14563,November,2020,Anchorage,AK,Passenger,1,0,1,143,144,0.69
14564,November,2020,Placer,CA,Passenger,2,0,2,85,87,2.3
14565,November,2020,Pima,AZ,Passenger,3,1,4,324,328,1.22
14566,November,2020,San Diego,CA,Passenger,14,4,18,2711,2729,0.66
14567,November,2020,Klickitat,WA,Truck,0,0,0,8086,8086,0.0
14568,November,2020,Santa Clara,CA,Passenger,6,2,8,270,278,2.88
14569,November,2020,Ventura,CA,Passenger,1,1,2,269,271,0.74
14570,November,2020,San Joaquin,CA,Passenger,1,0,1,110,111,0.9
14571,November,2020,Wichita,TX,Passenger,1,0,1,41,42,2.38
14572,November,2020,Arlington,VA,Passenger,0,2,2,143,145,1.38
14573,November,2020,Island,WA,Passenger,480,287,767,62942,63709,1.2
14574,November,2020,Larimer,CO,Passenger,1,0,1,53,54,1.85
14575,November,2020,Stevens,WA,Truck,0,0,0,18671,18671,0.0
14576,November,2020,Albemarle,VA,Passenger,1,0,1,21,22,4.55
14577,November,2020,Ada,ID,Passenger,0,1,1,245,246,0.41
14578,November,2020,Oldham,KY,Passenger,0,1,1,4,5,20.0
14579,November,2020,Harrison,MS,Passenger,1,0,1,53,54,1.85
14580,November,2020,Norfolk,VA,Passenger,2,3,5,341,346,1.45
14581,November,2020,Douglas,WA,Passenger,82,43,125,28127,28252,0.44
14582,November,2020,Whatcom,WA,Truck,3,0,3,43487,43490,0.01
14583,November,2020,Houston,GA,Passenger,1,0,1,52,53,1.89
14584,November,2020,New Haven,CT,Passenger,0,2,2,35,37,5.41
14585,November,2020,Plaquemines,LA,Passenger,0,1,1,13,14,7.14
14586,November,2020,Bartow,GA,Passenger,0,1,1,4,5,20.0
14587,November,2020,Klickitat,WA,Passenger,62,42,104,14976,15080,0.69
14588,November,2020,Monroe,IL,Passenger,1,0,1,3,4,25.0
14589,November,2020,Dakota,MN,Passenger,0,1,1,28,29,3.45
14590,November,2020,Shelby,OH,Passenger,0,1,1,1,2,50.0
14591,November,2020,Wahkiakum,WA,Truck,0,0,0,1766,1766,0.0
14592,November,2020,Lee,FL,Passenger,1,0,1,45,46,2.17
14593,November,2020,Skagit,WA,Passenger,481,235,716,91415,92131,0.78
14594,November,2020,Queens,NY,Passenger,1,0,1,52,53,1.89
14595,November,2020,San Francisco,CA,Passenger,1,1,2,89,91,2.2
14596,November,2020,St. Louis,MO,Passenger,1,0,1,95,96,1.04
14597,November,2020,Douglas,NE,Passenger,0,1,1,48,49,2.04
14598,November,2020,DeKalb,IN,Passenger,1,0,1,0,1,100.0
14599,November,2020,Snohomish,WA,Truck,0,0,0,125469,125469,0.0
14600,November,2020,Grant,WA,Passenger,78,79,157,65766,65923,0.24
14601,November,2020,New London,CT,Passenger,1,2,3,237,240,1.25
14602,November,2020,Chelan,WA,Truck,0,0,0,22778,22778,0.0
14603,November,2020,Clark,WA,Truck,0,0,0,83228,83228,0.0
14604,November,2020,Hamilton,IN,Passenger,2,0,2,34,36,5.56
14605,November,2020,Nassau,FL,Passenger,1,0,1,36,37,2.7
14606,November,2020,Solano,CA,Passenger,1,0,1,206,207,0.48
14607,November,2020,Owyhee,ID,Passenger,1,0,1,3,4,25.0
14608,November,2020,Clallam,WA,Truck,1,0,1,21782,21783,0.0
14609,November,2020,Harnett,NC,Passenger,1,0,1,187,188,0.53
14610,November,2020,Whitman,WA,Truck,0,0,0,8487,8487,0.0
14611,November,2020,Powhatan,VA,Passenger,1,0,1,0,1,100.0
14612,November,2020,Kent,MI,Passenger,0,1,1,24,25,4.0
14613,November,2020,Lewis,WA,Passenger,117,117,234,58633,58867,0.4
14614,November,2020,Cowlitz,WA,Passenger,170,124,294,72016,72310,0.41
14615,November,2020,Jefferson,WA,Truck,0,0,0,9582,9582,0.0
14616,November,2020,District of Columbia,DC,Passenger,3,1,4,199,203,1.97
14617,November,2020,Charleston,SC,Passenger,2,0,2,91,93,2.15
14618,November,2020,Vigo,IN,Passenger,1,0,1,6,7,14.29
14619,November,2020,Polk,FL,Passenger,1,0,1,58,59,1.69
14620,November,2020,Maui,HI,Passenger,1,0,1,28,29,3.45
14621,November,2020,Bucks,PA,Passenger,1,0,1,18,19,5.26
14622,November,2020,Grays Harbor,WA,Passenger,122,117,239,48546,48785,0.49
14623,November,2020,Boulder,CO,Passenger,0,1,1,44,45,2.22
14624,November,2020,Franklin,WA,Truck,0,0,0,20378,20378,0.0
14625,November,2020,Alexandria,VA,Passenger,2,0,2,134,136,1.47
14626,November,2020,Broward,FL,Passenger,2,1,3,109,112,2.68
14627,November,2020,Stafford,VA,Passenger,1,1,2,93,95,2.11
14628,November,2020,Nueces,TX,Passenger,1,0,1,83,84,1.19
14629,November,2020,Walla Walla,WA,Truck,0,0,0,13819,13819,0.0
14630,November,2020,Kauai,HI,Passenger,1,0,1,15,16,6.25
14631,November,2020,Dallas,TX,Passenger,1,0,1,174,175,0.57
14632,November,2020,Collin,TX,Passenger,1,1,2,117,119,1.68
14633,November,2020,Washington,OR,Passenger,1,0,1,416,417,0.24
14634,November,2020,Ferry,WA,Passenger,8,3,11,4347,4358,0.25
14635,November,2020,Calvert,MD,Passenger,0,2,2,85,87,2.3
14636,November,2020,Tulsa,OK,Passenger,1,1,2,39,41,4.88
14637,November,2020,Pierce,WA,Truck,0,0,0,144543,144543,0.0
14638,November,2020,Richmond,GA,Passenger,0,1,1,79,80,1.25
14639,November,2020,Alameda,CA,Passenger,3,0,3,259,262,1.15
14640,November,2020,Montgomery,OH,Passenger,0,1,1,52,53,1.89
14641,November,2020,Penobscot,ME,Passenger,0,1,1,10,11,9.09
14642,November,2020,Leavenworth,KS,Passenger,0,1,1,125,126,0.79
14643,November,2020,Pacific,WA,Truck,0,0,0,7762,7762,0.0
14644,November,2020,Okanogan,WA,Truck,0,0,0,16579,16579,0.0
14645,November,2020,Charles,MD,Passenger,1,1,2,73,75,2.67
14646,November,2020,Whatcom,WA,Passenger,1203,534,1737,149736,151473,1.15
14647,November,2020,Klamath,OR,Passenger,1,0,1,31,32,3.12
14648,November,2020,Sumter,FL,Passenger,0,1,1,10,11,9.09
14649,November,2020,Douglas,CO,Passenger,0,1,1,78,79,1.27
14650,November,2020,Kittitas,WA,Passenger,125,52,177,29743,29920,0.59
14651,November,2020,Benton,WA,Truck,0,0,0,43111,43111,0.0
14652,November,2020,Honolulu,HI,Passenger,5,2,7,429,436,1.61
14653,November,2020,Kitsap,WA,Passenger,1521,737,2258,179773,182031,1.24
14654,November,2020,Denton,TX,Passenger,1,0,1,85,86,1.16
14655,November,2020,Flathead,MT,Passenger,1,0,1,53,54,1.85
14656,November,2020,Yakima,WA,Truck,0,0,0,60772,60772,0.0
14657,November,2020,DeKalb,GA,Passenger,1,0,1,71,72,1.39
14658,November,2020,Carson City,NV,Passenger,1,0,1,12,13,7.69
14659,November,2020,Ramsey,MN,Passenger,1,0,1,34,35,2.86
14660,November,2020,Middlesex,MA,Passenger,1,1,2,91,93,2.15
14661,November,2020,Island,WA,Truck,0,0,0,21304,21304,0.0
14662,November,2020,Putnam,TN,Passenger,0,1,1,2,3,33.33
14663,November,2020,Sacramento,CA,Passenger,2,0,2,242,244,0.82
14664,November,2020,Garfield,WA,Passenger,0,1,1,1363,1364,0.07
14665,November,2020,Hampshire,MA,Passenger,1,0,1,6,7,14.29
14666,November,2020,Chesapeake,VA,Passenger,0,3,3,405,408,0.74
14667,November,2020,Lincoln,WA,Truck,0,0,0,4660,4660,0.0
14668,November,2020,Spokane,WA,Truck,0,0,0,100377,100377,0.0
14669,November,2020,Clark,NV,Passenger,3,2,5,653,658,0.76
14670,November,2020,Skamania,WA,Truck,0,0,0,4008,4008,0.0
14671,November,2020,Sarasota,FL,Passenger,2,0,2,26,28,7.14
14672,November,2020,Pend Oreille,WA,Passenger,9,4,13,9146,9159,0.14
14673,November,2020,Wilson,TX,Passenger,0,1,1,5,6,16.67
14674,November,2020,Morris,NJ,Passenger,1,0,1,17,18,5.56
14675,November,2020,Juneau,AK,Passenger,0,1,1,26,27,3.7
14676,November,2020,Contra Costa,CA,Passenger,4,3,7,284,291,2.41
14677,November,2020,Portsmouth,VA,Passenger,0,1,1,76,77,1.3
14678,November,2020,Washoe,NV,Passenger,1,0,1,103,104,0.96
14679,November,2020,Fairfax,VA,Passenger,4,3,7,710,717,0.98
14680,November,2020,RÃ­o Grande,PR,Passenger,1,0,1,1,2,50.0
14681,November,2020,Rogers,OK,Passenger,1,0,1,4,5,20.0
14682,November,2020,Los Angeles,CA,Passenger,9,10,19,957,976,1.95
14683,November,2020,Virginia Beach,VA,Passenger,1,0,1,643,644,0.16
14684,November,2020,Lincoln,WA,Passenger,5,11,16,7617,7633,0.21
14685,November,2020,Greene,MO,Passenger,0,1,1,32,33,3.03
14686,November,2020,Grays Harbor,WA,Truck,0,0,0,21133,21133,0.0
14687,November,2020,Columbia,WA,Passenger,4,3,7,2439,2446,0.29
14689,November,2020,Sedgwick,KS,Passenger,1,1,2,89,91,2.2
14690,November,2020,Cumberland,NC,Passenger,0,3,3,447,450,0.67
14691,November,2020,Carroll,NH,Passenger,0,1,1,5,6,16.67
14692,November,2020,Franklin,WA,Passenger,78,80,158,61166,61324,0.26
14693,November,2020,Kitsap,WA,Truck,0,0,0,54292,54292,0.0
14694,November,2020,Allegheny,PA,Passenger,1,1,2,66,68,2.94
14695,November,2020,Miami-Dade,FL,Passenger,1,0,1,101,102,0.98
14696,November,2020,Utah,UT,Passenger,0,1,1,128,129,0.78
14697,November,2020,Grant,WA,Truck,0,0,0,27418,27418,0.0
14698,November,2020,Travis,TX,Passenger,2,0,2,170,172,1.16
14699,November,2020,Montgomery,AL,Passenger,0,1,1,40,41,2.44
14700,November,2020,Monterey,CA,Passenger,0,1,1,155,156,0.64
14701,November,2020,Fairbanks North Star,AK,Passenger,0,1,1,92,93,1.08
14702,November,2020,Thurston,WA,Truck,0,0,0,56280,56280,0.0
14703,November,2020,Montgomery,PA,Passenger,1,0,1,24,25,4.0
14704,November,2020,Clackamas,OR,Passenger,2,0,2,179,181,1.1
14705,November,2020,Salt Lake,UT,Passenger,0,1,1,172,173,0.58
14706,November,2020,Fort Bend,TX,Passenger,1,0,1,42,43,2.33
14707,November,2020,Ferry,WA,Truck,0,0,0,3598,3598,0.0
14708,November,2020,El Paso,CO,Passenger,2,0,2,699,701,0.29
14709,November,2020,Wahkiakum,WA,Passenger,6,6,12,3039,3051,0.39
14710,November,2020,Multnomah,OR,Passenger,3,6,9,690,699,1.29
14711,November,2020,New York,NY,Passenger,1,0,1,54,55,1.82
14712,November,2020,Hennepin,MN,Passenger,2,0,2,83,85,2.35
14713,November,2020,King,WA,Passenger,26599,8083,34682,1371168,1405850,2.47
14714,November,2020,Howard,IN,Passenger,0,1,1,3,4,25.0
14715,November,2020,Chelan,WA,Passenger,271,84,355,54377,54732,0.65
14716,November,2020,Denver,CO,Passenger,1,0,1,114,115,0.87
14717,November,2020,Douglas,WA,Truck,0,0,0,12451,12451,0.0
14718,November,2020,Lake,IL,Passenger,2,0,2,158,160,1.25
14719,November,2020,Boone,MO,Passenger,0,1,1,10,11,9.09
14720,November,2020,Duval,FL,Passenger,0,2,2,354,356,0.56
14721,November,2021,Whitman,WA,Passenger,66,58,124,21959,22083,0.56
14722,November,2021,Klamath,OR,Passenger,1,0,1,28,29,3.45
14723,November,2021,Nassau,NY,Passenger,2,0,2,24,26,7.69
14724,November,2021,Penobscot,ME,Passenger,0,1,1,8,9,11.11
14725,November,2021,Douglas,CO,Passenger,0,1,1,76,77,1.3
14726,November,2021,Orange,CA,Passenger,5,2,7,384,391,1.79
14727,November,2021,Platte,MO,Passenger,1,0,1,17,18,5.56
14728,November,2021,Kauai,HI,Passenger,1,0,1,17,18,5.56
14729,November,2021,Spokane,WA,Passenger,1262,748,2010,327064,329074,0.61
14730,November,2021,Middlesex,MA,Passenger,1,1,2,84,86,2.33
14731,November,2021,Suffolk,MA,Passenger,0,2,2,26,28,7.14
14732,November,2021,Sevier,AR,Passenger,0,1,1,0,1,100.0
14733,November,2021,Douglas,WA,Passenger,106,53,159,28610,28769,0.55
14734,November,2021,Harrison,MS,Passenger,2,0,2,46,48,4.17
14735,November,2021,Geary,KS,Passenger,1,0,1,96,97,1.03
14736,November,2021,Orange,FL,Passenger,1,0,1,104,105,0.95
14737,November,2021,Lake,IL,Passenger,3,0,3,152,155,1.94
14738,November,2021,Benton,WA,Truck,0,0,0,43650,43650,0.0
14739,November,2021,Riverside,CA,Passenger,5,1,6,502,508,1.18
14740,November,2021,Hudson,NJ,Passenger,1,0,1,40,41,2.44
14741,November,2021,Stafford,VA,Passenger,2,1,3,95,98,3.06
14742,November,2021,Mason,WA,Passenger,255,158,413,47799,48212,0.86
14743,November,2021,Lane,OR,Passenger,0,1,1,109,110,0.91
14744,November,2021,Wilson,NC,Passenger,1,0,1,0,1,100.0
14745,November,2021,Benton,WA,Passenger,625,435,1060,136011,137071,0.77
14746,November,2021,Honolulu,HI,Passenger,4,3,7,356,363,1.93
14747,November,2021,Salt Lake,UT,Passenger,0,1,1,155,156,0.64
14748,November,2021,Vigo,IN,Passenger,1,0,1,5,6,16.67
14749,November,2021,Santa Cruz,CA,Passenger,1,0,1,22,23,4.35
14750,November,2021,Baltimore,MD,Passenger,1,0,1,83,84,1.19
14751,November,2021,Travis,TX,Passenger,3,3,6,129,135,4.44
14752,November,2021,Powhatan,VA,Passenger,1,0,1,1,2,50.0
14753,November,2021,El Paso,CO,Passenger,3,0,3,653,656,0.46
14754,November,2021,Sonoma,CA,Passenger,0,1,1,82,83,1.2
14755,November,2021,Pennington,SD,Passenger,1,0,1,31,32,3.12
14756,November,2021,Champaign,IL,Passenger,1,0,1,9,10,10.0
14757,November,2021,Snohomish,WA,Truck,2,0,2,125685,125687,0.0
14758,November,2021,Fort Bend,TX,Passenger,1,0,1,35,36,2.78
14759,November,2021,Cook,IL,Passenger,2,0,2,192,194,1.03
14760,November,2021,Pend Oreille,WA,Truck,0,0,0,5696,5696,0.0
14761,November,2021,Sarpy,NE,Passenger,1,0,1,58,59,1.69
14762,November,2021,Coryell,TX,Passenger,1,0,1,106,107,0.93
14763,November,2021,Wahkiakum,WA,Truck,0,0,0,1817,1817,0.0
14764,November,2021,Alexandria,VA,Passenger,2,0,2,118,120,1.67
14765,November,2021,Stevens,WA,Passenger,54,43,97,30313,30410,0.32
14766,November,2021,New Haven,CT,Passenger,0,2,2,27,29,6.9
14767,November,2021,Suffolk,VA,Passenger,1,0,1,122,123,0.81
14768,November,2021,Skamania,WA,Passenger,57,40,97,8344,8441,1.15
14769,November,2021,San Juan,WA,Passenger,473,147,620,14195,14815,4.18
14770,November,2021,Klickitat,WA,Truck,0,0,0,8335,8335,0.0
14771,November,2021,Larimer,CO,Passenger,1,0,1,50,51,1.96
14772,November,2021,Yakima,WA,Truck,0,0,0,61715,61715,0.0
14773,November,2021,Yakima,WA,Passenger,272,167,439,168647,169086,0.26
14774,November,2021,Island,WA,Passenger,701,342,1043,62971,64014,1.63
14775,November,2021,Virginia Beach,VA,Passenger,2,0,2,569,571,0.35
14776,November,2021,Harris,TX,Passenger,1,1,2,168,170,1.18
14777,November,2021,San Mateo,CA,Passenger,2,0,2,79,81,2.47
14778,November,2021,Kings,NY,Passenger,1,0,1,66,67,1.49
14779,November,2021,Grant,WA,Passenger,131,97,228,66942,67170,0.34
14780,November,2021,Miami-Dade,FL,Passenger,1,0,1,89,90,1.11
14781,November,2021,Harnett,NC,Passenger,1,1,2,151,153,1.31
14782,November,2021,Washington,MD,Passenger,2,0,2,14,16,12.5
14783,November,2021,Columbia,WA,Passenger,6,2,8,2459,2467,0.32
14784,November,2021,Collin,TX,Passenger,1,0,1,101,102,0.98
14785,November,2021,Skagit,WA,Truck,1,0,1,32804,32805,0.0
14786,November,2021,Kitsap,WA,Passenger,2083,941,3024,180487,183511,1.65
14787,November,2021,Philadelphia,PA,Passenger,1,0,1,38,39,2.56
14788,November,2021,Columbia,WA,Truck,0,0,0,1552,1552,0.0
14789,November,2021,Kings,CA,Passenger,2,0,2,322,324,0.62
14790,November,2021,St. Clair,IL,Passenger,2,0,2,120,122,1.64
14791,November,2021,Jefferson,WA,Passenger,372,195,567,24790,25357,2.24
14792,November,2021,Louisa,VA,Passenger,0,1,1,1,2,50.0
14793,November,2021,Ferry,WA,Truck,0,0,0,3600,3600,0.0
14794,November,2021,San Joaquin,CA,Passenger,1,1,2,95,97,2.06
14795,November,2021,Flathead,MT,Passenger,1,0,1,40,41,2.44
14796,November,2021,Rogers,OK,Passenger,1,0,1,3,4,25.0
14797,November,2021,Jefferson,NY,Passenger,0,1,1,202,203,0.49
14798,November,2021,San Francisco,CA,Passenger,0,1,1,80,81,1.23
14799,November,2021,Lee,FL,Passenger,1,0,1,29,30,3.33
14800,November,2021,DuPage,IL,Passenger,1,0,1,49,50,2.0
14801,November,2021,Portsmouth,VA,Passenger,0,1,1,77,78,1.28
14802,November,2021,Skamania,WA,Truck,0,0,0,4003,4003,0.0
14803,November,2021,Dallas,TX,Passenger,1,0,1,143,144,0.69
14804,November,2021,King,WA,Passenger,34716,10089,44805,1362899,1407704,3.18
14805,November,2021,New London,CT,Passenger,1,4,5,212,217,2.3
14806,November,2021,Goochland,VA,Passenger,3,2,5,187,192,2.6
14807,November,2021,Fairbanks North Star,AK,Passenger,0,1,1,76,77,1.3
14808,November,2021,Thurston,WA,Passenger,1845,949,2794,197125,199919,1.4
14809,November,2021,Douglas,NE,Passenger,1,1,2,46,48,4.17
14810,November,2021,Okanogan,WA,Truck,0,0,0,16689,16689,0.0
14811,November,2021,San Diego,CA,Passenger,16,8,24,2436,2460,0.98
14812,November,2021,Contra Costa,CA,Passenger,1,4,5,262,267,1.87
14813,November,2021,Las Animas,CO,Passenger,1,0,1,0,1,100.0
14814,November,2021,Whatcom,WA,Passenger,1611,660,2271,150227,152498,1.49
14815,November,2021,Cumberland,NC,Passenger,1,2,3,395,398,0.75
14816,November,2021,Boone,MO,Passenger,0,1,1,9,10,10.0
14817,November,2021,San Juan,WA,Truck,0,0,0,5996,5996,0.0
14819,November,2021,Milwaukee,WI,Passenger,1,0,1,36,37,2.7
14820,November,2021,Pacific,WA,Truck,0,0,0,8004,8004,0.0
14821,November,2021,Hillsborough,FL,Passenger,0,1,1,138,139,0.72
14822,November,2021,Plaquemines,LA,Passenger,0,1,1,17,18,5.56
14823,November,2021,Bexar,TX,Passenger,3,4,7,484,491,1.43
14824,November,2021,Loudoun,VA,Passenger,1,0,1,66,67,1.49
14825,November,2021,Erie,NY,Passenger,1,0,1,31,32,3.12
14826,November,2021,Pinellas,FL,Passenger,0,1,1,87,88,1.14
14827,November,2021,Kern,CA,Passenger,0,1,1,199,200,0.5
14828,November,2021,Pierce,WA,Passenger,4130,2111,6241,557334,563575,1.11
14829,November,2021,Williams,ND,Passenger,0,1,1,8,9,11.11
14830,November,2021,Sedgwick,KS,Passenger,1,1,2,81,83,2.41
14831,November,2021,Walla Walla,WA,Passenger,137,85,222,36395,36617,0.61
14832,November,2021,St. Mary's,MD,Passenger,1,0,1,202,203,0.49
14833,November,2021,Kittitas,WA,Truck,0,0,0,14805,14805,0.0
14834,November,2021,Charleston,SC,Passenger,2,1,3,77,80,3.75
14835,November,2021,Klickitat,WA,Passenger,88,52,140,15349,15489,0.9
14836,November,2021,Cowlitz,WA,Truck,0,1,1,29027,29028,0.0
14837,November,2021,El Paso,TX,Passenger,3,0,3,348,351,0.85
14838,November,2021,Oldham,KY,Passenger,0,1,1,4,5,20.0
14839,November,2021,Carroll,MD,Passenger,0,1,1,16,17,5.88
14840,November,2021,Denton,TX,Passenger,1,0,1,75,76,1.32
14841,November,2021,Broward,FL,Passenger,2,0,2,96,98,2.04
14842,November,2021,Asotin,WA,Truck,0,0,0,6760,6760,0.0
14843,November,2021,Houston,GA,Passenger,1,0,1,43,44,2.27
14844,November,2021,Jefferson,WA,Truck,0,0,0,9601,9601,0.0
14845,November,2021,Anne Arundel,MD,Passenger,4,3,7,357,364,1.92
14846,November,2021,Hawaii,HI,Passenger,1,0,1,41,42,2.38
14847,November,2021,Richmond,NY,Passenger,1,0,1,6,7,14.29
14848,November,2021,Spartanburg,SC,Passenger,0,1,1,48,49,2.04
14849,November,2021,Owyhee,ID,Passenger,1,0,1,2,3,33.33
14850,November,2021,Lincoln,WA,Passenger,7,16,23,7693,7716,0.3
14851,November,2021,Asotin,WA,Passenger,21,17,38,12753,12791,0.3
14852,November,2021,Ulster,NY,Passenger,1,0,1,9,10,10.0
14853,November,2021,Duval,FL,Passenger,0,2,2,322,324,0.62
14854,November,2021,Fresno,CA,Passenger,1,0,1,156,157,0.64
14855,November,2021,Sarasota,FL,Passenger,2,0,2,29,31,6.45
14856,November,2021,Pima,AZ,Passenger,1,1,2,249,251,0.8
14857,November,2021,Prince William,VA,Passenger,1,1,2,200,202,0.99
14858,November,2021,Clackamas,OR,Passenger,2,0,2,162,164,1.22
14859,November,2021,Maricopa,AZ,Passenger,8,2,10,1060,1070,0.93
14860,November,2021,Saratoga,NY,Passenger,1,0,1,39,40,2.5
14861,November,2021,RÃ­o Grande,PR,Passenger,1,0,1,0,1,100.0
14862,November,2021,Montgomery,TX,Passenger,1,1,2,36,38,5.26
14863,November,2021,Douglas,WA,Truck,0,0,0,12693,12693,0.0
14864,November,2021,Monterey,CA,Passenger,0,1,1,137,138,0.72
14865,November,2021,Nueces,TX,Passenger,1,0,1,64,65,1.54
14866,November,2021,Franklin,WA,Truck,0,0,0,20782,20782,0.0
14867,November,2021,Solano,CA,Passenger,1,0,1,175,176,0.57
14868,November,2021,Norfolk,VA,Passenger,3,3,6,307,313,1.92
14869,November,2021,Lake,FL,Passenger,1,0,1,22,23,4.35
14870,November,2021,Wilson,TX,Passenger,0,1,1,2,3,33.33
14871,November,2021,Sumter,SC,Passenger,0,1,1,34,35,2.86
14872,November,2021,Garfield,WA,Truck,0,0,0,995,995,0.0
14873,November,2021,Dorchester,SC,Passenger,1,0,1,63,64,1.56
14874,November,2021,Ventura,CA,Passenger,2,1,3,246,249,1.2
14875,November,2021,Pend Oreille,WA,Passenger,18,7,25,9167,9192,0.27
14876,November,2021,Lewis,WA,Passenger,199,163,362,59631,59993,0.6
14877,November,2021,Multnomah,OR,Passenger,2,6,8,612,620,1.29
14878,November,2021,St. Louis,MO,Passenger,1,0,1,71,72,1.39
14879,November,2021,Lewis,WA,Truck,0,0,0,26719,26719,0.0
14880,November,2021,Carson City,NV,Passenger,1,0,1,8,9,11.11
14881,November,2021,Placer,CA,Passenger,2,0,2,70,72,2.78
14882,November,2021,Burlington,NJ,Passenger,0,1,1,120,121,0.83
14883,November,2021,Clark,WA,Truck,0,0,0,84070,84070,0.0
14884,November,2021,Leavenworth,KS,Passenger,0,1,1,107,108,0.93
14885,November,2021,Hidalgo,TX,Passenger,0,1,1,53,54,1.85
14886,November,2021,Hamilton,IN,Passenger,2,0,2,28,30,6.67
14887,November,2021,Albemarle,VA,Passenger,1,0,1,19,20,5.0
14888,November,2021,Wahkiakum,WA,Passenger,17,10,27,3091,3118,0.87
14889,November,2021,Stevens,WA,Truck,0,0,0,18924,18924,0.0
14890,November,2021,Juneau,AK,Passenger,0,1,1,27,28,3.57
14891,November,2021,Alameda,CA,Passenger,4,0,4,211,215,1.86
14892,November,2021,Randolph,NC,Passenger,1,0,1,5,6,16.67
14893,November,2021,Snohomish,WA,Passenger,6837,2229,9066,538413,547479,1.66
14894,November,2021,Cowlitz,WA,Passenger,265,159,424,71773,72197,0.59
14895,November,2021,Kitsap,WA,Truck,0,0,0,54275,54275,0.0
14896,November,2021,Calvert,MD,Passenger,0,2,2,82,84,2.38
14897,November,2021,Walla Walla,WA,Truck,0,0,0,14078,14078,0.0
14898,November,2021,Rockdale,GA,Passenger,1,0,1,7,8,12.5
14899,November,2021,San Luis Obispo,CA,Passenger,1,0,1,57,58,1.72
14900,November,2021,Grays Harbor,WA,Truck,0,0,0,21428,21428,0.0
14901,November,2021,Montgomery,PA,Passenger,2,0,2,21,23,8.7
14902,November,2021,Adams,WA,Truck,0,0,0,5421,5421,0.0
14903,November,2021,Hamilton,OH,Passenger,1,0,1,32,33,3.03
14904,November,2021,Santa Clara,CA,Passenger,7,1,8,230,238,3.36
14905,November,2021,Escambia,FL,Passenger,0,1,1,138,139,0.72
14906,November,2021,Manassas,VA,Passenger,0,1,1,7,8,12.5
14907,November,2021,Anchorage,AK,Passenger,1,0,1,124,125,0.8
14908,November,2021,Whatcom,WA,Truck,4,0,4,43702,43706,0.01
14909,November,2021,Shelby,OH,Passenger,0,1,1,2,3,33.33
14910,November,2021,District of Columbia,DC,Passenger,5,0,5,191,196,2.55
14911,November,2021,Gwinnett,GA,Passenger,1,0,1,58,59,1.69
14912,November,2021,Marin,CA,Passenger,0,1,1,33,34,2.94
14913,November,2021,Thurston,WA,Truck,0,0,0,56178,56178,0.0
14914,November,2021,Clark,WA,Passenger,3363,1536,4899,320835,325734,1.5
14915,November,2021,Los Angeles,CA,Passenger,10,7,17,832,849,2.0
14916,November,2021,Lincoln,WA,Truck,0,0,0,4811,4811,0.0
14917,November,2021,Clark,NV,Passenger,4,2,6,558,564,1.06
14918,November,2021,Carroll,NH,Passenger,0,1,1,5,6,16.67
14919,November,2021,DeKalb,GA,Passenger,1,0,1,56,57,1.75
14920,November,2021,Camden,NJ,Passenger,0,1,1,14,15,6.67
14921,November,2021,Okanogan,WA,Passenger,67,43,110,26601,26711,0.41
14922,November,2021,Clallam,WA,Passenger,372,238,610,50508,51118,1.19
14923,November,2021,Sacramento,CA,Passenger,2,0,2,216,218,0.92
14924,November,2021,Spokane,WA,Truck,0,0,0,102699,102699,0.0
14925,November,2021,Washington,OR,Passenger,1,0,1,348,349,0.29
14926,November,2021,Whitman,WA,Truck,0,0,0,8556,8556,0.0
14927,November,2021,Chelan,WA,Passenger,400,113,513,54703,55216,0.93
14928,November,2021,Saginaw,MI,Passenger,1,0,1,5,6,16.67
14929,November,2021,King,WA,Truck,6,1,7,183330,183337,0.0
14930,November,2021,Polk,FL,Passenger,1,0,1,55,56,1.79
14931,November,2021,Essex,NJ,Passenger,2,0,2,10,12,16.67
14932,November,2021,Wood,OH,Passenger,0,1,1,5,6,16.67
14933,November,2021,Onslow,NC,Passenger,0,1,1,169,170,0.59
14934,November,2021,Frederick,MD,Passenger,1,1,2,69,71,2.82
14935,November,2021,Rockingham,NH,Passenger,1,0,1,19,20,5.0
14936,November,2021,Ray,MO,Passenger,0,1,1,1,2,50.0
14937,November,2021,Island,WA,Truck,0,0,0,21547,21547,0.0
14938,November,2021,Richmond,GA,Passenger,0,1,1,71,72,1.39
14939,November,2021,Adams,WA,Passenger,16,14,30,13044,13074,0.23
14940,November,2021,Franklin,WA,Passenger,154,103,257,62279,62536,0.41
14941,November,2021,Skagit,WA,Passenger,667,299,966,91301,92267,1.05
14942,November,2021,Ferry,WA,Passenger,13,3,16,4457,4473,0.36
14943,November,2021,Yamhill,OR,Passenger,1,0,1,32,33,3.03
14944,November,2021,Bartow,GA,Passenger,0,1,1,3,4,25.0
14945,November,2021,Grays Harbor,WA,Passenger,191,155,346,49503,49849,0.69
14946,November,2021,San Bernardino,CA,Passenger,0,1,1,363,364,0.27
14947,November,2021,Moore,NC,Passenger,0,1,1,121,122,0.82
14948,November,2021,Williamson,TX,Passenger,1,2,3,93,96,3.12
14949,November,2021,Howard,IN,Passenger,0,1,1,6,7,14.29
14950,November,2021,Fairfax,VA,Passenger,3,4,7,656,663,1.06
14951,November,2021,Allegheny,PA,Passenger,1,1,2,59,61,3.28
14952,November,2021,Allen,IN,Passenger,1,0,1,14,15,6.67
14953,November,2021,Tarrant,TX,Passenger,1,0,1,129,130,0.77
14954,November,2021,Danville,VA,Passenger,1,0,1,0,1,100.0
14955,November,2021,Pierce,WA,Truck,0,0,0,145138,145138,0.0
14956,November,2021,Hennepin,MN,Passenger,3,0,3,65,68,4.41
14957,November,2021,Kittitas,WA,Passenger,196,75,271,29843,30114,0.9
14958,November,2021,Pacific,WA,Passenger,51,64,115,16071,16186,0.71
14959,November,2021,Bernalillo,NM,Passenger,1,0,1,109,110,0.91
14960,November,2021,Prince George's,MD,Passenger,2,1,3,141,144,2.08
14961,November,2021,Clallam,WA,Truck,1,0,1,22115,22116,0.0
14962,November,2021,Mason,WA,Truck,0,0,0,21254,21254,0.0
14963,November,2021,Grant,WA,Truck,0,0,0,28045,28045,0.0
14964,November,2021,Chesapeake,VA,Passenger,2,3,5,373,378,1.32
14965,November,2021,Arlington,VA,Passenger,1,1,2,127,129,1.55
14966,November,2021,Charles,MD,Passenger,1,1,2,67,69,2.9
14967,November,2021,Okaloosa,FL,Passenger,0,1,1,109,110,0.91
14968,November,2021,New York,NY,Passenger,1,0,1,37,38,2.63
14969,November,2021,Chelan,WA,Truck,0,0,0,23094,23094,0.0
14970,November,2021,Garfield,WA,Passenger,0,3,3,1350,1353,0.22
14971,November,2021,Montgomery,MD,Passenger,3,2,5,203,208,2.4
14972,November,2021,Queens,NY,Passenger,1,0,1,46,47,2.13
14973,November,2021,Howard,MD,Passenger,0,1,1,54,55,1.82
14974,November,2021,Cape May,NJ,Passenger,0,1,1,8,9,11.11
14975,November,2021,Wichita,TX,Passenger,1,0,1,42,43,2.33
14976,November,2021,Greene,MO,Passenger,0,1,1,25,26,3.85
14977,November,2021,Richland,SC,Passenger,0,1,1,130,131,0.76
14978,November,2021,Boulder,CO,Passenger,1,1,2,37,39,5.13
14979,November,2021,Wake,NC,Passenger,1,0,1,108,109,0.92
14980,November,2022,Solano,CA,Passenger,2,0,2,146,148,1.35
14981,November,2022,Wichita,TX,Passenger,2,0,2,36,38,5.26
14982,November,2022,Saratoga,NY,Passenger,1,0,1,36,37,2.7
14983,November,2022,Goochland,VA,Passenger,0,1,1,71,72,1.39
14984,November,2022,Whitman,WA,Passenger,109,65,174,21989,22163,0.79
14985,November,2022,Montgomery,PA,Passenger,1,0,1,18,19,5.26
14986,November,2022,Grays Harbor,WA,Passenger,242,161,403,48681,49084,0.82
14987,November,2022,Essex,NJ,Passenger,2,0,2,8,10,20.0
14988,November,2022,Hidalgo,TX,Passenger,0,1,1,48,49,2.04
14989,November,2022,Prince George's,MD,Passenger,3,1,4,111,115,3.48
14990,November,2022,Whatcom,WA,Passenger,2054,800,2854,148864,151718,1.88
14991,November,2022,St. Tammany,LA,Passenger,1,0,1,32,33,3.03
14992,November,2022,Honolulu,HI,Passenger,3,3,6,287,293,2.05
14993,November,2022,King,WA,Truck,337,2,339,179007,179346,0.19
14994,November,2022,Clark,NV,Passenger,5,2,7,427,434,1.61
14995,November,2022,Bartow,GA,Passenger,0,1,1,3,4,25.0
14996,November,2022,Orange,CA,Passenger,6,2,8,304,312,2.56
14997,November,2022,Wahkiakum,WA,Passenger,25,13,38,3045,3083,1.23
14998,November,2022,Franklin,WA,Passenger,246,117,363,61801,62164,0.58
14999,November,2022,Douglas,WA,Passenger,162,59,221,28510,28731,0.77
15000,November,2022,Charles,MD,Passenger,1,1,2,49,51,3.92
15001,November,2022,Island,WA,Passenger,922,394,1316,61562,62878,2.09
15002,November,2022,Multnomah,OR,Passenger,0,2,2,454,456,0.44
15003,November,2022,Douglas,WA,Truck,2,0,2,12811,12813,0.02
15004,November,2022,Kootenai,ID,Truck,1,0,1,29,30,3.33
15005,November,2022,San Diego,CA,Passenger,17,10,27,2066,2093,1.29
15006,November,2022,Hawaii,HI,Passenger,1,0,1,26,27,3.7
15007,November,2022,Anne Arundel,MD,Passenger,4,4,8,301,309,2.59
15008,November,2022,Bexar,TX,Passenger,4,3,7,379,386,1.81
15009,November,2022,Chelan,WA,Truck,11,0,11,23139,23150,0.05
15010,November,2022,San Joaquin,CA,Passenger,1,0,1,75,76,1.32
15011,November,2022,Boulder,CO,Passenger,1,0,1,30,31,3.23
15012,November,2022,Allen,IN,Passenger,1,0,1,11,12,8.33
15013,November,2022,Travis,TX,Passenger,1,0,1,83,84,1.19
15014,November,2022,El Paso,CO,Passenger,3,1,4,525,529,0.76
15015,November,2022,Galveston,TX,Passenger,0,1,1,16,17,5.88
15016,November,2022,San Bernardino,CA,Passenger,1,1,2,290,292,0.68
15017,November,2022,Frederick,MD,Passenger,1,0,1,57,58,1.72
15018,November,2022,Newport News,VA,Passenger,1,0,1,95,96,1.04
15019,November,2022,Fairfax,VA,Truck,1,0,1,101,102,0.98
15020,November,2022,San Juan,WA,Truck,7,0,7,5939,5946,0.12
15021,November,2022,Pierce,WA,Truck,71,0,71,139968,140039,0.05
15022,November,2022,Champaign,IL,Passenger,1,0,1,7,8,12.5
15023,November,2022,Plaquemines,LA,Passenger,1,1,2,16,18,11.11
15024,November,2022,Santa Cruz,CA,Passenger,1,0,1,18,19,5.26
15025,November,2022,Ferry,WA,Passenger,24,4,28,4370,4398,0.64
15026,November,2022,Benton,WA,Truck,7,0,7,43416,43423,0.02
15027,November,2022,Montgomery,MD,Passenger,3,2,5,175,180,2.78
15028,November,2022,Yellowstone,MT,Passenger,0,1,1,17,18,5.56
15029,November,2022,Richmond,NY,Passenger,1,0,1,6,7,14.29
15030,November,2022,Penobscot,ME,Passenger,0,1,1,8,9,11.11
15031,November,2022,Sonoma,CA,Passenger,1,1,2,64,66,3.03
15032,November,2022,Alexandria,VA,Passenger,4,1,5,95,100,5.0
15033,November,2022,Arlington,VA,Passenger,1,0,1,107,108,0.93
15034,November,2022,Adams,CO,Passenger,1,0,1,33,34,2.94
15035,November,2022,Elmore,ID,Passenger,1,0,1,11,12,8.33
15036,November,2022,Pierce,WA,Passenger,5996,2477,8473,540119,548592,1.54
15037,November,2022,Salt Lake,UT,Passenger,1,1,2,106,108,1.85
15038,November,2022,Middlesex,MA,Passenger,2,1,3,61,64,4.69
15039,November,2022,Garfield,WA,Truck,0,0,0,981,981,0.0
15040,November,2022,St. Louis,MO,Passenger,1,0,1,54,55,1.82
15041,November,2022,Arapahoe,CO,Passenger,0,1,1,70,71,1.41
15042,November,2022,Stevens,WA,Passenger,88,56,144,30077,30221,0.48
15043,November,2022,Montgomery,AL,Passenger,0,1,1,29,30,3.33
15044,November,2022,Howard,MD,Passenger,0,1,1,46,47,2.13
15045,November,2022,Louisa,VA,Passenger,0,1,1,1,2,50.0
15046,November,2022,Cook,IL,Passenger,2,0,2,158,160,1.25
15047,November,2022,Houston,GA,Passenger,1,0,1,25,26,3.85
15048,November,2022,Danville,VA,Passenger,1,0,1,0,1,100.0
15049,November,2022,Bryan,GA,Passenger,0,1,1,38,39,2.56
15050,November,2022,Adams,WA,Passenger,22,11,33,13032,13065,0.25
15051,November,2022,Duval,FL,Passenger,1,1,2,242,244,0.82
15052,November,2022,Ferry,WA,Truck,0,0,0,3579,3579,0.0
15053,November,2022,Harnett,NC,Passenger,2,0,2,133,135,1.48
15054,November,2022,Calvert,MD,Passenger,0,2,2,74,76,2.63
15055,November,2022,Asotin,WA,Passenger,29,20,49,12522,12571,0.39
15056,November,2022,Berkeley,SC,Passenger,0,1,1,109,110,0.91
15057,November,2022,Contra Costa,CA,Passenger,0,3,3,209,212,1.42
15058,November,2022,Cowlitz,WA,Passenger,389,188,577,70283,70860,0.81
15059,November,2022,Jefferson,WA,Truck,6,0,6,9386,9392,0.06
15060,November,2022,Benton,WA,Passenger,914,491,1405,135879,137284,1.02
15061,November,2022,Alameda,CA,Passenger,3,0,3,163,166,1.81
15062,November,2022,Norfolk,VA,Passenger,3,3,6,272,278,2.16
15063,November,2022,Richmond,GA,Passenger,0,1,1,58,59,1.69
15064,November,2022,Wilson,TX,Passenger,0,1,1,2,3,33.33
15065,November,2022,Hennepin,MN,Passenger,1,0,1,39,40,2.5
15066,November,2022,Lewis,WA,Passenger,260,178,438,59990,60428,0.72
15067,November,2022,Ray,MO,Passenger,0,1,1,1,2,50.0
15068,November,2022,Island,WA,Truck,15,0,15,21264,21279,0.07
15069,November,2022,Harrison,MS,Passenger,1,0,1,32,33,3.03
15070,November,2022,Sarasota,FL,Passenger,1,0,1,18,19,5.26
15071,November,2022,Clallam,WA,Passenger,470,261,731,49431,50162,1.46
15072,November,2022,Williamson,TX,Passenger,0,2,2,64,66,3.03
15073,November,2022,El Paso,TX,Passenger,2,0,2,292,294,0.68
15074,November,2022,Clark,WA,Passenger,4776,1979,6755,315151,321906,2.1
15075,November,2022,Escambia,FL,Passenger,0,1,1,117,118,0.85
15076,November,2022,Clackamas,OR,Passenger,1,0,1,117,118,0.85
15077,November,2022,DeKalb,GA,Passenger,1,0,1,40,41,2.44
15078,November,2022,Kings,CA,Passenger,2,1,3,282,285,1.05
15079,November,2022,Grant,WA,Passenger,220,110,330,66830,67160,0.49
15080,November,2022,Kitsap,WA,Passenger,2699,1134,3833,177551,181384,2.11
15081,November,2022,Napa,CA,Passenger,0,1,1,9,10,10.0
15082,November,2022,Los Angeles,CA,Passenger,5,6,11,672,683,1.61
15083,November,2022,Lincoln,WA,Passenger,12,19,31,7772,7803,0.4
15084,November,2022,Pennington,SD,Passenger,2,0,2,24,26,7.69
15085,November,2022,Hoke,NC,Passenger,1,0,1,57,58,1.72
15086,November,2022,Grant,WA,Truck,4,0,4,27996,28000,0.01
15087,November,2022,Queens,NY,Passenger,1,0,1,32,33,3.03
15088,November,2022,New London,CT,Passenger,2,4,6,182,188,3.19
15089,November,2022,Lee,FL,Passenger,1,0,1,25,26,3.85
15090,November,2022,Whatcom,WA,Truck,21,0,21,43111,43132,0.05
15091,November,2022,Hamilton,OH,Passenger,1,0,1,27,28,3.57
15092,November,2022,Spokane,WA,Truck,19,0,19,101973,101992,0.02
15093,November,2022,Las Animas,CO,Passenger,1,0,1,1,2,50.0
15094,November,2022,Stafford,VA,Passenger,3,1,4,80,84,4.76
15095,November,2022,Allegheny,PA,Passenger,1,0,1,48,49,2.04
15096,November,2022,Whitman,WA,Truck,3,0,3,8630,8633,0.03
15097,November,2022,Fairbanks North Star,AK,Passenger,0,1,1,60,61,1.64
15098,November,2022,Larimer,CO,Passenger,1,0,1,41,42,2.38
15099,November,2022,Lewis,WA,Truck,2,0,2,26343,26345,0.01
15100,November,2022,Geary,KS,Passenger,1,0,1,77,78,1.28
15101,November,2022,Bell,TX,Passenger,1,0,1,281,282,0.35
15102,November,2022,New Haven,CT,Passenger,0,2,2,23,25,8.0
15103,November,2022,Chesapeake,VA,Passenger,2,3,5,293,298,1.68
15104,November,2022,Grays Harbor,WA,Truck,3,0,3,21117,21120,0.01
15105,November,2022,Lincoln,OR,Passenger,0,1,1,17,18,5.56
15106,November,2022,Columbia,WA,Truck,0,0,0,1591,1591,0.0
15107,November,2022,Hillsborough,FL,Passenger,0,1,1,110,111,0.9
15108,November,2022,Loudoun,VA,Passenger,3,1,4,60,64,6.25
15109,November,2022,Lincoln,WA,Truck,0,0,0,4862,4862,0.0
15110,November,2022,Yakima,WA,Passenger,410,218,628,166511,167139,0.38
15111,November,2022,St. Mary's,MD,Passenger,1,0,1,170,171,0.58
15112,November,2022,San Juan,WA,Passenger,554,168,722,13981,14703,4.91
15113,November,2022,Clark,WA,Truck,39,0,39,82070,82109,0.05
15114,November,2022,Kittitas,WA,Passenger,297,93,390,29569,29959,1.3
15115,November,2022,Douglas,CO,Passenger,0,1,1,58,59,1.69
15116,November,2022,Cumberland,NC,Passenger,1,2,3,320,323,0.93
15117,November,2022,Carroll,NH,Passenger,0,1,1,5,6,16.67
15118,November,2022,Cowlitz,WA,Truck,4,0,4,28412,28416,0.01
15119,November,2022,Collin,TX,Passenger,2,0,2,54,56,3.57
15120,November,2022,Skagit,WA,Passenger,908,352,1260,89513,90773,1.39
15121,November,2022,Polk,OR,Passenger,0,1,1,20,21,4.76
15122,November,2022,Lake,IL,Passenger,1,0,1,117,118,0.85
15123,November,2022,Onslow,NC,Passenger,0,1,1,150,151,0.66
15124,November,2022,Pend Oreille,WA,Truck,0,0,0,5602,5602,0.0
15125,November,2022,Monterey,CA,Passenger,1,1,2,119,121,1.65
15126,November,2022,Adams,WA,Truck,1,0,1,5396,5397,0.02
15127,November,2022,Kern,CA,Passenger,1,1,2,188,190,1.05
15128,November,2022,Walla Walla,WA,Passenger,201,108,309,35703,36012,0.86
15129,November,2022,Thurston,WA,Passenger,2552,1116,3668,192629,196297,1.87
15130,November,2022,District of Columbia,DC,Passenger,4,0,4,155,159,2.52
15131,November,2022,Leavenworth,KS,Passenger,0,1,1,92,93,1.08
15132,November,2022,Charleston,SC,Passenger,2,2,4,53,57,7.02
15133,November,2022,Denton,TX,Passenger,1,0,1,53,54,1.85
15134,November,2022,Kitsap,WA,Truck,28,0,28,53049,53077,0.05
15135,November,2022,Owyhee,ID,Passenger,1,0,1,3,4,25.0
15136,November,2022,Suffolk,VA,Passenger,1,0,1,113,114,0.88
15137,November,2022,Sacramento,CA,Passenger,3,0,3,171,174,1.72
15138,November,2022,King,WA,Passenger,46991,12053,59044,1341209,1400253,4.22
15139,November,2022,Jefferson,NY,Passenger,0,1,1,191,192,0.52
15140,November,2022,Rockingham,NH,Passenger,1,0,1,12,13,7.69
15141,November,2022,Asotin,WA,Truck,0,0,0,6694,6694,0.0
15142,November,2022,Cumberland,PA,Passenger,1,0,1,35,36,2.78
15143,November,2022,Moore,NC,Passenger,0,1,1,106,107,0.93
15144,November,2022,Harris,TX,Passenger,1,0,1,124,125,0.8
15145,November,2022,Skamania,WA,Passenger,89,51,140,8127,8267,1.69
15146,November,2022,Beaufort,SC,Passenger,1,0,1,21,22,4.55
15147,November,2022,Gwinnett,GA,Passenger,1,0,1,46,47,2.13
15148,November,2022,Kauai,HI,Passenger,1,1,2,13,15,13.33
15149,November,2022,Burlington,NJ,Passenger,0,2,2,97,99,2.02
15150,November,2022,Dallas,TX,Passenger,1,0,1,87,88,1.14
15151,November,2022,Fairfax,VA,Passenger,5,3,8,572,580,1.38
15152,November,2022,Santa Clara,CA,Passenger,9,2,11,177,188,5.85
15154,November,2022,Randolph,NC,Passenger,1,0,1,4,5,20.0
15155,November,2022,Santa Barbara,CA,Passenger,1,0,1,66,67,1.49
15156,November,2022,Stevens,WA,Truck,2,0,2,18874,18876,0.01
15157,November,2022,Hamilton,OH,Truck,1,0,1,2,3,33.33
15158,November,2022,Riverside,CA,Passenger,7,0,7,406,413,1.69
15159,November,2022,Yakima,WA,Truck,6,0,6,61264,61270,0.01
15160,November,2022,Douglas,NE,Passenger,2,2,4,29,33,12.12
15161,November,2022,Lake,FL,Passenger,1,0,1,16,17,5.88
15162,November,2022,Maricopa,AZ,Passenger,6,2,8,721,729,1.1
15163,November,2022,Pacific,WA,Passenger,70,79,149,15759,15908,0.94
15164,November,2022,Snohomish,WA,Truck,79,0,79,122767,122846,0.06
15165,November,2022,Kittitas,WA,Truck,5,0,5,14582,14587,0.03
15166,November,2022,Spokane,WA,Passenger,1896,915,2811,324763,327574,0.86
15167,November,2022,Virginia Beach,VA,Passenger,2,0,2,460,462,0.43
15168,November,2022,Jefferson,WA,Passenger,474,229,703,24392,25095,2.8
15169,November,2022,Wahkiakum,WA,Truck,1,0,1,1804,1805,0.06
15170,November,2022,Ulster,NY,Passenger,1,0,1,5,6,16.67
15171,November,2022,Skamania,WA,Truck,0,0,0,3892,3892,0.0
15172,November,2022,Sheridan,WY,Passenger,1,0,1,5,6,16.67
15173,November,2022,Oldham,KY,Passenger,0,1,1,4,5,20.0
15174,November,2022,Pend Oreille,WA,Passenger,19,13,32,8989,9021,0.35
15175,November,2022,Columbia,WA,Passenger,8,1,9,2431,2440,0.37
15176,November,2022,Camden,NJ,Passenger,0,1,1,12,13,7.69
15177,November,2022,Washington,MD,Passenger,2,0,2,14,16,12.5
15178,November,2022,Snohomish,WA,Passenger,9877,2716,12593,530771,543364,2.32
15179,November,2022,Klickitat,WA,Truck,3,0,3,8251,8254,0.04
15180,November,2022,Pulaski,AR,Passenger,3,0,3,26,29,10.34
15181,November,2022,Franklin,WA,Truck,3,0,3,20955,20958,0.01
15182,November,2022,Clallam,WA,Truck,8,0,8,21885,21893,0.04
15183,November,2022,Marin,CA,Passenger,0,1,1,29,30,3.33
15184,November,2022,Broward,FL,Passenger,1,0,1,64,65,1.54
15185,November,2022,Kent,DE,Passenger,1,0,1,49,50,2.0
15186,November,2022,Okanogan,WA,Truck,2,0,2,16474,16476,0.01
15187,November,2022,Carroll,MD,Passenger,0,1,1,17,18,5.56
15188,November,2022,Sedgwick,KS,Passenger,1,1,2,65,67,2.99
15189,November,2022,Rockdale,GA,Passenger,1,0,1,6,7,14.29
15190,November,2022,Okanogan,WA,Passenger,98,51,149,26251,26400,0.56
15191,November,2022,Sevier,AR,Passenger,0,1,1,0,1,100.0
15192,November,2022,Sarpy,NE,Passenger,1,0,1,49,50,2.0
15193,November,2022,St. Clair,IL,Passenger,2,0,2,112,114,1.75
15194,November,2022,Walla Walla,WA,Truck,3,0,3,13912,13915,0.02
15195,November,2022,Dorchester,SC,Passenger,1,0,1,44,45,2.22
15196,November,2022,Lane,OR,Passenger,0,1,1,74,75,1.33
15197,November,2022,Yavapai,AZ,Passenger,1,0,1,22,23,4.35
15198,November,2022,Pacific,WA,Truck,1,0,1,7853,7854,0.01
15199,November,2022,Placer,CA,Passenger,2,0,2,59,61,3.28
15200,November,2022,Jackson,OK,Passenger,0,1,1,32,33,3.03
15201,November,2022,Mason,WA,Truck,7,0,7,20895,20902,0.03
15202,November,2022,Okaloosa,FL,Passenger,0,1,1,92,93,1.08
15203,November,2022,Ventura,CA,Passenger,2,1,3,212,215,1.4
15204,November,2022,Portsmouth,VA,Passenger,0,1,1,70,71,1.41
15205,November,2022,Garfield,WA,Passenger,1,3,4,1307,1311,0.31
15206,November,2022,Hudson,NJ,Passenger,1,0,1,30,31,3.23
15207,November,2022,Thurston,WA,Truck,34,0,34,54782,54816,0.06
15208,November,2022,Cape May,NJ,Passenger,0,1,1,7,8,12.5
15209,November,2022,Platte,MO,Passenger,1,0,1,19,20,5.0
15210,November,2022,Rock Island,IL,Passenger,0,1,1,15,16,6.25
15211,November,2022,Williams,ND,Passenger,0,1,1,5,6,16.67
15212,November,2022,Sumter,SC,Passenger,0,1,1,33,34,2.94
15213,November,2022,Klickitat,WA,Passenger,120,53,173,15133,15306,1.13
15214,November,2022,Skagit,WA,Truck,8,0,8,32208,32216,0.02
15215,November,2022,Mason,WA,Passenger,360,190,550,46961,47511,1.16
15216,November,2022,Nueces,TX,Passenger,0,1,1,50,51,1.96
15217,November,2022,Chelan,WA,Passenger,525,142,667,54281,54948,1.21
15218,November,2022,Nassau,NY,Passenger,1,0,1,21,22,4.55
15219,November,2022,Miami-Dade,FL,Passenger,1,0,1,64,65,1.54
15220,October,2017,Adams,WA,Passenger,3,3,6,12283,12289,0.05
15221,October,2017,Mason,WA,Truck,0,0,0,19470,19470,0.0
15222,October,2017,Pend Oreille,WA,Passenger,3,4,7,9370,9377,0.07
15223,October,2017,Albemarle,VA,Passenger,0,1,1,32,33,3.03
15224,October,2017,Twin Falls,ID,Passenger,0,1,1,24,25,4.0
15225,October,2017,DeKalb,GA,Passenger,1,0,1,85,86,1.16
15226,October,2017,Monterey,CA,Passenger,0,2,2,193,195,1.03
15227,October,2017,Grant,WA,Passenger,20,33,53,61666,61719,0.09
15228,October,2017,Garfield,WA,Truck,0,0,0,943,943,0.0
15229,October,2017,Thurston,WA,Truck,0,0,0,53577,53577,0.0
15230,October,2017,Pima,AZ,Passenger,1,1,2,414,416,0.48
15231,October,2017,Franklin,OH,Passenger,0,1,1,112,113,0.88
15232,October,2017,Richmond,GA,Passenger,0,1,1,90,91,1.1
15233,October,2017,Contra Costa,CA,Passenger,0,1,1,489,490,0.2
15234,October,2017,Kent,MI,Passenger,0,1,1,34,35,2.86
15235,October,2017,Wahkiakum,WA,Truck,0,0,0,1672,1672,0.0
15236,October,2017,Hamilton,TN,Passenger,1,0,1,21,22,4.55
15237,October,2017,Bexar,TX,Passenger,1,1,2,822,824,0.24
15238,October,2017,Franklin,WA,Passenger,31,49,80,56508,56588,0.14
15239,October,2017,Honolulu,HI,Passenger,2,2,4,557,561,0.71
15240,October,2017,Adams,WA,Truck,0,0,0,5135,5135,0.0
15241,October,2017,Lane,OR,Passenger,0,1,1,214,215,0.47
15242,October,2017,Whatcom,WA,Truck,2,0,2,41876,41878,0.0
15243,October,2017,Lewis,WA,Truck,0,0,0,25209,25209,0.0
15244,October,2017,Orange,FL,Passenger,1,1,2,145,147,1.36
15245,October,2017,Skamania,WA,Passenger,10,7,17,8571,8588,0.2
15246,October,2017,Morris,NJ,Passenger,1,0,1,22,23,4.35
15247,October,2017,Grays Harbor,WA,Passenger,38,41,79,45374,45453,0.17
15248,October,2017,Maricopa,AZ,Passenger,2,0,2,1627,1629,0.12
15249,October,2017,Ferry,WA,Truck,0,0,0,3549,3549,0.0
15250,October,2017,San Juan,WA,Truck,0,0,0,5569,5569,0.0
15251,October,2017,Douglas,WA,Truck,0,0,0,11656,11656,0.0
15252,October,2017,Yakima,WA,Truck,0,0,0,57813,57813,0.0
15253,October,2017,Santa Rosa,FL,Passenger,1,0,1,108,109,0.92
15254,October,2017,Grays Harbor,WA,Truck,0,0,0,20007,20007,0.0
15255,October,2017,Cowlitz,WA,Passenger,54,65,119,70430,70549,0.17
15256,October,2017,Fairfax,VA,Passenger,2,2,4,839,843,0.47
15257,October,2017,Manatee,FL,Passenger,1,0,1,42,43,2.33
15258,October,2017,Whitman,WA,Passenger,12,20,32,22299,22331,0.14
15259,October,2017,El Paso,TX,Passenger,1,0,1,527,528,0.19
15260,October,2017,Shelby,TN,Passenger,0,1,1,104,105,0.95
15261,October,2017,New London,CT,Passenger,1,1,2,249,251,0.8
15262,October,2017,Nueces,TX,Passenger,0,1,1,93,94,1.06
15263,October,2017,Riverside,CA,Passenger,1,2,3,744,747,0.4
15264,October,2017,Pierce,WA,Passenger,1040,916,1956,525482,527438,0.37
15265,October,2017,Deschutes,OR,Passenger,1,0,1,185,186,0.54
15266,October,2017,Volusia,FL,Passenger,0,1,1,40,41,2.44
15267,October,2017,Clallam,WA,Truck,0,0,0,21147,21147,0.0
15268,October,2017,Clark,WA,Passenger,829,559,1388,302262,303650,0.46
15269,October,2017,Los Angeles,CA,Passenger,5,2,7,1219,1226,0.57
15270,October,2017,Missoula,MT,Passenger,1,0,1,70,71,1.41
15271,October,2017,Virginia Beach,VA,Passenger,2,1,3,654,657,0.46
15272,October,2017,Asotin,WA,Passenger,7,5,12,12479,12491,0.1
15273,October,2017,Prince William,VA,Passenger,0,3,3,268,271,1.11
15274,October,2017,Sacramento,CA,Passenger,1,0,1,323,324,0.31
15275,October,2017,Benton,WA,Truck,0,0,0,40386,40386,0.0
15276,October,2017,Flathead,MT,Passenger,1,0,1,54,55,1.82
15277,October,2017,Mason,WA,Passenger,61,74,135,44453,44588,0.3
15278,October,2017,Santa Fe,NM,Passenger,0,1,1,41,42,2.38
15279,October,2017,Okaloosa,FL,Passenger,1,0,1,186,187,0.53
15280,October,2017,Benton,WA,Passenger,164,155,319,129410,129729,0.25
15281,October,2017,Kitsap,WA,Truck,1,0,1,52588,52589,0.0
15282,October,2017,Snohomish,WA,Passenger,1947,999,2946,515244,518190,0.57
15283,October,2017,Klickitat,WA,Truck,0,0,0,8005,8005,0.0
15284,October,2017,Anne Arundel,MD,Passenger,0,1,1,486,487,0.21
15285,October,2017,Moore,NC,Passenger,0,1,1,202,203,0.49
15286,October,2017,Palm Beach,FL,Passenger,0,1,1,95,96,1.04
15287,October,2017,Nantucket,MA,Passenger,1,0,1,3,4,25.0
15288,October,2017,Saratoga,NY,Passenger,1,1,2,73,75,2.67
15289,October,2017,Skagit,WA,Truck,1,0,1,31629,31630,0.0
15290,October,2017,Santa Clara,CA,Passenger,6,1,7,386,393,1.78
15291,October,2017,Thurston,WA,Passenger,442,371,813,188869,189682,0.43
15292,October,2017,Clark,WA,Truck,0,0,0,78122,78122,0.0
15293,October,2017,Pacific,WA,Passenger,14,10,24,15322,15346,0.16
15294,October,2017,Ventura,CA,Passenger,0,1,1,335,336,0.3
15295,October,2017,Lee,AL,Passenger,1,0,1,35,36,2.78
15296,October,2017,Chelan,WA,Passenger,77,36,113,52717,52830,0.21
15297,October,2017,Tuolumne,CA,Passenger,0,1,1,15,16,6.25
15298,October,2017,Okanogan,WA,Passenger,5,17,22,25713,25735,0.09
15299,October,2017,Franklin,WA,Truck,0,0,0,18324,18324,0.0
15300,October,2017,Snohomish,WA,Truck,1,0,1,121462,121463,0.0
15301,October,2017,Sedgwick,KS,Passenger,0,1,1,103,104,0.96
15302,October,2017,Queens,NY,Passenger,1,0,1,62,63,1.59
15303,October,2017,Carroll,NH,Passenger,0,1,1,1,2,50.0
15304,October,2017,Dakota,MN,Passenger,0,2,2,38,40,5.0
15305,October,2017,Alameda,CA,Passenger,0,1,1,352,353,0.28
15306,October,2017,Jefferson,WA,Passenger,116,68,184,24072,24256,0.76
15307,October,2017,Columbia,WA,Truck,0,0,0,1542,1542,0.0
15308,October,2017,Lincoln,WA,Truck,0,0,0,4491,4491,0.0
15309,October,2017,Stevens,WA,Truck,0,0,0,18305,18305,0.0
15310,October,2017,Wayne,MI,Passenger,0,1,1,68,69,1.45
15311,October,2017,Travis,TX,Passenger,0,1,1,193,194,0.52
15312,October,2017,Sangamon,IL,Passenger,1,0,1,11,12,8.33
15313,October,2017,Latah,ID,Passenger,0,1,1,84,85,1.18
15314,October,2017,Utah,UT,Passenger,0,1,1,142,143,0.7
15315,October,2017,Clay,FL,Passenger,0,1,1,112,113,0.88
15316,October,2017,Tarrant,TX,Passenger,1,0,1,228,229,0.44
15317,October,2017,Jefferson,NY,Passenger,1,0,1,241,242,0.41
15318,October,2017,Garfield,WA,Passenger,1,0,1,1315,1316,0.08
15319,October,2017,Ramsey,MN,Passenger,1,0,1,40,41,2.44
15320,October,2017,Lumpkin,GA,Passenger,1,0,1,9,10,10.0
15321,October,2017,Essex,NJ,Passenger,1,0,1,13,14,7.14
15322,October,2017,Chelan,WA,Truck,0,0,0,21490,21490,0.0
15324,October,2017,Kittitas,WA,Passenger,33,23,56,28118,28174,0.2
15325,October,2017,King,WA,Passenger,10942,4483,15425,1372199,1387624,1.11
15326,October,2017,Franklin,MA,Passenger,0,1,1,4,5,20.0
15327,October,2017,Tulare,CA,Passenger,1,0,1,193,194,0.52
15328,October,2017,San Diego,CA,Passenger,5,1,6,2612,2618,0.23
15329,October,2017,King,WA,Truck,7,1,8,185856,185864,0.0
15330,October,2017,Pend Oreille,WA,Truck,0,0,0,5562,5562,0.0
15331,October,2017,Prince George's,MD,Passenger,0,1,1,180,181,0.55
15332,October,2017,San Juan,WA,Passenger,127,40,167,13759,13926,1.2
15333,October,2017,Fulton,GA,Passenger,1,0,1,109,110,0.91
15334,October,2017,Skamania,WA,Truck,0,0,0,3892,3892,0.0
15335,October,2017,Whitman,WA,Truck,0,0,0,8440,8440,0.0
15336,October,2017,Kittitas,WA,Truck,0,0,0,13695,13695,0.0
15337,October,2017,Orleans,LA,Passenger,0,1,1,46,47,2.13
15338,October,2017,Walla Walla,WA,Truck,0,0,0,13256,13256,0.0
15339,October,2017,Orange,CA,Passenger,3,1,4,600,604,0.66
15340,October,2017,Montgomery,TN,Passenger,1,0,1,272,273,0.37
15341,October,2017,Madison,ID,Passenger,1,0,1,37,38,2.63
15342,October,2017,Frederick,MD,Passenger,0,1,1,84,85,1.18
15343,October,2017,Multnomah,OR,Passenger,1,3,4,911,915,0.44
15344,October,2017,Hamilton,IN,Passenger,1,0,1,58,59,1.69
15345,October,2017,Yakima,WA,Passenger,57,72,129,161008,161137,0.08
15346,October,2017,Nassau,NY,Passenger,1,1,2,38,40,5.0
15347,October,2017,Dale,AL,Passenger,0,1,1,61,62,1.61
15348,October,2017,Cape May,NJ,Passenger,0,1,1,19,20,5.0
15349,October,2017,Spokane,WA,Truck,1,0,1,91331,91332,0.0
15350,October,2017,District of Columbia,DC,Passenger,0,3,3,204,207,1.45
15351,October,2017,Stevens,WA,Passenger,9,22,31,31532,31563,0.1
15352,October,2017,Island,WA,Passenger,138,153,291,61081,61372,0.47
15353,October,2017,Hardin,KY,Passenger,0,1,1,117,118,0.85
15354,October,2017,Spokane,WA,Passenger,286,238,524,298905,299429,0.17
15355,October,2017,Okanogan,WA,Truck,0,0,0,16246,16246,0.0
15356,October,2017,Manassas,VA,Passenger,0,1,1,9,10,10.0
15357,October,2017,DeKalb,IN,Passenger,1,0,1,1,2,50.0
15358,October,2017,Howard,MD,Passenger,0,2,2,88,90,2.22
15359,October,2017,Maui,HI,Passenger,1,0,1,69,70,1.43
15360,October,2017,Lincoln,WA,Passenger,2,5,7,7575,7582,0.09
15361,October,2017,Montgomery,MD,Passenger,1,0,1,302,303,0.33
15362,October,2017,St. Clair,IL,Passenger,0,1,1,160,161,0.62
15363,October,2017,Columbia,WA,Passenger,1,1,2,2393,2395,0.08
15364,October,2017,Lewis,WA,Passenger,53,39,92,56275,56367,0.16
15365,October,2017,Dallas,TX,Passenger,0,1,1,180,181,0.55
15366,October,2017,San Mateo,CA,Passenger,0,1,1,149,150,0.67
15367,October,2017,Jefferson,WA,Truck,0,0,0,9438,9438,0.0
15368,October,2017,Walla Walla,WA,Passenger,28,28,56,35147,35203,0.16
15369,October,2017,New Haven,CT,Passenger,0,1,1,52,53,1.89
15370,October,2017,Arlington,VA,Passenger,1,2,3,168,171,1.75
15371,October,2017,Ferry,WA,Passenger,1,1,2,4396,4398,0.05
15372,October,2017,Charles,MD,Passenger,0,1,1,83,84,1.19
15373,October,2017,Canyon,ID,Passenger,0,1,1,92,93,1.08
15374,October,2017,Sumter,FL,Passenger,0,1,1,10,11,9.09
15375,October,2017,Pacific,WA,Truck,0,0,0,7521,7521,0.0
15376,October,2017,Norfolk,MA,Passenger,1,0,1,37,38,2.63
15377,October,2017,Hawaii,HI,Passenger,1,0,1,74,75,1.33
15378,October,2017,Whatcom,WA,Passenger,510,202,712,144316,145028,0.49
15379,October,2017,St. Lucie,FL,Passenger,1,0,1,27,28,3.57
15380,October,2017,Douglas,WA,Passenger,36,32,68,26967,27035,0.25
15381,October,2017,Clallam,WA,Passenger,96,85,181,48722,48903,0.37
15382,October,2017,Montgomery,PA,Passenger,1,0,1,38,39,2.56
15383,October,2017,Juneau,AK,Passenger,0,1,1,45,46,2.17
15384,October,2017,Norfolk,VA,Passenger,1,1,2,307,309,0.65
15385,October,2017,Kitsap,WA,Passenger,661,355,1016,174891,175907,0.58
15386,October,2017,Skagit,WA,Passenger,151,126,277,88959,89236,0.31
15387,October,2017,Montgomery,TX,Passenger,1,0,1,61,62,1.61
15388,October,2017,El Paso,CO,Passenger,2,0,2,769,771,0.26
15389,October,2017,Northampton,PA,Passenger,0,1,1,69,70,1.43
15390,October,2017,Pierce,WA,Truck,0,0,0,137020,137020,0.0
15391,October,2017,Clark,NV,Passenger,1,2,3,767,770,0.39
15392,October,2017,Asotin,WA,Truck,0,0,0,6524,6524,0.0
15393,October,2017,Allegheny,PA,Passenger,1,0,1,91,92,1.09
15394,October,2017,Wahkiakum,WA,Passenger,0,2,2,2849,2851,0.07
15395,October,2017,Gwinnett,GA,Passenger,0,1,1,85,86,1.16
15396,October,2017,Portsmouth,VA,Passenger,0,1,1,65,66,1.52
15397,October,2017,Richland,SC,Passenger,0,1,1,183,184,0.54
15398,October,2017,Marin,CA,Passenger,1,0,1,58,59,1.69
15399,October,2017,Pinal,AZ,Passenger,2,0,2,222,224,0.89
15400,October,2017,Island,WA,Truck,0,0,0,20596,20596,0.0
15401,October,2017,Klickitat,WA,Passenger,22,27,49,14805,14854,0.33
15402,October,2017,Grant,WA,Truck,0,0,0,25459,25459,0.0
15403,October,2017,Duval,FL,Passenger,1,1,2,368,370,0.54
15404,October,2017,Polk,FL,Passenger,1,0,1,63,64,1.56
15405,October,2017,Cowlitz,WA,Truck,0,0,0,28114,28114,0.0
15406,October,2018,Brevard,FL,Passenger,0,1,1,92,93,1.08
15407,October,2018,Palm Beach,FL,Passenger,0,1,1,90,91,1.1
15408,October,2018,Collin,TX,Passenger,1,1,2,151,153,1.31
15409,October,2018,Island,WA,Truck,0,0,0,21130,21130,0.0
15410,October,2018,Kent,MI,Passenger,0,1,1,25,26,3.85
15411,October,2018,San Mateo,CA,Passenger,1,1,2,128,130,1.54
15412,October,2018,Virginia Beach,VA,Passenger,2,1,3,696,699,0.43
15413,October,2018,Carson City,NV,Passenger,1,0,1,14,15,6.67
15414,October,2018,Columbia,WA,Passenger,2,2,4,2432,2436,0.16
15415,October,2018,Polk,FL,Passenger,1,0,1,62,63,1.59
15416,October,2018,Manatee,FL,Passenger,1,0,1,39,40,2.5
15417,October,2018,Franklin,WA,Passenger,35,66,101,58751,58852,0.17
15418,October,2018,Lewis,WA,Truck,0,0,0,25611,25611,0.0
15419,October,2018,Dale,AL,Passenger,0,1,1,58,59,1.69
15420,October,2018,St. Clair,IL,Passenger,0,1,1,162,163,0.61
15421,October,2018,Snohomish,WA,Passenger,2637,1378,4015,525955,529970,0.76
15422,October,2018,Nantucket,MA,Passenger,1,0,1,4,5,20.0
15423,October,2018,Whitman,WA,Truck,0,0,0,8531,8531,0.0
15424,October,2018,Honolulu,HI,Passenger,1,2,3,517,520,0.58
15425,October,2018,Sumter,FL,Passenger,0,1,1,10,11,9.09
15426,October,2018,Adams,WA,Truck,0,0,0,5151,5151,0.0
15427,October,2018,Hennepin,MN,Passenger,2,0,2,112,114,1.75
15428,October,2018,District of Columbia,DC,Passenger,0,3,3,192,195,1.54
15429,October,2018,Riverside,CA,Passenger,2,2,4,678,682,0.59
15430,October,2018,Columbia,WA,Truck,0,0,0,1518,1518,0.0
15431,October,2018,Yakima,WA,Truck,0,0,0,58757,58757,0.0
15432,October,2018,Richland,SC,Passenger,0,1,1,165,166,0.6
15433,October,2018,Nassau,NY,Passenger,3,0,3,36,39,7.69
15434,October,2018,Utah,UT,Passenger,0,1,1,137,138,0.72
15435,October,2018,Manassas,VA,Passenger,0,1,1,9,10,10.0
15436,October,2018,Orange,CA,Passenger,5,1,6,547,553,1.08
15437,October,2018,Prince William,VA,Passenger,0,4,4,258,262,1.53
15438,October,2018,Marion,IN,Passenger,1,0,1,119,120,0.83
15439,October,2018,Cowlitz,WA,Passenger,69,86,155,72155,72310,0.21
15440,October,2018,Oldham,KY,Passenger,0,1,1,5,6,16.67
15441,October,2018,Walla Walla,WA,Passenger,36,50,86,35994,36080,0.24
15442,October,2018,Cape May,NJ,Passenger,0,1,1,21,22,4.55
15443,October,2018,Sangamon,IL,Passenger,1,0,1,11,12,8.33
15444,October,2018,Broward,FL,Passenger,2,1,3,136,139,2.16
15445,October,2018,Lee,AL,Passenger,1,0,1,36,37,2.7
15446,October,2018,Maricopa,AZ,Passenger,3,1,4,1564,1568,0.26
15447,October,2018,Dallas,TX,Passenger,0,1,1,197,198,0.51
15448,October,2018,New Haven,CT,Passenger,0,1,1,46,47,2.13
15449,October,2018,Los Angeles,CA,Passenger,6,5,11,1134,1145,0.96
15450,October,2018,Santa Cruz,CA,Passenger,1,0,1,40,41,2.44
15451,October,2018,Washington,OR,Passenger,0,1,1,475,476,0.21
15452,October,2018,Mason,WA,Truck,0,0,0,20174,20174,0.0
15453,October,2018,Shasta,CA,Passenger,1,0,1,43,44,2.27
15454,October,2018,Jefferson,WA,Truck,0,0,0,9612,9612,0.0
15455,October,2018,Charles,MD,Passenger,0,1,1,81,82,1.22
15456,October,2018,Guadalupe,TX,Passenger,1,0,1,80,81,1.23
15457,October,2018,Grays Harbor,WA,Truck,0,0,0,20286,20286,0.0
15458,October,2018,Orange,FL,Passenger,2,1,3,164,167,1.8
15459,October,2018,Marion,OR,Passenger,1,0,1,121,122,0.82
15460,October,2018,Skagit,WA,Passenger,240,180,420,91010,91430,0.46
15461,October,2018,Pinal,AZ,Passenger,2,0,2,204,206,0.97
15462,October,2018,Yakima,WA,Passenger,71,96,167,164423,164590,0.1
15463,October,2018,Asotin,WA,Truck,0,0,0,6636,6636,0.0
15464,October,2018,Jefferson,WA,Passenger,163,101,264,24781,25045,1.05
15465,October,2018,Rogers,OK,Passenger,1,0,1,6,7,14.29
15466,October,2018,Volusia,FL,Passenger,0,1,1,37,38,2.63
15467,October,2018,Thurston,WA,Truck,0,0,0,54803,54803,0.0
15468,October,2018,Skamania,WA,Truck,0,0,0,3983,3983,0.0
15469,October,2018,Nueces,TX,Passenger,1,1,2,90,92,2.17
15470,October,2018,Cochise,AZ,Passenger,0,1,1,121,122,0.82
15471,October,2018,Juneau,AK,Passenger,0,1,1,43,44,2.27
15472,October,2018,Douglas,WA,Passenger,47,33,80,27894,27974,0.29
15473,October,2018,Cowlitz,WA,Truck,0,0,0,28666,28666,0.0
15474,October,2018,Hardin,KY,Passenger,0,1,1,116,117,0.85
15475,October,2018,Snohomish,WA,Truck,1,0,1,121864,121865,0.0
15476,October,2018,Suffolk,MA,Passenger,0,1,1,43,44,2.27
15477,October,2018,Grant,WA,Passenger,32,50,82,63918,64000,0.13
15478,October,2018,Caddo,LA,Passenger,0,1,1,24,25,4.0
15479,October,2018,Lane,OR,Passenger,0,1,1,174,175,0.57
15480,October,2018,Carroll,NH,Passenger,0,1,1,1,2,50.0
15481,October,2018,Cook,IL,Passenger,1,0,1,252,253,0.4
15482,October,2018,St. Lucie,FL,Passenger,1,0,1,29,30,3.33
15483,October,2018,Monroe,IL,Passenger,1,0,1,4,5,20.0
15484,October,2018,Williamson,TX,Passenger,0,1,1,158,159,0.63
15485,October,2018,Benton,WA,Passenger,192,217,409,132576,132985,0.31
15486,October,2018,Larimer,CO,Passenger,1,0,1,60,61,1.64
15487,October,2018,Pacific,WA,Passenger,19,23,42,15765,15807,0.27
15488,October,2018,Chelan,WA,Passenger,126,59,185,53932,54117,0.34
15489,October,2018,Chelan,WA,Truck,0,0,0,22058,22058,0.0
15490,October,2018,Montgomery,PA,Passenger,2,0,2,36,38,5.26
15491,October,2018,Maui,HI,Passenger,1,0,1,54,55,1.82
15492,October,2018,Saratoga,NY,Passenger,1,0,1,60,61,1.64
15493,October,2018,San Juan,WA,Passenger,169,69,238,14212,14450,1.65
15494,October,2018,Montgomery,MD,Passenger,1,0,1,279,280,0.36
15495,October,2018,Whatcom,WA,Passenger,700,341,1041,148806,149847,0.69
15496,October,2018,Spokane,WA,Passenger,383,352,735,306205,306940,0.24
15497,October,2018,Clallam,WA,Truck,0,0,0,21569,21569,0.0
15498,October,2018,El Paso,CO,Passenger,3,1,4,758,762,0.52
15499,October,2018,Klamath,OR,Passenger,1,0,1,34,35,2.86
15500,October,2018,Garfield,OK,Passenger,1,0,1,14,15,6.67
15501,October,2018,Norfolk,VA,Passenger,2,2,4,336,340,1.18
15502,October,2018,San Diego,CA,Passenger,8,2,10,2561,2571,0.39
15503,October,2018,Santa Clara,CA,Passenger,8,0,8,373,381,2.1
15504,October,2018,Okanogan,WA,Truck,0,0,0,16501,16501,0.0
15505,October,2018,Ventura,CA,Passenger,0,2,2,314,316,0.63
15506,October,2018,Prince George,VA,Passenger,0,1,1,78,79,1.27
15507,October,2018,Clallam,WA,Passenger,136,119,255,50301,50556,0.5
15508,October,2018,Fulton,GA,Passenger,1,2,3,107,110,2.73
15509,October,2018,Multnomah,OR,Passenger,3,4,7,758,765,0.92
15510,October,2018,Thurston,WA,Passenger,663,552,1215,195071,196286,0.62
15511,October,2018,Skamania,WA,Passenger,18,12,30,8728,8758,0.34
15512,October,2018,Walla Walla,WA,Truck,0,0,0,13507,13507,0.0
15513,October,2018,Pierce,WA,Truck,0,0,0,138782,138782,0.0
15514,October,2018,Monterey,CA,Passenger,0,1,1,190,191,0.52
15515,October,2018,New London,CT,Passenger,0,1,1,254,255,0.39
15516,October,2018,Garfield,WA,Truck,0,0,0,960,960,0.0
15517,October,2018,Middlesex,MA,Passenger,0,1,1,138,139,0.72
15518,October,2018,Washtenaw,MI,Passenger,1,0,1,38,39,2.56
15519,October,2018,Jefferson,CO,Passenger,0,1,1,63,64,1.56
15520,October,2018,Pend Oreille,WA,Passenger,6,5,11,9588,9599,0.11
15521,October,2018,Arlington,VA,Passenger,1,1,2,166,168,1.19
15522,October,2018,Whatcom,WA,Truck,2,0,2,42555,42557,0.0
15523,October,2018,Prince George's,MD,Passenger,1,1,2,180,182,1.1
15524,October,2018,Douglas,WA,Truck,0,0,0,12077,12077,0.0
15525,October,2018,Gwinnett,GA,Passenger,0,1,1,79,80,1.25
15526,October,2018,Adams,WA,Passenger,5,5,10,12720,12730,0.08
15527,October,2018,Richmond,GA,Passenger,0,1,1,92,93,1.08
15528,October,2018,Sedgwick,KS,Passenger,0,1,1,99,100,1.0
15529,October,2018,Denver,CO,Passenger,1,0,1,128,129,0.78
15530,October,2018,Contra Costa,CA,Passenger,0,2,2,419,421,0.48
15531,October,2018,Grays Harbor,WA,Passenger,60,66,126,47272,47398,0.27
15532,October,2018,Albemarle,VA,Passenger,1,0,1,27,28,3.57
15533,October,2018,Mason,WA,Passenger,101,108,209,46356,46565,0.45
15534,October,2018,Stevens,WA,Truck,0,0,0,18721,18721,0.0
15535,October,2018,Lincoln,WA,Passenger,2,6,8,7740,7748,0.1
15536,October,2018,Santa Fe,NM,Passenger,0,1,1,43,44,2.27
15537,October,2018,Jefferson,NY,Passenger,0,1,1,224,225,0.44
15538,October,2018,Island,WA,Passenger,244,216,460,63045,63505,0.72
15539,October,2018,Benton,WA,Truck,0,0,0,41429,41429,0.0
15540,October,2018,Cumberland,NC,Passenger,0,1,1,523,524,0.19
15541,October,2018,Tuolumne,CA,Passenger,0,1,1,12,13,7.69
15542,October,2018,Bexar,TX,Passenger,3,4,7,731,738,0.95
15543,October,2018,Twin Falls,ID,Passenger,0,1,1,22,23,4.35
15544,October,2018,Ramsey,MN,Passenger,1,0,1,40,41,2.44
15545,October,2018,Alameda,CA,Passenger,0,2,2,333,335,0.6
15546,October,2018,Clark,NV,Passenger,2,2,4,729,733,0.55
15547,October,2018,Fresno,CA,Passenger,1,0,1,185,186,0.54
15548,October,2018,Lumpkin,GA,Passenger,1,0,1,7,8,12.5
15549,October,2018,Whitman,WA,Passenger,19,33,52,22745,22797,0.23
15550,October,2018,Skagit,WA,Truck,1,0,1,32334,32335,0.0
15551,October,2018,Okanogan,WA,Passenger,15,21,36,26108,26144,0.14
15552,October,2018,DeKalb,IN,Passenger,1,0,1,1,2,50.0
15553,October,2018,Wahkiakum,WA,Passenger,1,1,2,2984,2986,0.07
15554,October,2018,Frederick,MD,Passenger,0,1,1,83,84,1.19
15555,October,2018,DeKalb,GA,Passenger,1,0,1,78,79,1.27
15556,October,2018,Shelby,TN,Passenger,0,1,1,103,104,0.96
15557,October,2018,Duval,FL,Passenger,1,2,3,383,386,0.78
15558,October,2018,Pima,AZ,Passenger,1,1,2,405,407,0.49
15559,October,2018,Pend Oreille,WA,Truck,0,0,0,5752,5752,0.0
15560,October,2018,Kittitas,WA,Passenger,57,35,92,29279,29371,0.31
15561,October,2018,Ferry,WA,Truck,0,0,0,3566,3566,0.0
15562,October,2018,Charleston,SC,Passenger,1,0,1,128,129,0.78
15563,October,2018,Clark,WA,Passenger,1149,814,1963,310425,312388,0.63
15564,October,2018,Norfolk,MA,Passenger,1,0,1,37,38,2.63
15565,October,2018,Deschutes,OR,Passenger,2,0,2,161,163,1.23
15566,October,2018,Santa Rosa,FL,Passenger,1,0,1,89,90,1.11
15567,October,2018,Lewis,WA,Passenger,88,70,158,58040,58198,0.27
15568,October,2018,Clark,WA,Truck,0,0,0,79579,79579,0.0
15569,October,2018,King,WA,Passenger,15034,6221,21255,1376342,1397597,1.52
15570,October,2018,Mecklenburg,NC,Passenger,1,0,1,81,82,1.22
15571,October,2018,Portsmouth,VA,Passenger,0,1,1,77,78,1.28
15572,October,2018,Dakota,MN,Passenger,0,2,2,33,35,5.71
15573,October,2018,Lee,FL,Passenger,1,0,1,56,57,1.75
15574,October,2018,Fairfax,VA,Passenger,1,2,3,809,812,0.37
15575,October,2018,Kootenai,ID,Passenger,1,1,2,218,220,0.91
15576,October,2018,Garfield,WA,Passenger,1,1,2,1330,1332,0.15
15577,October,2018,Asotin,WA,Passenger,12,9,21,12713,12734,0.16
15578,October,2018,Kitsap,WA,Passenger,880,507,1387,179926,181313,0.76
15579,October,2018,Flathead,MT,Passenger,1,0,1,53,54,1.85
15580,October,2018,Morris,NJ,Passenger,1,0,1,17,18,5.56
15581,October,2018,Hamilton,IN,Passenger,1,0,1,47,48,2.08
15582,October,2018,Valencia,NM,Passenger,1,0,1,10,11,9.09
15583,October,2018,Klickitat,WA,Truck,0,0,0,8154,8154,0.0
15584,October,2018,San Francisco,CA,Passenger,1,1,2,115,117,1.71
15585,October,2018,El Paso,TX,Passenger,1,0,1,501,502,0.2
15586,October,2018,Grant,WA,Truck,0,0,0,26085,26085,0.0
15587,October,2018,Pacific,WA,Truck,0,0,0,7630,7630,0.0
15588,October,2018,Camden,NJ,Passenger,0,1,1,27,28,3.57
15589,October,2018,St. Mary's,MD,Passenger,1,0,1,219,220,0.45
15590,October,2018,Wahkiakum,WA,Truck,0,0,0,1701,1701,0.0
15591,October,2018,Lincoln,WA,Truck,0,0,0,4608,4608,0.0
15592,October,2018,Montgomery,TX,Passenger,2,0,2,61,63,3.17
15593,October,2018,Klickitat,WA,Passenger,24,32,56,15389,15445,0.36
15594,October,2018,Anne Arundel,MD,Passenger,0,1,1,451,452,0.22
15595,October,2018,DuPage,IL,Passenger,1,0,1,56,57,1.75
15596,October,2018,Beaufort,SC,Passenger,1,0,1,35,36,2.78
15597,October,2018,Spokane,WA,Truck,1,0,1,93433,93434,0.0
15598,October,2018,Ada,ID,Passenger,0,2,2,313,315,0.63
15600,October,2018,Kitsap,WA,Truck,1,0,1,53622,53623,0.0
15601,October,2018,Stevens,WA,Passenger,14,28,42,31809,31851,0.13
15602,October,2018,Allegheny,PA,Passenger,1,0,1,83,84,1.19
15603,October,2018,Clackamas,OR,Passenger,0,1,1,214,215,0.47
15604,October,2018,Pierce,WA,Passenger,1405,1305,2710,537166,539876,0.5
15605,October,2018,Madison,ID,Passenger,1,0,1,37,38,2.63
15606,October,2018,Randolph,NC,Passenger,1,0,1,5,6,16.67
15607,October,2018,Hawaii,HI,Passenger,1,0,1,67,68,1.47
15608,October,2018,Franklin,WA,Truck,0,0,0,18952,18952,0.0
15609,October,2018,Kittitas,WA,Truck,0,0,0,14126,14126,0.0
15610,October,2018,Clay,FL,Passenger,0,1,1,91,92,1.09
15611,October,2018,Douglas,NE,Passenger,0,1,1,68,69,1.45
15612,October,2018,Houston,GA,Passenger,1,0,1,53,54,1.85
15613,October,2018,San Juan,WA,Truck,0,0,0,5787,5787,0.0
15614,October,2018,Tarrant,TX,Passenger,1,0,1,206,207,0.48
15615,October,2018,Franklin,MA,Passenger,0,1,1,1,2,50.0
15616,October,2018,Howard,MD,Passenger,0,1,1,87,88,1.14
15617,October,2018,Moore,NC,Passenger,0,1,1,195,196,0.51
15618,October,2018,Washoe,NV,Passenger,1,0,1,108,109,0.92
15619,October,2018,Tulsa,OK,Passenger,1,1,2,47,49,4.08
15620,October,2018,San Juan,PR,Passenger,0,1,1,4,5,20.0
15621,October,2018,King,WA,Truck,7,1,8,182837,182845,0.0
15622,October,2018,Ferry,WA,Passenger,3,2,5,4406,4411,0.11
15623,October,2019,Cowlitz,WA,Truck,0,0,0,29023,29023,0.0
15624,October,2019,Sarasota,FL,Passenger,2,0,2,26,28,7.14
15625,October,2019,Douglas,WA,Passenger,63,38,101,28272,28373,0.36
15626,October,2019,Richland,SC,Passenger,0,1,1,159,160,0.62
15627,October,2019,Calvert,MD,Passenger,0,2,2,92,94,2.13
15628,October,2019,RÃ­o Grande,PR,Passenger,1,0,1,1,2,50.0
15629,October,2019,Whatcom,WA,Passenger,949,470,1419,151478,152897,0.93
15630,October,2019,New London,CT,Passenger,0,2,2,244,246,0.81
15631,October,2019,Spartanburg,SC,Passenger,0,1,1,41,42,2.38
15632,October,2019,Asotin,WA,Passenger,12,8,20,12644,12664,0.16
15633,October,2019,DeKalb,GA,Passenger,1,0,1,80,81,1.23
15634,October,2019,Fulton,GA,Passenger,0,2,2,102,104,1.92
15635,October,2019,Clark,WA,Passenger,1782,1016,2798,316964,319762,0.88
15636,October,2019,Shasta,CA,Passenger,1,0,1,40,41,2.44
15637,October,2019,Douglas,NE,Passenger,0,1,1,58,59,1.69
15638,October,2019,Ferry,WA,Passenger,5,2,7,4425,4432,0.16
15639,October,2019,Virginia Beach,VA,Passenger,1,0,1,696,697,0.14
15640,October,2019,Santa Cruz,CA,Passenger,1,0,1,36,37,2.7
15641,October,2019,Harnett,NC,Passenger,1,1,2,211,213,0.94
15642,October,2019,Chesapeake,VA,Passenger,0,1,1,444,445,0.22
15643,October,2019,Cape May,NJ,Passenger,0,1,1,13,14,7.14
15644,October,2019,Denver,CO,Passenger,1,0,1,131,132,0.76
15645,October,2019,Washoe,NV,Passenger,2,0,2,107,109,1.83
15646,October,2019,Lee,FL,Passenger,1,0,1,53,54,1.85
15647,October,2019,Kitsap,WA,Truck,1,0,1,54352,54353,0.0
15648,October,2019,Cowlitz,WA,Passenger,112,106,218,73568,73786,0.3
15649,October,2019,Lake,FL,Passenger,1,0,1,21,22,4.55
15650,October,2019,Clay,FL,Passenger,0,1,1,86,87,1.15
15651,October,2019,Monroe,IL,Passenger,1,0,1,5,6,16.67
15652,October,2019,Bexar,TX,Passenger,1,5,6,649,655,0.92
15653,October,2019,Richmond,GA,Passenger,0,1,1,91,92,1.09
15654,October,2019,Cochise,AZ,Passenger,0,1,1,106,107,0.93
15655,October,2019,Tulsa,OK,Passenger,1,1,2,48,50,4.0
15656,October,2019,Boulder,CO,Passenger,0,1,1,51,52,1.92
15657,October,2019,Franklin,WA,Passenger,53,76,129,60628,60757,0.21
15658,October,2019,Spokane,WA,Passenger,616,464,1080,314332,315412,0.34
15659,October,2019,Clackamas,OR,Passenger,2,1,3,212,215,1.4
15660,October,2019,San Mateo,CA,Passenger,1,1,2,120,122,1.64
15661,October,2019,Prince William,VA,Passenger,1,3,4,234,238,1.68
15662,October,2019,Valencia,NM,Passenger,1,0,1,6,7,14.29
15663,October,2019,Hudson,NJ,Passenger,1,0,1,39,40,2.5
15664,October,2019,Stevens,WA,Passenger,29,28,57,31624,31681,0.18
15665,October,2019,Fairfax,VA,Passenger,4,2,6,760,766,0.78
15666,October,2019,Okanogan,WA,Passenger,24,28,52,26251,26303,0.2
15667,October,2019,Adams,WA,Passenger,6,6,12,12912,12924,0.09
15668,October,2019,Travis,TX,Passenger,2,1,3,202,205,1.46
15669,October,2019,Montgomery,PA,Passenger,2,0,2,36,38,5.26
15670,October,2019,Ramsey,MN,Passenger,1,0,1,40,41,2.44
15671,October,2019,Hawaii,HI,Passenger,1,0,1,58,59,1.69
15672,October,2019,Dakota,MN,Passenger,0,1,1,36,37,2.7
15673,October,2019,Cumberland,NC,Passenger,0,2,2,491,493,0.41
15674,October,2019,Grant,WA,Truck,0,0,0,26891,26891,0.0
15675,October,2019,Stafford,VA,Passenger,1,1,2,95,97,2.06
15676,October,2019,Pierce,WA,Passenger,2058,1629,3687,546972,550659,0.67
15677,October,2019,Albemarle,VA,Passenger,1,0,1,25,26,3.85
15678,October,2019,Pinal,AZ,Passenger,1,0,1,189,190,0.53
15679,October,2019,Santa Rosa,FL,Passenger,1,0,1,87,88,1.14
15680,October,2019,Clark,NV,Passenger,4,2,6,686,692,0.87
15681,October,2019,Grays Harbor,WA,Truck,0,0,0,20730,20730,0.0
15682,October,2019,St. Mary's,MD,Passenger,1,0,1,218,219,0.46
15683,October,2019,Flathead,MT,Passenger,1,0,1,63,64,1.56
15684,October,2019,Solano,CA,Passenger,1,0,1,205,206,0.49
15685,October,2019,Osceola,FL,Passenger,1,0,1,39,40,2.5
15686,October,2019,Clallam,WA,Truck,1,0,1,21846,21847,0.0
15687,October,2019,Portsmouth,VA,Passenger,0,1,1,79,80,1.25
15688,October,2019,Anne Arundel,MD,Passenger,1,2,3,438,441,0.68
15689,October,2019,Clallam,WA,Passenger,194,150,344,50936,51280,0.67
15690,October,2019,Sangamon,IL,Passenger,1,0,1,5,6,16.67
15691,October,2019,Lincoln,WA,Passenger,2,11,13,7831,7844,0.17
15692,October,2019,Thurston,WA,Passenger,1005,686,1691,199109,200800,0.84
15693,October,2019,Berkshire,MA,Passenger,0,1,1,4,5,20.0
15694,October,2019,Pima,AZ,Passenger,2,1,3,378,381,0.79
15695,October,2019,Santa Fe,NM,Passenger,0,1,1,41,42,2.38
15696,October,2019,Pacific,WA,Passenger,30,29,59,16110,16169,0.36
15697,October,2019,Putnam,TN,Passenger,0,1,1,3,4,25.0
15698,October,2019,Snohomish,WA,Truck,0,0,0,123012,123012,0.0
15699,October,2019,Houston,GA,Passenger,1,0,1,57,58,1.72
15700,October,2019,Jefferson,NY,Passenger,0,2,2,213,215,0.93
15701,October,2019,New Haven,CT,Passenger,0,2,2,48,50,4.0
15702,October,2019,Island,WA,Passenger,362,250,612,63634,64246,0.95
15703,October,2019,Vigo,IN,Passenger,1,0,1,6,7,14.29
15704,October,2019,Sedgwick,KS,Passenger,1,1,2,96,98,2.04
15705,October,2019,Ventura,CA,Passenger,0,3,3,304,307,0.98
15706,October,2019,Penobscot,ME,Passenger,0,1,1,13,14,7.14
15707,October,2019,Asotin,WA,Truck,0,0,0,6694,6694,0.0
15708,October,2019,Santa Clara,CA,Passenger,6,2,8,364,372,2.15
15709,October,2019,King,WA,Truck,6,1,7,182394,182401,0.0
15710,October,2019,DuPage,IL,Passenger,3,0,3,60,63,4.76
15711,October,2019,Pend Oreille,WA,Passenger,7,6,13,9493,9506,0.14
15712,October,2019,Okanogan,WA,Truck,0,0,0,16523,16523,0.0
15713,October,2019,Harrison,MS,Passenger,1,0,1,58,59,1.69
15714,October,2019,Skagit,WA,Passenger,336,210,546,92600,93146,0.59
15715,October,2019,Kootenai,ID,Passenger,1,1,2,224,226,0.88
15716,October,2019,Whitman,WA,Truck,0,0,0,8596,8596,0.0
15717,October,2019,Cascade,MT,Passenger,0,1,1,57,58,1.72
15718,October,2019,Grant,WA,Passenger,55,64,119,65376,65495,0.18
15719,October,2019,Riverside,CA,Passenger,4,1,5,646,651,0.77
15720,October,2019,Stevens,WA,Truck,0,0,0,18773,18773,0.0
15721,October,2019,DeKalb,IN,Passenger,1,0,1,1,2,50.0
15722,October,2019,Allegheny,PA,Passenger,1,0,1,77,78,1.28
15723,October,2019,Clark,WA,Truck,0,0,0,81150,81150,0.0
15724,October,2019,Benton,WA,Truck,0,0,0,42370,42370,0.0
15725,October,2019,Loudoun,VA,Passenger,1,0,1,94,95,1.05
15726,October,2019,Wahkiakum,WA,Truck,0,0,0,1752,1752,0.0
15727,October,2019,Douglas,WA,Truck,0,0,0,12295,12295,0.0
15728,October,2019,Alameda,CA,Passenger,5,1,6,296,302,1.99
15729,October,2019,Yakima,WA,Truck,0,0,0,59494,59494,0.0
15730,October,2019,Garfield,WA,Truck,0,0,0,963,963,0.0
15731,October,2019,Thurston,WA,Truck,0,0,0,55645,55645,0.0
15732,October,2019,Placer,CA,Passenger,1,0,1,95,96,1.04
15733,October,2019,Kitsap,WA,Passenger,1177,645,1822,182157,183979,0.99
15734,October,2019,Walla Walla,WA,Passenger,62,62,124,36327,36451,0.34
15735,October,2019,Klamath,OR,Passenger,1,0,1,39,40,2.5
15736,October,2019,Norfolk,MA,Passenger,1,0,1,36,37,2.7
15737,October,2019,San Juan,WA,Truck,0,0,0,5924,5924,0.0
15738,October,2019,Pend Oreille,WA,Truck,0,0,0,5739,5739,0.0
15739,October,2019,Volusia,FL,Passenger,0,1,1,41,42,2.38
15740,October,2019,Jefferson,WA,Truck,0,0,0,9672,9672,0.0
15741,October,2019,Skamania,WA,Truck,0,0,0,4101,4101,0.0
15742,October,2019,Tuolumne,CA,Passenger,0,1,1,12,13,7.69
15743,October,2019,Multnomah,OR,Passenger,4,6,10,726,736,1.36
15744,October,2019,Suffolk,MA,Passenger,0,1,1,38,39,2.56
15745,October,2019,Charleston,SC,Passenger,1,0,1,113,114,0.88
15746,October,2019,Boone,MO,Passenger,0,1,1,11,12,8.33
15747,October,2019,Collin,TX,Passenger,1,1,2,130,132,1.52
15748,October,2019,Carroll,NH,Passenger,0,1,1,3,4,25.0
15749,October,2019,Jefferson,CO,Passenger,0,2,2,59,61,3.28
15750,October,2019,Dallas,TX,Passenger,1,0,1,211,212,0.47
15751,October,2019,Benton,WA,Passenger,307,302,609,134942,135551,0.45
15752,October,2019,Orange,CA,Passenger,7,3,10,510,520,1.92
15753,October,2019,Williamson,TX,Passenger,0,2,2,143,145,1.38
15754,October,2019,Shelby,OH,Passenger,0,1,1,1,2,50.0
15755,October,2019,Oldham,KY,Passenger,0,1,1,5,6,16.67
15756,October,2019,Mason,WA,Passenger,140,129,269,47564,47833,0.56
15757,October,2019,Franklin,MA,Passenger,0,1,1,1,2,50.0
15758,October,2019,Camden,NJ,Passenger,0,1,1,23,24,4.17
15759,October,2019,Queens,NY,Passenger,1,0,1,52,53,1.89
15760,October,2019,Twin Falls,ID,Passenger,0,1,1,26,27,3.7
15761,October,2019,Adams,WA,Truck,0,0,0,5154,5154,0.0
15762,October,2019,Yakima,WA,Passenger,115,114,229,165908,166137,0.14
15763,October,2019,Palm Beach,FL,Passenger,0,1,1,84,85,1.18
15764,October,2019,Larimer,CO,Passenger,1,0,1,59,60,1.67
15765,October,2019,Nueces,TX,Passenger,1,1,2,92,94,2.13
15766,October,2019,Montgomery,TX,Passenger,1,0,1,58,59,1.69
15767,October,2019,Wahkiakum,WA,Passenger,4,3,7,3049,3056,0.23
15768,October,2019,Manassas,VA,Passenger,0,1,1,7,8,12.5
15769,October,2019,Maricopa,AZ,Passenger,6,5,11,1515,1526,0.72
15770,October,2019,Jefferson,WA,Passenger,210,126,336,25159,25495,1.32
15771,October,2019,San Francisco,CA,Passenger,2,1,3,100,103,2.91
15772,October,2019,King,WA,Passenger,21367,7391,28758,1396136,1424894,2.02
15773,October,2019,Bucks,PA,Passenger,1,0,1,24,25,4.0
15774,October,2019,Arlington,VA,Passenger,0,2,2,151,153,1.31
15775,October,2019,Montgomery,AL,Passenger,0,1,1,40,41,2.44
15776,October,2019,Ada,ID,Passenger,0,2,2,300,302,0.66
15777,October,2019,Cook,IL,Passenger,1,0,1,232,233,0.43
15778,October,2019,District of Columbia,DC,Passenger,1,1,2,210,212,0.94
15779,October,2019,San Juan,WA,Passenger,236,76,312,14410,14722,2.12
15780,October,2019,Pacific,WA,Truck,0,0,0,7726,7726,0.0
15781,October,2019,Kittitas,WA,Truck,0,0,0,14618,14618,0.0
15782,October,2019,Arapahoe,CO,Passenger,1,0,1,146,147,0.68
15783,October,2019,Contra Costa,CA,Passenger,2,2,4,356,360,1.11
15784,October,2019,Juneau,AK,Passenger,0,2,2,28,30,6.67
15785,October,2019,Garfield,WA,Passenger,0,1,1,1301,1302,0.08
15786,October,2019,Franklin,WA,Truck,0,0,0,19656,19656,0.0
15787,October,2019,Maui,HI,Passenger,1,0,1,43,44,2.27
15788,October,2019,Mason,WA,Truck,0,0,0,20466,20466,0.0
15789,October,2019,Polk,FL,Passenger,1,0,1,66,67,1.49
15790,October,2019,Columbia,WA,Passenger,3,2,5,2435,2440,0.2
15791,October,2019,Pierce,WA,Truck,0,0,0,140688,140688,0.0
15792,October,2019,Howard,MD,Passenger,0,1,1,75,76,1.32
15793,October,2019,Snohomish,WA,Passenger,3897,1683,5580,535121,540701,1.03
15794,October,2019,Hennepin,MN,Passenger,3,1,4,99,103,3.88
15795,October,2019,Ferry,WA,Truck,0,0,0,3575,3575,0.0
15796,October,2019,Fairbanks North Star,AK,Passenger,0,1,1,101,102,0.98
15797,October,2019,Prince George's,MD,Passenger,1,1,2,178,180,1.11
15798,October,2019,Charles,MD,Passenger,0,1,1,82,83,1.2
15799,October,2019,Norfolk,VA,Passenger,2,2,4,346,350,1.14
15800,October,2019,El Paso,TX,Passenger,3,0,3,462,465,0.65
15801,October,2019,Klickitat,WA,Passenger,43,37,80,15665,15745,0.51
15802,October,2019,Saginaw,MI,Passenger,1,0,1,11,12,8.33
15803,October,2019,San Diego,CA,Passenger,10,3,13,2804,2817,0.46
15804,October,2019,Jones,GA,Passenger,1,0,1,1,2,50.0
15805,October,2019,Wilson,TX,Passenger,0,1,1,7,8,12.5
15806,October,2019,Island,WA,Truck,0,0,0,21320,21320,0.0
15807,October,2019,Lewis,WA,Passenger,108,102,210,59447,59657,0.35
15808,October,2019,Tarrant,TX,Passenger,2,0,2,198,200,1.0
15809,October,2019,Kent,MI,Passenger,0,1,1,23,24,4.17
15810,October,2019,Alexandria,VA,Passenger,1,0,1,147,148,0.68
15811,October,2019,Powhatan,VA,Passenger,1,0,1,0,1,100.0
15812,October,2019,Fresno,CA,Passenger,1,0,1,191,192,0.52
15813,October,2019,Brevard,FL,Passenger,0,1,1,90,91,1.1
15814,October,2019,Nassau,NY,Passenger,4,0,4,38,42,9.52
15815,October,2019,Chelan,WA,Passenger,191,75,266,54655,54921,0.48
15816,October,2019,Skamania,WA,Passenger,25,20,45,8803,8848,0.51
15817,October,2019,Guadalupe,TX,Passenger,1,0,1,68,69,1.45
15818,October,2019,Whatcom,WA,Truck,2,0,2,43096,43098,0.0
15819,October,2019,Rogers,OK,Passenger,1,0,1,5,6,16.67
15820,October,2019,Kittitas,WA,Passenger,87,45,132,29964,30096,0.44
15822,October,2019,Columbia,WA,Truck,0,0,0,1533,1533,0.0
15823,October,2019,Klickitat,WA,Truck,0,0,0,8311,8311,0.0
15824,October,2019,Lewis,WA,Truck,0,0,0,26045,26045,0.0
15825,October,2019,Walla Walla,WA,Truck,0,0,0,13670,13670,0.0
15826,October,2019,Honolulu,HI,Passenger,4,2,6,487,493,1.22
15827,October,2019,Deschutes,OR,Passenger,3,0,3,151,154,1.95
15828,October,2019,Owyhee,ID,Passenger,1,0,1,3,4,25.0
15829,October,2019,Middlesex,MA,Passenger,1,1,2,108,110,1.82
15830,October,2019,Whitman,WA,Passenger,38,45,83,22717,22800,0.36
15831,October,2019,Washtenaw,MI,Passenger,1,0,1,40,41,2.44
15832,October,2019,Carson City,NV,Passenger,1,0,1,11,12,8.33
15833,October,2019,Kern,CA,Passenger,0,1,1,222,223,0.45
15834,October,2019,Grays Harbor,WA,Passenger,95,95,190,48305,48495,0.39
15835,October,2019,Sumter,FL,Passenger,0,1,1,9,10,10.0
15836,October,2019,Broward,FL,Passenger,2,1,3,124,127,2.36
15837,October,2019,Spokane,WA,Truck,1,0,1,96090,96091,0.0
15838,October,2019,Wayne,MI,Passenger,0,1,1,62,63,1.59
15839,October,2019,El Paso,CO,Passenger,2,1,3,733,736,0.41
15840,October,2019,Skagit,WA,Truck,1,0,1,32558,32559,0.0
15841,October,2019,Greene,MO,Passenger,0,1,1,31,32,3.12
15842,October,2019,Pinellas,FL,Passenger,1,1,2,109,111,1.8
15843,October,2019,Oklahoma,OK,Passenger,0,1,1,130,131,0.76
15844,October,2019,Duval,FL,Passenger,1,2,3,369,372,0.81
15845,October,2019,Randolph,NC,Passenger,1,0,1,6,7,14.29
15846,October,2019,Shelby,TN,Passenger,0,1,1,96,97,1.03
15847,October,2019,Lake,IL,Passenger,1,0,1,166,167,0.6
15848,October,2019,Frederick,MD,Passenger,1,1,2,85,87,2.3
15849,October,2019,Los Angeles,CA,Passenger,9,8,17,1071,1088,1.56
15850,October,2019,Chelan,WA,Truck,0,0,0,22495,22495,0.0
15851,October,2019,San Joaquin,CA,Passenger,1,0,1,137,138,0.72
15852,October,2019,Harris,TX,Passenger,1,1,2,244,246,0.81
15853,October,2019,Goochland,VA,Passenger,3,1,4,267,271,1.48
15854,October,2019,Moore,NC,Passenger,0,1,1,177,178,0.56
15855,October,2019,Lincoln,WA,Truck,0,0,0,4691,4691,0.0
15856,October,2020,District of Columbia,DC,Passenger,2,1,3,199,202,1.49
15857,October,2020,RÃ­o Grande,PR,Passenger,1,0,1,1,2,50.0
15859,October,2020,Montgomery,PA,Passenger,1,0,1,25,26,3.85
15860,October,2020,Randolph,NC,Passenger,1,0,1,7,8,12.5
15861,October,2020,Whitman,WA,Passenger,50,46,96,21981,22077,0.43
15862,October,2020,Collin,TX,Passenger,1,1,2,116,118,1.69
15863,October,2020,Plaquemines,LA,Passenger,0,1,1,13,14,7.14
15864,October,2020,Santa Clara,CA,Passenger,5,2,7,270,277,2.53
15865,October,2020,Clark,NV,Passenger,3,2,5,660,665,0.75
15866,October,2020,Orange,CA,Passenger,5,3,8,461,469,1.71
15867,October,2020,Placer,CA,Passenger,2,0,2,85,87,2.3
15868,October,2020,Clark,WA,Passenger,2212,1121,3333,318837,322170,1.03
15869,October,2020,New Haven,CT,Passenger,0,2,2,33,35,5.71
15870,October,2020,Stevens,WA,Truck,0,0,0,18696,18696,0.0
15871,October,2020,Thurston,WA,Truck,0,0,0,56300,56300,0.0
15872,October,2020,Whatcom,WA,Passenger,1169,531,1700,149671,151371,1.12
15873,October,2020,Harnett,NC,Passenger,1,0,1,188,189,0.53
15874,October,2020,Skagit,WA,Truck,1,0,1,32682,32683,0.0
15875,October,2020,Moore,NC,Passenger,0,1,1,152,153,0.65
15876,October,2020,Bexar,TX,Passenger,4,5,9,576,585,1.54
15877,October,2020,Klickitat,WA,Truck,0,0,0,8088,8088,0.0
15878,October,2020,Arapahoe,CO,Passenger,1,0,1,122,123,0.81
15879,October,2020,Columbia,WA,Truck,0,0,0,1532,1532,0.0
15880,October,2020,Duval,FL,Passenger,0,2,2,357,359,0.56
15881,October,2020,Kent,MI,Passenger,0,1,1,23,24,4.17
15882,October,2020,Cascade,MT,Passenger,0,1,1,51,52,1.92
15883,October,2020,Ferry,WA,Truck,0,0,0,3596,3596,0.0
15884,October,2020,Palm Beach,FL,Passenger,0,1,1,75,76,1.32
15885,October,2020,Fresno,CA,Passenger,1,0,1,174,175,0.57
15886,October,2020,Walla Walla,WA,Passenger,86,65,151,36014,36165,0.42
15887,October,2020,San Juan,WA,Truck,0,0,0,5864,5864,0.0
15888,October,2020,Clackamas,OR,Passenger,2,0,2,184,186,1.08
15889,October,2020,Pierce,WA,Truck,0,0,0,144394,144394,0.0
15890,October,2020,Lake,FL,Passenger,1,0,1,22,23,4.35
15891,October,2020,Monterey,CA,Passenger,0,1,1,155,156,0.64
15892,October,2020,Clark,WA,Truck,0,0,0,83170,83170,0.0
15893,October,2020,Island,WA,Passenger,463,284,747,62908,63655,1.17
15894,October,2020,Monroe,IL,Passenger,1,0,1,3,4,25.0
15895,October,2020,Howard,MD,Passenger,0,1,1,62,63,1.59
15896,October,2020,Williamson,TX,Passenger,0,2,2,127,129,1.55
15897,October,2020,Whatcom,WA,Truck,3,0,3,43462,43465,0.01
15898,October,2020,Kitsap,WA,Truck,0,0,0,54236,54236,0.0
15899,October,2020,Cape May,NJ,Passenger,0,1,1,12,13,7.69
15900,October,2020,Larimer,CO,Passenger,1,0,1,51,52,1.92
15901,October,2020,San Juan,WA,Passenger,340,103,443,13969,14412,3.07
15902,October,2020,Deschutes,OR,Passenger,1,0,1,123,124,0.81
15903,October,2020,Bartow,GA,Passenger,0,1,1,4,5,20.0
15904,October,2020,Contra Costa,CA,Passenger,4,3,7,286,293,2.39
15905,October,2020,King,WA,Passenger,25876,8012,33888,1372970,1406858,2.41
15906,October,2020,Fairfax,VA,Passenger,4,3,7,717,724,0.97
15907,October,2020,Harris,TX,Passenger,1,0,1,220,221,0.45
15908,October,2020,Ventura,CA,Passenger,1,1,2,271,273,0.73
15909,October,2020,Richmond,GA,Passenger,0,1,1,79,80,1.25
15910,October,2020,New London,CT,Passenger,1,2,3,237,240,1.25
15911,October,2020,Frederick,MD,Passenger,1,1,2,72,74,2.7
15912,October,2020,Rogers,OK,Passenger,1,0,1,4,5,20.0
15913,October,2020,Platte,MO,Passenger,1,0,1,17,18,5.56
15914,October,2020,Tulsa,OK,Passenger,1,1,2,40,42,4.76
15915,October,2020,San Francisco,CA,Passenger,1,1,2,90,92,2.17
15916,October,2020,Los Angeles,CA,Passenger,9,10,19,969,988,1.92
15917,October,2020,Walla Walla,WA,Truck,0,0,0,13797,13797,0.0
15918,October,2020,Garfield,WA,Passenger,0,1,1,1352,1353,0.07
15919,October,2020,Spokane,WA,Passenger,828,525,1353,319743,321096,0.42
15920,October,2020,Twin Falls,ID,Passenger,0,1,1,23,24,4.17
15921,October,2020,Denton,TX,Passenger,1,0,1,85,86,1.16
15922,October,2020,Douglas,WA,Truck,0,0,0,12416,12416,0.0
15923,October,2020,Morris,NJ,Passenger,1,0,1,18,19,5.26
15924,October,2020,DeKalb,IN,Passenger,1,0,1,1,2,50.0
15925,October,2020,Douglas,WA,Passenger,80,43,123,28068,28191,0.44
15926,October,2020,Allegheny,PA,Passenger,1,0,1,68,69,1.45
15927,October,2020,Douglas,NE,Passenger,0,1,1,48,49,2.04
15928,October,2020,Boone,MO,Passenger,0,1,1,10,11,9.09
15929,October,2020,Charles,MD,Passenger,1,1,2,75,77,2.6
15930,October,2020,Grant,WA,Truck,0,0,0,27386,27386,0.0
15931,October,2020,Oldham,KY,Passenger,0,1,1,4,5,20.0
15932,October,2020,Benton,WA,Truck,0,0,0,43068,43068,0.0
15933,October,2020,Okanogan,WA,Passenger,47,36,83,25991,26074,0.32
15934,October,2020,Clallam,WA,Truck,1,0,1,21767,21768,0.0
15935,October,2020,Washtenaw,MI,Passenger,1,0,1,31,32,3.12
15936,October,2020,Greene,MO,Passenger,0,1,1,33,34,2.94
15937,October,2020,Klamath,OR,Passenger,1,0,1,31,32,3.12
15938,October,2020,Skamania,WA,Passenger,32,20,52,8331,8383,0.62
15939,October,2020,Howard,IN,Passenger,0,1,1,3,4,25.0
15940,October,2020,Sumter,FL,Passenger,0,1,1,10,11,9.09
15941,October,2020,Vigo,IN,Passenger,1,0,1,6,7,14.29
15942,October,2020,Wilson,TX,Passenger,0,1,1,5,6,16.67
15943,October,2020,Franklin,WA,Truck,0,0,0,20373,20373,0.0
15944,October,2020,Spartanburg,SC,Passenger,0,1,1,49,50,2.0
15945,October,2020,Montgomery,AL,Passenger,0,1,1,40,41,2.44
15946,October,2020,Clallam,WA,Passenger,252,173,425,49893,50318,0.84
15947,October,2020,Alexandria,VA,Passenger,2,0,2,135,137,1.46
15948,October,2020,Calvert,MD,Passenger,0,2,2,84,86,2.33
15949,October,2020,Santa Cruz,CA,Passenger,1,0,1,30,31,3.23
15950,October,2020,Prince George's,MD,Passenger,2,1,3,150,153,1.96
15951,October,2020,Douglas,CO,Passenger,0,1,1,77,78,1.28
15952,October,2020,Salt Lake,UT,Passenger,0,1,1,176,177,0.56
15953,October,2020,Juneau,AK,Passenger,0,1,1,27,28,3.57
15954,October,2020,Owyhee,ID,Passenger,1,0,1,3,4,25.0
15955,October,2020,Dallas,TX,Passenger,1,0,1,179,180,0.56
15956,October,2020,Chelan,WA,Passenger,265,82,347,54374,54721,0.63
15957,October,2020,Okaloosa,FL,Passenger,0,1,1,137,138,0.72
15958,October,2020,Prince William,VA,Passenger,2,2,4,220,224,1.79
15959,October,2020,Miami-Dade,FL,Passenger,1,0,1,103,104,0.96
15960,October,2020,Suffolk,MA,Passenger,0,2,2,34,36,5.56
15961,October,2020,Shelby,OH,Passenger,0,1,1,1,2,50.0
15962,October,2020,Cowlitz,WA,Truck,0,0,0,28894,28894,0.0
15963,October,2020,Kittitas,WA,Truck,0,0,0,14630,14630,0.0
15964,October,2020,St. Louis,MO,Passenger,1,0,1,97,98,1.02
15965,October,2020,Middlesex,MA,Passenger,1,1,2,94,96,2.08
15966,October,2020,Adams,WA,Passenger,8,7,15,12936,12951,0.12
15967,October,2020,Ferry,WA,Passenger,8,3,11,4351,4362,0.25
15968,October,2020,Kittitas,WA,Passenger,121,49,170,29701,29871,0.57
15969,October,2020,Washington,OR,Passenger,1,0,1,421,422,0.24
15970,October,2020,Pacific,WA,Passenger,34,34,68,15725,15793,0.43
15971,October,2020,Mason,WA,Passenger,165,134,299,47497,47796,0.63
15972,October,2020,Wahkiakum,WA,Passenger,6,6,12,3035,3047,0.39
15973,October,2020,Hawaii,HI,Passenger,1,0,1,52,53,1.89
15974,October,2020,Skamania,WA,Truck,0,0,0,3995,3995,0.0
15975,October,2020,Manassas,VA,Passenger,0,1,1,5,6,16.67
15976,October,2020,Asotin,WA,Truck,0,0,0,6685,6685,0.0
15977,October,2020,Lee,FL,Passenger,1,0,1,47,48,2.08
15978,October,2020,Stafford,VA,Passenger,1,1,2,94,96,2.08
15979,October,2020,Lewis,WA,Truck,0,0,0,26496,26496,0.0
15980,October,2020,Kern,CA,Passenger,0,1,1,219,220,0.45
15981,October,2020,Pima,AZ,Passenger,3,1,4,325,329,1.22
15982,October,2020,Anne Arundel,MD,Passenger,1,1,2,404,406,0.49
15983,October,2020,Polk,FL,Passenger,1,0,1,59,60,1.67
15984,October,2020,Williams,ND,Passenger,0,1,1,11,12,8.33
15985,October,2020,Pacific,WA,Truck,0,0,0,7752,7752,0.0
15986,October,2020,Putnam,TN,Passenger,0,1,1,2,3,33.33
15987,October,2020,Thurston,WA,Passenger,1254,761,2015,197304,199319,1.01
15988,October,2020,Portsmouth,VA,Passenger,0,1,1,74,75,1.33
15989,October,2020,Nassau,FL,Passenger,1,0,1,36,37,2.7
15990,October,2020,Fort Bend,TX,Passenger,1,0,1,43,44,2.27
15991,October,2020,Yakima,WA,Truck,0,0,0,60694,60694,0.0
15992,October,2020,Broward,FL,Passenger,1,1,2,110,112,1.79
15993,October,2020,Leavenworth,KS,Passenger,0,1,1,124,125,0.8
15994,October,2020,Sacramento,CA,Passenger,1,0,1,243,244,0.41
15995,October,2020,Solano,CA,Passenger,1,0,1,205,206,0.49
15996,October,2020,Hudson,NJ,Passenger,1,0,1,39,40,2.5
15997,October,2020,Cumberland,NC,Passenger,0,3,3,450,453,0.66
15998,October,2020,Goochland,VA,Passenger,3,2,5,246,251,1.99
15999,October,2020,Penobscot,ME,Passenger,0,1,1,12,13,7.69
16000,October,2020,Nueces,TX,Passenger,1,0,1,85,86,1.16
16001,October,2020,Chelan,WA,Truck,0,0,0,22770,22770,0.0
16002,October,2020,Lincoln,WA,Truck,0,0,0,4661,4661,0.0
16003,October,2020,Ramsey,MN,Passenger,1,0,1,34,35,2.86
16004,October,2020,Jefferson,NY,Passenger,0,1,1,209,210,0.48
16005,October,2020,Kitsap,WA,Passenger,1465,730,2195,179705,181900,1.21
16006,October,2020,Kings,NY,Passenger,1,0,1,63,64,1.56
16007,October,2020,Loudoun,VA,Passenger,1,0,1,80,81,1.23
16008,October,2020,DeKalb,GA,Passenger,1,0,1,74,75,1.33
16009,October,2020,Chesapeake,VA,Passenger,0,3,3,405,408,0.74
16010,October,2020,San Joaquin,CA,Passenger,1,0,1,113,114,0.88
16011,October,2020,Sarasota,FL,Passenger,2,0,2,24,26,7.69
16012,October,2020,Montgomery,OH,Passenger,0,1,1,48,49,2.04
16013,October,2020,Honolulu,HI,Passenger,5,2,7,428,435,1.61
16014,October,2020,Klickitat,WA,Passenger,59,44,103,15003,15106,0.68
16015,October,2020,Spokane,WA,Truck,0,0,0,100211,100211,0.0
16016,October,2020,Wahkiakum,WA,Truck,0,0,0,1764,1764,0.0
16017,October,2020,Gwinnett,GA,Passenger,1,0,1,68,69,1.45
16018,October,2020,El Paso,TX,Passenger,3,0,3,411,414,0.72
16019,October,2020,Multnomah,OR,Passenger,3,6,9,700,709,1.27
16020,October,2020,Fulton,GA,Passenger,1,2,3,89,92,3.26
16021,October,2020,Queens,NY,Passenger,1,0,1,52,53,1.89
16022,October,2020,El Dorado,CA,Passenger,1,0,1,32,33,3.03
16023,October,2020,Dakota,MN,Passenger,0,1,1,28,29,3.45
16024,October,2020,Kauai,HI,Passenger,1,0,1,14,15,6.67
16025,October,2020,Boulder,CO,Passenger,0,1,1,42,43,2.33
16026,October,2020,Lincoln,WA,Passenger,5,10,15,7609,7624,0.2
16027,October,2020,Washoe,NV,Passenger,1,0,1,100,101,0.99
16028,October,2020,Franklin,WA,Passenger,73,78,151,61101,61252,0.25
16029,October,2020,Yakima,WA,Passenger,157,122,279,166886,167165,0.17
16030,October,2020,Montgomery,TX,Passenger,1,0,1,47,48,2.08
16031,October,2020,Erie,NY,Passenger,1,0,1,45,46,2.17
16032,October,2020,Arlington,VA,Passenger,0,2,2,144,146,1.37
16033,October,2020,Pinellas,FL,Passenger,1,1,2,99,101,1.98
16034,October,2020,Cowlitz,WA,Passenger,160,122,282,72100,72382,0.39
16035,October,2020,Harrison,MS,Passenger,1,0,1,51,52,1.92
16036,October,2020,Stevens,WA,Passenger,36,39,75,30368,30443,0.25
16037,October,2020,Skagit,WA,Passenger,466,231,697,91532,92229,0.76
16038,October,2020,Okanogan,WA,Truck,0,0,0,16573,16573,0.0
16039,October,2020,El Paso,CO,Passenger,2,0,2,699,701,0.29
16040,October,2020,Hamilton,IN,Passenger,2,0,2,37,39,5.13
16041,October,2020,Riverside,CA,Passenger,4,1,5,600,605,0.83
16042,October,2020,St. Clair,IL,Passenger,1,0,1,136,137,0.73
16043,October,2020,New York,NY,Passenger,1,0,1,56,57,1.75
16044,October,2020,Hennepin,MN,Passenger,2,0,2,83,85,2.35
16045,October,2020,Richland,SC,Passenger,0,1,1,143,144,0.69
16046,October,2020,DuPage,IL,Passenger,3,0,3,54,57,5.26
16047,October,2020,Grant,WA,Passenger,71,81,152,65747,65899,0.23
16048,October,2020,Houston,GA,Passenger,1,0,1,52,53,1.89
16049,October,2020,Jefferson,WA,Truck,0,0,0,9575,9575,0.0
16050,October,2020,Pend Oreille,WA,Truck,0,0,0,5717,5717,0.0
16051,October,2020,Fairbanks North Star,AK,Passenger,0,1,1,94,95,1.05
16052,October,2020,Jones,GA,Passenger,1,0,1,1,2,50.0
16053,October,2020,Rockingham,NH,Passenger,1,0,1,22,23,4.35
16054,October,2020,King,WA,Truck,5,1,6,184061,184067,0.0
16055,October,2020,Pend Oreille,WA,Passenger,8,4,12,9158,9170,0.13
16056,October,2020,Snohomish,WA,Truck,0,0,0,125318,125318,0.0
16057,October,2020,Ada,ID,Passenger,0,1,1,250,251,0.4
16058,October,2020,Benton,WA,Passenger,403,339,742,134682,135424,0.55
16059,October,2020,Jefferson,WA,Passenger,260,151,411,24723,25134,1.64
16060,October,2020,Ulster,NY,Passenger,1,0,1,8,9,11.11
16061,October,2020,Mason,WA,Truck,0,0,0,20836,20836,0.0
16062,October,2020,Carroll,MD,Passenger,0,1,1,21,22,4.55
16063,October,2020,San Diego,CA,Passenger,14,4,18,2724,2742,0.66
16064,October,2020,Suffolk,VA,Passenger,1,0,1,126,127,0.79
16065,October,2020,Flathead,MT,Passenger,1,0,1,54,55,1.82
16066,October,2020,Garfield,WA,Truck,0,0,0,991,991,0.0
16067,October,2020,Utah,UT,Passenger,0,1,1,128,129,0.78
16068,October,2020,Sedgwick,KS,Passenger,1,1,2,91,93,2.15
16069,October,2020,Nassau,NY,Passenger,4,0,4,28,32,12.5
16070,October,2020,Bucks,PA,Passenger,1,0,1,18,19,5.26
16071,October,2020,Maricopa,AZ,Passenger,5,6,11,1330,1341,0.82
16072,October,2020,Grays Harbor,WA,Passenger,118,117,235,48521,48756,0.48
16073,October,2020,San Mateo,CA,Passenger,1,1,2,105,107,1.87
16074,October,2020,St. Mary's,MD,Passenger,1,0,1,215,216,0.46
16075,October,2020,Alameda,CA,Passenger,2,0,2,255,257,0.78
16076,October,2020,Saginaw,MI,Passenger,1,0,1,9,10,10.0
16077,October,2020,Virginia Beach,VA,Passenger,1,0,1,646,647,0.15
16078,October,2020,Albemarle,VA,Passenger,1,0,1,21,22,4.55
16079,October,2020,Carson City,NV,Passenger,1,0,1,11,12,8.33
16080,October,2020,Grays Harbor,WA,Truck,0,0,0,21123,21123,0.0
16081,October,2020,Maui,HI,Passenger,1,0,1,28,29,3.45
16082,October,2020,Travis,TX,Passenger,2,1,3,168,171,1.75
16083,October,2020,Columbia,WA,Passenger,4,3,7,2439,2446,0.29
16084,October,2020,Powhatan,VA,Passenger,1,0,1,0,1,100.0
16085,October,2020,Norfolk,VA,Passenger,2,3,5,345,350,1.43
16086,October,2020,Charleston,SC,Passenger,2,0,2,91,93,2.15
16087,October,2020,Carroll,NH,Passenger,0,1,1,5,6,16.67
16088,October,2020,Denver,CO,Passenger,1,0,1,113,114,0.88
16089,October,2020,Lewis,WA,Passenger,114,115,229,58451,58680,0.39
16090,October,2020,Camden,NJ,Passenger,0,1,1,22,23,4.35
16091,October,2020,Bradley,TN,Passenger,1,0,1,0,1,100.0
16092,October,2020,Pierce,WA,Passenger,2660,1740,4400,554816,559216,0.79
16093,October,2020,Asotin,WA,Passenger,17,14,31,12401,12432,0.25
16094,October,2020,Whitman,WA,Truck,0,0,0,8487,8487,0.0
16095,October,2020,Snohomish,WA,Passenger,4831,1816,6647,537854,544501,1.22
16096,October,2020,Adams,WA,Truck,0,0,0,5335,5335,0.0
16097,October,2020,Island,WA,Truck,1,0,1,21311,21312,0.0
16098,October,2020,Lake,IL,Passenger,2,0,2,160,162,1.23
16099,October,2020,Hampshire,MA,Passenger,1,0,1,6,7,14.29
16100,October,2021,Clark,NV,Passenger,4,2,6,573,579,1.04
16101,October,2021,St. Mary's,MD,Passenger,1,0,1,203,204,0.49
16103,October,2021,Kitsap,WA,Passenger,2042,916,2958,180643,183601,1.61
16104,October,2021,Ferry,WA,Passenger,11,3,14,4446,4460,0.31
16105,October,2021,Milwaukee,WI,Passenger,1,0,1,36,37,2.7
16106,October,2021,Richmond,GA,Passenger,0,1,1,71,72,1.39
16107,October,2021,Stafford,VA,Passenger,2,1,3,96,99,3.03
16108,October,2021,Monterey,CA,Passenger,0,1,1,142,143,0.7
16109,October,2021,Carroll,NH,Passenger,0,1,1,5,6,16.67
16110,October,2021,Snohomish,WA,Truck,2,0,2,125795,125797,0.0
16111,October,2021,Stevens,WA,Truck,0,0,0,18891,18891,0.0
16112,October,2021,Juneau,AK,Passenger,0,1,1,27,28,3.57
16113,October,2021,Island,WA,Truck,0,0,0,21569,21569,0.0
16114,October,2021,Fairbanks North Star,AK,Passenger,0,1,1,77,78,1.28
16115,October,2021,Rockdale,GA,Passenger,1,0,1,7,8,12.5
16116,October,2021,Chelan,WA,Truck,0,0,0,23075,23075,0.0
16117,October,2021,Walla Walla,WA,Passenger,132,82,214,36363,36577,0.59
16118,October,2021,Las Animas,CO,Passenger,1,0,1,0,1,100.0
16119,October,2021,Grays Harbor,WA,Truck,0,0,0,21396,21396,0.0
16120,October,2021,Klickitat,WA,Passenger,87,51,138,15357,15495,0.89
16121,October,2021,Ventura,CA,Passenger,2,1,3,248,251,1.2
16122,October,2021,Cowlitz,WA,Truck,0,1,1,29069,29070,0.0
16123,October,2021,Grant,WA,Passenger,133,95,228,66824,67052,0.34
16124,October,2021,Whatcom,WA,Truck,4,0,4,43778,43782,0.01
16125,October,2021,Champaign,IL,Passenger,1,0,1,10,11,9.09
16126,October,2021,Fresno,CA,Passenger,1,0,1,160,161,0.62
16127,October,2021,Montgomery,PA,Passenger,2,0,2,23,25,8.0
16128,October,2021,Harrison,MS,Passenger,2,0,2,48,50,4.0
16129,October,2021,Hudson,NJ,Passenger,1,0,1,41,42,2.38
16130,October,2021,Hawaii,HI,Passenger,1,0,1,41,42,2.38
16131,October,2021,Montgomery,TX,Passenger,1,1,2,37,39,5.13
16132,October,2021,Suffolk,VA,Passenger,1,0,1,122,123,0.81
16133,October,2021,Yamhill,OR,Passenger,1,0,1,32,33,3.03
16134,October,2021,DeKalb,GA,Passenger,1,0,1,56,57,1.75
16135,October,2021,Asotin,WA,Passenger,21,17,38,12770,12808,0.3
16136,October,2021,Grant,WA,Truck,0,0,0,28018,28018,0.0
16137,October,2021,Wahkiakum,WA,Passenger,17,8,25,3065,3090,0.81
16138,October,2021,Fairfax,VA,Passenger,4,4,8,664,672,1.19
16139,October,2021,Portsmouth,VA,Passenger,0,1,1,77,78,1.28
16140,October,2021,Harnett,NC,Passenger,1,1,2,153,155,1.29
16141,October,2021,Hillsborough,FL,Passenger,0,1,1,142,143,0.7
16142,October,2021,Arlington,VA,Passenger,1,1,2,128,130,1.54
16143,October,2021,Lewis,WA,Passenger,194,158,352,59631,59983,0.59
16144,October,2021,Adams,WA,Truck,0,0,0,5409,5409,0.0
16145,October,2021,Lake,IL,Passenger,3,0,3,154,157,1.91
16146,October,2021,Honolulu,HI,Passenger,5,3,8,363,371,2.16
16147,October,2021,Whatcom,WA,Passenger,1581,646,2227,150431,152658,1.46
16148,October,2021,Orange,FL,Passenger,1,0,1,107,108,0.93
16149,October,2021,Rogers,OK,Passenger,1,0,1,3,4,25.0
16150,October,2021,Penobscot,ME,Passenger,0,1,1,8,9,11.11
16151,October,2021,Pacific,WA,Truck,0,0,0,7990,7990,0.0
16152,October,2021,Washington,MD,Passenger,2,0,2,13,15,13.33
16153,October,2021,Sarpy,NE,Passenger,1,0,1,58,59,1.69
16154,October,2021,Yakima,WA,Passenger,270,165,435,168835,169270,0.26
16155,October,2021,Goochland,VA,Passenger,3,2,5,197,202,2.48
16156,October,2021,Pierce,WA,Passenger,4001,2085,6086,557924,564010,1.08
16157,October,2021,Columbia,WA,Passenger,7,2,9,2439,2448,0.37
16158,October,2021,Clark,WA,Truck,0,0,0,84034,84034,0.0
16159,October,2021,Harris,TX,Passenger,1,1,2,170,172,1.16
16160,October,2021,Pend Oreille,WA,Passenger,18,7,25,9206,9231,0.27
16161,October,2021,Wichita,TX,Passenger,1,0,1,43,44,2.27
16162,October,2021,Snohomish,WA,Passenger,6655,2197,8852,538791,547643,1.62
16163,October,2021,Montgomery,OH,Passenger,0,1,1,53,54,1.85
16164,October,2021,Carson City,NV,Passenger,1,0,1,10,11,9.09
16165,October,2021,Middlesex,MA,Passenger,1,1,2,86,88,2.27
16166,October,2021,King,WA,Passenger,33841,9915,43756,1363940,1407696,3.11
16167,October,2021,Jefferson,WA,Passenger,362,191,553,24778,25331,2.18
16168,October,2021,Placer,CA,Passenger,2,0,2,71,73,2.74
16169,October,2021,Klickitat,WA,Truck,0,0,0,8316,8316,0.0
16170,October,2021,Charles,MD,Passenger,1,1,2,68,70,2.86
16171,October,2021,Boone,MO,Passenger,0,1,1,9,10,10.0
16172,October,2021,Sedgwick,KS,Passenger,1,1,2,79,81,2.47
16173,October,2021,Shelby,OH,Passenger,0,1,1,2,3,33.33
16174,October,2021,Riverside,CA,Passenger,5,1,6,514,520,1.15
16175,October,2021,Larimer,CO,Passenger,1,0,1,49,50,2.0
16176,October,2021,Charleston,SC,Passenger,2,1,3,79,82,3.66
16177,October,2021,Douglas,CO,Passenger,0,1,1,75,76,1.32
16178,October,2021,Garfield,WA,Passenger,0,3,3,1355,1358,0.22
16179,October,2021,Cook,IL,Passenger,2,0,2,195,197,1.02
16180,October,2021,Ulster,NY,Passenger,1,0,1,9,10,10.0
16181,October,2021,Lewis,WA,Truck,0,0,0,26738,26738,0.0
16182,October,2021,Island,WA,Passenger,679,333,1012,63091,64103,1.58
16183,October,2021,Saratoga,NY,Passenger,1,0,1,41,42,2.38
16184,October,2021,Sacramento,CA,Passenger,2,0,2,215,217,0.92
16185,October,2021,Clark,WA,Passenger,3253,1514,4767,321077,325844,1.46
16186,October,2021,Wilson,TX,Passenger,0,1,1,2,3,33.33
16187,October,2021,Hamilton,IN,Passenger,2,0,2,28,30,6.67
16188,October,2021,Lincoln,WA,Passenger,7,16,23,7707,7730,0.3
16189,October,2021,Salt Lake,UT,Passenger,0,1,1,158,159,0.63
16190,October,2021,Richland,SC,Passenger,0,1,1,129,130,0.77
16191,October,2021,Douglas,WA,Passenger,103,51,154,28576,28730,0.54
16192,October,2021,Powhatan,VA,Passenger,1,0,1,1,2,50.0
16193,October,2021,Broward,FL,Passenger,2,0,2,97,99,2.02
16194,October,2021,Greene,MO,Passenger,0,1,1,26,27,3.7
16195,October,2021,Houston,GA,Passenger,1,0,1,44,45,2.22
16196,October,2021,Hidalgo,TX,Passenger,0,1,1,54,55,1.82
16197,October,2021,Burlington,NJ,Passenger,0,1,1,120,121,0.83
16198,October,2021,Chesapeake,VA,Passenger,1,3,4,376,380,1.05
16199,October,2021,St. Clair,IL,Passenger,2,0,2,123,125,1.6
16200,October,2021,Whitman,WA,Truck,0,0,0,8556,8556,0.0
16201,October,2021,Geary,KS,Passenger,1,0,1,96,97,1.03
16202,October,2021,Sumter,SC,Passenger,0,1,1,36,37,2.7
16203,October,2021,Tarrant,TX,Passenger,1,0,1,136,137,0.73
16204,October,2021,Escambia,FL,Passenger,0,1,1,139,140,0.71
16205,October,2021,Spartanburg,SC,Passenger,0,1,1,48,49,2.04
16206,October,2021,Kittitas,WA,Passenger,193,72,265,29844,30109,0.88
16207,October,2021,Manassas,VA,Passenger,0,1,1,7,8,12.5
16208,October,2021,Spokane,WA,Truck,0,0,0,102587,102587,0.0
16209,October,2021,Williamson,TX,Passenger,1,2,3,97,100,3.0
16210,October,2021,Cape May,NJ,Passenger,0,1,1,8,9,11.11
16211,October,2021,New York,NY,Passenger,1,0,1,37,38,2.63
16212,October,2021,Duval,FL,Passenger,0,2,2,321,323,0.62
16213,October,2021,Mason,WA,Passenger,246,156,402,47894,48296,0.83
16214,October,2021,Howard,IN,Passenger,0,1,1,6,7,14.29
16215,October,2021,Rockingham,NH,Passenger,1,0,1,19,20,5.0
16216,October,2021,Cumberland,NC,Passenger,0,2,2,399,401,0.5
16217,October,2021,Pima,AZ,Passenger,1,1,2,251,253,0.79
16218,October,2021,Nueces,TX,Passenger,1,0,1,64,65,1.54
16219,October,2021,Cowlitz,WA,Passenger,258,154,412,71857,72269,0.57
16220,October,2021,New London,CT,Passenger,1,4,5,212,217,2.3
16221,October,2021,Fort Bend,TX,Passenger,1,0,1,35,36,2.78
16222,October,2021,Missoula,MT,Passenger,1,0,1,52,53,1.89
16223,October,2021,Wake,NC,Passenger,1,0,1,112,113,0.88
16224,October,2021,Sonoma,CA,Passenger,0,1,1,82,83,1.2
16225,October,2021,Denton,TX,Passenger,1,0,1,76,77,1.3
16226,October,2021,Lee,FL,Passenger,1,0,1,33,34,2.94
16227,October,2021,Richmond,NY,Passenger,1,0,1,6,7,14.29
16228,October,2021,Franklin,WA,Passenger,144,102,246,62082,62328,0.39
16229,October,2021,Baltimore,MD,Passenger,1,0,1,86,87,1.15
16230,October,2021,RÃ­o Grande,PR,Passenger,1,0,1,0,1,100.0
16231,October,2021,Multnomah,OR,Passenger,2,6,8,622,630,1.27
16232,October,2021,Skamania,WA,Truck,0,0,0,4019,4019,0.0
16233,October,2021,Solano,CA,Passenger,1,0,1,177,178,0.56
16234,October,2021,Calvert,MD,Passenger,0,2,2,83,85,2.35
16235,October,2021,Onslow,NC,Passenger,0,1,1,170,171,0.58
16236,October,2021,Douglas,NE,Passenger,1,1,2,49,51,3.92
16237,October,2021,Williams,ND,Passenger,0,1,1,8,9,11.11
16238,October,2021,Thurston,WA,Passenger,1803,921,2724,197240,199964,1.36
16239,October,2021,Clallam,WA,Truck,1,0,1,22063,22064,0.0
16240,October,2021,Clackamas,OR,Passenger,2,0,2,165,167,1.2
16241,October,2021,Kings,CA,Passenger,2,0,2,322,324,0.62
16242,October,2021,Saginaw,MI,Passenger,1,0,1,5,6,16.67
16243,October,2021,Pacific,WA,Passenger,49,59,108,16114,16222,0.67
16244,October,2021,Platte,MO,Passenger,1,0,1,17,18,5.56
16245,October,2021,Clallam,WA,Passenger,365,235,600,50522,51122,1.17
16246,October,2021,Whitman,WA,Passenger,63,58,121,21932,22053,0.55
16247,October,2021,Garfield,WA,Truck,0,0,0,999,999,0.0
16248,October,2021,Sevier,AR,Passenger,0,1,1,0,1,100.0
16249,October,2021,Moore,NC,Passenger,0,1,1,123,124,0.81
16250,October,2021,Columbia,WA,Truck,0,0,0,1537,1537,0.0
16251,October,2021,San Joaquin,CA,Passenger,1,1,2,96,98,2.04
16252,October,2021,Kern,CA,Passenger,0,1,1,196,197,0.51
16253,October,2021,San Luis Obispo,CA,Passenger,1,0,1,58,59,1.69
16254,October,2021,Suffolk,MA,Passenger,0,2,2,27,29,6.9
16255,October,2021,Anne Arundel,MD,Passenger,4,3,7,363,370,1.89
16256,October,2021,Alexandria,VA,Passenger,2,0,2,122,124,1.61
16257,October,2021,Wahkiakum,WA,Truck,0,0,0,1827,1827,0.0
16258,October,2021,San Juan,WA,Truck,0,0,0,5976,5976,0.0
16259,October,2021,Montgomery,MD,Passenger,3,2,5,206,211,2.37
16260,October,2021,Pierce,WA,Truck,0,0,0,145249,145249,0.0
16261,October,2021,Bexar,TX,Passenger,3,5,8,489,497,1.61
16262,October,2021,Erie,NY,Passenger,1,0,1,31,32,3.12
16263,October,2021,Allegheny,PA,Passenger,1,1,2,60,62,3.23
16264,October,2021,Loudoun,VA,Passenger,1,0,1,67,68,1.47
16265,October,2021,Frederick,MD,Passenger,1,1,2,69,71,2.82
16266,October,2021,Pend Oreille,WA,Truck,0,0,0,5687,5687,0.0
16267,October,2021,Jefferson,WA,Truck,0,0,0,9592,9592,0.0
16268,October,2021,Kitsap,WA,Truck,0,0,0,54245,54245,0.0
16269,October,2021,Asotin,WA,Truck,0,0,0,6748,6748,0.0
16270,October,2021,New Haven,CT,Passenger,0,2,2,28,30,6.67
16271,October,2021,Mason,WA,Truck,0,0,0,21283,21283,0.0
16272,October,2021,Coryell,TX,Passenger,1,0,1,108,109,0.92
16273,October,2021,Randolph,NC,Passenger,1,0,1,5,6,16.67
16274,October,2021,Hamilton,OH,Passenger,1,0,1,33,34,2.94
16275,October,2021,Los Angeles,CA,Passenger,7,9,16,833,849,1.88
16276,October,2021,Okanogan,WA,Passenger,66,44,110,26572,26682,0.41
16277,October,2021,Kings,NY,Passenger,1,0,1,70,71,1.41
16278,October,2021,Douglas,WA,Truck,0,0,0,12679,12679,0.0
16279,October,2021,Collin,TX,Passenger,1,0,1,100,101,0.99
16280,October,2021,Benton,WA,Truck,0,0,0,43707,43707,0.0
16281,October,2021,Flathead,MT,Passenger,1,0,1,43,44,2.27
16282,October,2021,Pinellas,FL,Passenger,0,1,1,89,90,1.11
16283,October,2021,Okaloosa,FL,Passenger,0,1,1,112,113,0.88
16284,October,2021,Benton,WA,Passenger,595,426,1021,136009,137030,0.75
16285,October,2021,Skamania,WA,Passenger,58,39,97,8335,8432,1.15
16286,October,2021,Franklin,WA,Truck,0,0,0,20773,20773,0.0
16287,October,2021,Vigo,IN,Passenger,1,0,1,5,6,16.67
16288,October,2021,San Juan,WA,Passenger,469,146,615,14189,14804,4.15
16289,October,2021,Grays Harbor,WA,Passenger,187,151,338,49486,49824,0.68
16290,October,2021,Dorchester,SC,Passenger,1,0,1,65,66,1.52
16291,October,2021,San Francisco,CA,Passenger,0,1,1,81,82,1.22
16292,October,2021,Nassau,NY,Passenger,2,0,2,25,27,7.41
16293,October,2021,Ferry,WA,Truck,0,0,0,3592,3592,0.0
16294,October,2021,El Paso,TX,Passenger,3,0,3,349,352,0.85
16295,October,2021,Thurston,WA,Truck,0,0,0,56195,56195,0.0
16296,October,2021,Albemarle,VA,Passenger,1,0,1,19,20,5.0
16297,October,2021,Owyhee,ID,Passenger,1,0,1,2,3,33.33
16298,October,2021,Contra Costa,CA,Passenger,1,4,5,264,269,1.86
16299,October,2021,Santa Clara,CA,Passenger,7,2,9,237,246,3.66
16300,October,2021,Carroll,MD,Passenger,0,1,1,16,17,5.88
16301,October,2021,Washington,OR,Passenger,1,0,1,355,356,0.28
16302,October,2021,Allen,IN,Passenger,1,0,1,15,16,6.25
16303,October,2021,Walla Walla,WA,Truck,0,0,0,14050,14050,0.0
16304,October,2021,Alameda,CA,Passenger,4,0,4,212,216,1.85
16305,October,2021,Klamath,OR,Passenger,1,0,1,28,29,3.45
16306,October,2021,Queens,NY,Passenger,1,0,1,44,45,2.22
16307,October,2021,Philadelphia,PA,Passenger,1,0,1,40,41,2.44
16308,October,2021,Skagit,WA,Truck,1,0,1,32836,32837,0.0
16309,October,2021,Yakima,WA,Truck,0,0,0,61670,61670,0.0
16310,October,2021,Adams,WA,Passenger,16,14,30,13034,13064,0.23
16311,October,2021,Hennepin,MN,Passenger,3,0,3,69,72,4.17
16312,October,2021,Miami-Dade,FL,Passenger,1,0,1,94,95,1.05
16313,October,2021,Louisa,VA,Passenger,0,1,1,1,2,50.0
16314,October,2021,Anchorage,AK,Passenger,1,0,1,130,131,0.76
16315,October,2021,Prince William,VA,Passenger,1,1,2,201,203,0.99
16316,October,2021,Boulder,CO,Passenger,1,1,2,37,39,5.13
16317,October,2021,Polk,FL,Passenger,1,0,1,53,54,1.85
16318,October,2021,Sarasota,FL,Passenger,2,0,2,30,32,6.25
16319,October,2021,Essex,NJ,Passenger,2,0,2,10,12,16.67
16320,October,2021,District of Columbia,DC,Passenger,5,0,5,193,198,2.53
16321,October,2021,Orange,CA,Passenger,5,2,7,389,396,1.77
16322,October,2021,King,WA,Truck,4,1,5,183489,183494,0.0
16323,October,2021,Stevens,WA,Passenger,52,43,95,30243,30338,0.31
16324,October,2021,Howard,MD,Passenger,0,1,1,54,55,1.82
16325,October,2021,Camden,NJ,Passenger,0,1,1,14,15,6.67
16326,October,2021,Pennington,SD,Passenger,1,0,1,30,31,3.23
16327,October,2021,Bartow,GA,Passenger,0,1,1,3,4,25.0
16328,October,2021,Skagit,WA,Passenger,649,295,944,91478,92422,1.02
16329,October,2021,Spokane,WA,Passenger,1218,727,1945,326533,328478,0.59
16330,October,2021,Bernalillo,NM,Passenger,1,0,1,111,112,0.89
16331,October,2021,Kittitas,WA,Truck,0,0,0,14773,14773,0.0
16332,October,2021,Leavenworth,KS,Passenger,0,1,1,108,109,0.92
16333,October,2021,Chelan,WA,Passenger,385,110,495,54679,55174,0.9
16334,October,2021,Lane,OR,Passenger,0,1,1,114,115,0.87
16335,October,2021,Gwinnett,GA,Passenger,1,0,1,58,59,1.69
16336,October,2021,Wilson,NC,Passenger,1,0,1,0,1,100.0
16337,October,2021,Kauai,HI,Passenger,1,0,1,17,18,5.56
16338,October,2021,Travis,TX,Passenger,3,3,6,132,138,4.35
16339,October,2021,Oldham,KY,Passenger,0,1,1,4,5,20.0
16340,October,2021,Jefferson,NY,Passenger,0,1,1,206,207,0.48
16341,October,2021,Santa Cruz,CA,Passenger,1,0,1,25,26,3.85
16342,October,2021,Lincoln,WA,Truck,0,0,0,4804,4804,0.0
16343,October,2021,San Diego,CA,Passenger,16,8,24,2467,2491,0.96
16344,October,2021,Virginia Beach,VA,Passenger,2,0,2,576,578,0.35
16345,October,2021,DuPage,IL,Passenger,1,0,1,50,51,1.96
16346,October,2021,Norfolk,VA,Passenger,3,3,6,312,318,1.89
16347,October,2021,Ray,MO,Passenger,0,1,1,1,2,50.0
16348,October,2021,Okanogan,WA,Truck,0,0,0,16678,16678,0.0
16349,October,2021,El Paso,CO,Passenger,3,0,3,655,658,0.46
16350,October,2021,San Mateo,CA,Passenger,2,0,2,83,85,2.35
16351,October,2021,Danville,VA,Passenger,1,0,1,0,1,100.0
16352,October,2021,Maricopa,AZ,Passenger,8,2,10,1080,1090,0.92
16353,October,2021,St. Louis,MO,Passenger,1,0,1,72,73,1.37
16354,October,2021,Lake,FL,Passenger,1,0,1,22,23,4.35
16355,October,2021,Prince George's,MD,Passenger,2,1,3,138,141,2.13
16356,October,2021,Plaquemines,LA,Passenger,0,1,1,17,18,5.56
16357,October,2021,Dallas,TX,Passenger,1,0,1,144,145,0.69
16358,October,2022,Hamilton,OH,Passenger,1,0,1,28,29,3.45
16359,October,2022,Walla Walla,WA,Passenger,190,107,297,35711,36008,0.82
16360,October,2022,Lane,OR,Passenger,0,1,1,75,76,1.32
16361,October,2022,Pend Oreille,WA,Passenger,18,12,30,9012,9042,0.33
16362,October,2022,Montgomery,AL,Passenger,0,1,1,29,30,3.33
16363,October,2022,Ferry,WA,Passenger,24,4,28,4384,4412,0.63
16364,October,2022,Hudson,NJ,Passenger,2,0,2,30,32,6.25
16365,October,2022,Santa Cruz,CA,Passenger,1,0,1,19,20,5.0
16366,October,2022,Mason,WA,Passenger,350,187,537,46978,47515,1.13
16367,October,2022,Kern,CA,Passenger,1,1,2,186,188,1.06
16368,October,2022,Collin,TX,Passenger,2,0,2,60,62,3.23
16369,October,2022,Yakima,WA,Passenger,394,214,608,166433,167041,0.36
16370,October,2022,Middlesex,MA,Passenger,2,1,3,61,64,4.69
16371,October,2022,New Haven,CT,Passenger,0,2,2,24,26,7.69
16372,October,2022,Geary,KS,Passenger,1,0,1,78,79,1.27
16373,October,2022,Escambia,FL,Passenger,0,1,1,119,120,0.83
16374,October,2022,Solano,CA,Passenger,2,0,2,148,150,1.33
16375,October,2022,Moore,NC,Passenger,0,1,1,108,109,0.92
16376,October,2022,Walla Walla,WA,Truck,3,0,3,13949,13952,0.02
16377,October,2022,Whitman,WA,Passenger,103,65,168,21978,22146,0.76
16378,October,2022,Washington,MD,Passenger,2,0,2,14,16,12.5
16379,October,2022,Snohomish,WA,Passenger,9424,2670,12094,531029,543123,2.23
16380,October,2022,Wilson,TX,Passenger,0,1,1,2,3,33.33
16381,October,2022,Norfolk,VA,Passenger,3,3,6,273,279,2.15
16382,October,2022,Grant,WA,Truck,2,0,2,28024,28026,0.01
16383,October,2022,Manassas,VA,Passenger,0,1,1,7,8,12.5
16384,October,2022,Goochland,VA,Passenger,0,1,1,74,75,1.33
16385,October,2022,District of Columbia,DC,Passenger,4,0,4,158,162,2.47
16386,October,2022,Wichita,TX,Passenger,2,0,2,36,38,5.26
16387,October,2022,Pierce,WA,Passenger,5747,2449,8196,540967,549163,1.49
16388,October,2022,Thurston,WA,Truck,30,0,30,54906,54936,0.05
16389,October,2022,Grays Harbor,WA,Truck,2,0,2,21098,21100,0.01
16390,October,2022,Chelan,WA,Truck,8,0,8,23087,23095,0.03
16391,October,2022,Montgomery,PA,Passenger,1,0,1,19,20,5.0
16392,October,2022,Pend Oreille,WA,Truck,0,0,0,5614,5614,0.0
16393,October,2022,Fairfax,VA,Passenger,6,3,9,570,579,1.55
16394,October,2022,Clark,WA,Truck,31,0,31,82151,82182,0.04
16395,October,2022,Sedgwick,KS,Passenger,1,1,2,65,67,2.99
16396,October,2022,Spartanburg,SC,Passenger,0,1,1,29,30,3.33
16397,October,2022,Alexandria,VA,Passenger,4,0,4,97,101,3.96
16398,October,2022,Whatcom,WA,Truck,20,0,20,43123,43143,0.05
16399,October,2022,Jefferson,WA,Truck,5,0,5,9394,9399,0.05
16400,October,2022,Bexar,TX,Passenger,5,3,8,389,397,2.02
16401,October,2022,Sumter,SC,Passenger,0,1,1,33,34,2.94
16402,October,2022,Portsmouth,VA,Passenger,0,1,1,71,72,1.39
16403,October,2022,Travis,TX,Passenger,1,0,1,88,89,1.12
16404,October,2022,Placer,CA,Passenger,2,0,2,58,60,3.33
16405,October,2022,Bell,TX,Passenger,1,0,1,283,284,0.35
16406,October,2022,Calvert,MD,Passenger,0,2,2,74,76,2.63
16407,October,2022,Asotin,WA,Truck,0,0,0,6692,6692,0.0
16408,October,2022,Denton,TX,Passenger,1,0,1,54,55,1.82
16409,October,2022,Essex,NJ,Passenger,2,0,2,8,10,20.0
16410,October,2022,Adams,CO,Passenger,1,0,1,35,36,2.78
16411,October,2022,Chesapeake,VA,Passenger,3,3,6,299,305,1.97
16412,October,2022,El Paso,CO,Passenger,3,1,4,536,540,0.74
16413,October,2022,Elmore,ID,Passenger,1,0,1,12,13,7.69
16414,October,2022,Monterey,CA,Passenger,1,1,2,120,122,1.64
16415,October,2022,Kittitas,WA,Passenger,291,94,385,29590,29975,1.28
16416,October,2022,Jackson,OK,Passenger,0,1,1,32,33,3.03
16417,October,2022,Rockingham,NH,Passenger,1,0,1,12,13,7.69
16418,October,2022,Sheridan,WY,Passenger,1,0,1,5,6,16.67
16419,October,2022,Garfield,WA,Passenger,1,3,4,1315,1319,0.3
16420,October,2022,Champaign,IL,Passenger,1,0,1,8,9,11.11
16421,October,2022,Miami-Dade,FL,Passenger,1,0,1,67,68,1.47
16422,October,2022,Contra Costa,CA,Passenger,0,3,3,214,217,1.38
16423,October,2022,Oldham,KY,Passenger,0,1,1,4,5,20.0
16424,October,2022,Santa Clara,CA,Passenger,9,2,11,184,195,5.64
16425,October,2022,Jefferson,WA,Passenger,464,225,689,24416,25105,2.74
16426,October,2022,Prince George's,MD,Passenger,3,1,4,110,114,3.51
16427,October,2022,Salt Lake,UT,Passenger,1,1,2,108,110,1.82
16428,October,2022,Hamilton,OH,Truck,1,0,1,2,3,33.33
16429,October,2022,Stafford,VA,Passenger,2,1,3,81,84,3.57
16430,October,2022,Kings,CA,Passenger,2,1,3,284,287,1.05
16431,October,2022,San Juan,WA,Truck,7,0,7,5952,5959,0.12
16432,October,2022,Skagit,WA,Truck,8,0,8,32247,32255,0.02
16433,October,2022,Franklin,WA,Passenger,239,112,351,61817,62168,0.56
16434,October,2022,San Juan,WA,Passenger,549,165,714,13992,14706,4.86
16435,October,2022,Lincoln,WA,Truck,0,0,0,4863,4863,0.0
16436,October,2022,Rockdale,GA,Passenger,1,0,1,6,7,14.29
16437,October,2022,DeKalb,GA,Passenger,1,0,1,41,42,2.38
16439,October,2022,Pulaski,AR,Passenger,3,0,3,27,30,10.0
16440,October,2022,Carroll,NH,Passenger,0,1,1,5,6,16.67
16441,October,2022,Charles,MD,Passenger,1,1,2,51,53,3.77
16442,October,2022,Loudoun,VA,Passenger,3,1,4,61,65,6.15
16443,October,2022,Lewis,WA,Truck,2,0,2,26372,26374,0.01
16444,October,2022,Louisa,VA,Passenger,0,1,1,1,2,50.0
16445,October,2022,Galveston,TX,Passenger,0,1,1,16,17,5.88
16446,October,2022,Ray,MO,Passenger,0,1,1,1,2,50.0
16447,October,2022,Clark,WA,Passenger,4606,1925,6531,315200,321731,2.03
16448,October,2022,Spokane,WA,Truck,14,0,14,101936,101950,0.01
16449,October,2022,Douglas,WA,Passenger,158,59,217,28437,28654,0.76
16450,October,2022,Fairbanks North Star,AK,Passenger,0,1,1,63,64,1.56
16451,October,2022,Hidalgo,TX,Passenger,0,1,1,50,51,1.96
16452,October,2022,Allegheny,PA,Passenger,1,1,2,48,50,4.0
16453,October,2022,Stevens,WA,Passenger,84,56,140,30055,30195,0.46
16454,October,2022,Danville,VA,Passenger,1,0,1,0,1,100.0
16455,October,2022,Philadelphia,PA,Passenger,1,0,1,36,37,2.7
16456,October,2022,Queens,NY,Passenger,1,0,1,33,34,2.94
16457,October,2022,Columbia,WA,Passenger,8,1,9,2442,2451,0.37
16458,October,2022,Chelan,WA,Passenger,508,140,648,54201,54849,1.18
16459,October,2022,Hoke,NC,Passenger,1,0,1,60,61,1.64
16460,October,2022,Harrison,MS,Passenger,1,0,1,34,35,2.86
16461,October,2022,Fairfax,VA,Truck,1,0,1,105,106,0.94
16462,October,2022,Clark,NV,Passenger,4,2,6,441,447,1.34
16463,October,2022,Cumberland,PA,Passenger,1,0,1,35,36,2.78
16464,October,2022,Virginia Beach,VA,Passenger,2,0,2,469,471,0.42
16465,October,2022,Whitman,WA,Truck,3,0,3,8609,8612,0.03
16466,October,2022,Garfield,WA,Truck,0,0,0,977,977,0.0
16467,October,2022,Kittitas,WA,Truck,5,0,5,14601,14606,0.03
16468,October,2022,Sonoma,CA,Passenger,1,1,2,67,69,2.9
16469,October,2022,Wahkiakum,WA,Truck,1,0,1,1800,1801,0.06
16470,October,2022,Whatcom,WA,Passenger,1993,786,2779,148767,151546,1.83
16471,October,2022,Arapahoe,CO,Passenger,0,1,1,72,73,1.37
16472,October,2022,Alameda,CA,Passenger,4,0,4,165,169,2.37
16473,October,2022,Leavenworth,KS,Passenger,0,1,1,93,94,1.06
16474,October,2022,El Paso,TX,Passenger,2,0,2,296,298,0.67
16475,October,2022,Honolulu,HI,Passenger,3,3,6,294,300,2.0
16476,October,2022,Harnett,NC,Passenger,2,0,2,134,136,1.47
16477,October,2022,San Diego,CA,Passenger,17,10,27,2100,2127,1.27
16478,October,2022,Cowlitz,WA,Truck,4,0,4,28459,28463,0.01
16479,October,2022,Franklin,WA,Truck,2,0,2,20887,20889,0.01
16480,October,2022,Williamson,TX,Passenger,0,2,2,66,68,2.94
16481,October,2022,Carroll,MD,Passenger,0,1,1,17,18,5.56
16482,October,2022,Rock Island,IL,Passenger,0,1,1,15,16,6.25
16483,October,2022,Owyhee,ID,Passenger,1,0,1,3,4,25.0
16484,October,2022,Platte,MO,Passenger,1,0,1,19,20,5.0
16485,October,2022,Richmond,GA,Passenger,0,1,1,57,58,1.72
16486,October,2022,Yellowstone,MT,Passenger,0,1,1,18,19,5.26
16487,October,2022,Okanogan,WA,Truck,1,0,1,16478,16479,0.01
16488,October,2022,Lewis,WA,Passenger,261,179,440,59898,60338,0.73
16489,October,2022,Gwinnett,GA,Passenger,1,0,1,47,48,2.08
16490,October,2022,King,WA,Passenger,45341,11925,57266,1343327,1400593,4.09
16491,October,2022,Sevier,AR,Passenger,0,1,1,0,1,100.0
16492,October,2022,Wood,OH,Passenger,0,1,1,3,4,25.0
16493,October,2022,Onslow,NC,Passenger,0,1,1,153,154,0.65
16494,October,2022,St. Clair,IL,Passenger,2,0,2,115,117,1.71
16495,October,2022,Benton,WA,Passenger,867,485,1352,135773,137125,0.99
16496,October,2022,Grant,WA,Passenger,210,108,318,66743,67061,0.47
16497,October,2022,Asotin,WA,Passenger,26,19,45,12566,12611,0.36
16498,October,2022,Clallam,WA,Passenger,456,256,712,49453,50165,1.42
16499,October,2022,Pierce,WA,Truck,62,0,62,140244,140306,0.04
16500,October,2022,Frederick,MD,Passenger,1,0,1,57,58,1.72
16501,October,2022,Bartow,GA,Passenger,0,1,1,3,4,25.0
16502,October,2022,Plaquemines,LA,Passenger,1,1,2,16,18,11.11
16503,October,2022,St. Tammany,LA,Passenger,1,0,1,33,34,2.94
16504,October,2022,Hillsborough,FL,Passenger,0,1,1,112,113,0.88
16505,October,2022,Napa,CA,Passenger,0,1,1,10,11,9.09
16506,October,2022,Richmond,NY,Passenger,1,0,1,6,7,14.29
16507,October,2022,San Bernardino,CA,Passenger,1,1,2,291,293,0.68
16508,October,2022,Kauai,HI,Passenger,1,0,1,14,15,6.67
16509,October,2022,Kitsap,WA,Passenger,2634,1125,3759,177642,181401,2.07
16510,October,2022,Yakima,WA,Truck,5,0,5,61277,61282,0.01
16511,October,2022,Spokane,WA,Passenger,1837,910,2747,324785,327532,0.84
16512,October,2022,Nassau,NY,Passenger,1,0,1,21,22,4.55
16513,October,2022,Lee,FL,Passenger,1,0,1,24,25,4.0
16514,October,2022,Los Angeles,CA,Passenger,6,6,12,685,697,1.72
16515,October,2022,Saratoga,NY,Passenger,1,0,1,37,38,2.63
16516,October,2022,Cook,IL,Passenger,2,0,2,162,164,1.22
16517,October,2022,Maricopa,AZ,Passenger,7,2,9,739,748,1.2
16518,October,2022,Penobscot,ME,Passenger,0,1,1,8,9,11.11
16519,October,2022,Camden,NJ,Passenger,0,1,1,12,13,7.69
16520,October,2022,Polk,OR,Passenger,0,1,1,19,20,5.0
16521,October,2022,Anne Arundel,MD,Passenger,4,4,8,304,312,2.56
16522,October,2022,Montgomery,MD,Passenger,4,2,6,177,183,3.28
16523,October,2022,Hennepin,MN,Passenger,1,0,1,41,42,2.38
16524,October,2022,Williams,ND,Passenger,0,1,1,5,6,16.67
16525,October,2022,Skagit,WA,Passenger,886,349,1235,89523,90758,1.36
16526,October,2022,Bryan,GA,Passenger,0,1,1,37,38,2.63
16527,October,2022,Hawaii,HI,Passenger,1,0,1,29,30,3.33
16528,October,2022,Duval,FL,Passenger,1,2,3,246,249,1.2
16529,October,2022,Lincoln,WA,Passenger,12,17,29,7735,7764,0.37
16530,October,2022,Nueces,TX,Passenger,0,1,1,49,50,2.0
16531,October,2022,Harris,TX,Passenger,1,0,1,126,127,0.79
16532,October,2022,Skamania,WA,Truck,0,0,0,3897,3897,0.0
16533,October,2022,Broward,FL,Passenger,1,0,1,65,66,1.52
16534,October,2022,Boulder,CO,Passenger,1,0,1,31,32,3.12
16535,October,2022,Sarasota,FL,Passenger,1,0,1,17,18,5.56
16536,October,2022,Benton,WA,Truck,7,0,7,43350,43357,0.02
16537,October,2022,Mason,WA,Truck,6,0,6,20938,20944,0.03
16538,October,2022,Ferry,WA,Truck,0,0,0,3593,3593,0.0
16539,October,2022,Las Animas,CO,Passenger,1,0,1,1,2,50.0
16540,October,2022,Allen,IN,Passenger,1,0,1,12,13,7.69
16541,October,2022,Lincoln,OR,Passenger,0,1,1,19,20,5.0
16542,October,2022,Randolph,NC,Passenger,1,0,1,5,6,16.67
16543,October,2022,Jefferson,NY,Passenger,0,1,1,193,194,0.52
16544,October,2022,Suffolk,VA,Passenger,1,0,1,114,115,0.87
16545,October,2022,St. Mary's,MD,Passenger,1,0,1,171,172,0.58
16546,October,2022,Berkeley,SC,Passenger,0,1,1,111,112,0.89
16547,October,2022,Lake,IL,Passenger,1,0,1,119,120,0.83
16548,October,2022,Island,WA,Passenger,901,389,1290,61684,62974,2.05
16549,October,2022,Cape May,NJ,Passenger,0,1,1,7,8,12.5
16550,October,2022,Houston,GA,Passenger,1,0,1,27,28,3.57
16551,October,2022,Ulster,NY,Passenger,1,0,1,5,6,16.67
16552,October,2022,Douglas,WA,Truck,2,0,2,12811,12813,0.02
16553,October,2022,Kootenai,ID,Truck,1,0,1,30,31,3.23
16554,October,2022,Sarpy,NE,Passenger,1,0,1,49,50,2.0
16555,October,2022,New London,CT,Passenger,2,4,6,185,191,3.14
16556,October,2022,Howard,MD,Passenger,0,1,1,49,50,2.0
16557,October,2022,Wahkiakum,WA,Passenger,24,12,36,3064,3100,1.16
16558,October,2022,Thurston,WA,Passenger,2467,1109,3576,192794,196370,1.82
16559,October,2022,Douglas,CO,Passenger,0,1,1,61,62,1.61
16560,October,2022,Grays Harbor,WA,Passenger,231,166,397,48742,49139,0.81
16561,October,2022,Dorchester,SC,Passenger,1,0,1,45,46,2.17
16562,October,2022,Island,WA,Truck,14,0,14,21277,21291,0.07
16563,October,2022,Marin,CA,Passenger,0,1,1,28,29,3.45
16564,October,2022,Okanogan,WA,Passenger,95,49,144,26284,26428,0.54
16565,October,2022,Pacific,WA,Passenger,68,74,142,15756,15898,0.89
16566,October,2022,Pacific,WA,Truck,1,0,1,7875,7876,0.01
16567,October,2022,Adams,WA,Truck,1,0,1,5429,5430,0.02
16568,October,2022,Columbia,WA,Truck,0,0,0,1583,1583,0.0
16569,October,2022,Cumberland,NC,Passenger,1,2,3,326,329,0.91
16570,October,2022,Orange,CA,Passenger,5,2,7,308,315,2.22
16571,October,2022,Burlington,NJ,Passenger,0,2,2,96,98,2.04
16572,October,2022,Lake,FL,Passenger,1,0,1,16,17,5.88
16573,October,2022,Cowlitz,WA,Passenger,381,184,565,70323,70888,0.8
16574,October,2022,Stevens,WA,Truck,2,0,2,18903,18905,0.01
16575,October,2022,Dallas,TX,Passenger,1,0,1,91,92,1.09
16576,October,2022,Adams,WA,Passenger,22,12,34,13045,13079,0.26
16577,October,2022,San Joaquin,CA,Passenger,1,0,1,76,77,1.3
16578,October,2022,Sacramento,CA,Passenger,3,0,3,177,180,1.67
16579,October,2022,Pennington,SD,Passenger,2,0,2,24,26,7.69
16580,October,2022,Fort Bend,TX,Passenger,1,0,1,22,23,4.35
16581,October,2022,Ventura,CA,Passenger,2,1,3,213,216,1.39
16582,October,2022,Douglas,NE,Passenger,2,2,4,31,35,11.43
16583,October,2022,Snohomish,WA,Truck,76,0,76,122941,123017,0.06
16584,October,2022,King,WA,Truck,300,2,302,179312,179614,0.17
16585,October,2022,Multnomah,OR,Passenger,0,3,3,469,472,0.64
16586,October,2022,Klickitat,WA,Passenger,114,51,165,15116,15281,1.08
16587,October,2022,Skamania,WA,Passenger,85,51,136,8110,8246,1.65
16588,October,2022,Beaufort,SC,Passenger,1,0,1,21,22,4.55
16589,October,2022,Klickitat,WA,Truck,3,0,3,8250,8253,0.04
16590,October,2022,Charleston,SC,Passenger,2,2,4,53,57,7.02
16591,October,2022,Clallam,WA,Truck,7,0,7,21890,21897,0.03
16592,October,2022,Riverside,CA,Passenger,7,0,7,417,424,1.65
16593,October,2022,Kitsap,WA,Truck,25,0,25,53166,53191,0.05
16594,October,2022,Clackamas,OR,Passenger,1,0,1,121,122,0.82
16595,October,2022,St. Louis,MO,Passenger,1,0,1,55,56,1.79
16596,October,2022,Arlington,VA,Passenger,1,0,1,107,108,0.93
16597,October,2022,Okaloosa,FL,Passenger,0,1,1,92,93,1.08
16598,September,2017,Santa Fe,NM,Passenger,0,1,1,42,43,2.33
16599,September,2017,Kittitas,WA,Passenger,33,21,54,27988,28042,0.19
16600,September,2017,Ferry,WA,Truck,0,0,0,3538,3538,0.0
16601,September,2017,Pierce,WA,Passenger,1012,898,1910,525165,527075,0.36
16602,September,2017,Prince William,VA,Passenger,0,3,3,268,271,1.11
16603,September,2017,Norfolk,MA,Passenger,1,0,1,38,39,2.56
16604,September,2017,Madison,ID,Passenger,1,0,1,37,38,2.63
16605,September,2017,Arlington,VA,Passenger,1,2,3,163,166,1.81
16606,September,2017,Virginia Beach,VA,Passenger,2,1,3,656,659,0.46
16607,September,2017,Grant,WA,Passenger,20,33,53,61457,61510,0.09
16608,September,2017,Adams,WA,Passenger,3,3,6,12263,12269,0.05
16609,September,2017,Sangamon,IL,Passenger,1,0,1,11,12,8.33
16610,September,2017,King,WA,Truck,7,1,8,186365,186373,0.0
16611,September,2017,Travis,TX,Passenger,0,1,1,190,191,0.52
16612,September,2017,Pend Oreille,WA,Passenger,3,4,7,9371,9378,0.07
16613,September,2017,Lane,OR,Passenger,0,1,1,218,219,0.46
16614,September,2017,Wahkiakum,WA,Truck,0,0,0,1667,1667,0.0
16615,September,2017,El Paso,CO,Passenger,2,0,2,774,776,0.26
16616,September,2017,Whitman,WA,Passenger,12,22,34,22193,22227,0.15
16617,September,2017,Frederick,MD,Passenger,0,1,1,83,84,1.19
16618,September,2017,Riverside,CA,Passenger,1,2,3,751,754,0.4
16619,September,2017,Okanogan,WA,Passenger,5,18,23,25690,25713,0.09
16620,September,2017,Sedgwick,KS,Passenger,0,1,1,102,103,0.97
16621,September,2017,Los Angeles,CA,Passenger,5,2,7,1234,1241,0.56
16622,September,2017,Lincoln,WA,Truck,0,0,0,4472,4472,0.0
16623,September,2017,Spokane,WA,Truck,1,0,1,91172,91173,0.0
16624,September,2017,Kent,MI,Passenger,0,1,1,36,37,2.7
16625,September,2017,Lewis,WA,Passenger,53,38,91,56022,56113,0.16
16626,September,2017,Portsmouth,VA,Passenger,0,1,1,66,67,1.49
16627,September,2017,Whitman,WA,Truck,0,0,0,8428,8428,0.0
16628,September,2017,Wayne,MI,Passenger,0,1,1,67,68,1.47
16629,September,2017,Wahkiakum,WA,Passenger,0,2,2,2836,2838,0.07
16630,September,2017,Montgomery,TX,Passenger,1,0,1,61,62,1.61
16631,September,2017,Stevens,WA,Passenger,8,22,30,31547,31577,0.1
16632,September,2017,Canyon,ID,Passenger,0,1,1,92,93,1.08
16633,September,2017,Duval,FL,Passenger,1,1,2,367,369,0.54
16634,September,2017,Walla Walla,WA,Passenger,27,28,55,35036,35091,0.16
16635,September,2017,Benton,WA,Passenger,163,150,313,129262,129575,0.24
16636,September,2017,Anne Arundel,MD,Passenger,0,1,1,494,495,0.2
16637,September,2017,Manatee,FL,Passenger,1,0,1,42,43,2.33
16638,September,2017,Howard,MD,Passenger,0,2,2,88,90,2.22
16639,September,2017,Pacific,WA,Passenger,12,9,21,15262,15283,0.14
16640,September,2017,Nassau,NY,Passenger,1,1,2,39,41,4.88
16641,September,2017,Skagit,WA,Passenger,148,120,268,88642,88910,0.3
16642,September,2017,Lee,AL,Passenger,1,0,1,34,35,2.86
16643,September,2017,Kitsap,WA,Truck,1,0,1,52599,52600,0.0
16644,September,2017,Cowlitz,WA,Passenger,52,64,116,70272,70388,0.16
16645,September,2017,Okaloosa,FL,Passenger,1,0,1,186,187,0.53
16646,September,2017,Sacramento,CA,Passenger,1,0,1,334,335,0.3
16647,September,2017,DeKalb,GA,Passenger,1,0,1,84,85,1.18
16648,September,2017,Columbia,WA,Passenger,1,1,2,2378,2380,0.08
16649,September,2017,Okanogan,WA,Truck,0,0,0,16235,16235,0.0
16650,September,2017,Norfolk,VA,Passenger,1,1,2,312,314,0.64
16651,September,2017,Klickitat,WA,Passenger,22,26,48,14774,14822,0.32
16652,September,2017,Garfield,WA,Passenger,1,0,1,1295,1296,0.08
16653,September,2017,Gwinnett,GA,Passenger,0,1,1,84,85,1.18
16654,September,2017,Hamilton,IN,Passenger,1,0,1,58,59,1.69
16655,September,2017,Grays Harbor,WA,Truck,0,0,0,19976,19976,0.0
16656,September,2017,Juneau,AK,Passenger,0,1,1,45,46,2.17
16657,September,2017,Polk,FL,Passenger,1,0,1,62,63,1.59
16658,September,2017,Prince George's,MD,Passenger,0,1,1,182,183,0.55
16659,September,2017,San Mateo,CA,Passenger,0,1,1,147,148,0.68
16660,September,2017,Pacific,WA,Truck,0,0,0,7514,7514,0.0
16661,September,2017,Charles,MD,Passenger,0,1,1,84,85,1.18
16662,September,2017,Maricopa,AZ,Passenger,2,0,2,1647,1649,0.12
16663,September,2017,Skamania,WA,Passenger,10,7,17,8572,8589,0.2
16664,September,2017,Morris,NJ,Passenger,1,0,1,22,23,4.35
16665,September,2017,Clay,FL,Passenger,0,1,1,113,114,0.88
16666,September,2017,Cobb,GA,Passenger,0,1,1,68,69,1.45
16667,September,2017,Multnomah,OR,Passenger,1,3,4,924,928,0.43
16668,September,2017,Flathead,MT,Passenger,1,0,1,56,57,1.75
16669,September,2017,Kitsap,WA,Passenger,653,346,999,174309,175308,0.57
16670,September,2017,Clark,WA,Passenger,810,542,1352,301404,302756,0.45
16671,September,2017,Lincoln,WA,Passenger,2,6,8,7563,7571,0.11
16672,September,2017,Island,WA,Passenger,129,149,278,60853,61131,0.45
16673,September,2017,Honolulu,HI,Passenger,2,2,4,561,565,0.71
16674,September,2017,Nueces,TX,Passenger,0,1,1,93,94,1.06
16675,September,2017,Tuolumne,CA,Passenger,0,1,1,15,16,6.25
16676,September,2017,Deschutes,OR,Passenger,1,0,1,193,194,0.52
16677,September,2017,District of Columbia,DC,Passenger,0,2,2,204,206,0.97
16678,September,2017,Contra Costa,CA,Passenger,0,1,1,506,507,0.2
16679,September,2017,Clallam,WA,Passenger,95,83,178,48609,48787,0.36
16680,September,2017,Richland,SC,Passenger,0,1,1,185,186,0.54
16681,September,2017,Jefferson,WA,Passenger,114,65,179,24008,24187,0.74
16682,September,2017,Chelan,WA,Truck,0,0,0,21414,21414,0.0
16683,September,2017,Moore,NC,Passenger,0,1,1,202,203,0.49
16684,September,2017,Snohomish,WA,Passenger,1911,975,2886,514376,517262,0.56
16685,September,2017,Walla Walla,WA,Truck,0,0,0,13243,13243,0.0
16686,September,2017,Pend Oreille,WA,Truck,0,0,0,5552,5552,0.0
16687,September,2017,Orleans,LA,Passenger,0,1,1,45,46,2.17
16688,September,2017,Franklin,MA,Passenger,0,1,1,4,5,20.0
16689,September,2017,Hawaii,HI,Passenger,1,0,1,77,78,1.28
16690,September,2017,Bexar,TX,Passenger,1,1,2,837,839,0.24
16691,September,2017,Cape May,NJ,Passenger,0,1,1,19,20,5.0
16692,September,2017,Albemarle,VA,Passenger,0,1,1,32,33,3.03
16693,September,2017,San Juan,WA,Passenger,117,42,159,13676,13835,1.15
16694,September,2017,Yakima,WA,Passenger,57,69,126,160618,160744,0.08
16695,September,2017,New London,CT,Passenger,1,1,2,250,252,0.79
16696,September,2017,Columbia,WA,Truck,0,0,0,1557,1557,0.0
16697,September,2017,Mason,WA,Truck,0,0,0,19379,19379,0.0
16698,September,2017,Hamilton,TN,Passenger,1,0,1,21,22,4.55
16699,September,2017,Jefferson,WA,Truck,0,0,0,9419,9419,0.0
16700,September,2017,Richmond,GA,Passenger,0,1,1,90,91,1.1
16701,September,2017,Clark,WA,Truck,0,0,0,77868,77868,0.0
16702,September,2017,Asotin,WA,Passenger,7,5,12,12463,12475,0.1
16703,September,2017,Maui,HI,Passenger,1,0,1,70,71,1.41
16704,September,2017,San Diego,CA,Passenger,6,1,7,2641,2648,0.26
16705,September,2017,Whatcom,WA,Passenger,496,190,686,143859,144545,0.47
16706,September,2017,Fulton,GA,Passenger,1,0,1,110,111,0.9
16707,September,2017,St. Lucie,FL,Passenger,1,0,1,27,28,3.57
16708,September,2017,Thurston,WA,Passenger,435,363,798,188247,189045,0.42
16709,September,2017,Yakima,WA,Truck,0,0,0,57707,57707,0.0
16710,September,2017,Island,WA,Truck,0,0,0,20564,20564,0.0
16711,September,2017,Benton,WA,Truck,0,0,0,40273,40273,0.0
16712,September,2017,Santa Clara,CA,Passenger,5,2,7,388,395,1.77
16713,September,2017,Snohomish,WA,Truck,1,0,1,121526,121527,0.0
16714,September,2017,Chelan,WA,Passenger,75,37,112,52503,52615,0.21
16715,September,2017,St. Clair,IL,Passenger,0,1,1,165,166,0.6
16716,September,2017,Manassas,VA,Passenger,0,1,1,9,10,10.0
16717,September,2017,Sumter,FL,Passenger,0,1,1,10,11,9.09
16718,September,2017,Shelby,TN,Passenger,0,1,1,106,107,0.93
16719,September,2017,Dale,AL,Passenger,0,1,1,63,64,1.56
16720,September,2017,Missoula,MT,Passenger,1,0,1,70,71,1.41
16721,September,2017,Saratoga,NY,Passenger,1,1,2,72,74,2.7
16722,September,2017,Franklin,OH,Passenger,0,1,1,112,113,0.88
16723,September,2017,Mason,WA,Passenger,61,73,134,44172,44306,0.3
16724,September,2017,Lewis,WA,Truck,0,0,0,25113,25113,0.0
16725,September,2017,Douglas,WA,Truck,0,0,0,11592,11592,0.0
16726,September,2017,Douglas,WA,Passenger,35,29,64,26927,26991,0.24
16727,September,2017,King,WA,Passenger,10654,4350,15004,1372562,1387566,1.08
16728,September,2017,Monterey,CA,Passenger,0,2,2,195,197,1.02
16729,September,2017,Volusia,FL,Passenger,0,1,1,43,44,2.27
16730,September,2017,Grant,WA,Truck,0,0,0,25425,25425,0.0
16731,September,2017,Allegheny,PA,Passenger,1,0,1,87,88,1.14
16732,September,2017,Fairfax,VA,Passenger,2,2,4,845,849,0.47
16733,September,2017,Clallam,WA,Truck,0,0,0,21085,21085,0.0
16734,September,2017,Franklin,WA,Passenger,29,48,77,56181,56258,0.14
16735,September,2017,Skagit,WA,Truck,1,0,1,31550,31551,0.0
16736,September,2017,San Juan,WA,Truck,0,0,0,5559,5559,0.0
16737,September,2017,Palm Beach,FL,Passenger,0,1,1,96,97,1.03
16738,September,2017,Skamania,WA,Truck,0,0,0,3878,3878,0.0
16739,September,2017,Twin Falls,ID,Passenger,0,1,1,22,23,4.35
16740,September,2017,Marin,CA,Passenger,1,0,1,59,60,1.67
16741,September,2017,Santa Rosa,FL,Passenger,1,0,1,109,110,0.91
16742,September,2017,Franklin,WA,Truck,0,0,0,18248,18248,0.0
16743,September,2017,Whatcom,WA,Truck,2,0,2,41837,41839,0.0
16744,September,2017,Northampton,PA,Passenger,0,1,1,83,84,1.19
16745,September,2017,Klickitat,WA,Truck,0,0,0,7988,7988,0.0
16746,September,2017,Grays Harbor,WA,Passenger,38,38,76,45132,45208,0.17
16747,September,2017,Montgomery,PA,Passenger,1,0,1,37,38,2.63
16748,September,2017,Latah,ID,Passenger,0,1,1,91,92,1.09
16749,September,2017,Carroll,NH,Passenger,0,1,1,1,2,50.0
16750,September,2017,Ferry,WA,Passenger,1,1,2,4380,4382,0.05
16751,September,2017,Kittitas,WA,Truck,0,0,0,13657,13657,0.0
16752,September,2017,New Haven,CT,Passenger,0,1,1,54,55,1.82
16753,September,2017,DeKalb,IN,Passenger,1,0,1,1,2,50.0
16754,September,2017,Alameda,CA,Passenger,0,1,1,351,352,0.28
16755,September,2017,Tulare,CA,Passenger,1,0,1,197,198,0.51
16756,September,2017,Tarrant,TX,Passenger,1,0,1,235,236,0.42
16757,September,2017,El Paso,TX,Passenger,1,0,1,545,546,0.18
16758,September,2017,Ramsey,MN,Passenger,1,0,1,40,41,2.44
16759,September,2017,Orange,FL,Passenger,1,1,2,144,146,1.37
16760,September,2017,Adams,WA,Truck,0,0,0,5123,5123,0.0
16761,September,2017,Pinal,AZ,Passenger,2,0,2,226,228,0.88
16762,September,2017,Dallas,TX,Passenger,0,1,1,179,180,0.56
16763,September,2017,Utah,UT,Passenger,0,1,1,145,146,0.68
16764,September,2017,Essex,NJ,Passenger,1,0,1,13,14,7.14
16765,September,2017,Thurston,WA,Truck,0,0,0,53500,53500,0.0
16766,September,2017,Garfield,WA,Truck,0,0,0,940,940,0.0
16767,September,2017,Montgomery,TN,Passenger,1,0,1,276,277,0.36
16768,September,2017,Hardin,KY,Passenger,0,1,1,116,117,0.85
16769,September,2017,Jefferson,NY,Passenger,1,0,1,242,243,0.41
16770,September,2017,Pierce,WA,Truck,0,0,0,137078,137078,0.0
16772,September,2017,Nantucket,MA,Passenger,1,0,1,3,4,25.0
16773,September,2017,Pima,AZ,Passenger,1,1,2,418,420,0.48
16774,September,2017,Spokane,WA,Passenger,276,229,505,298150,298655,0.17
16775,September,2017,Clark,NV,Passenger,1,2,3,774,777,0.39
16776,September,2017,Lumpkin,GA,Passenger,1,0,1,9,10,10.0
16777,September,2017,Cowlitz,WA,Truck,0,0,0,28041,28041,0.0
16778,September,2017,Asotin,WA,Truck,0,0,0,6507,6507,0.0
16779,September,2017,Montgomery,MD,Passenger,1,0,1,305,306,0.33
16780,September,2017,Orange,CA,Passenger,3,1,4,607,611,0.65
16781,September,2017,Stevens,WA,Truck,0,0,0,18251,18251,0.0
16782,September,2017,Dakota,MN,Passenger,0,2,2,36,38,5.26
16783,September,2018,Volusia,FL,Passenger,0,1,1,38,39,2.56
16784,September,2018,Cowlitz,WA,Passenger,63,85,148,72024,72172,0.21
16785,September,2018,Cumberland,NC,Passenger,0,1,1,526,527,0.19
16786,September,2018,Walla Walla,WA,Truck,0,0,0,13492,13492,0.0
16787,September,2018,Skagit,WA,Passenger,222,176,398,90860,91258,0.44
16788,September,2018,Collin,TX,Passenger,1,1,2,152,154,1.3
16789,September,2018,Nantucket,MA,Passenger,1,0,1,4,5,20.0
16790,September,2018,Maui,HI,Passenger,1,0,1,56,57,1.75
16791,September,2018,El Paso,CO,Passenger,3,1,4,761,765,0.52
16792,September,2018,Klickitat,WA,Passenger,24,32,56,15362,15418,0.36
16793,September,2018,Brevard,FL,Passenger,0,1,1,92,93,1.08
16794,September,2018,Palm Beach,FL,Passenger,0,1,1,88,89,1.12
16795,September,2018,Ferry,WA,Truck,0,0,0,3559,3559,0.0
16796,September,2018,Kootenai,ID,Passenger,0,1,1,216,217,0.46
16797,September,2018,Whatcom,WA,Truck,2,0,2,42433,42435,0.0
16798,September,2018,Carson City,NV,Passenger,1,0,1,14,15,6.67
16799,September,2018,Chelan,WA,Passenger,117,59,176,53803,53979,0.33
16800,September,2018,Snohomish,WA,Passenger,2516,1329,3845,524563,528408,0.73
16801,September,2018,Guadalupe,TX,Passenger,1,0,1,83,84,1.19
16802,September,2018,Shelby,TN,Passenger,0,1,1,102,103,0.97
16803,September,2018,DuPage,IL,Passenger,1,0,1,56,57,1.75
16804,September,2018,Bexar,TX,Passenger,3,4,7,732,739,0.95
16805,September,2018,Williamson,TX,Passenger,0,1,1,160,161,0.62
16806,September,2018,Franklin,MA,Passenger,0,1,1,1,2,50.0
16807,September,2018,Wahkiakum,WA,Passenger,1,1,2,2980,2982,0.07
16808,September,2018,St. Lucie,FL,Passenger,1,0,1,30,31,3.23
16809,September,2018,Juneau,AK,Passenger,0,1,1,43,44,2.27
16810,September,2018,Mecklenburg,NC,Passenger,1,0,1,82,83,1.2
16811,September,2018,Skamania,WA,Truck,0,0,0,3967,3967,0.0
16812,September,2018,Pacific,WA,Passenger,18,22,40,15733,15773,0.25
16813,September,2018,Wahkiakum,WA,Truck,0,0,0,1691,1691,0.0
16814,September,2018,Ada,ID,Passenger,0,2,2,315,317,0.63
16815,September,2018,Madison,ID,Passenger,1,0,1,38,39,2.56
16816,September,2018,Latah,ID,Passenger,0,1,1,72,73,1.37
16817,September,2018,Stevens,WA,Truck,0,0,0,18680,18680,0.0
16818,September,2018,Frederick,MD,Passenger,0,1,1,87,88,1.14
16819,September,2018,St. Clair,IL,Passenger,0,1,1,158,159,0.63
16820,September,2018,Duval,FL,Passenger,1,2,3,383,386,0.78
16821,September,2018,New Haven,CT,Passenger,0,1,1,48,49,2.04
16822,September,2018,Virginia Beach,VA,Passenger,2,1,3,697,700,0.43
16823,September,2018,King,WA,Truck,7,1,8,182870,182878,0.0
16824,September,2018,Jefferson,WA,Passenger,153,99,252,24693,24945,1.01
16825,September,2018,Walla Walla,WA,Passenger,36,50,86,35925,36011,0.24
16826,September,2018,Kent,MI,Passenger,0,1,1,27,28,3.57
16827,September,2018,Jefferson,WA,Truck,0,0,0,9644,9644,0.0
16828,September,2018,St. Mary's,MD,Passenger,1,0,1,217,218,0.46
16829,September,2018,Washoe,NV,Passenger,1,0,1,111,112,0.89
16830,September,2018,Montgomery,MD,Passenger,1,0,1,283,284,0.35
16831,September,2018,Adams,WA,Truck,0,0,0,5158,5158,0.0
16832,September,2018,Jefferson,NY,Passenger,0,1,1,225,226,0.44
16833,September,2018,Houston,GA,Passenger,1,0,1,54,55,1.82
16834,September,2018,Mason,WA,Passenger,94,100,194,46187,46381,0.42
16835,September,2018,Kittitas,WA,Truck,0,0,0,14105,14105,0.0
16836,September,2018,Klamath,OR,Passenger,1,0,1,35,36,2.78
16837,September,2018,Montgomery,PA,Passenger,2,0,2,36,38,5.26
16838,September,2018,Norfolk,MA,Passenger,1,0,1,37,38,2.63
16839,September,2018,Washington,OR,Passenger,0,1,1,469,470,0.21
16840,September,2018,Gwinnett,GA,Passenger,0,1,1,84,85,1.18
16841,September,2018,Manatee,FL,Passenger,1,0,1,37,38,2.63
16842,September,2018,Carroll,NH,Passenger,0,1,1,1,2,50.0
16843,September,2018,Grant,WA,Truck,0,0,0,26068,26068,0.0
16844,September,2018,Clark,WA,Passenger,1089,784,1873,309720,311593,0.6
16845,September,2018,Hawaii,HI,Passenger,1,0,1,70,71,1.41
16846,September,2018,Hardin,KY,Passenger,0,1,1,121,122,0.82
16847,September,2018,DeKalb,IN,Passenger,1,0,1,1,2,50.0
16848,September,2018,Anne Arundel,MD,Passenger,0,1,1,450,451,0.22
16849,September,2018,Arlington,VA,Passenger,1,1,2,170,172,1.16
16850,September,2018,Columbia,WA,Passenger,2,2,4,2429,2433,0.16
16851,September,2018,Marion,IN,Passenger,1,0,1,118,119,0.84
16852,September,2018,Los Angeles,CA,Passenger,7,5,12,1130,1142,1.05
16853,September,2018,Nassau,NY,Passenger,2,0,2,37,39,5.13
16854,September,2018,Richland,SC,Passenger,0,1,1,167,168,0.6
16855,September,2018,Lewis,WA,Truck,0,0,0,25568,25568,0.0
16856,September,2018,Tarrant,TX,Passenger,1,0,1,210,211,0.47
16857,September,2018,Clark,WA,Truck,0,0,0,79366,79366,0.0
16858,September,2018,San Juan,PR,Passenger,0,1,1,4,5,20.0
16859,September,2018,Clallam,WA,Passenger,129,122,251,50164,50415,0.5
16860,September,2018,Benton,WA,Passenger,188,209,397,132434,132831,0.3
16861,September,2018,Orange,CA,Passenger,4,1,5,549,554,0.9
16862,September,2018,Okanogan,WA,Truck,0,0,0,16497,16497,0.0
16863,September,2018,New London,CT,Passenger,0,1,1,253,254,0.39
16864,September,2018,Grays Harbor,WA,Passenger,55,65,120,47163,47283,0.25
16865,September,2018,Santa Fe,NM,Passenger,0,1,1,44,45,2.22
16866,September,2018,Tuolumne,CA,Passenger,0,1,1,12,13,7.69
16867,September,2018,Yakima,WA,Passenger,67,93,160,164243,164403,0.1
16868,September,2018,Sangamon,IL,Passenger,1,0,1,11,12,8.33
16869,September,2018,Multnomah,OR,Passenger,3,4,7,775,782,0.9
16870,September,2018,Charles,MD,Passenger,0,1,1,82,83,1.2
16871,September,2018,Santa Clara,CA,Passenger,8,0,8,373,381,2.1
16872,September,2018,Island,WA,Truck,0,0,0,21101,21101,0.0
16873,September,2018,Middlesex,MA,Passenger,0,1,1,139,140,0.71
16874,September,2018,San Diego,CA,Passenger,7,2,9,2558,2567,0.35
16875,September,2018,Caddo,LA,Passenger,0,1,1,23,24,4.17
16876,September,2018,Camden,NJ,Passenger,0,1,1,27,28,3.57
16877,September,2018,Skamania,WA,Passenger,15,11,26,8710,8736,0.3
16878,September,2018,Columbia,WA,Truck,0,0,0,1521,1521,0.0
16879,September,2018,Monroe,IL,Passenger,1,0,1,5,6,16.67
16880,September,2018,Lee,AL,Passenger,1,0,1,37,38,2.63
16881,September,2018,Flathead,MT,Passenger,1,0,1,51,52,1.92
16882,September,2018,Monterey,CA,Passenger,0,1,1,189,190,0.53
16883,September,2018,Whitman,WA,Passenger,20,32,52,22690,22742,0.23
16884,September,2018,Klickitat,WA,Truck,0,0,0,8137,8137,0.0
16885,September,2018,Pierce,WA,Passenger,1325,1267,2592,535571,538163,0.48
16886,September,2018,Grant,WA,Passenger,33,50,83,63766,63849,0.13
16887,September,2018,Sumter,FL,Passenger,0,1,1,10,11,9.09
16888,September,2018,Cochise,AZ,Passenger,0,1,1,120,121,0.83
16889,September,2018,Douglas,NE,Passenger,0,1,1,68,69,1.45
16890,September,2018,Fairfax,VA,Passenger,2,2,4,809,813,0.49
16891,September,2018,Hamilton,IN,Passenger,1,0,1,47,48,2.08
16892,September,2018,Oldham,KY,Passenger,0,1,1,5,6,16.67
16893,September,2018,Snohomish,WA,Truck,1,0,1,121775,121776,0.0
16894,September,2018,Norfolk,VA,Passenger,2,2,4,331,335,1.19
16895,September,2018,Kitsap,WA,Passenger,841,499,1340,179462,180802,0.74
16896,September,2018,Whatcom,WA,Passenger,666,335,1001,148503,149504,0.67
16897,September,2018,Dallas,TX,Passenger,0,1,1,196,197,0.51
16898,September,2018,Clallam,WA,Truck,0,0,0,21492,21492,0.0
16899,September,2018,King,WA,Passenger,14203,6079,20282,1373990,1394272,1.45
16900,September,2018,Clackamas,OR,Passenger,0,1,1,217,218,0.46
16901,September,2018,Lincoln,WA,Truck,0,0,0,4580,4580,0.0
16902,September,2018,Allegheny,PA,Passenger,1,0,1,80,81,1.23
16903,September,2018,Kitsap,WA,Truck,1,0,1,53537,53538,0.0
16904,September,2018,Benton,WA,Truck,0,0,0,41347,41347,0.0
16905,September,2018,Pend Oreille,WA,Passenger,5,5,10,9589,9599,0.1
16906,September,2018,Montgomery,TX,Passenger,2,0,2,61,63,3.17
16907,September,2018,Maricopa,AZ,Passenger,2,1,3,1561,1564,0.19
16908,September,2018,Island,WA,Passenger,227,208,435,62869,63304,0.69
16909,September,2018,Pinal,AZ,Passenger,2,0,2,201,203,0.99
16910,September,2018,District of Columbia,DC,Passenger,0,3,3,197,200,1.5
16911,September,2018,Ferry,WA,Passenger,2,2,4,4406,4410,0.09
16912,September,2018,Prince George,VA,Passenger,0,1,1,76,77,1.3
16913,September,2018,Contra Costa,CA,Passenger,0,2,2,423,425,0.47
16914,September,2018,Fulton,GA,Passenger,1,2,3,107,110,2.73
16915,September,2018,Morris,NJ,Passenger,1,0,1,17,18,5.56
16916,September,2018,Denver,CO,Passenger,1,0,1,134,135,0.74
16917,September,2018,Okanogan,WA,Passenger,10,20,30,26057,26087,0.11
16918,September,2018,Howard,MD,Passenger,0,1,1,87,88,1.14
16919,September,2018,Orange,FL,Passenger,2,1,3,165,168,1.79
16920,September,2018,Douglas,WA,Passenger,48,33,81,27849,27930,0.29
16921,September,2018,Alameda,CA,Passenger,0,2,2,333,335,0.6
16922,September,2018,Utah,UT,Passenger,0,1,1,138,139,0.72
16923,September,2018,Washtenaw,MI,Passenger,1,0,1,38,39,2.56
16924,September,2018,Clay,FL,Passenger,0,1,1,91,92,1.09
16925,September,2018,Beaufort,SC,Passenger,1,0,1,37,38,2.63
16926,September,2018,Cowlitz,WA,Truck,0,0,0,28600,28600,0.0
16927,September,2018,Saratoga,NY,Passenger,1,0,1,62,63,1.59
16928,September,2018,Twin Falls,ID,Passenger,0,1,1,21,22,4.55
16929,September,2018,Lewis,WA,Passenger,84,66,150,57934,58084,0.26
16930,September,2018,Dale,AL,Passenger,0,1,1,57,58,1.72
16931,September,2018,Prince George's,MD,Passenger,1,1,2,180,182,1.1
16932,September,2018,Garfield,WA,Passenger,1,1,2,1320,1322,0.15
16933,September,2018,Pima,AZ,Passenger,1,1,2,410,412,0.49
16934,September,2018,Lincoln,WA,Passenger,2,6,8,7748,7756,0.1
16935,September,2018,Stevens,WA,Passenger,13,27,40,31699,31739,0.13
16936,September,2018,Moore,NC,Passenger,0,1,1,196,197,0.51
16937,September,2018,Spokane,WA,Passenger,359,344,703,305145,305848,0.23
16938,September,2018,Grays Harbor,WA,Truck,0,0,0,20307,20307,0.0
16939,September,2018,Asotin,WA,Passenger,11,8,19,12678,12697,0.15
16940,September,2018,Ramsey,MN,Passenger,1,0,1,40,41,2.44
16941,September,2018,Deschutes,OR,Passenger,2,0,2,162,164,1.22
16942,September,2018,Polk,FL,Passenger,1,0,1,63,64,1.56
16944,September,2018,Thurston,WA,Truck,0,0,0,54640,54640,0.0
16945,September,2018,Douglas,WA,Truck,0,0,0,12012,12012,0.0
16946,September,2018,Jefferson,CO,Passenger,0,1,1,64,65,1.54
16947,September,2018,Honolulu,HI,Passenger,1,2,3,524,527,0.57
16948,September,2018,Cape May,NJ,Passenger,0,1,1,22,23,4.35
16949,September,2018,Garfield,OK,Passenger,1,0,1,15,16,6.25
16950,September,2018,Marion,OR,Passenger,1,0,1,122,123,0.81
16951,September,2018,Spokane,WA,Truck,1,0,1,93185,93186,0.0
16952,September,2018,Portsmouth,VA,Passenger,0,1,1,76,77,1.3
16953,September,2018,Whitman,WA,Truck,0,0,0,8517,8517,0.0
16954,September,2018,Thurston,WA,Passenger,621,527,1148,194606,195754,0.59
16955,September,2018,San Francisco,CA,Passenger,1,1,2,117,119,1.68
16956,September,2018,Ventura,CA,Passenger,0,2,2,311,313,0.64
16957,September,2018,Suffolk,MA,Passenger,0,1,1,43,44,2.27
16958,September,2018,Dakota,MN,Passenger,0,2,2,33,35,5.71
16959,September,2018,Richmond,GA,Passenger,0,1,1,92,93,1.08
16960,September,2018,Pacific,WA,Truck,0,0,0,7632,7632,0.0
16961,September,2018,Pend Oreille,WA,Truck,0,0,0,5744,5744,0.0
16962,September,2018,Lee,FL,Passenger,1,0,1,57,58,1.72
16963,September,2018,Yakima,WA,Truck,0,0,0,58690,58690,0.0
16964,September,2018,Prince William,VA,Passenger,0,4,4,260,264,1.52
16965,September,2018,Franklin,WA,Passenger,37,65,102,58512,58614,0.17
16966,September,2018,Cook,IL,Passenger,1,0,1,256,257,0.39
16967,September,2018,Riverside,CA,Passenger,2,2,4,688,692,0.58
16968,September,2018,Mason,WA,Truck,0,0,0,20090,20090,0.0
16969,September,2018,Broward,FL,Passenger,1,1,2,135,137,1.46
16970,September,2018,Sedgwick,KS,Passenger,0,1,1,97,98,1.02
16971,September,2018,San Juan,WA,Truck,0,0,0,5761,5761,0.0
16972,September,2018,Asotin,WA,Truck,0,0,0,6631,6631,0.0
16973,September,2018,Manassas,VA,Passenger,0,1,1,9,10,10.0
16974,September,2018,Lumpkin,GA,Passenger,1,0,1,7,8,12.5
16975,September,2018,Charleston,SC,Passenger,1,0,1,129,130,0.77
16976,September,2018,San Juan,WA,Passenger,161,68,229,14183,14412,1.59
16977,September,2018,Lane,OR,Passenger,0,1,1,177,178,0.56
16978,September,2018,Chelan,WA,Truck,0,0,0,22027,22027,0.0
16979,September,2018,DeKalb,GA,Passenger,1,0,1,78,79,1.27
16980,September,2018,Skagit,WA,Truck,1,0,1,32261,32262,0.0
16981,September,2018,Hennepin,MN,Passenger,1,0,1,110,111,0.9
16982,September,2018,Santa Rosa,FL,Passenger,1,0,1,89,90,1.11
16983,September,2018,Fresno,CA,Passenger,1,0,1,191,192,0.52
16984,September,2018,Garfield,WA,Truck,0,0,0,966,966,0.0
16985,September,2018,Nueces,TX,Passenger,1,1,2,88,90,2.22
16986,September,2018,Queens,NY,Passenger,1,0,1,61,62,1.61
16987,September,2018,Larimer,CO,Passenger,1,0,1,61,62,1.61
16988,September,2018,Franklin,WA,Truck,0,0,0,18876,18876,0.0
16989,September,2018,Clark,NV,Passenger,1,2,3,732,735,0.41
16990,September,2018,Tulsa,OK,Passenger,1,1,2,47,49,4.08
16991,September,2018,Pierce,WA,Truck,0,0,0,138460,138460,0.0
16992,September,2018,El Paso,TX,Passenger,1,0,1,498,499,0.2
16993,September,2018,Adams,WA,Passenger,5,5,10,12682,12692,0.08
16994,September,2018,Kittitas,WA,Passenger,55,36,91,29200,29291,0.31
16995,September,2018,San Mateo,CA,Passenger,1,1,2,132,134,1.49
16996,September,2019,Clark,NV,Passenger,4,2,6,684,690,0.87
16997,September,2019,Franklin,MA,Passenger,0,1,1,1,2,50.0
16998,September,2019,Twin Falls,ID,Passenger,0,1,1,26,27,3.7
16999,September,2019,Cowlitz,WA,Passenger,106,106,212,73309,73521,0.29
17000,September,2019,Anne Arundel,MD,Passenger,1,2,3,437,440,0.68
17001,September,2019,Stafford,VA,Passenger,1,1,2,96,98,2.04
17002,September,2019,King,WA,Passenger,20421,7282,27703,1394905,1422608,1.95
17003,September,2019,Wahkiakum,WA,Passenger,2,3,5,3049,3054,0.16
17004,September,2019,Duval,FL,Passenger,1,2,3,369,372,0.81
17005,September,2019,District of Columbia,DC,Passenger,1,1,2,210,212,0.94
17006,September,2019,Montgomery,TX,Passenger,1,0,1,58,59,1.69
17007,September,2019,Pacific,WA,Truck,0,0,0,7676,7676,0.0
17008,September,2019,Jones,GA,Passenger,1,0,1,1,2,50.0
17009,September,2019,Jefferson,CO,Passenger,0,2,2,59,61,3.28
17010,September,2019,Walla Walla,WA,Passenger,59,63,122,36254,36376,0.34
17011,September,2019,Chesapeake,VA,Passenger,0,1,1,442,443,0.23
17012,September,2019,Sedgwick,KS,Passenger,1,1,2,99,101,1.98
17013,September,2019,Orange,CA,Passenger,7,3,10,513,523,1.91
17014,September,2019,Sumter,FL,Passenger,0,1,1,9,10,10.0
17015,September,2019,Osceola,FL,Passenger,1,0,1,40,41,2.44
17016,September,2019,Snohomish,WA,Truck,0,0,0,122968,122968,0.0
17017,September,2019,Kern,CA,Passenger,0,1,1,217,218,0.46
17018,September,2019,Broward,FL,Passenger,2,1,3,128,131,2.29
17019,September,2019,St. Mary's,MD,Passenger,1,0,1,218,219,0.46
17020,September,2019,Fulton,GA,Passenger,0,2,2,102,104,1.92
17021,September,2019,DuPage,IL,Passenger,3,0,3,61,64,4.69
17022,September,2019,Manassas,VA,Passenger,0,1,1,7,8,12.5
17023,September,2019,Riverside,CA,Passenger,4,1,5,650,655,0.76
17024,September,2019,Moore,NC,Passenger,0,1,1,180,181,0.55
17025,September,2019,Mason,WA,Passenger,133,129,262,47444,47706,0.55
17026,September,2019,Shasta,CA,Passenger,1,0,1,39,40,2.5
17027,September,2019,Wayne,MI,Passenger,0,1,1,63,64,1.56
17028,September,2019,Nassau,NY,Passenger,4,0,4,37,41,9.76
17029,September,2019,Deschutes,OR,Passenger,3,0,3,153,156,1.92
17030,September,2019,Pacific,WA,Passenger,25,29,54,16078,16132,0.33
17031,September,2019,Larimer,CO,Passenger,1,0,1,60,61,1.64
17032,September,2019,Thurston,WA,Truck,0,0,0,55538,55538,0.0
17033,September,2019,Santa Rosa,FL,Passenger,1,0,1,87,88,1.14
17034,September,2019,Chelan,WA,Passenger,174,71,245,54511,54756,0.45
17035,September,2019,Houston,GA,Passenger,1,0,1,56,57,1.75
17036,September,2019,Tuolumne,CA,Passenger,0,1,1,11,12,8.33
17037,September,2019,Snohomish,WA,Passenger,3740,1661,5401,533934,539335,1.0
17038,September,2019,DeKalb,IN,Passenger,1,0,1,1,2,50.0
17039,September,2019,Ramsey,MN,Passenger,1,0,1,40,41,2.44
17040,September,2019,Clay,FL,Passenger,0,1,1,85,86,1.16
17041,September,2019,Bexar,TX,Passenger,1,5,6,651,657,0.91
17042,September,2019,Albemarle,VA,Passenger,1,0,1,23,24,4.17
17043,September,2019,Guadalupe,TX,Passenger,1,0,1,70,71,1.41
17044,September,2019,Frederick,MD,Passenger,1,1,2,80,82,2.44
17045,September,2019,Lake,FL,Passenger,1,0,1,21,22,4.55
17046,September,2019,Spokane,WA,Truck,1,0,1,95761,95762,0.0
17047,September,2019,El Paso,CO,Passenger,2,1,3,739,742,0.4
17048,September,2019,Whatcom,WA,Passenger,922,460,1382,151337,152719,0.9
17049,September,2019,Columbia,WA,Truck,0,0,0,1536,1536,0.0
17050,September,2019,Douglas,NE,Passenger,0,1,1,59,60,1.67
17051,September,2019,Ferry,WA,Truck,0,0,0,3583,3583,0.0
17052,September,2019,Lake,IL,Passenger,1,0,1,165,166,0.6
17053,September,2019,Sarasota,FL,Passenger,1,0,1,26,27,3.7
17054,September,2019,Cowlitz,WA,Truck,0,0,0,28959,28959,0.0
17055,September,2019,Clallam,WA,Truck,1,0,1,21843,21844,0.0
17056,September,2019,Solano,CA,Passenger,1,0,1,207,208,0.48
17057,September,2019,Ferry,WA,Passenger,5,2,7,4423,4430,0.16
17058,September,2019,Vigo,IN,Passenger,1,0,1,6,7,14.29
17059,September,2019,Yakima,WA,Truck,0,0,0,59399,59399,0.0
17060,September,2019,Nueces,TX,Passenger,1,1,2,92,94,2.13
17061,September,2019,Lewis,WA,Passenger,107,101,208,59362,59570,0.35
17062,September,2019,Richland,SC,Passenger,0,1,1,156,157,0.64
17063,September,2019,Skagit,WA,Passenger,315,210,525,92513,93038,0.56
17064,September,2019,Kitsap,WA,Passenger,1135,641,1776,181617,183393,0.97
17065,September,2019,Carson City,NV,Passenger,1,0,1,10,11,9.09
17066,September,2019,Clark,WA,Passenger,1700,982,2682,316090,318772,0.84
17067,September,2019,Asotin,WA,Passenger,12,8,20,12631,12651,0.16
17068,September,2019,Oldham,KY,Passenger,0,1,1,5,6,16.67
17069,September,2019,Polk,FL,Passenger,1,0,1,66,67,1.49
17070,September,2019,San Diego,CA,Passenger,10,3,13,2770,2783,0.47
17071,September,2019,Island,WA,Passenger,346,249,595,63481,64076,0.93
17072,September,2019,Asotin,WA,Truck,0,0,0,6682,6682,0.0
17073,September,2019,San Mateo,CA,Passenger,2,1,3,119,122,2.46
17074,September,2019,Cascade,MT,Passenger,0,1,1,58,59,1.69
17075,September,2019,Charleston,SC,Passenger,1,0,1,113,114,0.88
17076,September,2019,Lewis,WA,Truck,0,0,0,25970,25970,0.0
17077,September,2019,Monroe,IL,Passenger,1,0,1,5,6,16.67
17078,September,2019,Tarrant,TX,Passenger,2,0,2,195,197,1.02
17079,September,2019,Dallas,TX,Passenger,1,0,1,209,210,0.48
17080,September,2019,Cumberland,NC,Passenger,0,2,2,490,492,0.41
17081,September,2019,Wilson,TX,Passenger,0,1,1,6,7,14.29
17082,September,2019,El Paso,TX,Passenger,3,0,3,472,475,0.63
17083,September,2019,Oklahoma,OK,Passenger,0,1,1,127,128,0.78
17084,September,2019,Boone,MO,Passenger,0,1,1,10,11,9.09
17085,September,2019,Dakota,MN,Passenger,0,1,1,37,38,2.63
17086,September,2019,Kitsap,WA,Truck,1,0,1,54211,54212,0.0
17087,September,2019,Kittitas,WA,Truck,0,0,0,14565,14565,0.0
17088,September,2019,Fairbanks North Star,AK,Passenger,0,1,1,98,99,1.01
17089,September,2019,Thurston,WA,Passenger,953,672,1625,198595,200220,0.81
17090,September,2019,Pend Oreille,WA,Passenger,6,6,12,9472,9484,0.13
17091,September,2019,Williamson,TX,Passenger,0,2,2,144,146,1.37
17092,September,2019,Alexandria,VA,Passenger,1,0,1,147,148,0.68
17093,September,2019,Grays Harbor,WA,Passenger,89,89,178,48096,48274,0.37
17094,September,2019,Skamania,WA,Truck,0,0,0,4086,4086,0.0
17095,September,2019,Norfolk,MA,Passenger,1,0,1,36,37,2.7
17096,September,2019,Pima,AZ,Passenger,2,1,3,379,382,0.79
17097,September,2019,Boulder,CO,Passenger,0,1,1,49,50,2.0
17098,September,2019,Santa Clara,CA,Passenger,4,2,6,358,364,1.65
17099,September,2019,Klickitat,WA,Passenger,38,36,74,15624,15698,0.47
17100,September,2019,Maui,HI,Passenger,1,0,1,41,42,2.38
17101,September,2019,Okanogan,WA,Passenger,24,26,50,26237,26287,0.19
17102,September,2019,Rogers,OK,Passenger,1,0,1,5,6,16.67
17103,September,2019,Klickitat,WA,Truck,0,0,0,8298,8298,0.0
17104,September,2019,Travis,TX,Passenger,2,1,3,203,206,1.46
17105,September,2019,Ventura,CA,Passenger,0,2,2,305,307,0.65
17106,September,2019,Fairfax,VA,Passenger,3,2,5,759,764,0.65
17107,September,2019,Alameda,CA,Passenger,4,1,5,295,300,1.67
17108,September,2019,Allegheny,PA,Passenger,1,0,1,79,80,1.25
17109,September,2019,San Francisco,CA,Passenger,2,1,3,105,108,2.78
17110,September,2019,Pierce,WA,Passenger,1966,1602,3568,545437,549005,0.65
17111,September,2019,Whitman,WA,Passenger,36,45,81,22710,22791,0.36
17112,September,2019,Island,WA,Truck,0,0,0,21294,21294,0.0
17113,September,2019,Maricopa,AZ,Passenger,7,4,11,1521,1532,0.72
17114,September,2019,Garfield,WA,Truck,0,0,0,970,970,0.0
17115,September,2019,Lincoln,WA,Passenger,2,10,12,7807,7819,0.15
17116,September,2019,Los Angeles,CA,Passenger,9,7,16,1087,1103,1.45
17117,September,2019,Grays Harbor,WA,Truck,0,0,0,20636,20636,0.0
17118,September,2019,Prince William,VA,Passenger,1,3,4,242,246,1.63
17119,September,2019,Suffolk,MA,Passenger,0,1,1,38,39,2.56
17120,September,2019,Spartanburg,SC,Passenger,0,1,1,39,40,2.5
17121,September,2019,Arlington,VA,Passenger,0,2,2,152,154,1.3
17122,September,2019,Penobscot,ME,Passenger,0,1,1,13,14,7.14
17123,September,2019,Juneau,AK,Passenger,0,2,2,28,30,6.67
17124,September,2019,San Juan,WA,Truck,0,0,0,5916,5916,0.0
17125,September,2019,Chelan,WA,Truck,0,0,0,22420,22420,0.0
17126,September,2019,Fresno,CA,Passenger,1,0,1,194,195,0.51
17127,September,2019,Whitman,WA,Truck,0,0,0,8604,8604,0.0
17128,September,2019,Clackamas,OR,Passenger,2,1,3,211,214,1.4
17129,September,2019,San Juan,WA,Passenger,229,73,302,14431,14733,2.05
17130,September,2019,Pinellas,FL,Passenger,1,1,2,110,112,1.79
17131,September,2019,Shelby,TN,Passenger,0,1,1,94,95,1.05
17132,September,2019,Clallam,WA,Passenger,185,151,336,50854,51190,0.66
17133,September,2019,Denver,CO,Passenger,1,0,1,129,130,0.77
17134,September,2019,New London,CT,Passenger,0,2,2,242,244,0.82
17135,September,2019,Carroll,NH,Passenger,0,1,1,3,4,25.0
17136,September,2019,Ada,ID,Passenger,0,2,2,302,304,0.66
17137,September,2019,Jefferson,NY,Passenger,0,2,2,216,218,0.92
17138,September,2019,Powhatan,VA,Passenger,1,0,1,0,1,100.0
17139,September,2019,Kootenai,ID,Passenger,1,1,2,222,224,0.89
17140,September,2019,Pinal,AZ,Passenger,2,0,2,190,192,1.04
17141,September,2019,Walla Walla,WA,Truck,0,0,0,13687,13687,0.0
17142,September,2019,Yakima,WA,Passenger,111,113,224,165657,165881,0.14
17143,September,2019,Washoe,NV,Passenger,2,0,2,107,109,1.83
17144,September,2019,Cochise,AZ,Passenger,0,1,1,107,108,0.93
17145,September,2019,Hawaii,HI,Passenger,1,0,1,57,58,1.72
17146,September,2019,Pend Oreille,WA,Truck,0,0,0,5712,5712,0.0
17147,September,2019,Richmond,GA,Passenger,0,1,1,92,93,1.08
17148,September,2019,Camden,NJ,Passenger,0,1,1,24,25,4.0
17149,September,2019,Lincoln,WA,Truck,0,0,0,4690,4690,0.0
17150,September,2019,Benton,WA,Truck,0,0,0,42229,42229,0.0
17151,September,2019,Harris,TX,Passenger,1,1,2,246,248,0.81
17152,September,2019,Franklin,WA,Truck,0,0,0,19536,19536,0.0
17153,September,2019,King,WA,Truck,6,1,7,182395,182402,0.0
17154,September,2019,New Haven,CT,Passenger,0,2,2,47,49,4.08
17155,September,2019,RÃ­o Grande,PR,Passenger,1,0,1,1,2,50.0
17156,September,2019,Franklin,WA,Passenger,51,73,124,60363,60487,0.21
17157,September,2019,Placer,CA,Passenger,1,0,1,96,97,1.03
17158,September,2019,Multnomah,OR,Passenger,5,6,11,739,750,1.47
17159,September,2019,Cape May,NJ,Passenger,0,1,1,13,14,7.14
17160,September,2019,Kittitas,WA,Passenger,81,44,125,29832,29957,0.42
17161,September,2019,Klamath,OR,Passenger,1,0,1,39,40,2.5
17162,September,2019,Tulsa,OK,Passenger,1,1,2,49,51,3.92
17163,September,2019,Jefferson,WA,Truck,0,0,0,9682,9682,0.0
17164,September,2019,Goochland,VA,Passenger,2,1,3,264,267,1.12
17165,September,2019,Santa Cruz,CA,Passenger,1,0,1,36,37,2.7
17166,September,2019,Stevens,WA,Truck,0,0,0,18754,18754,0.0
17167,September,2019,Skamania,WA,Passenger,26,18,44,8787,8831,0.5
17168,September,2019,Washtenaw,MI,Passenger,1,0,1,41,42,2.38
17169,September,2019,Volusia,FL,Passenger,0,1,1,38,39,2.56
17170,September,2019,Calvert,MD,Passenger,0,2,2,91,93,2.15
17171,September,2019,Flathead,MT,Passenger,1,0,1,64,65,1.54
17172,September,2019,Prince George's,MD,Passenger,1,1,2,176,178,1.12
17173,September,2019,Stevens,WA,Passenger,27,28,55,31672,31727,0.17
17174,September,2019,Palm Beach,FL,Passenger,0,1,1,84,85,1.18
17175,September,2019,Kent,MI,Passenger,0,1,1,23,24,4.17
17176,September,2019,Valencia,NM,Passenger,1,0,1,6,7,14.29
17177,September,2019,San Joaquin,CA,Passenger,1,0,1,135,136,0.74
17178,September,2019,Santa Fe,NM,Passenger,0,1,1,42,43,2.33
17179,September,2019,Cook,IL,Passenger,1,0,1,240,241,0.41
17180,September,2019,Loudoun,VA,Passenger,1,0,1,94,95,1.05
17181,September,2019,Montgomery,PA,Passenger,2,0,2,36,38,5.26
17182,September,2019,Greene,MO,Passenger,0,1,1,31,32,3.12
17183,September,2019,Virginia Beach,VA,Passenger,1,0,1,700,701,0.14
17184,September,2019,Grant,WA,Truck,0,0,0,26789,26789,0.0
17185,September,2019,Harrison,MS,Passenger,1,0,1,61,62,1.61
17186,September,2019,Columbia,WA,Passenger,3,2,5,2446,2451,0.2
17187,September,2019,Contra Costa,CA,Passenger,2,2,4,367,371,1.08
17188,September,2019,Harnett,NC,Passenger,1,1,2,212,214,0.93
17189,September,2019,Portsmouth,VA,Passenger,0,1,1,79,80,1.25
17190,September,2019,Owyhee,ID,Passenger,1,0,1,4,5,20.0
17191,September,2019,Middlesex,MA,Passenger,1,1,2,109,111,1.8
17192,September,2019,Skagit,WA,Truck,1,0,1,32515,32516,0.0
17193,September,2019,DeKalb,GA,Passenger,1,0,1,79,80,1.25
17194,September,2019,Wahkiakum,WA,Truck,0,0,0,1760,1760,0.0
17195,September,2019,Sangamon,IL,Passenger,1,0,1,6,7,14.29
17196,September,2019,Hennepin,MN,Passenger,3,1,4,103,107,3.74
17197,September,2019,Okanogan,WA,Truck,0,0,0,16497,16497,0.0
17198,September,2019,Shelby,OH,Passenger,0,1,1,1,2,50.0
17199,September,2019,Benton,WA,Passenger,291,297,588,134616,135204,0.43
17200,September,2019,Brevard,FL,Passenger,0,1,1,87,88,1.14
17201,September,2019,Honolulu,HI,Passenger,4,2,6,492,498,1.2
17202,September,2019,Adams,WA,Passenger,5,5,10,12887,12897,0.08
17203,September,2019,Putnam,TN,Passenger,0,1,1,3,4,25.0
17204,September,2019,Garfield,WA,Passenger,0,1,1,1311,1312,0.08
17205,September,2019,Pierce,WA,Truck,0,0,0,140471,140471,0.0
17206,September,2019,Charles,MD,Passenger,0,1,1,86,87,1.15
17207,September,2019,Randolph,NC,Passenger,1,0,1,6,7,14.29
17208,September,2019,Howard,MD,Passenger,0,1,1,76,77,1.3
17209,September,2019,Whatcom,WA,Truck,2,0,2,43030,43032,0.0
17210,September,2019,Mason,WA,Truck,0,0,0,20438,20438,0.0
17211,September,2019,Adams,WA,Truck,0,0,0,5139,5139,0.0
17212,September,2019,Norfolk,VA,Passenger,2,2,4,344,348,1.15
17213,September,2019,Douglas,WA,Truck,0,0,0,12275,12275,0.0
17215,September,2019,Clark,WA,Truck,0,0,0,80968,80968,0.0
17216,September,2019,Collin,TX,Passenger,1,1,2,128,130,1.54
17217,September,2019,Spokane,WA,Passenger,596,445,1041,313551,314592,0.33
17218,September,2019,Berkshire,MA,Passenger,0,1,1,4,5,20.0
17219,September,2019,Saginaw,MI,Passenger,1,0,1,11,12,8.33
17220,September,2019,Bucks,PA,Passenger,1,0,1,23,24,4.17
17221,September,2019,Jefferson,WA,Passenger,207,126,333,25125,25458,1.31
17222,September,2019,Lee,FL,Passenger,1,0,1,50,51,1.96
17223,September,2019,Grant,WA,Passenger,48,63,111,65170,65281,0.17
17224,September,2019,Montgomery,AL,Passenger,0,1,1,42,43,2.33
17225,September,2019,Douglas,WA,Passenger,62,37,99,28207,28306,0.35
17226,September,2020,Washoe,NV,Passenger,1,0,1,99,100,1.0
17227,September,2020,Cowlitz,WA,Passenger,157,120,277,72161,72438,0.38
17228,September,2020,Duval,FL,Passenger,0,2,2,357,359,0.56
17229,September,2020,Mason,WA,Truck,0,0,0,20804,20804,0.0
17230,September,2020,Adams,WA,Truck,0,0,0,5309,5309,0.0
17231,September,2020,Hamilton,IN,Passenger,1,0,1,37,38,2.63
17232,September,2020,Skamania,WA,Truck,0,0,0,4005,4005,0.0
17233,September,2020,New London,CT,Passenger,1,2,3,237,240,1.25
17234,September,2020,DeKalb,IN,Passenger,1,0,1,1,2,50.0
17235,September,2020,Bexar,TX,Passenger,4,5,9,582,591,1.52
17236,September,2020,Prince William,VA,Passenger,2,2,4,219,223,1.79
17237,September,2020,Cascade,MT,Passenger,0,1,1,53,54,1.85
17238,September,2020,Grant,WA,Truck,0,0,0,27301,27301,0.0
17239,September,2020,Walla Walla,WA,Truck,0,0,0,13789,13789,0.0
17240,September,2020,Pacific,WA,Passenger,32,34,66,15716,15782,0.42
17241,September,2020,Portsmouth,VA,Passenger,0,1,1,74,75,1.33
17242,September,2020,Kauai,HI,Passenger,1,0,1,14,15,6.67
17243,September,2020,Greene,MO,Passenger,0,1,1,32,33,3.03
17244,September,2020,Maricopa,AZ,Passenger,5,7,12,1347,1359,0.88
17245,September,2020,DeKalb,GA,Passenger,1,0,1,77,78,1.28
17246,September,2020,Spartanburg,SC,Passenger,0,1,1,49,50,2.0
17247,September,2020,Oldham,KY,Passenger,0,1,1,4,5,20.0
17248,September,2020,Garfield,WA,Passenger,0,1,1,1348,1349,0.07
17249,September,2020,San Francisco,CA,Passenger,2,1,3,89,92,3.26
17250,September,2020,Howard,MD,Passenger,0,1,1,63,64,1.56
17251,September,2020,Wahkiakum,WA,Passenger,6,6,12,3016,3028,0.4
17252,September,2020,Prince George's,MD,Passenger,2,1,3,149,152,1.97
17253,September,2020,Clackamas,OR,Passenger,2,0,2,183,185,1.08
17254,September,2020,Santa Clara,CA,Passenger,6,2,8,276,284,2.82
17255,September,2020,Travis,TX,Passenger,2,1,3,169,172,1.74
17256,September,2020,Montgomery,TX,Passenger,1,0,1,47,48,2.08
17257,September,2020,Sacramento,CA,Passenger,1,0,1,251,252,0.4
17258,September,2020,Harnett,NC,Passenger,1,0,1,191,192,0.52
17259,September,2020,Clark,WA,Passenger,2174,1098,3272,318408,321680,1.02
17260,September,2020,Erie,NY,Passenger,1,0,1,46,47,2.13
17261,September,2020,Fresno,CA,Passenger,1,0,1,173,174,0.57
17262,September,2020,Stafford,VA,Passenger,1,1,2,93,95,2.11
17263,September,2020,Placer,CA,Passenger,2,0,2,85,87,2.3
17264,September,2020,San Juan,WA,Passenger,331,100,431,13907,14338,3.01
17265,September,2020,El Dorado,CA,Passenger,1,0,1,33,34,2.94
17266,September,2020,Frederick,MD,Passenger,1,1,2,72,74,2.7
17267,September,2020,Manassas,VA,Passenger,0,1,1,5,6,16.67
17268,September,2020,El Paso,CO,Passenger,2,0,2,707,709,0.28
17269,September,2020,Asotin,WA,Passenger,17,14,31,12398,12429,0.25
17270,September,2020,Miami-Dade,FL,Passenger,1,0,1,104,105,0.95
17271,September,2020,Rockingham,NH,Passenger,1,0,1,22,23,4.35
17272,September,2020,Walla Walla,WA,Passenger,86,62,148,35944,36092,0.41
17273,September,2020,Leavenworth,KS,Passenger,0,1,1,120,121,0.83
17274,September,2020,Grant,WA,Passenger,67,80,147,65582,65729,0.22
17275,September,2020,Whatcom,WA,Passenger,1140,525,1665,149401,151066,1.1
17276,September,2020,Cumberland,NC,Passenger,0,3,3,452,455,0.66
17277,September,2020,Kittitas,WA,Passenger,113,48,161,29701,29862,0.54
17278,September,2020,Kings,NY,Passenger,1,0,1,65,66,1.52
17279,September,2020,San Joaquin,CA,Passenger,1,0,1,115,116,0.86
17280,September,2020,Lake,IL,Passenger,1,0,1,163,164,0.61
17281,September,2020,Sedgwick,KS,Passenger,1,1,2,92,94,2.13
17282,September,2020,Williamson,TX,Passenger,0,2,2,128,130,1.54
17283,September,2020,Douglas,WA,Passenger,79,45,124,28040,28164,0.44
17284,September,2020,New York,NY,Passenger,1,0,1,55,56,1.79
17285,September,2020,Loudoun,VA,Passenger,1,0,1,82,83,1.2
17286,September,2020,Virginia Beach,VA,Passenger,1,0,1,655,656,0.15
17287,September,2020,Houston,GA,Passenger,1,0,1,53,54,1.85
17288,September,2020,Snohomish,WA,Truck,0,0,0,124936,124936,0.0
17289,September,2020,Ferry,WA,Truck,0,0,0,3582,3582,0.0
17290,September,2020,Spokane,WA,Passenger,797,513,1310,318772,320082,0.41
17291,September,2020,St. Mary's,MD,Passenger,1,0,1,217,218,0.46
17292,September,2020,Richmond,GA,Passenger,0,1,1,81,82,1.22
17293,September,2020,Douglas,NE,Passenger,0,1,1,48,49,2.04
17294,September,2020,Bartow,GA,Passenger,0,1,1,4,5,20.0
17295,September,2020,Lee,FL,Passenger,1,0,1,47,48,2.08
17296,September,2020,Kern,CA,Passenger,0,1,1,223,224,0.45
17297,September,2020,St. Clair,IL,Passenger,1,0,1,137,138,0.72
17298,September,2020,Gwinnett,GA,Passenger,1,0,1,69,70,1.43
17299,September,2020,Boulder,CO,Passenger,0,1,1,43,44,2.27
17300,September,2020,Okanogan,WA,Passenger,45,36,81,25965,26046,0.31
17301,September,2020,Monroe,IL,Passenger,1,0,1,3,4,25.0
17302,September,2020,San Diego,CA,Passenger,15,5,20,2735,2755,0.73
17303,September,2020,Calvert,MD,Passenger,0,2,2,85,87,2.3
17304,September,2020,Tulsa,OK,Passenger,1,1,2,40,42,4.76
17305,September,2020,Saginaw,MI,Passenger,1,0,1,9,10,10.0
17306,September,2020,San Juan,WA,Truck,0,0,0,5848,5848,0.0
17307,September,2020,Pacific,WA,Truck,0,0,0,7742,7742,0.0
17308,September,2020,Shelby,OH,Passenger,0,1,1,1,2,50.0
17309,September,2020,Harrison,MS,Passenger,1,0,1,51,52,1.92
17310,September,2020,Nueces,TX,Passenger,1,0,1,86,87,1.15
17311,September,2020,Alexandria,VA,Passenger,2,0,2,135,137,1.46
17312,September,2020,Penobscot,ME,Passenger,0,1,1,12,13,7.69
17313,September,2020,Benton,WA,Passenger,394,329,723,134382,135105,0.54
17314,September,2020,Fulton,GA,Passenger,1,2,3,94,97,3.09
17315,September,2020,Collin,TX,Passenger,1,1,2,119,121,1.65
17316,September,2020,Allegheny,PA,Passenger,1,0,1,68,69,1.45
17317,September,2020,Dallas,TX,Passenger,1,0,1,179,180,0.56
17318,September,2020,Yakima,WA,Passenger,154,124,278,166493,166771,0.17
17319,September,2020,Washington,OR,Passenger,1,0,1,423,424,0.24
17320,September,2020,Wilson,TX,Passenger,0,1,1,5,6,16.67
17321,September,2020,Suffolk,VA,Passenger,1,0,1,125,126,0.79
17322,September,2020,Pierce,WA,Truck,0,0,0,143993,143993,0.0
17323,September,2020,Douglas,CO,Passenger,0,1,1,77,78,1.28
17324,September,2020,Snohomish,WA,Passenger,4694,1808,6502,537221,543723,1.2
17325,September,2020,Polk,FL,Passenger,1,0,1,60,61,1.64
17326,September,2020,Utah,UT,Passenger,0,1,1,129,130,0.77
17327,September,2020,Ferry,WA,Passenger,8,3,11,4305,4316,0.25
17328,September,2020,Clallam,WA,Passenger,245,173,418,49886,50304,0.83
17329,September,2020,Alameda,CA,Passenger,2,0,2,263,265,0.75
17330,September,2020,Skagit,WA,Truck,1,0,1,32643,32644,0.0
17331,September,2020,Garfield,WA,Truck,0,0,0,987,987,0.0
17332,September,2020,Ada,ID,Passenger,0,1,1,249,250,0.4
17333,September,2020,Harris,TX,Passenger,1,0,1,223,224,0.45
17334,September,2020,Lewis,WA,Truck,0,0,0,26446,26446,0.0
17335,September,2020,Boone,MO,Passenger,0,1,1,10,11,9.09
17336,September,2020,Arlington,VA,Passenger,0,2,2,146,148,1.35
17337,September,2020,El Paso,TX,Passenger,3,0,3,415,418,0.72
17338,September,2020,Fort Bend,TX,Passenger,1,0,1,44,45,2.22
17339,September,2020,New Haven,CT,Passenger,0,2,2,34,36,5.56
17340,September,2020,Montgomery,AL,Passenger,0,1,1,39,40,2.5
17341,September,2020,Klamath,OR,Passenger,1,0,1,31,32,3.12
17342,September,2020,Columbia,WA,Passenger,4,3,7,2421,2428,0.29
17343,September,2020,Albemarle,VA,Passenger,1,0,1,20,21,4.76
17344,September,2020,Salt Lake,UT,Passenger,0,1,1,176,177,0.56
17345,September,2020,Camden,NJ,Passenger,0,1,1,23,24,4.17
17346,September,2020,Flathead,MT,Passenger,1,0,1,56,57,1.75
17347,September,2020,Klickitat,WA,Passenger,58,42,100,15023,15123,0.66
17348,September,2020,King,WA,Passenger,25389,7895,33284,1371586,1404870,2.37
17349,September,2020,Benton,WA,Truck,0,0,0,43090,43090,0.0
17350,September,2020,Morris,NJ,Passenger,1,0,1,18,19,5.26
17351,September,2020,Chelan,WA,Passenger,260,80,340,54306,54646,0.62
17353,September,2020,Jefferson,CO,Passenger,0,1,1,55,56,1.79
17354,September,2020,District of Columbia,DC,Passenger,2,1,3,197,200,1.5
17355,September,2020,Putnam,TN,Passenger,0,1,1,2,3,33.33
17356,September,2020,Honolulu,HI,Passenger,5,2,7,428,435,1.61
17357,September,2020,Nassau,FL,Passenger,1,0,1,36,37,2.7
17358,September,2020,St. Louis,MO,Passenger,1,0,1,96,97,1.03
17359,September,2020,Juneau,AK,Passenger,0,1,1,28,29,3.45
17360,September,2020,Montgomery,OH,Passenger,0,1,1,47,48,2.08
17361,September,2020,Maui,HI,Passenger,1,0,1,29,30,3.33
17362,September,2020,Thurston,WA,Passenger,1211,753,1964,197219,199183,0.99
17363,September,2020,Hennepin,MN,Passenger,2,0,2,83,85,2.35
17364,September,2020,Stevens,WA,Passenger,35,38,73,30417,30490,0.24
17365,September,2020,Ramsey,MN,Passenger,1,0,1,36,37,2.7
17366,September,2020,Twin Falls,ID,Passenger,0,1,1,23,24,4.17
17367,September,2020,Williams,ND,Passenger,0,1,1,11,12,8.33
17368,September,2020,Jefferson,WA,Truck,0,0,0,9541,9541,0.0
17369,September,2020,Suffolk,MA,Passenger,0,2,2,34,36,5.56
17370,September,2020,Spokane,WA,Truck,1,0,1,99865,99866,0.0
17371,September,2020,Kootenai,ID,Passenger,1,0,1,220,221,0.45
17372,September,2020,Owyhee,ID,Passenger,1,0,1,3,4,25.0
17373,September,2020,San Mateo,CA,Passenger,0,1,1,105,106,0.94
17374,September,2020,Chelan,WA,Truck,0,0,0,22729,22729,0.0
17375,September,2020,Denver,CO,Passenger,1,0,1,113,114,0.88
17376,September,2020,Goochland,VA,Passenger,3,2,5,247,252,1.98
17377,September,2020,Arapahoe,CO,Passenger,1,0,1,127,128,0.78
17378,September,2020,Anne Arundel,MD,Passenger,1,1,2,400,402,0.5
17379,September,2020,Fairbanks North Star,AK,Passenger,0,1,1,94,95,1.05
17380,September,2020,Riverside,CA,Passenger,3,0,3,607,610,0.49
17381,September,2020,Douglas,WA,Truck,0,0,0,12380,12380,0.0
17382,September,2020,Pierce,WA,Passenger,2575,1710,4285,553881,558166,0.77
17383,September,2020,Fairfax,VA,Passenger,4,3,7,730,737,0.95
17384,September,2020,Cowlitz,WA,Truck,0,0,0,28936,28936,0.0
17385,September,2020,Asotin,WA,Truck,0,0,0,6693,6693,0.0
17386,September,2020,Powhatan,VA,Passenger,1,0,1,0,1,100.0
17387,September,2020,Palm Beach,FL,Passenger,0,1,1,78,79,1.27
17388,September,2020,Skagit,WA,Passenger,447,228,675,91505,92180,0.73
17389,September,2020,Middlesex,MA,Passenger,1,1,2,91,93,2.15
17390,September,2020,Nassau,NY,Passenger,4,0,4,28,32,12.5
17391,September,2020,Multnomah,OR,Passenger,4,6,10,696,706,1.42
17392,September,2020,Sumter,FL,Passenger,0,1,1,11,12,8.33
17393,September,2020,Monterey,CA,Passenger,0,1,1,157,158,0.63
17394,September,2020,Montgomery,PA,Passenger,1,0,1,27,28,3.57
17395,September,2020,Thurston,WA,Truck,0,0,0,56132,56132,0.0
17396,September,2020,Santa Cruz,CA,Passenger,1,0,1,31,32,3.12
17397,September,2020,Lincoln,WA,Passenger,5,10,15,7595,7610,0.2
17398,September,2020,Clallam,WA,Truck,1,0,1,21773,21774,0.0
17399,September,2020,Charles,MD,Passenger,1,1,2,74,76,2.63
17400,September,2020,Bucks,PA,Passenger,1,0,1,19,20,5.0
17401,September,2020,Lincoln,WA,Truck,0,0,0,4640,4640,0.0
17402,September,2020,Island,WA,Passenger,444,280,724,62886,63610,1.14
17403,September,2020,Queens,NY,Passenger,1,0,1,53,54,1.85
17404,September,2020,Adams,WA,Passenger,8,7,15,12918,12933,0.12
17405,September,2020,Hawaii,HI,Passenger,1,0,1,51,52,1.92
17406,September,2020,Island,WA,Truck,1,0,1,21261,21262,0.0
17407,September,2020,Plaquemines,LA,Passenger,0,1,1,14,15,6.67
17408,September,2020,Kent,MI,Passenger,0,1,1,23,24,4.17
17409,September,2020,Kittitas,WA,Truck,0,0,0,14601,14601,0.0
17410,September,2020,King,WA,Truck,5,1,6,183674,183680,0.0
17411,September,2020,Dakota,MN,Passenger,0,1,1,31,32,3.12
17412,September,2020,Pend Oreille,WA,Truck,0,0,0,5727,5727,0.0
17413,September,2020,Lake,FL,Passenger,1,0,1,23,24,4.17
17414,September,2020,Vigo,IN,Passenger,1,0,1,6,7,14.29
17415,September,2020,Chesapeake,VA,Passenger,0,3,3,412,415,0.72
17416,September,2020,DuPage,IL,Passenger,3,0,3,55,58,5.17
17417,September,2020,Whitman,WA,Truck,0,0,0,8497,8497,0.0
17418,September,2020,Ventura,CA,Passenger,1,2,3,272,275,1.09
17419,September,2020,Grays Harbor,WA,Truck,0,0,0,21093,21093,0.0
17420,September,2020,Bradley,TN,Passenger,1,0,1,1,2,50.0
17421,September,2020,Solano,CA,Passenger,1,0,1,205,206,0.49
17422,September,2020,RÃ­o Grande,PR,Passenger,1,0,1,1,2,50.0
17423,September,2020,Randolph,NC,Passenger,1,0,1,7,8,12.5
17424,September,2020,Wahkiakum,WA,Truck,0,0,0,1759,1759,0.0
17425,September,2020,Cape May,NJ,Passenger,0,1,1,11,12,8.33
17426,September,2020,Skamania,WA,Passenger,32,22,54,8373,8427,0.64
17427,September,2020,Mason,WA,Passenger,162,131,293,47460,47753,0.61
17428,September,2020,Carson City,NV,Passenger,1,0,1,10,11,9.09
17429,September,2020,Denton,TX,Passenger,1,0,1,87,88,1.14
17430,September,2020,Moore,NC,Passenger,0,1,1,156,157,0.64
17431,September,2020,Ulster,NY,Passenger,1,0,1,8,9,11.11
17432,September,2020,Lewis,WA,Passenger,111,117,228,58309,58537,0.39
17433,September,2020,Larimer,CO,Passenger,1,0,1,52,53,1.89
17434,September,2020,Contra Costa,CA,Passenger,4,3,7,296,303,2.31
17435,September,2020,Jefferson,NY,Passenger,0,1,1,210,211,0.47
17436,September,2020,Carroll,MD,Passenger,0,1,1,21,22,4.55
17437,September,2020,Whatcom,WA,Truck,3,0,3,43388,43391,0.01
17438,September,2020,Deschutes,OR,Passenger,1,0,1,125,126,0.79
17439,September,2020,Richland,SC,Passenger,0,1,1,143,144,0.69
17440,September,2020,Charleston,SC,Passenger,2,0,2,93,95,2.11
17441,September,2020,Carroll,NH,Passenger,0,1,1,5,6,16.67
17442,September,2020,Shelby,TN,Passenger,0,1,1,79,80,1.25
17443,September,2020,Orange,CA,Passenger,5,3,8,464,472,1.69
17444,September,2020,Sarasota,FL,Passenger,2,0,2,23,25,8.0
17445,September,2020,Grays Harbor,WA,Passenger,115,116,231,48482,48713,0.47
17446,September,2020,Whitman,WA,Passenger,47,47,94,21996,22090,0.43
17447,September,2020,Washtenaw,MI,Passenger,1,0,1,34,35,2.86
17448,September,2020,Pinellas,FL,Passenger,1,1,2,103,105,1.9
17449,September,2020,Jones,GA,Passenger,1,0,1,1,2,50.0
17450,September,2020,Klickitat,WA,Truck,0,0,0,8105,8105,0.0
17451,September,2020,Clark,NV,Passenger,2,2,4,663,667,0.6
17452,September,2020,Rogers,OK,Passenger,1,0,1,4,5,20.0
17453,September,2020,Jefferson,WA,Passenger,257,148,405,24734,25139,1.61
17454,September,2020,Clark,WA,Truck,0,0,0,82868,82868,0.0
17455,September,2020,Los Angeles,CA,Passenger,9,11,20,976,996,2.01
17456,September,2020,Kitsap,WA,Truck,0,0,0,54186,54186,0.0
17457,September,2020,Yakima,WA,Truck,0,0,0,60573,60573,0.0
17458,September,2020,Pend Oreille,WA,Passenger,8,4,12,9189,9201,0.13
17459,September,2020,Brevard,FL,Passenger,0,1,1,81,82,1.22
17460,September,2020,Franklin,WA,Truck,0,0,0,20289,20289,0.0
17461,September,2020,Broward,FL,Passenger,1,1,2,108,110,1.82
17462,September,2020,Norfolk,VA,Passenger,2,2,4,347,351,1.14
17463,September,2020,Howard,IN,Passenger,0,1,1,3,4,25.0
17464,September,2020,Franklin,WA,Passenger,68,76,144,60928,61072,0.24
17465,September,2020,Stevens,WA,Truck,0,0,0,18704,18704,0.0
17466,September,2020,Okaloosa,FL,Passenger,0,1,1,140,141,0.71
17467,September,2020,Pima,AZ,Passenger,3,1,4,326,330,1.21
17468,September,2020,Hudson,NJ,Passenger,1,0,1,39,40,2.5
17469,September,2020,Okanogan,WA,Truck,0,0,0,16547,16547,0.0
17470,September,2020,Columbia,WA,Truck,0,0,0,1532,1532,0.0
17471,September,2020,Kitsap,WA,Passenger,1426,713,2139,179647,181786,1.18
17472,September,2021,Rogers,OK,Passenger,1,0,1,3,4,25.0
17473,September,2021,Walla Walla,WA,Truck,0,0,0,14076,14076,0.0
17474,September,2021,Hennepin,MN,Passenger,3,0,3,71,74,4.05
17475,September,2021,Nueces,TX,Passenger,1,0,1,65,66,1.52
17476,September,2021,Baltimore,MD,Passenger,1,0,1,90,91,1.1
17477,September,2021,Fort Bend,TX,Passenger,1,0,1,37,38,2.63
17478,September,2021,Montgomery,OH,Passenger,0,1,1,56,57,1.75
17479,September,2021,Lewis,WA,Truck,0,0,0,26704,26704,0.0
17480,September,2021,Grant,WA,Passenger,125,97,222,66876,67098,0.33
17481,September,2021,Houston,GA,Passenger,1,0,1,44,45,2.22
17482,September,2021,Saratoga,NY,Passenger,1,0,1,42,43,2.33
17483,September,2021,Calvert,MD,Passenger,0,2,2,85,87,2.3
17484,September,2021,Arlington,VA,Passenger,1,1,2,132,134,1.49
17485,September,2021,Orange,CA,Passenger,5,2,7,397,404,1.73
17486,September,2021,Okaloosa,FL,Passenger,0,1,1,110,111,0.9
17488,September,2021,Philadelphia,PA,Passenger,1,0,1,43,44,2.27
17489,September,2021,St. Louis,MO,Passenger,1,0,1,78,79,1.27
17490,September,2021,Sedgwick,KS,Passenger,1,1,2,81,83,2.41
17491,September,2021,Loudoun,VA,Passenger,1,0,1,70,71,1.41
17492,September,2021,Suffolk,MA,Passenger,0,2,2,27,29,6.9
17493,September,2021,Oldham,KY,Passenger,0,1,1,4,5,20.0
17494,September,2021,Skagit,WA,Truck,1,0,1,32933,32934,0.0
17495,September,2021,Cowlitz,WA,Truck,0,1,1,29037,29038,0.0
17496,September,2021,Multnomah,OR,Passenger,2,6,8,623,631,1.27
17497,September,2021,Flathead,MT,Passenger,1,0,1,43,44,2.27
17498,September,2021,San Diego,CA,Passenger,16,8,24,2494,2518,0.95
17499,September,2021,Shelby,OH,Passenger,0,1,1,2,3,33.33
17500,September,2021,Hillsborough,FL,Passenger,0,1,1,144,145,0.69
17501,September,2021,Vigo,IN,Passenger,1,0,1,5,6,16.67
17502,September,2021,Walla Walla,WA,Passenger,128,82,210,36440,36650,0.57
17503,September,2021,Leavenworth,KS,Passenger,0,1,1,112,113,0.88
17504,September,2021,Duval,FL,Passenger,0,2,2,325,327,0.61
17505,September,2021,Frederick,MD,Passenger,1,1,2,68,70,2.86
17506,September,2021,Sacramento,CA,Passenger,2,0,2,218,220,0.91
17507,September,2021,El Paso,TX,Passenger,3,0,3,355,358,0.84
17508,September,2021,Kittitas,WA,Truck,0,0,0,14782,14782,0.0
17509,September,2021,Sonoma,CA,Passenger,0,1,1,82,83,1.2
17510,September,2021,Mason,WA,Passenger,239,151,390,47982,48372,0.81
17511,September,2021,Columbia,WA,Passenger,7,2,9,2451,2460,0.37
17512,September,2021,Travis,TX,Passenger,3,3,6,134,140,4.29
17513,September,2021,Erie,NY,Passenger,1,0,1,32,33,3.03
17514,September,2021,Franklin,WA,Passenger,138,100,238,62127,62365,0.38
17515,September,2021,Clackamas,OR,Passenger,2,0,2,163,165,1.21
17516,September,2021,Yakima,WA,Passenger,257,164,421,168958,169379,0.25
17517,September,2021,Broward,FL,Passenger,2,0,2,99,101,1.98
17518,September,2021,Goochland,VA,Passenger,3,2,5,202,207,2.42
17519,September,2021,Clark,NV,Passenger,4,2,6,584,590,1.02
17520,September,2021,Saginaw,MI,Passenger,1,0,1,5,6,16.67
17521,September,2021,Skagit,WA,Passenger,641,291,932,91682,92614,1.01
17522,September,2021,Clark,WA,Passenger,3150,1486,4636,321804,326440,1.42
17523,September,2021,Ferry,WA,Passenger,10,3,13,4403,4416,0.29
17524,September,2021,Essex,NJ,Passenger,2,0,2,10,12,16.67
17525,September,2021,Owyhee,ID,Passenger,1,0,1,2,3,33.33
17526,September,2021,Douglas,WA,Passenger,103,51,154,28572,28726,0.54
17527,September,2021,Chelan,WA,Truck,0,0,0,23103,23103,0.0
17528,September,2021,Suffolk,VA,Passenger,1,0,1,126,127,0.79
17529,September,2021,Geary,KS,Passenger,1,0,1,97,98,1.02
17530,September,2021,Louisa,VA,Passenger,0,1,1,1,2,50.0
17531,September,2021,Wahkiakum,WA,Passenger,16,8,24,3071,3095,0.78
17532,September,2021,Pierce,WA,Truck,0,0,0,145459,145459,0.0
17533,September,2021,RÃ­o Grande,PR,Passenger,1,0,1,0,1,100.0
17534,September,2021,Anchorage,AK,Passenger,1,0,1,134,135,0.74
17535,September,2021,Wichita,TX,Passenger,1,0,1,41,42,2.38
17536,September,2021,Thurston,WA,Passenger,1751,908,2659,197543,200202,1.33
17537,September,2021,Hamilton,IN,Passenger,2,0,2,28,30,6.67
17538,September,2021,San Luis Obispo,CA,Passenger,1,0,1,59,60,1.67
17539,September,2021,Rockdale,GA,Passenger,1,0,1,7,8,12.5
17540,September,2021,Manassas,VA,Passenger,0,1,1,7,8,12.5
17541,September,2021,San Joaquin,CA,Passenger,1,1,2,97,99,2.02
17542,September,2021,Hidalgo,TX,Passenger,0,1,1,53,54,1.85
17543,September,2021,Kitsap,WA,Truck,0,0,0,54327,54327,0.0
17544,September,2021,Columbia,WA,Truck,0,0,0,1537,1537,0.0
17545,September,2021,Thurston,WA,Truck,0,0,0,56349,56349,0.0
17546,September,2021,Hudson,NJ,Passenger,1,0,1,40,41,2.44
17547,September,2021,Danville,VA,Passenger,1,0,1,0,1,100.0
17548,September,2021,Snohomish,WA,Truck,1,0,1,125958,125959,0.0
17549,September,2021,Douglas,NE,Passenger,1,1,2,48,50,4.0
17550,September,2021,Pennington,SD,Passenger,1,0,1,31,32,3.12
17551,September,2021,Lee,FL,Passenger,1,0,1,34,35,2.86
17552,September,2021,Allegheny,PA,Passenger,1,1,2,63,65,3.08
17553,September,2021,Okanogan,WA,Truck,0,0,0,16701,16701,0.0
17554,September,2021,Burlington,NJ,Passenger,0,1,1,119,120,0.83
17555,September,2021,Ferry,WA,Truck,0,0,0,3592,3592,0.0
17556,September,2021,Sarasota,FL,Passenger,2,0,2,28,30,6.67
17557,September,2021,Juneau,AK,Passenger,0,1,1,26,27,3.7
17558,September,2021,Howard,IN,Passenger,0,1,1,6,7,14.29
17559,September,2021,DuPage,IL,Passenger,1,0,1,52,53,1.89
17560,September,2021,Randolph,NC,Passenger,1,0,1,5,6,16.67
17561,September,2021,St. Mary's,MD,Passenger,1,0,1,203,204,0.49
17562,September,2021,Adams,WA,Truck,0,0,0,5403,5403,0.0
17563,September,2021,Los Angeles,CA,Passenger,7,9,16,847,863,1.85
17564,September,2021,Honolulu,HI,Passenger,5,3,8,364,372,2.15
17565,September,2021,Carroll,NH,Passenger,0,1,1,5,6,16.67
17566,September,2021,Whatcom,WA,Truck,4,0,4,43814,43818,0.01
17567,September,2021,Gwinnett,GA,Passenger,1,0,1,57,58,1.72
17568,September,2021,Norfolk,VA,Passenger,3,3,6,309,315,1.9
17569,September,2021,Washington,MD,Passenger,2,0,2,13,15,13.33
17570,September,2021,Ventura,CA,Passenger,1,2,3,253,256,1.17
17571,September,2021,Jefferson,NY,Passenger,0,1,1,208,209,0.48
17572,September,2021,Kittitas,WA,Passenger,180,72,252,29865,30117,0.84
17573,September,2021,El Paso,CO,Passenger,3,0,3,656,659,0.46
17574,September,2021,Kauai,HI,Passenger,1,0,1,17,18,5.56
17575,September,2021,Montgomery,PA,Passenger,2,0,2,22,24,8.33
17576,September,2021,Santa Cruz,CA,Passenger,1,0,1,25,26,3.85
17577,September,2021,Missoula,MT,Passenger,1,0,1,52,53,1.89
17578,September,2021,Spokane,WA,Passenger,1187,703,1890,326207,328097,0.58
17579,September,2021,Bexar,TX,Passenger,3,4,7,499,506,1.38
17580,September,2021,New London,CT,Passenger,1,4,5,210,215,2.33
17581,September,2021,Moore,NC,Passenger,0,1,1,123,124,0.81
17582,September,2021,Lake,FL,Passenger,1,0,1,22,23,4.35
17583,September,2021,Richland,SC,Passenger,0,1,1,132,133,0.75
17584,September,2021,Whitman,WA,Truck,0,0,0,8558,8558,0.0
17585,September,2021,Harrison,MS,Passenger,2,0,2,50,52,3.85
17586,September,2021,San Francisco,CA,Passenger,0,1,1,82,83,1.2
17587,September,2021,King,WA,Truck,5,1,6,183901,183907,0.0
17588,September,2021,Penobscot,ME,Passenger,0,1,1,8,9,11.11
17589,September,2021,Mason,WA,Truck,0,0,0,21291,21291,0.0
17590,September,2021,Lincoln,WA,Passenger,7,16,23,7682,7705,0.3
17591,September,2021,Williamson,TX,Passenger,1,2,3,98,101,2.97
17592,September,2021,Polk,FL,Passenger,1,0,1,55,56,1.79
17593,September,2021,Yakima,WA,Truck,0,0,0,61737,61737,0.0
17594,September,2021,Cape May,NJ,Passenger,0,1,1,8,9,11.11
17595,September,2021,Dallas,TX,Passenger,1,0,1,146,147,0.68
17596,September,2021,Sumter,SC,Passenger,0,1,1,36,37,2.7
17597,September,2021,Portsmouth,VA,Passenger,0,1,1,77,78,1.28
17598,September,2021,Montgomery,TX,Passenger,1,1,2,36,38,5.26
17599,September,2021,Howard,MD,Passenger,0,1,1,56,57,1.75
17600,September,2021,San Mateo,CA,Passenger,1,0,1,88,89,1.12
17601,September,2021,Chesapeake,VA,Passenger,1,3,4,381,385,1.04
17602,September,2021,Salt Lake,UT,Passenger,0,1,1,156,157,0.64
17603,September,2021,Greene,MO,Passenger,0,1,1,27,28,3.57
17604,September,2021,Queens,NY,Passenger,2,0,2,44,46,4.35
17605,September,2021,Harris,TX,Passenger,1,1,2,174,176,1.14
17606,September,2021,Skamania,WA,Passenger,53,39,92,8385,8477,1.09
17607,September,2021,Miami-Dade,FL,Passenger,1,0,1,95,96,1.04
17608,September,2021,Garfield,WA,Truck,0,0,0,998,998,0.0
17609,September,2021,Fresno,CA,Passenger,1,0,1,161,162,0.62
17610,September,2021,Kings,CA,Passenger,1,0,1,320,321,0.31
17611,September,2021,Jefferson,WA,Passenger,358,186,544,24810,25354,2.15
17612,September,2021,Pend Oreille,WA,Passenger,17,7,24,9240,9264,0.26
17613,September,2021,Island,WA,Truck,0,0,0,21574,21574,0.0
17614,September,2021,Chelan,WA,Passenger,375,104,479,54762,55241,0.87
17615,September,2021,Lane,OR,Passenger,0,1,1,115,116,0.86
17616,September,2021,Richmond,GA,Passenger,0,1,1,72,73,1.37
17617,September,2021,Albemarle,VA,Passenger,1,0,1,19,20,5.0
17618,September,2021,Pierce,WA,Passenger,3877,2069,5946,559042,564988,1.05
17619,September,2021,Skamania,WA,Truck,0,0,0,4043,4043,0.0
17620,September,2021,Garfield,WA,Passenger,0,3,3,1366,1369,0.22
17621,September,2021,Camden,NJ,Passenger,0,1,1,14,15,6.67
17622,September,2021,Larimer,CO,Passenger,1,0,1,47,48,2.08
17623,September,2021,Champaign,IL,Passenger,1,0,1,10,11,9.09
17624,September,2021,Pima,AZ,Passenger,1,1,2,255,257,0.78
17625,September,2021,Stafford,VA,Passenger,2,1,3,95,98,3.06
17626,September,2021,Franklin,WA,Truck,0,0,0,20718,20718,0.0
17627,September,2021,Grant,WA,Truck,0,0,0,28010,28010,0.0
17628,September,2021,Douglas,WA,Truck,0,0,0,12713,12713,0.0
17629,September,2021,Lincoln,WA,Truck,0,0,0,4784,4784,0.0
17630,September,2021,Clark,WA,Truck,0,0,0,84157,84157,0.0
17631,September,2021,Benton,WA,Truck,0,0,0,43672,43672,0.0
17632,September,2021,Ulster,NY,Passenger,1,0,1,8,9,11.11
17633,September,2021,Carroll,MD,Passenger,0,1,1,16,17,5.88
17634,September,2021,Stevens,WA,Truck,0,0,0,18892,18892,0.0
17635,September,2021,New Haven,CT,Passenger,0,2,2,28,30,6.67
17636,September,2021,Grays Harbor,WA,Truck,0,0,0,21400,21400,0.0
17637,September,2021,Kitsap,WA,Passenger,1993,907,2900,180805,183705,1.58
17638,September,2021,Cook,IL,Passenger,2,0,2,201,203,0.99
17639,September,2021,Alameda,CA,Passenger,4,0,4,221,225,1.78
17640,September,2021,Rockingham,NH,Passenger,1,0,1,19,20,5.0
17641,September,2021,Spokane,WA,Truck,0,0,0,102568,102568,0.0
17642,September,2021,Richmond,NY,Passenger,1,0,1,8,9,11.11
17643,September,2021,Contra Costa,CA,Passenger,2,4,6,263,269,2.23
17644,September,2021,Prince William,VA,Passenger,1,1,2,205,207,0.97
17645,September,2021,Asotin,WA,Passenger,20,17,37,12736,12773,0.29
17646,September,2021,Wake,NC,Passenger,1,0,1,113,114,0.88
17647,September,2021,Cowlitz,WA,Passenger,246,154,400,72035,72435,0.55
17648,September,2021,Lewis,WA,Passenger,185,149,334,59589,59923,0.56
17649,September,2021,Spartanburg,SC,Passenger,0,1,1,48,49,2.04
17650,September,2021,Wilson,TX,Passenger,0,1,1,2,3,33.33
17651,September,2021,Yamhill,OR,Passenger,1,0,1,31,32,3.12
17652,September,2021,Lake,IL,Passenger,2,0,2,155,157,1.27
17653,September,2021,Williams,ND,Passenger,0,1,1,8,9,11.11
17654,September,2021,Maricopa,AZ,Passenger,7,3,10,1092,1102,0.91
17655,September,2021,Kings,NY,Passenger,1,0,1,67,68,1.47
17656,September,2021,Adams,WA,Passenger,16,14,30,13045,13075,0.23
17657,September,2021,Orange,FL,Passenger,1,0,1,108,109,0.92
17658,September,2021,San Juan,WA,Truck,0,0,0,5983,5983,0.0
17659,September,2021,Snohomish,WA,Passenger,6456,2164,8620,539501,548121,1.57
17660,September,2021,Plaquemines,LA,Passenger,0,1,1,17,18,5.56
17661,September,2021,Carson City,NV,Passenger,1,0,1,10,11,9.09
17662,September,2021,Harnett,NC,Passenger,1,1,2,156,158,1.27
17663,September,2021,Fairfax,VA,Passenger,5,4,9,673,682,1.32
17664,September,2021,Pend Oreille,WA,Truck,0,0,0,5690,5690,0.0
17665,September,2021,Nassau,NY,Passenger,2,0,2,25,27,7.41
17666,September,2021,Douglas,CO,Passenger,0,1,1,76,77,1.3
17667,September,2021,Ray,MO,Passenger,0,1,1,1,2,50.0
17668,September,2021,Milwaukee,WI,Passenger,1,0,1,38,39,2.56
17669,September,2021,Prince George's,MD,Passenger,2,1,3,137,140,2.14
17670,September,2021,Wahkiakum,WA,Truck,0,0,0,1815,1815,0.0
17671,September,2021,Jefferson,WA,Truck,0,0,0,9619,9619,0.0
17672,September,2021,St. Clair,IL,Passenger,2,0,2,127,129,1.55
17673,September,2021,Clallam,WA,Passenger,359,229,588,50550,51138,1.15
17674,September,2021,Wilson,NC,Passenger,1,0,1,0,1,100.0
17675,September,2021,Whitman,WA,Passenger,64,56,120,21929,22049,0.54
17676,September,2021,Denton,TX,Passenger,1,0,1,74,75,1.33
17677,September,2021,Grays Harbor,WA,Passenger,183,150,333,49489,49822,0.67
17678,September,2021,Platte,MO,Passenger,1,0,1,16,17,5.88
17679,September,2021,King,WA,Passenger,32879,9690,42569,1365552,1408121,3.02
17680,September,2021,Boulder,CO,Passenger,0,1,1,39,40,2.5
17681,September,2021,Charles,MD,Passenger,1,1,2,67,69,2.9
17682,September,2021,Monterey,CA,Passenger,0,1,1,143,144,0.69
17683,September,2021,Benton,WA,Passenger,581,414,995,136268,137263,0.72
17684,September,2021,Klamath,OR,Passenger,1,0,1,28,29,3.45
17685,September,2021,Pacific,WA,Truck,0,0,0,7998,7998,0.0
17686,September,2021,Riverside,CA,Passenger,4,1,5,522,527,0.95
17687,September,2021,Virginia Beach,VA,Passenger,2,0,2,590,592,0.34
17688,September,2021,Okanogan,WA,Passenger,67,44,111,26541,26652,0.42
17689,September,2021,DeKalb,GA,Passenger,1,0,1,57,58,1.72
17690,September,2021,Las Animas,CO,Passenger,1,0,1,0,1,100.0
17691,September,2021,Asotin,WA,Truck,0,0,0,6755,6755,0.0
17692,September,2021,Alexandria,VA,Passenger,2,0,2,122,124,1.61
17693,September,2021,Sevier,AR,Passenger,0,1,1,0,1,100.0
17694,September,2021,Hawaii,HI,Passenger,1,0,1,42,43,2.33
17695,September,2021,Escambia,FL,Passenger,0,1,1,143,144,0.69
17696,September,2021,Onslow,NC,Passenger,0,1,1,174,175,0.57
17697,September,2021,Middlesex,MA,Passenger,1,1,2,87,89,2.25
17698,September,2021,Placer,CA,Passenger,2,0,2,70,72,2.78
17699,September,2021,Santa Clara,CA,Passenger,8,2,10,241,251,3.98
17700,September,2021,Whatcom,WA,Passenger,1540,641,2181,150546,152727,1.43
17701,September,2021,Kern,CA,Passenger,0,1,1,197,198,0.51
17702,September,2021,Pinellas,FL,Passenger,0,1,1,90,91,1.1
17703,September,2021,Charleston,SC,Passenger,2,1,3,81,84,3.57
17704,September,2021,Montgomery,MD,Passenger,3,2,5,206,211,2.37
17705,September,2021,Allen,IN,Passenger,1,0,1,15,16,6.25
17706,September,2021,Stevens,WA,Passenger,51,42,93,30327,30420,0.31
17707,September,2021,Island,WA,Passenger,661,329,990,63226,64216,1.54
17708,September,2021,Pacific,WA,Passenger,49,57,106,16073,16179,0.66
17709,September,2021,Bartow,GA,Passenger,0,1,1,3,4,25.0
17710,September,2021,Anne Arundel,MD,Passenger,4,3,7,368,375,1.87
17711,September,2021,New York,NY,Passenger,1,0,1,38,39,2.56
17712,September,2021,District of Columbia,DC,Passenger,5,0,5,196,201,2.49
17713,September,2021,Cumberland,NC,Passenger,0,2,2,404,406,0.49
17714,September,2021,Powhatan,VA,Passenger,1,0,1,1,2,50.0
17715,September,2021,Washington,OR,Passenger,1,0,1,363,364,0.27
17716,September,2021,Klickitat,WA,Passenger,83,51,134,15391,15525,0.86
17717,September,2021,Collin,TX,Passenger,1,0,1,102,103,0.97
17718,September,2021,San Juan,WA,Passenger,462,143,605,14187,14792,4.09
17719,September,2021,Klickitat,WA,Truck,0,0,0,8341,8341,0.0
17720,September,2021,Fairbanks North Star,AK,Passenger,0,1,1,79,80,1.25
17721,September,2021,Boone,MO,Passenger,0,1,1,9,10,10.0
17722,September,2021,Clallam,WA,Truck,1,0,1,22018,22019,0.0
17723,September,2022,Calvert,MD,Passenger,0,2,2,74,76,2.63
17724,September,2022,Pend Oreille,WA,Truck,0,0,0,5638,5638,0.0
17725,September,2022,St. Louis,MO,Passenger,1,0,1,55,56,1.79
17726,September,2022,Douglas,WA,Truck,1,0,1,12781,12782,0.01
17727,September,2022,Walla Walla,WA,Truck,2,0,2,13946,13948,0.01
17728,September,2022,Collin,TX,Passenger,2,0,2,67,69,2.9
17729,September,2022,Skagit,WA,Passenger,869,349,1218,89712,90930,1.34
17730,September,2022,Denton,TX,Passenger,1,0,1,57,58,1.72
17731,September,2022,Grays Harbor,WA,Passenger,224,166,390,48799,49189,0.79
17732,September,2022,Randolph,NC,Passenger,1,0,1,5,6,16.67
17733,September,2022,Thurston,WA,Passenger,2380,1102,3482,192946,196428,1.77
17734,September,2022,Ventura,CA,Passenger,2,1,3,218,221,1.36
17735,September,2022,Whitman,WA,Passenger,96,64,160,21991,22151,0.72
17736,September,2022,Anchorage,AK,Passenger,1,0,1,107,108,0.93
17737,September,2022,Kootenai,ID,Truck,1,0,1,33,34,2.94
17738,September,2022,King,WA,Passenger,43484,11789,55273,1345189,1400462,3.95
17739,September,2022,Juneau,AK,Passenger,0,1,1,28,29,3.45
17740,September,2022,Broward,FL,Passenger,1,0,1,67,68,1.47
17741,September,2022,Galveston,TX,Passenger,0,1,1,17,18,5.56
17742,September,2022,St. Mary's,MD,Passenger,1,0,1,178,179,0.56
17743,September,2022,Skagit,WA,Truck,6,0,6,32229,32235,0.02
17744,September,2022,Bartow,GA,Passenger,0,1,1,3,4,25.0
17745,September,2022,Essex,NJ,Passenger,2,0,2,8,10,20.0
17746,September,2022,Fairbanks North Star,AK,Passenger,0,1,1,64,65,1.54
17747,September,2022,Wood,OH,Passenger,0,1,1,3,4,25.0
17748,September,2022,King,WA,Truck,241,2,243,179679,179922,0.14
17749,September,2022,Columbia,WA,Passenger,8,0,8,2439,2447,0.33
17750,September,2022,Clark,WA,Truck,19,0,19,82316,82335,0.02
17751,September,2022,Fairfax,VA,Truck,1,0,1,106,107,0.93
17752,September,2022,Lewis,WA,Truck,1,0,1,26365,26366,0.0
17753,September,2022,Clark,WA,Passenger,4480,1890,6370,315618,321988,1.98
17754,September,2022,Okaloosa,FL,Passenger,0,1,1,93,94,1.06
17755,September,2022,Wichita,TX,Passenger,2,0,2,35,37,5.41
17756,September,2022,Salt Lake,UT,Passenger,1,1,2,112,114,1.75
17757,September,2022,Santa Cruz,CA,Passenger,1,0,1,19,20,5.0
17758,September,2022,El Paso,TX,Passenger,2,0,2,301,303,0.66
17759,September,2022,Arapahoe,CO,Passenger,0,1,1,70,71,1.41
17760,September,2022,Allen,IN,Passenger,1,0,1,12,13,7.69
17761,September,2022,Pacific,WA,Truck,0,0,0,7871,7871,0.0
17762,September,2022,Benton,WA,Passenger,833,480,1313,135629,136942,0.96
17763,September,2022,Monterey,CA,Passenger,1,1,2,118,120,1.67
17764,September,2022,Napa,CA,Passenger,0,1,1,10,11,9.09
17765,September,2022,Pacific,WA,Passenger,70,74,144,15784,15928,0.9
17766,September,2022,Hudson,NJ,Passenger,2,0,2,30,32,6.25
17767,September,2022,Cowlitz,WA,Passenger,368,180,548,70395,70943,0.77
17768,September,2022,Klickitat,WA,Truck,2,0,2,8263,8265,0.02
17769,September,2022,Grant,WA,Passenger,200,108,308,66776,67084,0.46
17770,September,2022,Douglas,CO,Passenger,0,1,1,62,63,1.59
17771,September,2022,Fairfax,VA,Passenger,6,3,9,579,588,1.53
17772,September,2022,Allegheny,PA,Passenger,1,1,2,49,51,3.92
17773,September,2022,Chelan,WA,Passenger,495,135,630,54143,54773,1.15
17774,September,2022,Lincoln,WA,Passenger,10,16,26,7725,7751,0.34
17775,September,2022,Oldham,KY,Passenger,0,1,1,4,5,20.0
17776,September,2022,Suffolk,VA,Passenger,1,0,1,116,117,0.85
17777,September,2022,San Diego,CA,Passenger,17,10,27,2135,2162,1.25
17778,September,2022,Portsmouth,VA,Passenger,0,1,1,72,73,1.37
17779,September,2022,Stevens,WA,Passenger,81,56,137,30090,30227,0.45
17780,September,2022,Pierce,WA,Passenger,5530,2431,7961,541956,549917,1.45
17781,September,2022,St. Clair,IL,Passenger,2,0,2,114,116,1.72
17782,September,2022,Richmond,GA,Passenger,0,1,1,58,59,1.69
17783,September,2022,Lane,OR,Passenger,0,1,1,78,79,1.27
17784,September,2022,Yakima,WA,Passenger,376,210,586,166551,167137,0.35
17785,September,2022,Travis,TX,Passenger,1,0,1,95,96,1.04
17786,September,2022,Douglas,WA,Passenger,147,61,208,28445,28653,0.73
17787,September,2022,Bexar,TX,Passenger,5,3,8,401,409,1.96
17788,September,2022,Hoke,NC,Passenger,1,0,1,59,60,1.67
17789,September,2022,Whatcom,WA,Truck,14,0,14,43119,43133,0.03
17790,September,2022,Kings,CA,Passenger,2,1,3,286,289,1.04
17791,September,2022,Burlington,NJ,Passenger,0,2,2,99,101,1.98
17792,September,2022,Frederick,MD,Passenger,1,0,1,58,59,1.69
17793,September,2022,Charleston,SC,Passenger,2,2,4,56,60,6.67
17794,September,2022,Ray,MO,Passenger,0,1,1,1,2,50.0
17795,September,2022,Carroll,MD,Passenger,0,1,1,17,18,5.56
17796,September,2022,Grant,WA,Truck,2,0,2,28018,28020,0.01
17797,September,2022,Spokane,WA,Passenger,1770,889,2659,324764,327423,0.81
17798,September,2022,Island,WA,Truck,10,0,10,21293,21303,0.05
17799,September,2022,Solano,CA,Passenger,2,0,2,151,153,1.31
17800,September,2022,Asotin,WA,Passenger,25,19,44,12615,12659,0.35
17801,September,2022,Rockdale,GA,Passenger,1,0,1,6,7,14.29
17802,September,2022,Hawaii,HI,Passenger,1,0,1,30,31,3.23
17803,September,2022,Sheridan,WY,Passenger,1,0,1,5,6,16.67
17804,September,2022,Jefferson,WA,Truck,3,0,3,9383,9386,0.03
17805,September,2022,Howard,MD,Passenger,0,1,1,51,52,1.92
17806,September,2022,Richmond,NY,Passenger,1,0,1,6,7,14.29
17807,September,2022,Snohomish,WA,Truck,59,0,59,123094,123153,0.05
17808,September,2022,Alameda,CA,Passenger,4,0,4,169,173,2.31
17809,September,2022,Wahkiakum,WA,Truck,1,0,1,1801,1802,0.06
17810,September,2022,Owyhee,ID,Passenger,1,0,1,3,4,25.0
17811,September,2022,Asotin,WA,Truck,0,0,0,6710,6710,0.0
17812,September,2022,Kern,CA,Passenger,1,1,2,188,190,1.05
17813,September,2022,Saratoga,NY,Passenger,1,0,1,37,38,2.63
17814,September,2022,Bryan,GA,Passenger,0,1,1,37,38,2.63
17815,September,2022,Elmore,ID,Passenger,1,0,1,12,13,7.69
17816,September,2022,Nueces,TX,Passenger,1,1,2,49,51,3.92
17817,September,2022,Lake,FL,Passenger,1,0,1,16,17,5.88
17818,September,2022,Whitman,WA,Truck,2,0,2,8588,8590,0.02
17819,September,2022,Plaquemines,LA,Passenger,1,1,2,16,18,11.11
17820,September,2022,San Joaquin,CA,Passenger,1,0,1,78,79,1.27
17821,September,2022,Montgomery,AL,Passenger,0,1,1,32,33,3.03
17822,September,2022,Franklin,WA,Passenger,231,112,343,61926,62269,0.55
17823,September,2022,Yakima,WA,Truck,3,0,3,61428,61431,0.0
17824,September,2022,Cook,IL,Passenger,2,0,2,164,166,1.2
17825,September,2022,Rockingham,NH,Passenger,1,0,1,13,14,7.14
17826,September,2022,Klickitat,WA,Passenger,109,53,162,15150,15312,1.06
17827,September,2022,Wilson,TX,Passenger,0,1,1,2,3,33.33
17828,September,2022,Yellowstone,MT,Passenger,0,1,1,19,20,5.0
17829,September,2022,Grays Harbor,WA,Truck,2,0,2,21184,21186,0.01
17830,September,2022,Spartanburg,SC,Passenger,0,1,1,32,33,3.03
17831,September,2022,Montgomery,MD,Passenger,4,2,6,178,184,3.26
17832,September,2022,Middlesex,MA,Passenger,2,1,3,65,68,4.41
17833,September,2022,Virginia Beach,VA,Passenger,2,0,2,481,483,0.41
17834,September,2022,Philadelphia,PA,Passenger,1,0,1,37,38,2.63
17835,September,2022,Columbia,WA,Truck,0,0,0,1577,1577,0.0
17836,September,2022,Moore,NC,Passenger,0,1,1,107,108,0.93
17837,September,2022,Onslow,NC,Passenger,0,1,1,157,158,0.63
17838,September,2022,Dorchester,SC,Passenger,1,0,1,48,49,2.04
17839,September,2022,New London,CT,Passenger,2,4,6,186,192,3.12
17840,September,2022,El Paso,CO,Passenger,3,1,4,548,552,0.72
17841,September,2022,Adams,WA,Truck,1,0,1,5425,5426,0.02
17842,September,2022,Okanogan,WA,Truck,1,0,1,16528,16529,0.01
17843,September,2022,Wahkiakum,WA,Passenger,24,12,36,3078,3114,1.16
17844,September,2022,Clackamas,OR,Passenger,1,0,1,128,129,0.78
17845,September,2022,Escambia,FL,Passenger,0,1,1,121,122,0.82
17846,September,2022,Garfield,WA,Truck,0,0,0,970,970,0.0
17847,September,2022,San Bernardino,CA,Passenger,1,1,2,295,297,0.67
17848,September,2022,San Mateo,CA,Passenger,1,0,1,70,71,1.41
17849,September,2022,Kitsap,WA,Passenger,2572,1110,3682,177870,181552,2.03
17850,September,2022,Stevens,WA,Truck,1,0,1,18922,18923,0.01
17851,September,2022,Leavenworth,KS,Passenger,0,1,1,94,95,1.05
17852,September,2022,Pulaski,AR,Passenger,1,0,1,27,28,3.57
17853,September,2022,Cowlitz,WA,Truck,3,0,3,28470,28473,0.01
17854,September,2022,Ulster,NY,Passenger,1,0,1,7,8,12.5
17855,September,2022,Kittitas,WA,Passenger,290,91,381,29618,29999,1.27
17856,September,2022,Sedgwick,KS,Passenger,1,1,2,65,67,2.99
17857,September,2022,Goochland,VA,Passenger,0,1,1,83,84,1.19
17858,September,2022,San Juan,WA,Truck,6,0,6,5955,5961,0.1
17859,September,2022,Lewis,WA,Passenger,252,176,428,59836,60264,0.71
17860,September,2022,DeKalb,GA,Passenger,1,0,1,42,43,2.33
17861,September,2022,Orange,CA,Passenger,5,2,7,313,320,2.19
17862,September,2022,Polk,OR,Passenger,0,1,1,20,21,4.76
17863,September,2022,San Juan,WA,Passenger,536,162,698,14006,14704,4.75
17864,September,2022,Lincoln,OR,Passenger,0,1,1,22,23,4.35
17865,September,2022,Las Animas,CO,Passenger,1,0,1,1,2,50.0
17866,September,2022,Thurston,WA,Truck,21,0,21,55058,55079,0.04
17867,September,2022,Adams,CO,Passenger,1,0,1,36,37,2.7
17868,September,2022,Lincoln,WA,Truck,0,0,0,4853,4853,0.0
17869,September,2022,Sevier,AR,Passenger,0,1,1,0,1,100.0
17870,September,2022,District of Columbia,DC,Passenger,4,0,4,158,162,2.47
17871,September,2022,Charles,MD,Passenger,1,1,2,52,54,3.7
17872,September,2022,Contra Costa,CA,Passenger,0,3,3,222,225,1.33
17873,September,2022,Louisa,VA,Passenger,0,1,1,1,2,50.0
17874,September,2022,Franklin,WA,Truck,2,0,2,20933,20935,0.01
17875,September,2022,Ferry,WA,Truck,0,0,0,3616,3616,0.0
17877,September,2022,Alexandria,VA,Passenger,3,0,3,99,102,2.94
17878,September,2022,Cape May,NJ,Passenger,0,1,1,7,8,12.5
17879,September,2022,Camden,NJ,Passenger,0,1,1,12,13,7.69
17880,September,2022,Cumberland,NC,Passenger,1,2,3,330,333,0.9
17881,September,2022,Harrison,MS,Passenger,1,0,1,35,36,2.78
17882,September,2022,Chelan,WA,Truck,6,0,6,23093,23099,0.03
17883,September,2022,Multnomah,OR,Passenger,0,3,3,482,485,0.62
17884,September,2022,Snohomish,WA,Passenger,9066,2624,11690,531280,542970,2.15
17885,September,2022,Pennington,SD,Passenger,2,0,2,24,26,7.69
17886,September,2022,Benton,WA,Truck,5,0,5,43402,43407,0.01
17887,September,2022,Skamania,WA,Passenger,85,51,136,8126,8262,1.65
17888,September,2022,Stafford,VA,Passenger,2,1,3,83,86,3.49
17889,September,2022,Harnett,NC,Passenger,2,0,2,135,137,1.46
17890,September,2022,Maricopa,AZ,Passenger,7,1,8,771,779,1.03
17891,September,2022,Jackson,OK,Passenger,0,1,1,32,33,3.03
17892,September,2022,Penobscot,ME,Passenger,0,1,1,8,9,11.11
17893,September,2022,Sacramento,CA,Passenger,3,0,3,181,184,1.63
17894,September,2022,Boulder,CO,Passenger,1,0,1,31,32,3.12
17895,September,2022,Santa Clara,CA,Passenger,10,2,12,194,206,5.83
17896,September,2022,Adams,WA,Passenger,22,10,32,13017,13049,0.25
17897,September,2022,Lake,IL,Passenger,2,0,2,121,123,1.63
17898,September,2022,Sonoma,CA,Passenger,0,1,1,67,68,1.47
17899,September,2022,Dallas,TX,Passenger,1,0,1,95,96,1.04
17900,September,2022,Garfield,WA,Passenger,1,3,4,1324,1328,0.3
17901,September,2022,Anne Arundel,MD,Passenger,4,4,8,318,326,2.45
17902,September,2022,Honolulu,HI,Passenger,3,3,6,301,307,1.95
17903,September,2022,Washington,MD,Passenger,2,0,2,15,17,11.76
17904,September,2022,Geary,KS,Passenger,1,0,1,80,81,1.23
17905,September,2022,Okanogan,WA,Passenger,93,49,142,26316,26458,0.54
17906,September,2022,Whatcom,WA,Passenger,1952,772,2724,148826,151550,1.8
17907,September,2022,Riverside,CA,Passenger,7,0,7,425,432,1.62
17908,September,2022,Mason,WA,Truck,4,0,4,21008,21012,0.02
17909,September,2022,Platte,MO,Passenger,1,0,1,21,22,4.55
17910,September,2022,Hennepin,MN,Passenger,1,0,1,43,44,2.27
17911,September,2022,Island,WA,Passenger,877,382,1259,61751,63010,2.0
17912,September,2022,Hidalgo,TX,Passenger,0,1,1,53,54,1.85
17913,September,2022,Norfolk,VA,Passenger,3,3,6,275,281,2.14
17914,September,2022,Walla Walla,WA,Passenger,187,105,292,35831,36123,0.81
17915,September,2022,Tarrant,TX,Passenger,1,0,1,93,94,1.06
17916,September,2022,Sumter,SC,Passenger,0,1,1,32,33,3.03
17917,September,2022,Harris,TX,Passenger,1,0,1,127,128,0.78
17918,September,2022,Chesapeake,VA,Passenger,3,3,6,306,312,1.92
17919,September,2022,Spokane,WA,Truck,12,0,12,101973,101985,0.01
17920,September,2022,Danville,VA,Passenger,1,0,1,0,1,100.0
17921,September,2022,Sarpy,NE,Passenger,1,0,1,49,50,2.0
17922,September,2022,Kitsap,WA,Truck,23,0,23,53242,53265,0.04
17923,September,2022,St. Tammany,LA,Passenger,1,0,1,33,34,2.94
17924,September,2022,Jefferson,WA,Passenger,454,224,678,24444,25122,2.7
17925,September,2022,Rock Island,IL,Passenger,0,1,1,15,16,6.25
17926,September,2022,Bell,TX,Passenger,1,0,1,292,293,0.34
17927,September,2022,Arlington,VA,Passenger,1,0,1,114,115,0.87
17928,September,2022,Douglas,NE,Passenger,2,2,4,34,38,10.53
17929,September,2022,Berkeley,SC,Passenger,0,1,1,112,113,0.88
17930,September,2022,Pierce,WA,Truck,46,0,46,140496,140542,0.03
17931,September,2022,Pend Oreille,WA,Passenger,18,12,30,9024,9054,0.33
17932,September,2022,Clallam,WA,Passenger,442,249,691,49482,50173,1.38
17933,September,2022,Hillsborough,FL,Passenger,0,1,1,111,112,0.89
17934,September,2022,Cumberland,PA,Passenger,1,0,1,35,36,2.78
17935,September,2022,Lee,FL,Passenger,1,0,1,24,25,4.0
17936,September,2022,Miami-Dade,FL,Passenger,1,0,1,71,72,1.39
17937,September,2022,Duval,FL,Passenger,1,2,3,254,257,1.17
17938,September,2022,Williams,ND,Passenger,0,1,1,5,6,16.67
17939,September,2022,Los Angeles,CA,Passenger,7,6,13,695,708,1.84
17940,September,2022,Loudoun,VA,Passenger,2,1,3,62,65,4.62
17941,September,2022,Clallam,WA,Truck,6,0,6,21889,21895,0.03
17942,September,2022,Kauai,HI,Passenger,1,0,1,15,16,6.25
17943,September,2022,Manassas,VA,Passenger,0,1,1,8,9,11.11
17944,September,2022,Williamson,TX,Passenger,0,2,2,71,73,2.74
17945,September,2022,Hamilton,OH,Passenger,1,0,1,27,28,3.57
17946,September,2022,New Haven,CT,Passenger,0,2,2,24,26,7.69
17947,September,2022,Prince George's,MD,Passenger,3,1,4,112,116,3.45
17948,September,2022,Nassau,NY,Passenger,1,0,1,21,22,4.55
17949,September,2022,Kittitas,WA,Truck,4,0,4,14604,14608,0.03
17950,September,2022,Montgomery,PA,Passenger,1,0,1,20,21,4.76
17951,September,2022,Gwinnett,GA,Passenger,1,0,1,49,50,2.0
17952,September,2022,Skamania,WA,Truck,0,0,0,3908,3908,0.0
17953,September,2022,Placer,CA,Passenger,2,0,2,61,63,3.17
17954,September,2022,Queens,NY,Passenger,1,0,1,36,37,2.7
17955,September,2022,Carroll,NH,Passenger,0,1,1,5,6,16.67
17956,September,2022,Ferry,WA,Passenger,22,4,26,4400,4426,0.59
17957,September,2022,Houston,GA,Passenger,1,0,1,30,31,3.23
17958,September,2022,Jefferson,NY,Passenger,0,1,1,195,196,0.51
17959,September,2022,Clark,NV,Passenger,4,2,6,453,459,1.31
17960,September,2022,Sarasota,FL,Passenger,1,0,1,20,21,4.76
17961,September,2022,Coryell,TX,Passenger,1,0,1,86,87,1.15
17962,September,2022,Fort Bend,TX,Passenger,1,0,1,24,25,4.0
17963,September,2022,Mason,WA,Passenger,339,178,517,46951,47468,1.09
17964,September,2022,Marin,CA,Passenger,0,1,1,27,28,3.57
